Name,Points,Assists,FGA,FG,FTAs,FTs,Minutes,3s attempts,3s,turnovers,2s attempts,2s,usage,Appear_In_NBA,Year,All_NBA,All_Star,All_NBA_or_Star
JaMychal Green,1656,152,1184,614,598,425,3340.0,17,3,312.0,1167,611,27.4,Yes,2012,No,No,No
Tony Mitchell,1128,106,929,458,227,143,2549.0,229,69,125.0,700,389,23.8,Yes,2012,No,No,No
Carrick Felix,955,125,748,341,247,174,2626.0,304,99,162.0,444,242,21.0,Yes,2012,No,No,No
Solomon Hill,1430,304,1012,487,458,341,4030.0,307,115,290.0,705,372,19.7,Yes,2012,No,No,No
Nick Johnson,1333,304,1048,441,418,307,3339.0,401,144,197.0,647,297,22.7,Yes,2012,No,No,No
James White,863,78,706,357,240,146,2188.0,15,3,157.0,691,354,22.6,Yes,2012,No,No,No
Mitchell Anderson,602,70,575,231,164,97,1687.0,162,43,110.0,413,188,23.2,Yes,2012,No,No,No
Clay Johnson,148,82,106,52,66,42,1065.0,17,2,90.0,89,50,11.1,Yes,2012,No,No,No
Mo Williams,368,93,314,110,144,101,2002.0,163,47,103.0,151,63,12.3,Yes,2012,No,Yes,Yes
Pierre Jackson,1235,478,884,390,369,298,2424.0,414,157,256.0,470,233,27.1,Yes,2012,No,No,No
Quincy Acy,1360,86,835,503,496,351,3488.0,7,3,214.0,828,500,19.1,Yes,2012,No,No,No
Quincy Miller,393,53,309,138,114,93,903.0,69,24,66.0,240,114,23.9,Yes,2012,No,No,No
Anthony Jones,738,89,600,272,155,109,2653.0,247,85,129.0,353,187,15.2,Yes,2012,No,No,No
Cory Jefferson,1159,51,794,431,424,280,2589.0,50,17,101.0,744,414,21.4,Yes,2012,No,No,No
Ian Clark,1920,289,1406,681,269,218,3818.0,800,340,277.0,606,341,23.6,Yes,2012,No,No,No
Ryan Anderson,1787,151,1295,630,706,495,3906.0,120,32,235.0,1175,598,25.9,Yes,2012,No,No,No
Dee Brown,1041,193,874,375,249,188,2773.0,279,103,164.0,595,272,21.2,Yes,2012,No,No,No
Brandon Davies,1680,213,1166,609,691,456,3251.0,18,6,283.0,1148,603,26.4,Yes,2012,No,No,No
Mike Muscala,2036,211,1443,723,695,569,3815.0,67,21,217.0,1376,702,28.4,Yes,2012,No,No,No
Eddie Miller,650,88,552,233,162,113,1562.0,196,71,115.0,356,162,25.3,Yes,2012,No,No,No
Chris McNealy,1207,277,1062,439,278,198,3480.0,355,131,177.0,707,308,19.9,Yes,2012,No,No,No
Phil Martin,951,70,792,353,218,180,2005.0,184,65,146.0,608,288,27.5,Yes,2012,No,No,No
Robert Smith,846,293,818,288,244,165,2914.0,347,105,274.0,471,183,21.6,Yes,2012,No,No,No
Orlando Johnson,2208,319,1615,738,708,510,3878.0,568,222,324.0,1047,516,31.3,Yes,2012,No,No,No
James Nunnally,1685,247,1201,558,487,382,3618.0,484,187,276.0,717,371,25.0,Yes,2012,No,No,No
Alan Williams,1732,117,1295,637,649,458,3026.0,3,0,196.0,1292,637,32.0,Yes,2012,No,No,No
Allen Crabbe,1537,219,1195,533,320,262,3402.0,547,209,182.0,648,324,23.3,Yes,2012,No,No,No
Jorge Gutierrez,1232,423,959,412,438,323,3425.0,250,85,274.0,709,327,21.8,Yes,2012,No,No,No
Joe Harris,47,5,42,19,4,0,151.0,24,9,6.0,18,10,14.9,Yes,2012,No,No,No
Terrence Williams,972,228,857,326,372,265,2930.0,195,55,244.0,662,271,21.6,Yes,2012,No,No,No
Aaron Williams,240,29,279,91,60,36,936.0,95,22,73.0,184,69,20.2,Yes,2012,No,No,No
Sean Kilpatrick,2145,279,1687,707,536,418,4315.0,901,313,236.0,786,394,26.0,Yes,2012,No,No,No
Justin Jackson,770,166,633,322,267,124,2740.0,21,2,212.0,612,320,18.3,Yes,2012,No,No,No
Devin Booker,1154,99,897,445,368,242,3089.0,80,22,199.0,817,423,21.8,Yes,2012,No,Yes,Yes
Greg Smith,1051,133,839,356,391,282,2578.0,163,57,212.0,676,299,25.1,Yes,2012,No,No,No
Andre Roberson,1012,119,741,382,340,198,2970.0,143,50,183.0,598,332,19.0,Yes,2012,No,No,No
Spencer Dinwiddie,1115,227,690,290,506,420,2590.0,298,115,153.0,392,175,21.8,Yes,2012,No,No,No
Jeremy Lamb,1060,124,828,399,180,145,2406.0,336,117,120.0,492,282,22.2,Yes,2012,No,No,No
Shabazz Napier,1959,646,1447,595,626,509,4614.0,693,260,350.0,754,335,24.0,Yes,2012,No,No,No
Andre Drummond,340,15,292,157,88,26,967.0,2,0,52.0,290,157,20.9,Yes,2012,Yes,Yes,Yes
Doug McDermott,3150,194,2075,1141,715,594,4569.0,598,274,321.0,1477,867,32.3,Yes,2012,No,No,No
Chris Johnson,1467,145,1095,468,357,295,3439.0,636,236,158.0,459,232,21.0,Yes,2012,No,No,No
Kyle Anderson,1292,138,1152,435,198,153,4048.0,780,269,149.0,372,166,17.6,Yes,2012,No,No,No
Royce O'Neale,1268,400,862,411,401,301,4057.0,363,145,258.0,499,266,18.1,Yes,2012,No,No,No
Ray McCallum,1618,451,1173,546,593,429,3519.0,335,97,233.0,838,449,23.7,Yes,2012,No,No,No
Damion Lee,2016,244,1468,636,578,487,4104.0,710,257,217.0,758,379,26.0,Yes,2012,No,No,No
Austin Rivers,527,71,402,174,184,121,1129.0,159,58,79.0,243,116,25.2,Yes,2012,No,No,No
Seth Curry,2101,290,1582,682,498,412,4357.0,825,325,225.0,757,357,23.8,Yes,2012,No,No,No
Mason Plumlee,1384,212,915,525,569,332,3652.0,10,2,282.0,905,523,20.2,Yes,2012,No,No,No
Ryan Kelly,949,117,682,314,272,219,2437.0,269,102,104.0,413,212,18.8,Yes,2012,No,No,No
Andre Dawkins,1014,66,763,330,160,123,2468.0,568,231,88.0,195,99,18.7,Yes,2012,No,No,No
Miles Plumlee,650,45,470,262,200,125,2133.0,1,1,138.0,469,261,16.2,Yes,2012,No,No,No
Quinn Cook,1571,509,1235,534,313,267,4033.0,629,236,201.0,606,298,20.2,Yes,2012,No,No,No
Michael Gbinije,1177,310,900,409,313,200,3061.0,411,159,194.0,489,250,21.1,Yes,2012,No,No,No
T.J. McConnell,1414,751,1123,550,235,176,4425.0,363,138,281.0,760,412,17.4,Yes,2012,No,No,No
Alfonzo McKinnie,689,23,536,271,193,120,1811.0,77,27,121.0,459,244,21.9,Yes,2012,No,No,No
Quintin Dailey,230,59,220,81,43,31,1049.0,112,37,60.0,108,44,15.4,Yes,2012,No,No,No
Brandon Williams,0,1,4,0,0,0,12.0,1,0,1.0,3,0,17.5,Yes,2012,No,No,No
Reggie Lewis,1176,167,1139,432,172,124,3169.0,517,188,143.0,622,244,20.3,Yes,2012,No,Yes,Yes
Bernard Thompson,1835,246,1466,636,487,344,4031.0,601,219,278.0,865,417,24.8,Yes,2012,No,No,No
Bernard James,671,24,437,274,233,123,1698.0,0,0,123.0,437,274,19.7,Yes,2012,No,No,No
Okaro White,1402,95,944,466,502,401,3417.0,211,69,217.0,733,397,21.0,Yes,2012,No,No,No
Bradley Beal,546,83,393,175,173,133,1267.0,186,63,79.0,207,112,23.0,Yes,2012,No,Yes,Yes
Erik Murphy,1052,95,773,397,152,115,2488.0,329,143,139.0,444,254,21.0,Yes,2012,No,No,No
Tyler Johnson,1350,303,1077,491,348,249,3538.0,320,119,176.0,757,372,21.5,Yes,2012,No,No,No
Jordan Loyd,165,51,150,55,62,41,588.0,54,14,46.0,96,41,20.1,Yes,2012,No,No,No
Hollis Thompson,859,105,645,308,170,115,2434.0,291,128,107.0,354,180,18.3,Yes,2012,No,No,No
Henry Sims,591,167,447,214,246,161,1822.0,17,2,158.0,430,212,21.3,Yes,2012,No,No,No
Kentavious Caldwell-Pope,1013,96,814,338,250,188,2114.0,439,149,100.0,375,189,27.0,Yes,2012,No,No,No
Marcus Thornton,829,91,687,289,361,230,2885.0,72,21,165.0,615,268,18.9,Yes,2012,No,No,No
Elias Harris,1857,177,1289,666,618,447,3785.0,219,78,242.0,1070,588,24.6,Yes,2012,No,No,No
Robert Sacre,1270,91,812,409,614,451,2946.0,4,1,220.0,808,408,22.8,Yes,2012,No,No,No
David Stockton,661,423,526,223,207,145,2741.0,229,70,202.0,297,153,15.5,Yes,2012,No,No,No
Devin Brown,1427,149,1047,439,450,358,2991.0,507,191,230.0,540,248,25.6,Yes,2012,No,No,No
Malcolm Miller,1013,164,746,332,319,244,2917.0,284,105,175.0,462,227,20.1,Yes,2012,No,No,No
Jonathon Simmons,441,65,301,154,141,101,902.0,83,32,100.0,218,122,26.1,Yes,2012,No,No,No
Joe Young,2304,351,1718,778,519,460,4333.0,739,288,221.0,979,490,25.3,Yes,2012,No,No,No
Brandon Paul,1654,310,1356,521,554,401,3665.0,650,211,312.0,706,310,27.5,Yes,2012,No,No,No
Meyers Leonard,502,48,349,198,144,105,1290.0,12,1,94.0,337,197,21.1,Yes,2012,No,No,No
Myke Henry,991,76,808,384,209,147,2344.0,228,76,178.0,580,308,23.9,Yes,2012,No,No,No
Cody Zeller,1157,92,674,399,475,359,2087.0,2,0,141.0,672,399,25.4,Yes,2012,No,No,No
Victor Oladipo,1117,175,754,406,359,257,2558.0,142,48,203.0,612,358,22.7,Yes,2012,Yes,Yes,Yes
Scott Machado,1613,880,1232,529,584,432,4143.0,360,123,440.0,872,406,23.6,Yes,2012,No,No,No
Royce White,456,170,328,175,205,102,1072.0,12,4,130.0,316,171,26.5,Yes,2012,No,No,No
Chris Babb,942,215,802,302,161,118,3448.0,613,220,102.0,189,82,14.5,Yes,2012,No,No,No
Dion Waiters,77,46,63,22,47,33,385.0,13,0,30.0,50,22,15.6,Yes,2012,No,No,No
Rodney McGruder,1576,186,1257,568,332,252,3702.0,494,188,171.0,763,380,21.3,Yes,2012,No,No,No
Thomas Robinson,1026,101,753,395,378,229,1960.0,14,7,173.0,739,388,28.3,Yes,2012,No,No,No
Tyshawn Taylor,1580,575,1156,551,506,358,4039.0,324,120,379.0,832,431,21.8,Yes,2012,No,No,No
Jeff Withey,938,69,576,327,390,283,2319.0,1,1,138.0,575,326,19.7,Yes,2012,No,No,No
Anthony Davis,567,50,337,210,203,144,1281.0,20,3,41.0,317,207,18.8,Yes,2012,Yes,Yes,Yes
Doron Lamb,1018,122,693,336,249,202,2327.0,303,144,94.0,390,192,19.9,Yes,2012,No,No,No
Michael Kidd-Gilchrist,476,75,326,160,192,143,1245.0,51,13,87.0,275,147,20.6,Yes,2012,No,No,No
Terrence Jones,1064,111,820,383,401,256,2311.0,128,42,137.0,692,341,25.4,Yes,2012,No,No,No
Marquis Teague,401,191,352,145,119,85,1303.0,80,26,109.0,272,119,20.2,Yes,2012,No,No,No
Darius Miller,1248,278,990,444,227,185,3789.0,462,175,214.0,528,269,17.3,Yes,2012,No,No,No
Kyle Wiltjer,1909,190,1417,690,341,281,3504.0,583,248,186.0,834,442,26.0,Yes,2012,No,No,No
Mike James,847,107,709,313,183,147,1437.0,218,74,106.0,491,239,29.1,Yes,2012,No,No,No
Stan Brown,679,38,544,252,273,175,2085.0,4,0,120.0,540,252,18.1,Yes,2012,No,No,No
Jordan Hamilton,403,45,327,139,89,67,1375.0,179,58,63.0,148,81,15.7,Yes,2012,No,No,No
Marvin Williams,493,24,413,205,132,81,1372.0,9,2,95.0,404,203,21.6,Yes,2012,No,No,No
Casper Ware,1841,545,1458,586,582,456,4319.0,610,213,368.0,848,373,25.1,Yes,2012,No,No,No
David Robinson,578,88,465,178,160,131,1800.0,264,91,93.0,201,87,17.1,Yes,2012,Yes,Yes,Yes
Anthony Taylor,89,24,91,29,46,28,357.0,14,3,50.0,77,26,22.1,Yes,2012,No,No,No
Elfrid Payton,1426,486,1032,501,645,394,3155.0,112,30,336.0,920,471,25.6,Yes,2012,No,No,No
Darnell Jackson,65,12,64,24,21,11,326.0,19,6,19.0,45,18,13.9,Yes,2012,No,No,No
Fred Brown,1150,207,1042,416,184,135,2716.0,479,183,219.0,563,233,27.6,Yes,2012,No,Yes,Yes
Justin Hamilton,758,45,540,289,239,177,2091.0,12,3,101.0,528,286,18.4,Yes,2012,No,No,No
Ronald Martin,0,0,0,0,0,0,1.0,0,0,0.0,0,0,0.0,Yes,2012,No,No,No
Russ Smith,1908,378,1501,620,642,488,3228.0,521,180,316.0,980,440,32.6,Yes,2012,No,No,No
Chris Smith,1310,222,1115,449,357,251,3474.0,458,161,191.0,657,288,20.9,Yes,2012,No,No,No
Gorgui Dieng,851,127,620,338,272,174,2789.0,3,1,166.0,617,337,16.4,Yes,2012,No,No,No
Peyton Siva,1215,677,989,412,396,292,3774.0,340,99,384.0,649,313,20.7,Yes,2012,No,No,No
Mark Jackson,17,4,22,7,0,0,98.0,9,3,10.0,13,4,17.6,Yes,2012,No,Yes,Yes
Darius Johnson-Odom,1649,262,1257,558,432,312,3238.0,549,221,223.0,708,337,26.2,Yes,2012,No,No,No
Jae Crowder,1049,131,762,375,287,196,2174.0,294,103,74.0,468,272,21.9,Yes,2012,No,No,No
Vander Blue,982,212,820,352,321,226,2727.0,188,52,208.0,632,300,22.0,Yes,2012,No,No,No
Jamil Wilson,1077,205,908,397,277,196,3067.0,259,87,175.0,649,310,20.3,Yes,2012,No,No,No
Alex Len,583,50,418,225,199,132,1470.0,9,1,93.0,409,224,20.7,Yes,2012,No,No,No
Will Barton,1062,201,842,397,262,192,2306.0,254,76,164.0,588,321,24.9,Yes,2012,No,No,No
Tarik Black,1130,41,722,443,440,244,2797.0,1,0,158.0,721,443,19.5,Yes,2012,No,No,No
Chris Crawford,1223,468,1102,431,158,119,3911.0,659,242,258.0,443,189,18.2,Yes,2012,No,No,No
Adonis Thomas,589,84,523,223,137,102,1511.0,126,41,82.0,397,182,22.1,Yes,2012,No,No,No
Chris Smith,271,40,233,83,127,80,1125.0,82,25,78.0,151,58,17.5,Yes,2012,No,No,No
Shane Larkin,760,245,585,256,182,147,2131.0,269,101,142.0,316,155,20.4,Yes,2012,No,No,No
Reggie Johnson,1039,104,723,370,416,294,2524.0,21,5,186.0,702,365,22.9,Yes,2012,No,No,No
Trey McKinney-Jones,998,202,772,343,254,188,3323.0,342,124,171.0,430,219,17.7,Yes,2012,No,No,No
DeQuan Jones,508,53,457,201,152,96,1606.0,59,10,123.0,398,191,20.7,Yes,2012,No,No,No
Bill Edwards,289,59,279,104,55,47,921.0,107,34,84.0,172,70,23.2,Yes,2012,No,No,No
Draymond Green,1517,425,1163,543,495,340,3619.0,252,91,277.0,911,452,23.7,Yes,2012,Yes,Yes,Yes
Keith Appling,1509,465,1140,491,520,389,4229.0,413,138,296.0,727,353,20.7,Yes,2012,No,No,No
Branden Dawson,1309,181,1013,566,317,177,3456.0,9,0,219.0,1004,566,21.2,Yes,2012,No,No,No
Adreian Payne,1232,85,850,447,367,277,2759.0,149,61,187.0,701,386,22.9,Yes,2012,No,No,No
Trey Burke,1231,416,969,436,291,226,2605.0,362,133,180.0,607,303,27.4,Yes,2012,No,No,No
Tim Hardaway Jr.,1532,225,1239,527,381,276,3560.0,589,202,182.0,650,325,25.2,Yes,2012,No,No,No
Andre Ingram,115,8,93,45,52,25,604.0,0,0,34.0,93,45,13.1,Yes,2012,No,No,No
Arnett Moultrie,1142,100,863,441,343,232,3020.0,97,28,206.0,766,413,21.9,Yes,2012,No,No,No
Rodney Hood,890,139,699,318,176,136,2200.0,298,118,84.0,401,200,20.5,Yes,2012,No,No,No
Kim English,1570,204,1227,515,414,301,3409.0,606,239,236.0,621,276,23.8,Yes,2012,No,No,No
Phil Pressey,959,580,812,321,268,203,2943.0,329,114,270.0,483,207,20.5,Yes,2012,No,No,No
Will Cherry,1484,397,1138,489,564,405,3565.0,354,101,273.0,784,388,25.6,Yes,2012,No,No,No
Kevin Henderson,111,14,101,42,20,14,437.0,42,13,27.0,59,29,17.3,Yes,2012,No,No,No
Kevin Thompson,1499,177,1177,584,564,330,3738.0,2,1,306.0,1175,583,22.5,Yes,2012,No,No,No
Isaiah Canaan,2050,385,1411,635,593,476,3876.0,725,304,311.0,686,331,26.7,Yes,2012,No,No,No
David Rivers,411,59,377,160,138,81,2195.0,46,10,56.0,331,150,12.7,Yes,2012,No,No,No
Reggie Smith,655,155,500,197,272,193,1670.0,210,68,150.0,290,129,24.9,Yes,2012,No,No,No
Deonte Burton,2102,515,1479,649,826,620,4393.0,546,184,280.0,933,465,25.3,Yes,2012,No,No,No
Drew Gordon,1007,71,752,407,277,191,2323.0,4,2,173.0,748,405,23.5,Yes,2012,No,No,No
Tony Snell,952,213,738,311,201,165,2583.0,434,165,154.0,304,146,20.1,Yes,2012,No,No,No
Cameron Bairstow,1239,102,808,418,559,401,2787.0,6,2,157.0,802,416,23.3,Yes,2012,No,No,No
Joe Thomas,332,37,271,151,99,30,1550.0,0,0,70.0,271,151,12.3,Yes,2012,No,No,No
Eric Williams,183,11,142,74,60,35,709.0,0,0,44.0,142,74,15.0,Yes,2012,No,No,No
Kyle O'Quinn,1607,122,1104,610,486,333,3542.0,207,54,262.0,897,556,23.0,Yes,2012,No,No,No
Lorenzo Brown,1167,589,955,410,382,283,3289.0,210,64,304.0,745,346,21.8,Yes,2012,No,No,No
C.J. Williams,779,164,681,315,112,82,2746.0,218,67,130.0,463,248,15.9,Yes,2012,No,No,No
Harrison Barnes,1226,96,1018,438,319,234,2198.0,332,116,146.0,686,322,27.3,Yes,2012,No,No,No
Tyler Zeller,1503,69,1010,548,525,407,2696.0,2,0,165.0,1008,548,24.1,Yes,2012,No,No,No
John Henson,1124,108,955,475,349,169,2594.0,24,5,166.0,931,470,22.7,Yes,2012,No,No,No
Reggie Bullock,989,169,815,358,118,85,2457.0,486,188,94.0,329,170,18.2,Yes,2012,No,No,No
Kendall Marshall,523,581,406,181,163,113,2101.0,131,48,193.0,275,133,14.7,Yes,2012,No,No,No
James Michael McAdoo,1232,111,1044,467,524,298,2696.0,9,0,173.0,1035,467,25.5,Yes,2012,No,No,No
Tony Mitchell,755,62,526,258,272,191,1713.0,141,48,143.0,385,210,23.2,Yes,2012,No,No,No
Jordan Williams,1501,126,1249,504,469,350,3389.0,477,143,253.0,772,361,25.6,Yes,2012,No,No,No
Luis Flores,77,19,66,26,20,10,312.0,42,15,23.0,24,11,16.3,Yes,2012,No,No,No
Abdel Nader,1207,127,1106,432,294,215,2845.0,420,128,267.0,686,304,27.5,Yes,2012,No,No,No
Reggie Hearn,671,95,484,221,202,152,1923.0,218,77,110.0,266,144,20.3,Yes,2012,No,No,No
Jerian Grant,1739,690,1276,556,567,448,4337.0,519,179,266.0,757,377,23.1,Yes,2012,No,No,No
Jack Cooley,1017,66,656,394,344,228,2435.0,2,1,110.0,654,393,21.1,Yes,2012,No,No,No
Pat Connaughton,1465,257,1145,515,215,167,4484.0,695,268,135.0,450,247,16.9,Yes,2012,No,No,No
Jared Sullinger,1282,89,849,450,495,363,2295.0,52,19,130.0,797,431,27.4,Yes,2012,No,No,No
Jordan Sibert,1153,158,852,366,321,237,2660.0,506,184,138.0,346,182,23.2,Yes,2012,No,No,No
Markel Brown,1655,308,1255,551,555,407,4088.0,421,146,239.0,834,405,22.2,Yes,2012,No,No,No
Kent Bazemore,1416,379,1155,516,489,284,3681.0,299,100,320.0,856,416,23.8,Yes,2012,No,No,No
Jared Cunningham,1271,193,835,380,566,427,2733.0,244,84,251.0,591,296,24.5,Yes,2012,No,No,No
Eric Moreland,640,116,445,238,294,156,2227.0,24,8,161.0,421,230,16.6,Yes,2012,No,No,No
Jabari Brown,1052,103,696,307,385,301,2164.0,355,137,136.0,341,170,24.0,Yes,2012,No,No,No
Tim Frazier,1543,641,1214,508,585,453,4132.0,239,74,355.0,975,434,24.0,Yes,2012,No,No,No
Don Martin,0,4,8,0,0,0,55.0,3,0,3.0,5,0,10.3,Yes,2012,No,No,No
Lamar Patterson,1410,427,1097,477,394,285,3628.0,463,171,244.0,634,306,22.5,Yes,2012,No,No,No
John Johnson,422,81,344,137,107,81,1309.0,187,67,78.0,157,70,18.9,Yes,2012,No,Yes,Yes
Khem Birch,611,55,392,208,292,195,1755.0,0,0,82.0,392,208,17.6,Yes,2012,No,No,No
Eric Washington,1251,560,892,389,469,380,3498.0,282,93,340.0,610,296,22.8,Yes,2012,No,No,No
Bryce Cotton,1975,384,1452,611,581,487,4314.0,736,266,193.0,716,345,22.7,Yes,2012,No,No,No
Robbie Hummel,1772,268,1315,583,464,390,3830.0,555,216,138.0,760,367,24.2,Yes,2012,No,No,No
Anthony Johnson,643,101,593,237,180,112,1756.0,184,57,91.0,409,180,22.8,Yes,2012,No,No,No
James Johnson,1731,479,1511,581,443,351,4285.0,589,218,283.0,922,363,22.5,Yes,2012,No,No,No
Javonte Green,1911,141,1350,701,739,485,3378.0,101,24,245.0,1249,677,29.0,Yes,2012,No,No,No
Derrick Williams,816,80,477,250,372,277,2056.0,112,39,141.0,365,211,21.1,Yes,2012,No,No,No
Chris Johnson,389,265,304,130,144,98,1762.0,75,31,162.0,229,99,16.0,Yes,2012,No,No,No
Langston Galloway,1991,296,1501,657,407,334,4720.0,806,343,156.0,695,314,21.0,Yes,2012,No,No,No
Matthew Dellavedova,1933,768,1423,590,541,465,4944.0,761,288,342.0,662,302,21.2,Yes,2012,No,No,No
Jamaal Franklin,1162,162,849,362,436,340,2198.0,325,98,218.0,524,264,29.9,Yes,2012,No,No,No
Avery Johnson,427,127,356,142,107,80,2297.0,182,63,105.0,174,79,12.0,Yes,2012,No,No,No
Torrey Craig,2128,236,1808,747,502,337,4061.0,899,297,347.0,909,450,29.5,Yes,2012,No,No,No
Nate Wolters,2352,668,1716,773,807,648,4204.0,462,158,280.0,1254,615,29.3,Yes,2012,No,No,No
Jack Foley,6,1,11,1,4,3,43.0,9,1,5.0,2,0,22.0,Yes,2012,No,No,No
Ron Anderson,752,129,528,279,362,194,2686.0,3,0,155.0,525,279,17.1,Yes,2012,No,No,No
Dewayne Dedmon,360,25,294,153,88,54,1156.0,4,0,78.0,290,153,19.5,Yes,2012,No,No,No
Jalen Jones,1635,97,1247,568,627,434,3523.0,208,65,212.0,1039,503,26.4,Yes,2012,No,No,No
Andrew Nicholson,2103,87,1407,809,633,456,3672.0,77,29,296.0,1330,780,29.1,Yes,2012,No,No,No
Chris Johnson,563,70,432,182,182,149,1309.0,130,50,85.0,302,132,23.9,Yes,2012,No,No,No
Maurice Harkless,497,47,427,193,139,94,1155.0,79,17,80.0,348,176,24.9,Yes,2012,No,No,No
Chasson Randle,2375,354,1775,760,684,551,4791.0,787,304,324.0,988,456,25.9,Yes,2012,No,No,No
Anthony Brown,1562,231,1211,518,410,308,4200.0,541,218,228.0,670,300,20.1,Yes,2012,No,No,No
Dwight Powell,1465,240,1110,515,557,402,3569.0,114,33,283.0,996,482,23.8,Yes,2012,No,No,No
Josh Huestis,1019,113,870,392,277,169,3376.0,207,66,125.0,663,326,17.0,Yes,2012,No,No,No
Willie Green,888,125,645,337,294,198,2282.0,65,16,136.0,580,321,20.8,Yes,2012,No,No,No
Kris Joseph,1476,208,1094,491,544,382,3725.0,338,112,217.0,756,379,21.9,Yes,2012,No,No,No
Dion Waiters,690,142,547,248,166,125,1445.0,198,69,78.0,349,179,25.0,Yes,2012,No,No,No
James Southerland,880,68,724,325,104,77,2089.0,413,153,66.0,311,172,20.4,Yes,2012,No,No,No
Fab Melo,311,29,229,132,85,47,1090.0,0,0,68.0,229,132,15.9,Yes,2012,No,No,No
Rakeem Christmas,1046,86,731,409,335,228,3126.0,1,0,162.0,730,409,17.4,Yes,2012,No,No,No
Michael Carter-Williams,544,345,452,180,209,142,1678.0,137,42,154.0,315,138,21.3,Yes,2012,No,No,No
Robert Covington,1748,145,1309,623,399,320,3536.0,431,182,275.0,878,441,25.5,Yes,2012,No,No,No
Kevin Murphy,2019,249,1594,706,567,416,3718.0,513,191,381.0,1081,515,30.0,Yes,2012,No,No,No
Jordan McRae,1521,209,1190,496,455,350,3088.0,522,179,225.0,668,317,27.8,Yes,2012,No,No,No
Jarnell Stokes,1129,129,776,411,489,307,2587.0,3,0,180.0,773,411,24.2,Yes,2012,No,No,No
Josh Richardson,1252,246,1005,458,314,238,3842.0,308,98,209.0,697,360,19.0,Yes,2012,No,No,No
Jason Smith,91,18,86,29,39,27,275.0,22,6,33.0,64,23,26.0,Yes,2012,No,No,No
Kevin Lynch,4,0,7,2,1,0,75.0,0,0,3.0,7,2,7.4,Yes,2012,No,No,No
Elston Turner,1310,207,1109,456,243,188,3194.0,561,210,167.0,548,246,24.3,Yes,2012,No,No,No
Khris Middleton,981,175,789,340,272,209,2263.0,287,92,173.0,502,248,25.5,Yes,2012,No,Yes,Yes
Julian Washburn,1526,274,1360,592,319,223,4448.0,349,119,213.0,1011,473,21.3,Yes,2012,No,No,No
Josh Davis,1305,176,1033,475,562,344,3675.0,30,11,229.0,1003,464,21.6,Yes,2012,No,No,No
Jordan Clarkson,1433,249,1075,473,487,392,2952.0,295,95,254.0,780,378,27.8,Yes,2012,No,No,No
Travis Wear,1052,85,843,425,228,182,2845.0,50,20,115.0,793,405,18.8,Yes,2012,No,No,No
David Wear,888,96,748,354,163,120,2832.0,142,60,120.0,606,294,16.8,Yes,2012,No,No,No
Norman Powell,1376,214,1090,503,347,259,3555.0,354,111,180.0,736,392,20.3,Yes,2012,No,No,No
Ryan Broekhoff,1591,246,1103,512,385,315,3642.0,618,252,186.0,485,260,21.5,Yes,2012,No,No,No
John Jenkins,1658,111,1102,516,374,320,2998.0,699,306,130.0,403,210,24.2,Yes,2012,No,No,No
Jeffery Taylor,1897,252,1378,665,652,452,3923.0,321,115,309.0,1057,550,26.0,Yes,2012,No,No,No
Festus Ezeli,934,18,587,330,469,274,2168.0,0,0,195.0,587,330,23.7,Yes,2012,No,No,No
Maalik Wayns,1191,323,919,379,400,339,2464.0,323,94,223.0,596,285,26.9,Yes,2012,No,No,No
Darrun Hilliard,1511,248,1125,491,428,320,3537.0,569,209,206.0,556,282,22.4,Yes,2012,No,No,No
Troy Daniels,913,48,764,297,87,68,2109.0,650,251,73.0,114,46,20.9,Yes,2012,No,No,No
Treveon Graham,1882,199,1431,618,645,446,3558.0,565,200,191.0,866,418,26.8,Yes,2012,No,No,No
Briante Weber,862,378,695,296,299,230,2965.0,146,40,186.0,549,256,17.0,Yes,2012,No,No,No
Erick Green,1742,326,1356,592,520,418,3648.0,414,140,178.0,942,452,25.3,Yes,2012,No,No,No
Jarell Eddie,1182,139,995,383,276,224,3176.0,526,192,183.0,469,191,21.7,Yes,2012,No,No,No
Dorian Finney-Smith,1429,256,1168,480,432,284,3834.0,511,185,240.0,657,295,21.9,Yes,2012,No,No,No
Mike Scott,1538,124,1122,585,454,352,3457.0,44,16,211.0,1078,569,24.1,Yes,2012,No,No,No
Joe Harris,1698,254,1276,568,414,299,4084.0,646,263,213.0,630,305,23.6,Yes,2012,No,No,No
Malcolm Brogdon,1809,335,1399,601,482,422,4157.0,507,185,207.0,892,416,25.3,Yes,2012,No,No,No
James Johnson,240,14,178,94,91,52,813.0,0,0,79.0,178,94,19.2,Yes,2012,No,No,No
Terrence Ross,847,82,700,317,127,97,1681.0,319,116,94.0,381,201,23.8,Yes,2012,No,No,No
Tony Wroten,559,130,447,198,264,154,1062.0,56,9,132.0,391,189,31.2,Yes,2012,No,No,No
C.J. Wilcox,1880,214,1478,640,356,299,3735.0,773,301,178.0,705,339,24.1,Yes,2012,No,No,No
Damian Lillard,1934,362,1310,584,600,520,3363.0,630,246,246.0,680,338,28.6,Yes,2012,Yes,Yes,Yes
Mike Brown,26,4,16,8,6,4,99.0,10,6,7.0,6,2,13.8,Yes,2012,No,No,No
Kevin Jones,1822,141,1475,728,378,256,4347.0,349,110,136.0,1126,618,20.8,Yes,2012,No,No,No
Shayne Whittington,1119,81,807,416,367,279,2574.0,48,8,150.0,759,408,22.9,Yes,2012,No,No,No
Toure' Murry,1539,429,1280,519,480,366,3999.0,434,135,340.0,846,384,23.5,Yes,2012,No,No,No
Marcus Thornton,2178,308,1649,709,551,435,4328.0,809,325,324.0,840,384,28.7,Yes,2012,No,No,No
Reggie King,76,47,68,25,33,24,593.0,12,2,32.0,56,23,10.5,Yes,2012,No,No,No
Frank Kaminsky,1458,188,1013,529,389,297,2943.0,279,103,121.0,734,426,25.5,Yes,2012,No,No,No
Duje Dukan,298,37,248,106,64,42,970.0,134,44,36.0,114,62,18.6,Yes,2012,No,No,No
Larry Nance,1386,172,978,510,428,330,3631.0,117,36,193.0,861,474,22.8,Yes,2012,No,Yes,Yes
Carrick Felix,955,125,748,341,247,174,2626.0,304,99,162.0,444,242,21.0,Yes,2012,No,No,No
Solomon Hill,1430,304,1012,487,458,341,4030.0,307,115,290.0,705,372,19.7,Yes,2012,No,No,No
Nick Johnson,1333,304,1048,441,418,307,3339.0,401,144,197.0,647,297,22.7,Yes,2012,No,No,No
James White,863,78,706,357,240,146,2188.0,15,3,157.0,691,354,22.6,Yes,2012,No,No,No
Mitchell Anderson,602,70,575,231,164,97,1687.0,162,43,110.0,413,188,23.2,Yes,2012,No,No,No
Mo Williams,368,93,314,110,144,101,2002.0,163,47,103.0,151,63,12.3,Yes,2012,No,Yes,Yes
Pierre Jackson,1235,478,884,390,369,298,2424.0,414,157,256.0,470,233,27.1,Yes,2012,No,No,No
Cory Jefferson,1159,51,794,431,424,280,2589.0,50,17,101.0,744,414,21.4,Yes,2012,No,No,No
Ian Clark,1920,289,1406,681,269,218,3818.0,800,340,277.0,606,341,23.6,Yes,2012,No,No,No
Ryan Anderson,1787,151,1295,630,706,495,3906.0,120,32,235.0,1175,598,25.9,Yes,2012,No,No,No
Brandon Davies,1680,213,1166,609,691,456,3251.0,18,6,283.0,1148,603,26.4,Yes,2012,No,No,No
Mike Muscala,2036,211,1443,723,695,569,3815.0,67,21,217.0,1376,702,28.4,Yes,2012,No,No,No
James Johnson,306,10,206,123,98,60,1186.0,0,0,47.0,206,123,12.8,Yes,2012,No,No,No
Ian Clark,13,5,9,4,5,3,48.0,6,2,7.0,3,2,17.9,Yes,2012,No,No,No
Chris McNealy,1207,277,1062,439,278,198,3480.0,355,131,177.0,707,308,19.9,Yes,2012,No,No,No
Robert Smith,846,293,818,288,244,165,2914.0,347,105,274.0,471,183,21.6,Yes,2012,No,No,No
Alan Williams,1732,117,1295,637,649,458,3026.0,3,0,196.0,1292,637,32.0,Yes,2012,No,No,No
Allen Crabbe,1537,219,1195,533,320,262,3402.0,547,209,182.0,648,324,23.3,Yes,2012,No,No,No
Terrence Williams,972,228,857,326,372,265,2930.0,195,55,244.0,662,271,21.6,Yes,2012,No,No,No
Aaron Williams,240,29,279,91,60,36,936.0,95,22,73.0,184,69,20.2,Yes,2012,No,No,No
Sean Kilpatrick,2145,279,1687,707,536,418,4315.0,901,313,236.0,786,394,26.0,Yes,2012,No,No,No
Justin Jackson,770,166,633,322,267,124,2740.0,21,2,212.0,612,320,18.3,Yes,2012,No,No,No
Devin Booker,1154,99,897,445,368,242,3089.0,80,22,199.0,817,423,21.8,Yes,2012,No,Yes,Yes
Greg Smith,1051,133,839,356,391,282,2578.0,163,57,212.0,676,299,25.1,Yes,2012,No,No,No
Spencer Dinwiddie,1115,227,690,290,506,420,2590.0,298,115,153.0,392,175,21.8,Yes,2012,No,No,No
Andre Roberson,1012,119,741,382,340,198,2970.0,143,50,183.0,598,332,19.0,Yes,2012,No,No,No
Shabazz Napier,1959,646,1447,595,626,509,4614.0,693,260,350.0,754,335,24.0,Yes,2012,No,No,No
Doug McDermott,3150,194,2075,1141,715,594,4569.0,598,274,321.0,1477,867,32.3,Yes,2012,No,No,No
Kyle Anderson,1292,138,1152,435,198,153,4048.0,780,269,149.0,372,166,17.6,Yes,2012,No,No,No
Royce O'Neale,1268,400,862,411,401,301,4057.0,363,145,258.0,499,266,18.1,Yes,2012,No,No,No
Ray McCallum,1618,451,1173,546,593,429,3519.0,335,97,233.0,838,449,23.7,Yes,2012,No,No,No
Damion Lee,2016,244,1468,636,578,487,4104.0,710,257,217.0,758,379,26.0,Yes,2012,No,No,No
Mason Plumlee,1384,212,915,525,569,332,3652.0,10,2,282.0,905,523,20.2,Yes,2012,No,No,No
Seth Curry,2101,290,1582,682,498,412,4357.0,825,325,225.0,757,357,23.8,Yes,2012,No,No,No
Quinn Cook,1571,509,1235,534,313,267,4033.0,629,236,201.0,606,298,20.2,Yes,2012,No,No,No
Ryan Kelly,949,117,682,314,272,219,2437.0,269,102,104.0,413,212,18.8,Yes,2012,No,No,No
Brandon Williams,0,1,4,0,0,0,12.0,1,0,1.0,3,0,17.5,Yes,2012,No,No,No
Reggie Lewis,1176,167,1139,432,172,124,3169.0,517,188,143.0,622,244,20.3,Yes,2012,No,Yes,Yes
Bernard Thompson,1835,246,1466,636,487,344,4031.0,601,219,278.0,865,417,24.8,Yes,2012,No,No,No
Okaro White,1402,95,944,466,502,401,3417.0,211,69,217.0,733,397,21.0,Yes,2012,No,No,No
Erik Murphy,1052,95,773,397,152,115,2488.0,329,143,139.0,444,254,21.0,Yes,2012,No,No,No
Tyler Johnson,1350,303,1077,491,348,249,3538.0,320,119,176.0,757,372,21.5,Yes,2012,No,No,No
Jordan Loyd,165,51,150,55,62,41,588.0,54,14,46.0,96,41,20.1,Yes,2012,No,No,No
Kentavious Caldwell-Pope,1013,96,814,338,250,188,2114.0,439,149,100.0,375,189,27.0,Yes,2012,No,No,No
Marcus Thornton,829,91,687,289,361,230,2885.0,72,21,165.0,615,268,18.9,Yes,2012,No,No,No
Elias Harris,1857,177,1289,666,618,447,3785.0,219,78,242.0,1070,588,24.6,Yes,2012,No,No,No
David Stockton,661,423,526,223,207,145,2741.0,229,70,202.0,297,153,15.5,Yes,2012,No,No,No
Malcolm Miller,1013,164,746,332,319,244,2917.0,284,105,175.0,462,227,20.1,Yes,2012,No,No,No
Joe Young,2304,351,1718,778,519,460,4333.0,739,288,221.0,979,490,25.3,Yes,2012,No,No,No
Brandon Paul,1654,310,1356,521,554,401,3665.0,650,211,312.0,706,310,27.5,Yes,2012,No,No,No
Myke Henry,991,76,808,384,209,147,2344.0,228,76,178.0,580,308,23.9,Yes,2012,No,No,No
Cody Zeller,1157,92,674,399,475,359,2087.0,2,0,141.0,672,399,25.4,Yes,2012,No,No,No
Victor Oladipo,1117,175,754,406,359,257,2558.0,142,48,203.0,612,358,22.7,Yes,2012,Yes,Yes,Yes
Chris Babb,942,215,802,302,161,118,3448.0,613,220,102.0,189,82,14.5,Yes,2012,No,No,No
Rodney McGruder,1576,186,1257,568,332,252,3702.0,494,188,171.0,763,380,21.3,Yes,2012,No,No,No
Jeff Withey,938,69,576,327,390,283,2319.0,1,1,138.0,575,326,19.7,Yes,2012,No,No,No
Kyle Wiltjer,1909,190,1417,690,341,281,3504.0,583,248,186.0,834,442,26.0,Yes,2012,No,No,No
Stan Brown,679,38,544,252,273,175,2085.0,4,0,120.0,540,252,18.1,Yes,2012,No,No,No
David Robinson,578,88,465,178,160,131,1800.0,264,91,93.0,201,87,17.1,Yes,2012,Yes,Yes,Yes
Anthony Taylor,89,24,91,29,46,28,357.0,14,3,50.0,77,26,22.1,Yes,2012,No,No,No
Elfrid Payton,1426,486,1032,501,645,394,3155.0,112,30,336.0,920,471,25.6,Yes,2012,No,No,No
Russ Smith,1908,378,1501,620,642,488,3228.0,521,180,316.0,980,440,32.6,Yes,2012,No,No,No
Peyton Siva,1215,677,989,412,396,292,3774.0,340,99,384.0,649,313,20.7,Yes,2012,No,No,No
Gorgui Dieng,851,127,620,338,272,174,2789.0,3,1,166.0,617,337,16.4,Yes,2012,No,No,No
Mark Jackson,17,4,22,7,0,0,98.0,9,3,10.0,13,4,17.6,Yes,2012,No,Yes,Yes
Vander Blue,982,212,820,352,321,226,2727.0,188,52,208.0,632,300,22.0,Yes,2012,No,No,No
Jamil Wilson,1077,205,908,397,277,196,3067.0,259,87,175.0,649,310,20.3,Yes,2012,No,No,No
Alex Len,583,50,418,225,199,132,1470.0,9,1,93.0,409,224,20.7,Yes,2012,No,No,No
Adonis Thomas,589,84,523,223,137,102,1511.0,126,41,82.0,397,182,22.1,Yes,2012,No,No,No
Chris Crawford,1223,468,1102,431,158,119,3911.0,659,242,258.0,443,189,18.2,Yes,2012,No,No,No
Tarik Black,1130,41,722,443,440,244,2797.0,1,0,158.0,721,443,19.5,Yes,2012,No,No,No
Chris Smith,271,40,233,83,127,80,1125.0,82,25,78.0,151,58,17.5,Yes,2012,No,No,No
Shane Larkin,760,245,585,256,182,147,2131.0,269,101,142.0,316,155,20.4,Yes,2012,No,No,No
Trey McKinney-Jones,998,202,772,343,254,188,3323.0,342,124,171.0,430,219,17.7,Yes,2012,No,No,No
Reggie Johnson,1039,104,723,370,416,294,2524.0,21,5,186.0,702,365,22.9,Yes,2012,No,No,No
Reggie Johnson,1254,225,1124,418,434,292,2917.0,427,126,211.0,697,292,26.1,Yes,2012,No,No,No
Bill Edwards,289,59,279,104,55,47,921.0,107,34,84.0,172,70,23.2,Yes,2012,No,No,No
Keith Appling,1509,465,1140,491,520,389,4229.0,413,138,296.0,727,353,20.7,Yes,2012,No,No,No
Adreian Payne,1232,85,850,447,367,277,2759.0,149,61,187.0,701,386,22.9,Yes,2012,No,No,No
Branden Dawson,1309,181,1013,566,317,177,3456.0,9,0,219.0,1004,566,21.2,Yes,2012,No,No,No
Trey Burke,1231,416,969,436,291,226,2605.0,362,133,180.0,607,303,27.4,Yes,2012,No,No,No
Tim Hardaway Jr.,1532,225,1239,527,381,276,3560.0,589,202,182.0,650,325,25.2,Yes,2012,No,No,No
Andre Ingram,115,8,93,45,52,25,604.0,0,0,34.0,93,45,13.1,Yes,2012,No,No,No
Phil Pressey,959,580,812,321,268,203,2943.0,329,114,270.0,483,207,20.5,Yes,2012,No,No,No
Jabari Brown,1052,103,696,307,385,301,2164.0,355,137,136.0,341,170,24.0,Yes,2012,No,No,No
Will Cherry,1484,397,1138,489,564,405,3565.0,354,101,273.0,784,388,25.6,Yes,2012,No,No,No
Kevin Henderson,111,14,101,42,20,14,437.0,42,13,27.0,59,29,17.3,Yes,2012,No,No,No
Isaiah Canaan,2050,385,1411,635,593,476,3876.0,725,304,311.0,686,331,26.7,Yes,2012,No,No,No
David Rivers,411,59,377,160,138,81,2195.0,46,10,56.0,331,150,12.7,Yes,2012,No,No,No
Khem Birch,611,55,392,208,292,195,1755.0,0,0,82.0,392,208,17.6,Yes,2012,No,No,No
Deonte Burton,2102,515,1479,649,826,620,4393.0,546,184,280.0,933,465,25.3,Yes,2012,No,No,No
Tony Snell,952,213,738,311,201,165,2583.0,434,165,154.0,304,146,20.1,Yes,2012,No,No,No
Cameron Bairstow,1239,102,808,418,559,401,2787.0,6,2,157.0,802,416,23.3,Yes,2012,No,No,No
Joe Thomas,332,37,271,151,99,30,1550.0,0,0,70.0,271,151,12.3,Yes,2012,No,No,No
Lorenzo Brown,1167,589,955,410,382,283,3289.0,210,64,304.0,745,346,21.8,Yes,2012,No,No,No
James Michael McAdoo,1232,111,1044,467,524,298,2696.0,9,0,173.0,1035,467,25.5,Yes,2012,No,No,No
Reggie Bullock,989,169,815,358,118,85,2457.0,486,188,94.0,329,170,18.2,Yes,2012,No,No,No
Jordan Williams,1501,126,1249,504,469,350,3389.0,477,143,253.0,772,361,25.6,Yes,2012,No,No,No
Tony Mitchell,755,62,526,258,272,191,1713.0,141,48,143.0,385,210,23.2,Yes,2012,No,No,No
Luis Flores,77,19,66,26,20,10,312.0,42,15,23.0,24,11,16.3,Yes,2012,No,No,No
Abdel Nader,1207,127,1106,432,294,215,2845.0,420,128,267.0,686,304,27.5,Yes,2012,No,No,No
Brandon Williams,0,0,5,0,2,0,16.0,0,0,0.0,5,0,16.9,Yes,2012,No,No,No
Reggie Hearn,671,95,484,221,202,152,1923.0,218,77,110.0,266,144,20.3,Yes,2012,No,No,No
Jerian Grant,1739,690,1276,556,567,448,4337.0,519,179,266.0,757,377,23.1,Yes,2012,No,No,No
Jack Cooley,1017,66,656,394,344,228,2435.0,2,1,110.0,654,393,21.1,Yes,2012,No,No,No
Pat Connaughton,1465,257,1145,515,215,167,4484.0,695,268,135.0,450,247,16.9,Yes,2012,No,No,No
Markel Brown,1655,308,1255,551,555,407,4088.0,421,146,239.0,834,405,22.2,Yes,2012,No,No,No
Eric Moreland,640,116,445,238,294,156,2227.0,24,8,161.0,421,230,16.6,Yes,2012,No,No,No
Tim Frazier,1543,641,1214,508,585,453,4132.0,239,74,355.0,975,434,24.0,Yes,2012,No,No,No
Lamar Patterson,1410,427,1097,477,394,285,3628.0,463,171,244.0,634,306,22.5,Yes,2012,No,No,No
Eric Washington,1251,560,892,389,469,380,3498.0,282,93,340.0,610,296,22.8,Yes,2012,No,No,No
Bryce Cotton,1975,384,1452,611,581,487,4314.0,736,266,193.0,716,345,22.7,Yes,2012,No,No,No
Anthony Johnson,643,101,593,237,180,112,1756.0,184,57,91.0,409,180,22.8,Yes,2012,No,No,No
Javonte Green,1911,141,1350,701,739,485,3378.0,101,24,245.0,1249,677,29.0,Yes,2012,No,No,No
Derrick Williams,816,80,477,250,372,277,2056.0,112,39,141.0,365,211,21.1,Yes,2012,No,No,No
Langston Galloway,1991,296,1501,657,407,334,4720.0,806,343,156.0,695,314,21.0,Yes,2012,No,No,No
Matthew Dellavedova,1933,768,1423,590,541,465,4944.0,761,288,342.0,662,302,21.2,Yes,2012,No,No,No
Jamaal Franklin,1162,162,849,362,436,340,2198.0,325,98,218.0,524,264,29.9,Yes,2012,No,No,No
James Johnson,240,14,178,94,91,52,813.0,0,0,79.0,178,94,19.2,Yes,2012,No,No,No
Torrey Craig,2128,236,1808,747,502,337,4061.0,899,297,347.0,909,450,29.5,Yes,2012,No,No,No
Nate Wolters,2352,668,1716,773,807,648,4204.0,462,158,280.0,1254,615,29.3,Yes,2012,No,No,No
Jack Foley,6,1,11,1,4,3,43.0,9,1,5.0,2,0,22.0,Yes,2012,No,No,No
Dewayne Dedmon,360,25,294,153,88,54,1156.0,4,0,78.0,290,153,19.5,Yes,2012,No,No,No
Jalen Jones,1635,97,1247,568,627,434,3523.0,208,65,212.0,1039,503,26.4,Yes,2012,No,No,No
Malcolm Miller,920,68,685,326,134,98,1766.0,404,170,74.0,281,156,24.2,Yes,2012,No,No,No
Chris Johnson,563,70,432,182,182,149,1309.0,130,50,85.0,302,132,23.9,Yes,2012,No,No,No
Dwight Powell,1465,240,1110,515,557,402,3569.0,114,33,283.0,996,482,23.8,Yes,2012,No,No,No
Chasson Randle,2375,354,1775,760,684,551,4791.0,787,304,324.0,988,456,25.9,Yes,2012,No,No,No
Josh Huestis,1019,113,870,392,277,169,3376.0,207,66,125.0,663,326,17.0,Yes,2012,No,No,No
Anthony Brown,1562,231,1211,518,410,308,4200.0,541,218,228.0,670,300,20.1,Yes,2012,No,No,No
Willie Green,888,125,645,337,294,198,2282.0,65,16,136.0,580,321,20.8,Yes,2012,No,No,No
Michael Carter-Williams,544,345,452,180,209,142,1678.0,137,42,154.0,315,138,21.3,Yes,2012,No,No,No
James Southerland,880,68,724,325,104,77,2089.0,413,153,66.0,311,172,20.4,Yes,2012,No,No,No
Rakeem Christmas,1046,86,731,409,335,228,3126.0,1,0,162.0,730,409,17.4,Yes,2012,No,No,No
Robert Covington,1748,145,1309,623,399,320,3536.0,431,182,275.0,878,441,25.5,Yes,2012,No,No,No
Jordan McRae,1521,209,1190,496,455,350,3088.0,522,179,225.0,668,317,27.8,Yes,2012,No,No,No
Jarnell Stokes,1129,129,776,411,489,307,2587.0,3,0,180.0,773,411,24.2,Yes,2012,No,No,No
Josh Richardson,1252,246,1005,458,314,238,3842.0,308,98,209.0,697,360,19.0,Yes,2012,No,No,No
Elston Turner,1310,207,1109,456,243,188,3194.0,561,210,167.0,548,246,24.3,Yes,2012,No,No,No
Julian Washburn,1526,274,1360,592,319,223,4448.0,349,119,213.0,1011,473,21.3,Yes,2012,No,No,No
Josh Davis,1305,176,1033,475,562,344,3675.0,30,11,229.0,1003,464,21.6,Yes,2012,No,No,No
Travis Wear,1052,85,843,425,228,182,2845.0,50,20,115.0,793,405,18.8,Yes,2012,No,No,No
Kyle Anderson,865,355,670,303,303,223,2242.0,96,36,183.0,574,267,22.2,Yes,2012,No,No,No
David Wear,888,96,748,354,163,120,2832.0,142,60,120.0,606,294,16.8,Yes,2012,No,No,No
Norman Powell,1376,214,1090,503,347,259,3555.0,354,111,180.0,736,392,20.3,Yes,2012,No,No,No
Ryan Broekhoff,1591,246,1103,512,385,315,3642.0,618,252,186.0,485,260,21.5,Yes,2012,No,No,No
Darrun Hilliard,1511,248,1125,491,428,320,3537.0,569,209,206.0,556,282,22.4,Yes,2012,No,No,No
Treveon Graham,1882,199,1431,618,645,446,3558.0,565,200,191.0,866,418,26.8,Yes,2012,No,No,No
Troy Daniels,913,48,764,297,87,68,2109.0,650,251,73.0,114,46,20.9,Yes,2012,No,No,No
Briante Weber,862,378,695,296,299,230,2965.0,146,40,186.0,549,256,17.0,Yes,2012,No,No,No
Erick Green,1742,326,1356,592,520,418,3648.0,414,140,178.0,942,452,25.3,Yes,2012,No,No,No
Jarell Eddie,1182,139,995,383,276,224,3176.0,526,192,183.0,469,191,21.7,Yes,2012,No,No,No
Joe Harris,1698,254,1276,568,414,299,4084.0,646,263,213.0,630,305,23.6,Yes,2012,No,No,No
C.J. Wilcox,1880,214,1478,640,356,299,3735.0,773,301,178.0,705,339,24.1,Yes,2012,No,No,No
Mike Brown,1309,235,1065,446,421,304,3396.0,335,113,226.0,730,333,21.7,Yes,2012,No,No,No
Shayne Whittington,1119,81,807,416,367,279,2574.0,48,8,150.0,759,408,22.9,Yes,2012,No,No,No
Marcus Thornton,2178,308,1649,709,551,435,4328.0,809,325,324.0,840,384,28.7,Yes,2012,No,No,No
Reggie King,76,47,68,25,33,24,593.0,12,2,32.0,56,23,10.5,Yes,2012,No,No,No
Frank Kaminsky,1458,188,1013,529,389,297,2943.0,279,103,121.0,734,426,25.5,Yes,2012,No,No,No
Larry Nance,1386,172,978,510,428,330,3631.0,117,36,193.0,861,474,22.8,Yes,2012,No,Yes,Yes
Nick Johnson,1333,304,1048,441,418,307,3339.0,401,144,197.0,647,297,22.7,Yes,2012,No,No,No
T.J. McConnell,1414,751,1123,550,235,176,4425.0,363,138,281.0,760,412,17.4,Yes,2012,No,No,No
Chris Johnson,4,0,1,1,2,1,6.0,1,1,0.0,0,0,17.1,Yes,2012,No,No,No
James White,863,78,706,357,240,146,2188.0,15,3,157.0,691,354,22.6,Yes,2012,No,No,No
Mo Williams,368,93,314,110,144,101,2002.0,163,47,103.0,151,63,12.3,Yes,2012,No,Yes,Yes
Cory Jefferson,1159,51,794,431,424,280,2589.0,50,17,101.0,744,414,21.4,Yes,2012,No,No,No
Royce O'Neale,1268,400,862,411,401,301,4057.0,363,145,258.0,499,266,18.1,Yes,2012,No,No,No
Ryan Anderson,1787,151,1295,630,706,495,3906.0,120,32,235.0,1175,598,25.9,Yes,2012,No,No,No
James Johnson,306,10,206,123,98,60,1186.0,0,0,47.0,206,123,12.8,Yes,2012,No,No,No
Avery Johnson,427,127,356,142,107,80,2297.0,182,63,105.0,174,79,12.0,Yes,2012,No,No,No
Chris McNealy,1207,277,1062,439,278,198,3480.0,355,131,177.0,707,308,19.9,Yes,2012,No,No,No
Alan Williams,1732,117,1295,637,649,458,3026.0,3,0,196.0,1292,637,32.0,Yes,2012,No,No,No
Terrence Williams,972,228,857,326,372,265,2930.0,195,55,244.0,662,271,21.6,Yes,2012,No,No,No
Sean Kilpatrick,2145,279,1687,707,536,418,4315.0,901,313,236.0,786,394,26.0,Yes,2012,No,No,No
Justin Jackson,770,166,633,322,267,124,2740.0,21,2,212.0,612,320,18.3,Yes,2012,No,No,No
Spencer Dinwiddie,1115,227,690,290,506,420,2590.0,298,115,153.0,392,175,21.8,Yes,2012,No,No,No
Shabazz Napier,1959,646,1447,595,626,509,4614.0,693,260,350.0,754,335,24.0,Yes,2012,No,No,No
Doug McDermott,3150,194,2075,1141,715,594,4569.0,598,274,321.0,1477,867,32.3,Yes,2012,No,No,No
Jordan Sibert,1153,158,852,366,321,237,2660.0,506,184,138.0,346,182,23.2,Yes,2012,No,No,No
Kyle Anderson,1292,138,1152,435,198,153,4048.0,780,269,149.0,372,166,17.6,Yes,2012,No,No,No
Damion Lee,2016,244,1468,636,578,487,4104.0,710,257,217.0,758,379,26.0,Yes,2012,No,No,No
Rodney Hood,890,139,699,318,176,136,2200.0,298,118,84.0,401,200,20.5,Yes,2012,No,No,No
Quinn Cook,1571,509,1235,534,313,267,4033.0,629,236,201.0,606,298,20.2,Yes,2012,No,No,No
Andre Dawkins,1014,66,763,330,160,123,2468.0,568,231,88.0,195,99,18.7,Yes,2012,No,No,No
Reggie Smith,655,155,500,197,272,193,1670.0,210,68,150.0,290,129,24.9,Yes,2012,No,No,No
Anthony Johnson,89,17,75,32,27,17,399.0,25,8,23.0,50,24,14.8,Yes,2012,No,No,No
Reggie Lewis,1176,167,1139,432,172,124,3169.0,517,188,143.0,622,244,20.3,Yes,2012,No,Yes,Yes
Bernard Thompson,1835,246,1466,636,487,344,4031.0,601,219,278.0,865,417,24.8,Yes,2012,No,No,No
Okaro White,1402,95,944,466,502,401,3417.0,211,69,217.0,733,397,21.0,Yes,2012,No,No,No
Dorian Finney-Smith,1429,256,1168,480,432,284,3834.0,511,185,240.0,657,295,21.9,Yes,2012,No,No,No
Tyler Johnson,1350,303,1077,491,348,249,3538.0,320,119,176.0,757,372,21.5,Yes,2012,No,No,No
Marcus Thornton,829,91,687,289,361,230,2885.0,72,21,165.0,615,268,18.9,Yes,2012,No,No,No
David Stockton,661,423,526,223,207,145,2741.0,229,70,202.0,297,153,15.5,Yes,2012,No,No,No
Alfonzo McKinnie,689,23,536,271,193,120,1811.0,77,27,121.0,459,244,21.9,Yes,2012,No,No,No
Malcolm Miller,1013,164,746,332,319,244,2917.0,284,105,175.0,462,227,20.1,Yes,2012,No,No,No
Mike Scott,715,235,605,264,146,109,1663.0,226,78,87.0,379,186,23.5,Yes,2012,No,No,No
Tarik Black,1130,41,722,443,440,244,2797.0,1,0,158.0,721,443,19.5,Yes,2012,No,No,No
Elfrid Payton,1426,486,1032,501,645,394,3155.0,112,30,336.0,920,471,25.6,Yes,2012,No,No,No
Marvin Williams,493,24,413,205,132,81,1372.0,9,2,95.0,404,203,21.6,Yes,2012,No,No,No
Russ Smith,1908,378,1501,620,642,488,3228.0,521,180,316.0,980,440,32.6,Yes,2012,No,No,No
Jamil Wilson,1077,205,908,397,277,196,3067.0,259,87,175.0,649,310,20.3,Yes,2012,No,No,No
Deonte Burton,1052,108,845,404,265,176,2053.0,168,68,150.0,677,336,27.7,Yes,2012,No,No,No
Chris Crawford,1223,468,1102,431,158,119,3911.0,659,242,258.0,443,189,18.2,Yes,2012,No,No,No
Reggie Johnson,1254,225,1124,418,434,292,2917.0,427,126,211.0,697,292,26.1,Yes,2012,No,No,No
Bill Edwards,289,59,279,104,55,47,921.0,107,34,84.0,172,70,23.2,Yes,2012,No,No,No
Adreian Payne,1232,85,850,447,367,277,2759.0,149,61,187.0,701,386,22.9,Yes,2012,No,No,No
Keith Appling,1509,465,1140,491,520,389,4229.0,413,138,296.0,727,353,20.7,Yes,2012,No,No,No
Branden Dawson,1309,181,1013,566,317,177,3456.0,9,0,219.0,1004,566,21.2,Yes,2012,No,No,No
Jabari Brown,1052,103,696,307,385,301,2164.0,355,137,136.0,341,170,24.0,Yes,2012,No,No,No
Jordan Clarkson,1433,249,1075,473,487,392,2952.0,295,95,254.0,780,378,27.8,Yes,2012,No,No,No
David Rivers,411,59,377,160,138,81,2195.0,46,10,56.0,331,150,12.7,Yes,2012,No,No,No
Khem Birch,611,55,392,208,292,195,1755.0,0,0,82.0,392,208,17.6,Yes,2012,No,No,No
Deonte Burton,2102,515,1479,649,826,620,4393.0,546,184,280.0,933,465,25.3,Yes,2012,No,No,No
Cameron Bairstow,1239,102,808,418,559,401,2787.0,6,2,157.0,802,416,23.3,Yes,2012,No,No,No
Joe Thomas,332,37,271,151,99,30,1550.0,0,0,70.0,271,151,12.3,Yes,2012,No,No,No
James Michael McAdoo,1232,111,1044,467,524,298,2696.0,9,0,173.0,1035,467,25.5,Yes,2012,No,No,No
Jordan Williams,1501,126,1249,504,469,350,3389.0,477,143,253.0,772,361,25.6,Yes,2012,No,No,No
Anthony Johnson,1020,61,779,334,238,196,2009.0,412,156,122.0,367,178,25.1,Yes,2012,No,No,No
Pat Connaughton,1465,257,1145,515,215,167,4484.0,695,268,135.0,450,247,16.9,Yes,2012,No,No,No
Jerian Grant,1739,690,1276,556,567,448,4337.0,519,179,266.0,757,377,23.1,Yes,2012,No,No,No
Markel Brown,1655,308,1255,551,555,407,4088.0,421,146,239.0,834,405,22.2,Yes,2012,No,No,No
Eric Moreland,640,116,445,238,294,156,2227.0,24,8,161.0,421,230,16.6,Yes,2012,No,No,No
Joe Young,2304,351,1718,778,519,460,4333.0,739,288,221.0,979,490,25.3,Yes,2012,No,No,No
Tim Frazier,1543,641,1214,508,585,453,4132.0,239,74,355.0,975,434,24.0,Yes,2012,No,No,No
John Johnson,422,81,344,137,107,81,1309.0,187,67,78.0,157,70,18.9,Yes,2012,No,Yes,Yes
Lamar Patterson,1410,427,1097,477,394,285,3628.0,463,171,244.0,634,306,22.5,Yes,2012,No,No,No
Bryce Cotton,1975,384,1452,611,581,487,4314.0,736,266,193.0,716,345,22.7,Yes,2012,No,No,No
Javonte Green,1911,141,1350,701,739,485,3378.0,101,24,245.0,1249,677,29.0,Yes,2012,No,No,No
Derrick Williams,816,80,477,250,372,277,2056.0,112,39,141.0,365,211,21.1,Yes,2012,No,No,No
Langston Galloway,1991,296,1501,657,407,334,4720.0,806,343,156.0,695,314,21.0,Yes,2012,No,No,No
Josh Davis,1305,176,1033,475,562,344,3675.0,30,11,229.0,1003,464,21.6,Yes,2012,No,No,No
James Johnson,240,14,178,94,91,52,813.0,0,0,79.0,178,94,19.2,Yes,2012,No,No,No
Kevin Lynch,0,0,1,0,0,0,7.0,1,0,0.0,0,0,7.7,Yes,2012,No,No,No
Torrey Craig,2128,236,1808,747,502,337,4061.0,899,297,347.0,909,450,29.5,Yes,2012,No,No,No
Jack Foley,6,1,11,1,4,3,43.0,9,1,5.0,2,0,22.0,Yes,2012,No,No,No
Malcolm Miller,920,68,685,326,134,98,1766.0,404,170,74.0,281,156,24.2,Yes,2012,No,No,No
Chasson Randle,2375,354,1775,760,684,551,4791.0,787,304,324.0,988,456,25.9,Yes,2012,No,No,No
Dwight Powell,1465,240,1110,515,557,402,3569.0,114,33,283.0,996,482,23.8,Yes,2012,No,No,No
Anthony Brown,1562,231,1211,518,410,308,4200.0,541,218,228.0,670,300,20.1,Yes,2012,No,No,No
Josh Huestis,1019,113,870,392,277,169,3376.0,207,66,125.0,663,326,17.0,Yes,2012,No,No,No
Willie Green,888,125,645,337,294,198,2282.0,65,16,136.0,580,321,20.8,Yes,2012,No,No,No
Rakeem Christmas,1046,86,731,409,335,228,3126.0,1,0,162.0,730,409,17.4,Yes,2012,No,No,No
Michael Gbinije,1177,310,900,409,313,200,3061.0,411,159,194.0,489,250,21.1,Yes,2012,No,No,No
Jordan McRae,1521,209,1190,496,455,350,3088.0,522,179,225.0,668,317,27.8,Yes,2012,No,No,No
Jarnell Stokes,1129,129,776,411,489,307,2587.0,3,0,180.0,773,411,24.2,Yes,2012,No,No,No
Josh Richardson,1252,246,1005,458,314,238,3842.0,308,98,209.0,697,360,19.0,Yes,2012,No,No,No
Kevin Lynch,4,0,7,2,1,0,75.0,0,0,3.0,7,2,7.4,Yes,2012,No,No,No
Brandon Williams,186,8,133,77,60,32,761.0,3,0,31.0,130,77,12.4,Yes,2012,No,No,No
Julian Washburn,1526,274,1360,592,319,223,4448.0,349,119,213.0,1011,473,21.3,Yes,2012,No,No,No
Kyle Anderson,865,355,670,303,303,223,2242.0,96,36,183.0,574,267,22.2,Yes,2012,No,No,No
Norman Powell,1376,214,1090,503,347,259,3555.0,354,111,180.0,736,392,20.3,Yes,2012,No,No,No
Travis Wear,1052,85,843,425,228,182,2845.0,50,20,115.0,793,405,18.8,Yes,2012,No,No,No
David Wear,888,96,748,354,163,120,2832.0,142,60,120.0,606,294,16.8,Yes,2012,No,No,No
Darrun Hilliard,1511,248,1125,491,428,320,3537.0,569,209,206.0,556,282,22.4,Yes,2012,No,No,No
Treveon Graham,1882,199,1431,618,645,446,3558.0,565,200,191.0,866,418,26.8,Yes,2012,No,No,No
Briante Weber,862,378,695,296,299,230,2965.0,146,40,186.0,549,256,17.0,Yes,2012,No,No,No
Jarell Eddie,1182,139,995,383,276,224,3176.0,526,192,183.0,469,191,21.7,Yes,2012,No,No,No
Malcolm Brogdon,1809,335,1399,601,482,422,4157.0,507,185,207.0,892,416,25.3,Yes,2012,No,No,No
Joe Harris,1698,254,1276,568,414,299,4084.0,646,263,213.0,630,305,23.6,Yes,2012,No,No,No
C.J. Wilcox,1880,214,1478,640,356,299,3735.0,773,301,178.0,705,339,24.1,Yes,2012,No,No,No
Mike Brown,1309,235,1065,446,421,304,3396.0,335,113,226.0,730,333,21.7,Yes,2012,No,No,No
Shayne Whittington,1119,81,807,416,367,279,2574.0,48,8,150.0,759,408,22.9,Yes,2012,No,No,No
Marcus Thornton,2178,308,1649,709,551,435,4328.0,809,325,324.0,840,384,28.7,Yes,2012,No,No,No
Frank Kaminsky,1458,188,1013,529,389,297,2943.0,279,103,121.0,734,426,25.5,Yes,2012,No,No,No
Duje Dukan,298,37,248,106,64,42,970.0,134,44,36.0,114,62,18.6,Yes,2012,No,No,No
Larry Nance,1386,172,978,510,428,330,3631.0,117,36,193.0,861,474,22.8,Yes,2012,No,Yes,Yes
Michael Lyons,1527,214,1201,549,383,287,3482.0,448,142,228.0,753,407,26.7,No,2013,No,No,No
Mike Fitzgerald,804,90,551,261,200,162,2389.0,305,120,115.0,246,141,18.3,No,2013,No,No,No
Todd Fletcher,822,366,644,292,145,118,3441.0,334,120,172.0,310,172,14.8,No,2013,No,No,No
Taylor Broekhuis,828,149,606,303,266,170,2743.0,180,52,176.0,426,251,19.1,No,2013,No,No,No
Kyle Green,240,69,201,76,52,41,744.0,134,47,49.0,67,29,20.7,No,2013,No,No,No
DeLovell Earls,291,121,262,108,111,58,1207.0,64,17,100.0,198,91,19.1,No,2013,No,No,No
Marek Olesinski,750,121,578,265,134,97,2234.0,326,123,103.0,252,142,18.6,No,2013,No,No,No
Kamryn Williams,554,157,465,204,159,105,1807.0,127,41,127.0,338,163,20.6,No,2013,No,No,No
Cam Michael,527,61,408,182,93,72,1166.0,230,91,53.0,178,91,23.0,No,2013,No,No,No
Tre' Coggins,1483,194,1205,492,307,252,3101.0,682,247,232.0,523,245,26.0,No,2013,No,No,No
Max Yon,828,164,648,280,232,174,2206.0,289,94,154.0,359,186,23.1,No,2013,No,No,No
Justin Hammonds,530,111,361,196,205,118,1758.0,50,20,110.0,311,176,18.1,No,2013,No,No,No
Chase Kammerer,74,32,59,25,42,22,373.0,11,2,25.0,48,23,15.5,No,2013,No,No,No
Ethan Michael,24,16,19,6,20,11,81.0,5,1,7.0,14,5,23.9,No,2013,No,No,No
Zach Moer,359,47,280,133,102,77,897.0,48,16,84.0,232,117,24.5,No,2013,No,No,No
Zeke Marshall,1265,97,857,470,518,323,3213.0,8,2,196.0,849,468,20.6,No,2013,No,No,No
Demetrius Treadwell,1101,143,875,424,454,252,2554.0,13,1,194.0,862,423,25.7,No,2013,No,No,No
Alex Abreu,833,450,622,258,239,189,2530.0,319,128,245.0,303,130,19.8,No,2013,No,No,No
Nick Harney,781,77,606,298,238,159,1686.0,101,26,151.0,505,272,26.3,No,2013,No,No,No
Brian Walsh,532,94,430,176,122,92,1731.0,231,88,64.0,199,88,16.0,No,2013,No,No,No
Jake Kretzer,869,145,694,278,121,100,3034.0,571,213,96.0,123,65,14.3,No,2013,No,No,No
Chauncey Gilliam,1119,105,886,404,247,192,2843.0,323,119,130.0,563,285,21.0,No,2013,No,No,No
Reggie McAdams,975,76,735,314,139,99,2514.0,610,248,49.0,125,66,17.2,No,2013,No,No,No
Pat Forsythe,815,72,615,327,267,160,2210.0,6,1,171.0,609,326,21.2,No,2013,No,No,No
Adedeji Ibitayo,598,68,453,192,209,138,1508.0,219,76,89.0,234,116,22.0,No,2013,No,No,No
Carmelo Betancourt,132,125,132,48,47,27,918.0,44,9,109.0,88,39,14.7,No,2013,No,No,No
Jonas Stalyga,14,0,10,5,5,1,7.0,6,3,0.0,4,2,89.3,No,2013,No,No,No
Darius Hoisten,2,0,2,0,2,2,7.0,1,0,0.0,1,0,21.3,No,2013,No,No,No
Blake Justice,2,2,8,0,2,2,22.0,8,0,1.0,0,0,22.8,No,2013,No,No,No
Luke Avsec,0,2,1,0,0,0,17.0,1,0,3.0,0,0,11.9,No,2013,No,No,No
Demarquelle Tabb,1178,120,915,443,501,292,3004.0,7,0,194.0,908,443,22.5,No,2013,No,No,No
Jeremy Crutcher,1130,462,988,368,415,265,3563.0,361,129,322.0,627,239,21.3,No,2013,No,No,No
Brandon Ellis,773,77,690,275,179,124,2077.0,304,99,154.0,386,176,22.7,No,2013,No,No,No
Green Hill,523,178,406,158,244,182,1896.0,89,25,145.0,317,133,17.9,No,2013,No,No,No
Justin Banks,329,17,235,134,81,61,1299.0,2,0,75.0,233,134,13.6,No,2013,No,No,No
Jose Long,220,57,212,72,113,57,1255.0,74,19,45.0,138,53,12.7,No,2013,No,No,No
Tyler Davis,388,86,358,128,89,58,1861.0,237,74,97.0,121,54,13.8,Yes,2013,No,No,No
Nicholas West,957,92,733,307,381,274,2342.0,232,69,198.0,501,238,24.5,No,2013,No,No,No
Justin Wagner,69,9,70,22,30,17,224.0,37,8,10.0,33,14,21.1,No,2013,No,No,No
Justin Colvin,317,53,311,104,87,53,1043.0,185,56,68.0,126,48,20.8,No,2013,No,No,No
Arthur Capers,243,33,226,94,44,28,690.0,88,27,48.0,138,67,22.2,No,2013,No,No,No
Baryn Houston,112,11,145,40,28,15,503.0,78,17,14.0,67,23,17.6,No,2013,No,No,No
Anthony Lanier,29,4,30,11,10,7,143.0,0,0,8.0,30,11,15.0,No,2013,No,No,No
David Basil,2,0,2,1,0,0,6.0,0,0,1.0,2,1,25.1,No,2013,No,No,No
Rod Rucker,808,138,728,318,267,171,2009.0,15,1,147.0,713,317,23.6,No,2013,No,No,No
Jordan Swing,1011,207,811,339,251,197,2724.0,408,136,165.0,403,203,20.2,No,2013,No,No,No
Fahro Alihodzic,719,50,652,297,183,124,2246.0,6,1,123.0,646,296,18.1,No,2013,No,No,No
Robert Williams,709,135,580,243,212,147,2717.0,220,76,157.0,360,167,15.1,No,2013,No,No,No
Terence Jones,1148,329,1027,358,347,245,3400.0,573,187,345.0,454,171,22.8,No,2013,No,No,No
Preston Purifoy,679,69,508,210,172,144,2086.0,307,115,89.0,201,95,16.7,No,2013,No,No,No
Quincy Taylor,926,295,794,324,171,118,3348.0,397,160,259.0,397,164,17.7,No,2013,No,No,No
Isiah Jones,656,172,587,221,118,81,1833.0,378,133,137.0,209,88,20.8,No,2013,No,No,No
Jekore Tyler,192,40,184,70,59,38,479.0,48,14,62.0,136,56,30.5,No,2013,No,No,No
Alexander Scotland-Williamson,29,5,12,7,23,15,211.0,0,0,21.0,12,7,10.4,No,2013,No,No,No
Karl Moton,19,3,12,7,2,1,49.0,8,4,1.0,4,3,14.0,No,2013,No,No,No
Josh Freelove,948,79,818,364,117,88,2243.0,363,132,110.0,455,232,22.6,No,2013,No,No,No
Phillip Crawford,577,25,448,233,176,110,1120.0,5,1,93.0,443,232,28.4,No,2013,No,No,No
Shawntez Patterson,396,39,405,144,67,31,1221.0,214,77,85.0,191,67,21.2,No,2013,No,No,No
Jamel Waters,1527,579,1248,509,482,362,3894.0,419,147,296.0,829,362,22.3,No,2013,No,No,No
Ryan Watts,433,78,442,148,126,86,1408.0,180,51,136.0,262,97,23.0,No,2013,No,No,No
Denaell McDaniel,159,85,138,51,64,37,699.0,57,20,60.0,81,31,16.5,No,2013,No,No,No
Bobby Brown,925,92,888,337,205,133,2601.0,384,118,139.0,504,219,21.2,Yes,2013,No,No,No
Luther Page,660,89,502,227,381,206,2624.0,3,0,205.0,499,227,16.8,No,2013,No,No,No
Stephawn Brown,307,63,301,125,65,30,1520.0,93,27,89.0,208,98,14.1,No,2013,No,No,No
Jonathan Jefferson,66,10,86,21,36,22,407.0,27,2,23.0,59,19,15.8,No,2013,No,No,No
Joshua Mason,75,25,90,30,33,15,391.0,11,0,45.0,79,30,19.7,No,2013,No,No,No
Dominique Miller,20,1,21,9,12,2,76.0,5,0,4.0,16,9,20.4,No,2013,No,No,No
Kimani Key,11,0,17,4,0,0,40.0,9,3,3.0,8,1,25.3,No,2013,No,No,No
Anthony Price,32,26,35,12,13,5,234.0,14,3,21.0,21,9,13.5,No,2013,No,No,No
Timothy Coleman,9,0,7,3,3,3,48.0,0,0,2.0,7,3,11.0,No,2013,No,No,No
Devonte' Neal,11,1,10,3,10,5,54.0,0,0,1.0,10,3,14.6,No,2013,No,No,No
Terrelle Green,2,0,10,1,0,0,30.0,2,0,3.0,8,1,21.9,No,2013,No,No,No
Trevor Releford,1873,395,1319,638,537,437,4367.0,446,160,303.0,873,478,23.1,No,2013,No,No,No
Trevor Lacey,1197,295,971,404,293,218,3199.0,468,171,202.0,503,233,22.0,No,2013,No,No,No
Rodney Cooper,1122,161,988,401,245,182,3514.0,443,138,182.0,545,263,20.0,No,2013,No,No,No
Levi Randolph,1336,243,1043,455,411,307,4139.0,360,119,177.0,683,336,18.7,No,2013,No,No,No
Nick Jacobs,1057,22,895,454,229,149,2691.0,1,0,149.0,894,454,22.7,No,2013,No,No,No
Devonta Pollard,954,113,755,340,377,271,2572.0,19,3,164.0,736,337,22.2,No,2013,No,No,No
Retin Obasohan,1176,182,877,380,479,327,2937.0,266,89,206.0,611,291,24.0,No,2013,No,No,No
Andrew Steele,399,128,301,124,176,126,1775.0,90,25,101.0,211,99,14.3,No,2013,No,No,No
Moussa Gueye,219,17,162,79,91,61,1209.0,0,0,136.0,162,79,15.1,No,2013,No,No,No
Carl Engstrom,108,16,90,43,37,22,773.0,0,0,45.0,90,43,10.6,No,2013,No,No,No
Dakota Slaughter,393,70,308,139,65,49,1099.0,179,66,53.0,129,73,18.5,No,2013,No,No,No
Isiah Wilson,10,1,8,3,8,4,19.0,2,0,0.0,6,3,33.8,No,2013,No,No,No
Keon Blackledge,4,4,7,2,0,0,32.0,5,0,1.0,2,2,13.7,No,2013,No,No,No
Julian Goode,0,0,0,0,0,0,7.0,0,0,0.0,0,0,0.0,No,2013,No,No,No
Mike Black,1542,383,1190,508,470,346,3831.0,460,180,340.0,730,328,24.5,No,2013,No,No,No
Jacob Iati,655,116,501,201,124,100,2029.0,382,153,88.0,119,48,17.2,No,2013,No,No,No
Sam Rowley,1194,166,888,453,379,288,3202.0,6,0,268.0,882,453,23.1,No,2013,No,No,No
Peter Hooley,1519,337,1157,464,511,410,3905.0,555,181,257.0,602,283,22.8,No,2013,No,No,No
John Puk,548,62,471,217,162,114,2845.0,0,0,145.0,471,217,13.3,No,2013,No,No,No
Blake Metcalf,471,86,372,207,170,57,2536.0,2,0,124.0,370,207,12.2,No,2013,No,No,No
Jayson Guerrier,351,34,287,121,63,44,1118.0,172,65,43.0,115,56,17.1,No,2013,No,No,No
Luke Devlin,605,84,529,230,139,92,2389.0,182,53,90.0,347,177,15.5,No,2013,No,No,No
DJ Evans,481,110,401,155,147,113,1476.0,169,58,87.0,232,97,20.8,No,2013,No,No,No
Gary Johnson,433,58,315,151,178,129,1309.0,10,2,82.0,305,149,20.2,No,2013,No,No,No
Chris Page,13,2,17,5,2,1,37.0,11,2,1.0,6,3,28.2,No,2013,No,No,No
Dave Wiegmann,53,12,56,20,20,11,351.0,13,2,18.0,43,18,13.1,No,2013,No,No,No
Reece Williams,4,0,5,1,2,2,23.0,1,0,2.0,4,1,19.2,No,2013,No,No,No
LeAntwan Luckett,1533,214,1351,520,603,404,3384.0,342,89,264.0,1009,431,28.6,No,2013,No,No,No
Anthony Nieves,547,86,481,181,194,127,1363.0,163,58,151.0,318,123,26.7,No,2013,No,No,No
Marquis Baker,415,45,378,127,138,99,891.0,220,62,64.0,158,65,28.5,No,2013,No,No,No
Anthony Evans,255,93,288,94,50,34,1125.0,131,33,62.0,157,61,17.0,No,2013,No,No,No
Devonte Hampton,605,159,583,215,138,85,2356.0,280,90,154.0,303,125,17.4,No,2013,No,No,No
Ian Francis,751,86,613,273,346,205,2720.0,5,0,193.0,608,273,17.1,No,2013,No,No,No
Josh Nicholas,156,13,130,63,54,30,749.0,1,0,41.0,129,63,13.5,No,2013,No,No,No
Michael Starks,378,19,302,145,169,88,1904.0,0,0,86.0,302,145,11.9,No,2013,No,No,No
Tyrel Hunt,474,43,376,166,208,135,1516.0,20,7,79.0,356,159,18.5,No,2013,No,No,No
Stephane Raquil,108,11,97,44,42,20,881.0,1,0,37.0,96,44,9.1,No,2013,No,No,No
Jamaal Hester,32,4,27,13,13,6,179.0,0,0,10.0,27,13,12.0,No,2013,No,No,No
Terrance Birdie,29,8,31,11,10,4,117.0,13,3,8.0,18,8,18.7,No,2013,No,No,No
Marius Myles,78,11,63,28,34,22,616.0,0,0,21.0,63,28,8.6,No,2013,No,No,No
Clint Nwosuh,65,17,61,20,12,10,251.0,42,15,14.0,19,5,15.9,No,2013,No,No,No
Martrevious Sanders,71,41,69,30,15,11,289.0,2,0,31.0,67,30,19.0,No,2013,No,No,No
Larry Johnson,2,1,1,1,0,0,6.0,0,0,0.0,1,1,8.3,Yes,2013,Yes,Yes,Yes
Stephen Lumpkins,1354,107,968,501,564,352,3202.0,4,0,166.0,964,501,24.7,No,2013,No,No,No
Daniel Munoz,799,371,710,258,244,191,3332.0,270,92,226.0,440,166,17.9,No,2013,No,No,No
John Schoof,1154,230,909,390,185,147,4062.0,553,227,187.0,356,163,17.6,No,2013,No,No,No
Tony Wroblicky,881,132,657,363,242,155,2565.0,0,0,177.0,657,363,21.5,No,2013,No,No,No
Blake Jolivette,446,128,442,168,108,77,1678.0,78,33,133.0,364,135,21.0,No,2013,No,No,No
Jesse Reed,1405,171,1037,479,367,272,3927.0,448,175,207.0,589,304,21.8,No,2013,No,No,No
Mike Bersch,203,32,226,72,9,6,772.0,182,53,34.0,44,19,19.5,No,2013,No,No,No
Austin Carroll,188,58,181,62,29,17,872.0,140,47,56.0,41,15,16.1,No,2013,No,No,No
Marko Vasic,481,157,414,194,97,58,2081.0,135,35,96.0,279,159,16.2,No,2013,No,No,No
Kyle Kager,218,39,172,79,60,44,755.0,53,16,56.0,119,63,20.0,No,2013,No,No,No
Daniel Fisher,64,17,59,25,23,14,430.0,2,0,26.0,57,25,12.6,No,2013,No,No,No
Zach Elcano,72,24,57,28,30,16,443.0,0,0,39.0,57,28,15.7,No,2013,No,No,No
Warren Flood,1,0,5,0,2,1,15.0,0,0,2.0,5,0,30.3,No,2013,No,No,No
Nathan Healy,816,110,624,298,182,138,2396.0,222,82,125.0,402,216,17.6,No,2013,No,No,No
Jay Canty,578,109,468,212,193,134,1337.0,81,20,106.0,387,192,25.2,No,2013,No,No,No
Tevin Baskin,554,25,438,193,219,153,1274.0,46,15,75.0,392,178,24.2,No,2013,No,No,No
Tab Hamilton,913,94,865,329,150,109,2593.0,435,146,116.0,430,183,20.4,No,2013,No,No,No
Jamaal Trice,492,52,407,155,150,104,1490.0,205,78,97.0,202,77,19.6,No,2013,No,No,No
Michael Neal,704,259,597,226,250,170,2169.0,241,82,229.0,356,144,22.0,No,2013,No,No,No
Michael Obacha,495,53,310,156,342,183,2361.0,0,0,118.0,310,156,12.5,No,2013,No,No,No
Chris Burgess,782,271,670,265,149,120,2712.0,365,132,159.0,305,133,16.6,No,2013,No,No,No
Frank Eaves,1211,136,958,357,417,334,2388.0,466,163,160.0,492,194,27.3,No,2013,No,No,No
Brian Okam,35,3,30,11,27,13,246.0,0,0,15.0,30,11,11.8,No,2013,No,No,No
Rantavious Gilbert,79,6,69,32,23,15,262.0,0,0,15.0,69,32,18.2,No,2013,No,No,No
Tommy Spagnolo,590,66,447,239,171,106,1813.0,17,6,130.0,430,233,18.4,No,2013,No,No,No
Bennett Rutherford,2,1,5,1,0,0,16.0,3,0,0.0,2,1,15.8,No,2013,No,No,No
Jahii Carson,1261,330,975,442,424,308,2471.0,195,69,240.0,780,373,29.7,No,2013,No,No,No
Carrick Felix,955,125,748,341,247,174,2626.0,304,99,162.0,444,242,21.0,Yes,2013,No,No,No
Evan Gordon,1363,249,1116,456,345,260,3778.0,556,191,254.0,560,265,20.5,No,2013,No,No,No
Jordan Bachynski,968,33,632,354,424,260,2670.0,0,0,158.0,632,354,19.6,No,2013,No,No,No
Jonathan Gilling,998,272,784,323,138,94,3579.0,638,258,184.0,146,65,15.2,No,2013,No,No,No
Chris Colvin,441,228,420,147,206,110,1849.0,127,37,201.0,293,110,20.5,No,2013,No,No,No
Ruslan Pateev,344,53,270,143,98,58,1292.0,0,0,89.0,270,143,17.2,No,2013,No,No,No
Eric Jacobsen,659,65,415,239,305,180,2258.0,2,1,125.0,413,238,15.4,No,2013,No,No,No
Bo Barnes,575,64,461,182,112,83,1841.0,339,128,67.0,122,54,16.3,No,2013,No,No,No
Kenny Martin,5,0,11,2,0,0,38.0,8,1,2.0,3,1,17.8,No,2013,No,No,No
Joey Hormes,0,0,0,0,0,0,1.0,0,0,0.0,0,0,0.0,No,2013,No,No,No
Jarett Upchurch,7,1,4,3,0,0,12.0,2,1,1.0,2,2,21.6,No,2013,No,No,No
David Whitmore,4,1,3,1,2,2,28.0,1,0,0.0,2,1,7.7,No,2013,No,No,No
Mark Lyons,1740,358,1375,577,513,392,3975.0,553,194,315.0,822,383,25.1,No,2013,No,No,No
Solomon Hill,1430,304,1012,487,458,341,4030.0,307,115,290.0,705,372,19.7,Yes,2013,No,No,No
Nick Johnson,1333,304,1048,441,418,307,3339.0,401,144,197.0,647,297,22.7,Yes,2013,No,No,No
Kevin Parrom,755,204,557,259,196,141,2257.0,253,96,116.0,304,163,17.6,No,2013,No,No,No
Brandon Ashley,979,71,678,352,344,249,2383.0,68,26,146.0,610,326,21.5,No,2013,No,No,No
Kaleb Tarczewski,1185,63,740,415,504,355,3489.0,0,0,204.0,740,415,17.4,No,2013,No,No,No
Grant Jerrett,176,18,154,63,22,18,606.0,79,32,19.0,75,31,15.6,Yes,2013,No,No,No
Jordin Mayes,464,129,421,161,96,64,1664.0,222,78,97.0,199,83,17.7,No,2013,No,No,No
Angelo Chol,455,27,355,184,142,87,1649.0,0,0,113.0,355,184,17.2,No,2013,No,No,No
Gabe York,1143,191,915,379,208,156,2904.0,569,229,131.0,346,150,20.0,No,2013,No,No,No
Max Wiepking,16,0,8,5,5,2,36.0,7,4,1.0,1,1,16.4,No,2013,No,No,No
Quinton Crawford,0,1,3,0,0,0,15.0,3,0,0.0,0,0,10.4,No,2013,No,No,No
Jacob Hazzard,40,7,43,15,2,2,93.0,23,8,12.0,20,7,31.0,No,2013,No,No,No
Drew Mellon,1,3,8,0,2,1,46.0,3,0,1.0,5,0,11.2,No,2013,No,No,No
Will Neighbour,1054,97,788,354,340,257,2458.0,240,89,214.0,548,265,24.1,No,2013,No,No,No
John Gillon,1361,489,925,365,531,446,3411.0,489,185,252.0,436,180,21.0,No,2013,No,No,No
Josh Hagins,1475,468,1224,525,306,250,3495.0,497,175,241.0,727,350,24.0,No,2013,No,No,No
Leroy Isler,451,72,363,143,188,136,1644.0,93,29,109.0,270,114,17.1,No,2013,No,No,No
James White,863,78,706,357,240,146,2188.0,15,3,157.0,691,354,22.6,Yes,2013,No,No,No
Ben Dillard,801,119,584,223,307,253,2555.0,288,102,111.0,296,121,17.0,No,2013,No,No,No
Michael Javes,341,28,339,134,168,71,1202.0,7,2,85.0,332,132,21.5,No,2013,No,No,No
Kemy Osse,741,92,648,247,147,109,2156.0,396,138,89.0,252,109,19.5,No,2013,No,No,No
Taggart Lockhart,227,49,199,77,79,49,966.0,86,24,41.0,113,53,14.8,No,2013,No,No,No
Gus Leeper,367,19,322,141,111,82,1502.0,4,3,89.0,318,138,15.9,No,2013,No,No,No
Stetson Billings,199,51,207,65,73,54,1095.0,47,15,51.0,160,50,13.8,No,2013,No,No,No
Ted Crass,7,0,9,3,2,0,34.0,6,1,1.0,3,2,16.1,No,2013,No,No,No
Casey Wilmath,3,0,1,1,0,0,15.0,1,1,3.0,0,0,13.2,No,2013,No,No,No
Andrew Poulter,28,0,27,14,2,0,56.0,0,0,1.0,27,14,25.8,No,2013,No,No,No
DaVon Haynes,754,62,572,284,281,173,1812.0,51,13,137.0,521,271,23.7,No,2013,No,No,No
Lazabian Jackson,651,146,600,219,137,95,1838.0,366,118,120.0,234,101,21.8,No,2013,No,No,No
Terrell Kennedy,664,113,552,240,210,149,1727.0,107,35,122.0,445,205,23.0,No,2013,No,No,No
Mitchell Anderson,602,70,575,231,164,97,1687.0,162,43,110.0,413,188,23.2,Yes,2013,No,No,No
Tevin Hammond,892,365,755,255,354,257,3063.0,388,125,307.0,367,130,20.8,No,2013,No,No,No
Daniel Broughton,988,78,884,379,315,197,2543.0,89,33,224.0,795,346,25.5,No,2013,No,No,No
Marcel Mosley,1019,221,804,320,314,245,2664.0,368,134,259.0,436,186,23.8,No,2013,No,No,No
Jaylon Floyd,170,14,138,67,65,34,1085.0,9,2,60.0,129,65,10.9,No,2013,No,No,No
Trent Whiting,444,92,385,174,133,74,1860.0,78,22,105.0,307,152,15.7,No,2013,No,No,No
Warren Boyd,29,5,30,8,20,13,199.0,2,0,7.0,28,8,11.7,No,2013,No,No,No
Kyle Jones,56,20,66,18,8,3,383.0,62,17,21.0,4,1,12.3,No,2013,No,No,No
Chandler Savage,72,34,63,26,33,20,550.0,10,0,33.0,53,26,10.4,No,2013,No,No,No
Demetrious Smith,17,5,9,5,6,5,192.0,3,2,15.0,6,3,7.2,No,2013,No,No,No
Jared Young,8,0,5,3,3,1,23.0,2,1,3.0,3,2,21.2,No,2013,No,No,No
Edward Townsel,1177,240,1027,392,299,217,3366.0,496,176,247.0,531,216,21.8,No,2013,No,No,No
Brandon Peterson,1098,134,811,380,514,335,3676.0,14,3,228.0,797,377,18.0,No,2013,No,No,No
Trey Finn,1165,210,894,360,349,261,3845.0,491,184,162.0,403,176,16.4,No,2013,No,No,No
Cameron Golden,870,224,809,288,215,146,2406.0,475,148,175.0,334,140,23.2,No,2013,No,No,No
Marcus Hooten,644,88,581,220,208,141,1690.0,184,63,108.0,397,157,24.4,No,2013,No,No,No
Raeford Worsham,952,131,716,342,414,248,2340.0,91,20,155.0,625,322,22.8,No,2013,No,No,No
Kendrick Washington,808,112,614,295,341,213,2620.0,24,5,170.0,590,290,18.4,No,2013,No,No,No
Rakeem Dickerson,400,179,298,110,210,153,1708.0,88,27,116.0,210,83,15.6,No,2013,No,No,No
Kelvin Downs,325,28,283,126,110,72,1419.0,6,1,106.0,277,125,15.8,No,2013,No,No,No
Jordan Weaver,9,3,4,3,4,3,25.0,1,0,2.0,3,3,16.1,No,2013,No,No,No
Josh Pierre,40,4,52,10,16,11,337.0,46,9,6.0,6,1,9.6,No,2013,No,No,No
Seth Kisler,37,2,24,13,11,7,123.0,9,4,7.0,15,9,15.2,No,2013,No,No,No
Kristopher Brown,0,0,1,0,0,0,7.0,0,0,0.0,1,0,7.3,No,2013,No,No,No
B.J. Young,958,178,752,357,240,169,1673.0,231,75,138.0,521,282,29.3,No,2013,No,No,No
Marshawn Powell,1283,120,1011,497,383,247,2482.0,145,42,173.0,866,455,27.1,No,2013,No,No,No
Coty Clarke,556,116,386,181,206,160,1384.0,77,34,83.0,309,147,19.6,Yes,2013,No,No,No
Mardracus Wade,797,153,569,235,253,198,2662.0,341,129,121.0,228,106,14.9,No,2013,No,No,No
Hunter Mickelson,442,45,414,192,82,56,1397.0,12,2,77.0,402,190,18.7,No,2013,No,No,No
Michael Qualls,1100,147,851,364,372,269,2379.0,312,103,133.0,539,261,23.4,No,2013,No,No,No
Rickey Scott,532,163,487,195,204,117,1628.0,112,25,94.0,375,170,20.4,No,2013,No,No,No
Rashad Madden,1106,369,782,336,390,314,2997.0,353,120,246.0,429,216,19.5,No,2013,No,No,No
Anthlon Bell,1144,121,1012,394,149,119,2360.0,642,237,96.0,370,157,24.0,No,2013,No,No,No
Kikko Haydar,230,64,192,71,42,30,952.0,153,58,32.0,39,13,12.4,No,2013,No,No,No
Jacorey Williams,989,127,856,412,248,158,2208.0,37,7,139.0,819,405,25.5,No,2013,No,No,No
Fred Gulley III,265,140,270,90,99,55,1816.0,110,30,81.0,160,60,10.9,No,2013,No,No,No
DeQuavious Wagner,37,30,41,11,10,9,163.0,23,6,9.0,18,5,16.2,No,2013,No,No,No
Davion Spivey,4,0,5,2,0,0,18.0,0,0,3.0,5,2,21.6,No,2013,No,No,No
Charlie Henderson,3,0,4,1,0,0,10.0,1,1,0.0,3,0,19.4,No,2013,No,No,No
Ella Ellis,1585,159,1129,479,532,434,2952.0,510,193,206.0,619,286,27.6,No,2013,No,No,No
Kyle Wilson,2001,211,1676,686,446,355,3781.0,754,274,257.0,922,412,28.2,No,2013,No,No,No
Kyle Toth,585,53,492,207,51,33,1753.0,338,138,34.0,154,69,16.3,No,2013,No,No,No
Larry Toomey,666,197,587,225,187,128,2554.0,280,88,156.0,307,137,16.2,No,2013,No,No,No
Dylan Cox,1030,479,716,381,361,231,3135.0,113,37,266.0,603,344,18.3,No,2013,No,No,No
Josh Herbeck,777,99,708,266,64,48,2144.0,521,197,101.0,187,69,20.0,No,2013,No,No,No
Kevin Ferguson,1059,139,691,433,297,193,2802.0,0,0,196.0,691,433,18.1,No,2013,No,No,No
Andrew Stire,221,33,154,89,74,43,890.0,0,0,55.0,154,89,14.0,No,2013,No,No,No
Jordan Springer,297,55,225,110,119,77,1475.0,0,0,95.0,225,110,13.1,No,2013,No,No,No
Matt Gramling,184,75,196,69,58,36,797.0,62,10,38.0,134,59,16.6,No,2013,No,No,No
Maxwell Lenox,290,175,218,102,123,76,1180.0,43,10,126.0,175,92,17.5,No,2013,No,No,No
Tanner Plomb,1359,130,1098,468,316,239,2449.0,515,184,151.0,583,284,28.1,No,2013,No,No,No
Cartavious Kincade,68,19,57,23,27,19,256.0,15,3,17.0,42,20,17.3,No,2013,No,No,No
Mo Williams,368,93,314,110,144,101,2002.0,163,47,103.0,151,63,12.3,Yes,2013,No,Yes,Yes
Kyle Weldon,4,0,5,2,0,0,29.0,1,0,3.0,4,2,14.0,No,2013,No,No,No
Sean Billerman,14,3,12,4,7,4,36.0,9,2,0.0,3,2,21.5,No,2013,No,No,No
Milton Washington,161,57,115,58,58,41,473.0,8,4,57.0,107,54,21.5,No,2013,No,No,No
Zach Lord,0,0,0,0,0,0,1.0,0,0,0.0,0,0,0.0,No,2013,No,No,No
Travis Rollo,48,21,48,21,17,6,572.0,1,0,21.0,47,21,6.7,No,2013,No,No,No
Frankie Sullivan,1556,287,1268,497,431,334,3755.0,713,228,243.0,555,269,23.2,No,2013,No,No,No
Rob Chubb,759,63,675,315,214,129,2191.0,1,0,178.0,674,315,22.7,No,2013,No,No,No
Allen Payne,734,135,635,266,231,163,2765.0,154,39,193.0,481,227,17.5,No,2013,No,No,No
Chris Denson,1190,156,873,401,527,341,2496.0,171,47,129.0,702,354,25.9,No,2013,No,No,No
Shaquille Johnson,865,230,741,318,246,169,2352.0,240,60,245.0,501,258,24.0,No,2013,No,No,No
Noel Johnson,367,50,395,131,34,21,1350.0,250,84,83.0,145,47,18.5,No,2013,No,No,No
Jordan Price,1768,267,1449,578,467,355,3609.0,719,257,299.0,730,321,28.8,No,2013,No,No,No
Josh Wallace,439,302,395,148,203,132,2429.0,43,11,155.0,352,137,13.7,No,2013,No,No,No
Asauhn Dixon-Tatum,299,17,220,115,104,69,1123.0,0,0,64.0,220,115,15.2,No,2013,No,No,No
Brian Greene,216,101,242,79,46,29,1122.0,88,29,71.0,154,50,15.2,No,2013,No,No,No
Jordon Granger,366,58,288,128,86,56,1815.0,158,54,76.0,130,74,11.2,No,2013,No,No,No
Shareif Adamu,155,20,121,53,81,46,591.0,18,3,43.0,103,50,17.3,No,2013,No,No,No
Nick Pellar,3,1,2,1,0,0,12.0,1,1,1.0,1,0,13.0,No,2013,No,No,No
Dylan Spencer,3,0,5,1,2,0,17.0,5,1,3.0,0,0,27.6,No,2013,No,No,No
C.J. Holmes,8,0,3,3,0,0,14.0,2,2,1.0,1,1,14.6,No,2013,No,No,No
Travis Betran,1008,152,789,325,231,199,2069.0,416,159,155.0,373,166,25.3,No,2013,No,No,No
Anthony Campbell,1362,158,992,455,341,271,3150.0,507,181,222.0,485,274,22.0,No,2013,No,No,No
Will Triggs,1139,154,779,412,519,315,2964.0,3,0,197.0,776,412,20.5,No,2013,No,No,No
Chris Horton,1719,144,1200,662,633,395,3932.0,1,0,270.0,1199,662,22.2,No,2013,No,No,No
Chris Freeman,612,46,439,246,177,120,1740.0,1,0,117.0,438,246,18.3,No,2013,No,No,No
Corey Arentsen,201,46,168,65,24,18,666.0,136,53,29.0,32,12,15.5,No,2013,No,No,No
Jeremy Purvis,136,85,122,41,30,21,831.0,96,33,36.0,26,8,10.3,No,2013,No,No,No
A.J. Lynch,83,59,118,30,27,12,488.0,50,11,54.0,68,19,19.0,No,2013,No,No,No
Preston Herring,111,11,68,40,46,25,369.0,8,6,19.0,60,34,14.7,No,2013,No,No,No
Herdie Lawrence,171,75,166,54,60,39,715.0,103,24,102.0,63,30,20.7,No,2013,No,No,No
Jerome Clyburn,255,113,199,75,116,89,998.0,49,16,84.0,150,59,16.9,No,2013,No,No,No
Thomas Greer,64,21,47,18,35,20,339.0,20,8,29.0,27,10,13.6,No,2013,No,No,No
Matt Hasse,47,29,30,14,26,17,266.0,2,2,17.0,28,12,11.1,No,2013,No,No,No
Joe Harms,8,0,4,2,8,4,37.0,1,0,3.0,3,2,14.6,No,2013,No,No,No
Kevin Covington,1,1,1,0,2,1,17.0,0,0,3.0,1,0,14.5,No,2013,No,No,No
Jauwan Scaife,1326,187,1076,403,405,317,3369.0,579,203,198.0,497,200,23.1,No,2013,No,No,No
Jesse Berry,1257,181,999,377,379,279,3089.0,661,224,233.0,338,153,23.9,No,2013,No,No,No
Majok Majok,645,52,442,229,338,187,1799.0,0,0,143.0,442,229,21.1,No,2013,No,No,No
Chris Bond,1050,143,785,392,365,245,3105.0,79,21,205.0,706,371,19.5,No,2013,No,No,No
Marcus Posley,1321,265,1121,435,334,261,2942.0,577,190,196.0,544,245,25.5,No,2013,No,No,No
Matt Kamieniecki,431,71,300,156,228,118,1649.0,3,1,96.0,297,155,16.2,No,2013,No,No,No
Zach Fields,145,11,127,64,32,17,604.0,0,0,48.0,127,64,16.4,No,2013,No,No,No
Bo Calhoun,772,70,636,301,159,118,2207.0,153,52,140.0,483,249,20.4,No,2013,No,No,No
Michael Ramey,385,33,367,137,40,26,1279.0,239,85,39.0,128,52,17.8,No,2013,No,No,No
Tyler Koch,267,69,240,94,58,27,1211.0,155,52,70.0,85,42,14.8,No,2013,No,No,No
Chase Brogna,15,7,26,5,2,1,140.0,22,4,3.0,4,1,11.0,No,2013,No,No,No
Rocco Belcaster,101,30,111,33,19,10,529.0,91,25,34.0,20,8,15.7,No,2013,No,No,No
Pierre Jackson,1235,478,884,390,369,298,2424.0,414,157,256.0,470,233,27.1,Yes,2013,No,No,No
Cory Jefferson,1159,51,794,431,424,280,2589.0,50,17,101.0,744,414,21.4,Yes,2013,No,No,No
Isaiah Austin,883,91,744,338,241,159,2111.0,155,48,135.0,589,290,23.8,No,2013,No,No,No
Brady Heslip,1140,102,829,359,147,121,3015.0,689,301,42.0,140,58,15.8,No,2013,No,No,No
A.J. Walton,778,452,676,271,259,169,3413.0,201,67,298.0,475,204,16.2,No,2013,No,No,No
Rico Gathers,1208,46,879,430,583,347,3127.0,1,1,136.0,878,429,20.9,No,2013,No,No,No
Gary Franklin,513,185,483,163,101,68,2105.0,362,119,116.0,121,44,15.6,No,2013,No,No,No
Taurean Prince,1321,145,1017,468,355,255,2604.0,346,130,221.0,671,338,27.3,Yes,2013,No,No,No
Deuce Bello,555,78,428,194,222,128,1739.0,135,39,142.0,293,155,19.4,No,2013,No,No,No
L.J. Rose,608,415,516,192,210,155,2374.0,213,69,189.0,303,123,17.0,No,2013,No,No,No
Logan Lowery,228,27,199,86,47,34,673.0,58,22,53.0,141,64,20.5,No,2013,No,No,No
Jacob Neubert,14,2,20,6,4,2,59.0,2,0,5.0,18,6,22.9,No,2013,No,No,No
J'mison Morgan,180,13,147,74,83,32,677.0,0,0,42.0,147,74,17.5,No,2013,No,No,No
Ian Clark,1920,289,1406,681,269,218,3818.0,800,340,277.0,606,341,23.6,Yes,2013,No,No,No
Kerron Johnson,1388,515,848,405,682,511,3205.0,209,67,326.0,639,338,23.4,No,2013,No,No,No
Trevor Noack,693,51,592,265,122,84,1852.0,243,79,97.0,349,186,20.3,No,2013,No,No,No
J.J. Mann,1509,272,1212,524,265,227,3570.0,644,234,184.0,568,290,21.6,No,2013,No,No,No
Blake Jenkins,918,110,602,337,336,213,2381.0,99,31,156.0,503,306,19.5,No,2013,No,No,No
Reece Chamberlain,789,454,559,251,304,211,2787.0,211,76,219.0,348,175,17.1,No,2013,No,No,No
Brandon Baker,373,99,339,144,59,36,1600.0,180,49,73.0,159,95,13.7,No,2013,No,No,No
Craig Bradshaw,1698,328,1235,591,350,267,3370.0,632,249,279.0,603,342,25.4,No,2013,No,No,No
Adam Barnes,166,48,118,61,57,37,665.0,15,7,37.0,103,54,13.7,No,2013,No,No,No
Jeff Laidig,72,37,84,18,27,23,689.0,62,13,27.0,22,5,9.2,No,2013,No,No,No
Chad Lang,287,1,220,121,94,45,626.0,0,0,61.0,220,121,26.2,No,2013,No,No,No
Spencer Turner,158,33,143,53,12,7,463.0,128,45,20.0,15,8,18.8,No,2013,No,No,No
Holden Mobley,77,40,56,23,29,19,683.0,33,12,35.0,23,11,7.9,No,2013,No,No,No
Adrien Coleman,1027,151,768,392,424,224,2279.0,73,19,187.0,695,373,25.9,No,2013,No,No,No
Kevin Dukes,1159,264,982,376,171,131,3712.0,745,276,181.0,237,100,17.5,No,2013,No,No,No
Paul Scotland,363,97,310,110,123,91,1033.0,156,52,83.0,154,58,22.1,No,2013,No,No,No
Javoris Bryant,745,95,642,274,280,197,2618.0,5,0,131.0,637,274,18.1,No,2013,No,No,No
Alex Smith,277,28,196,121,68,35,929.0,1,0,52.0,195,121,15.2,No,2013,No,No,No
Ricky Johnson,1161,295,959,322,467,379,3574.0,464,138,242.0,495,184,20.6,No,2013,No,No,No
Malik Jackson,501,33,451,174,91,73,1279.0,241,80,60.0,210,94,22.7,No,2013,No,No,No
Marc Mack,155,15,184,63,54,28,852.0,7,1,54.0,177,62,15.8,No,2013,No,No,No
Brandon Stewart,292,28,240,80,141,106,709.0,100,26,60.0,140,54,28.0,No,2013,No,No,No
Allan Dempster,153,4,124,62,52,29,502.0,0,0,23.0,124,62,18.0,No,2013,No,No,No
Mikel Trapp,833,105,745,278,137,95,2874.0,536,182,140.0,209,96,17.8,No,2013,No,No,No
Myron Respress,2,0,5,1,0,0,47.0,0,0,0.0,5,1,5.3,No,2013,No,No,No
Jordan Reed,1175,105,958,387,533,371,2743.0,123,30,227.0,835,357,27.2,No,2013,No,No,No
Jimmy Gray,812,291,779,285,101,79,3205.0,506,163,241.0,273,122,17.9,No,2013,No,No,No
Taylor Johnston,368,44,326,124,60,40,1707.0,213,80,87.0,113,44,13.8,No,2013,No,No,No
Roland Brown,320,22,285,125,111,70,1021.0,2,0,87.0,283,125,21.8,No,2013,No,No,No
Rayner Moquete,357,73,357,124,70,45,1479.0,200,64,75.0,157,60,16.1,No,2013,No,No,No
Brian Freeman,111,5,97,47,28,17,338.0,0,0,34.0,97,47,22.3,No,2013,No,No,No
Javon Ralling,231,29,209,85,103,61,1028.0,1,0,68.0,208,85,17.0,No,2013,No,No,No
Alex Ogundadegbe,234,31,216,91,85,52,1244.0,2,0,60.0,214,91,13.6,No,2013,No,No,No
Karon Waller,200,32,172,59,78,56,856.0,84,26,51.0,88,33,16.1,No,2013,No,No,No
K.J. Brown,82,18,76,22,42,25,338.0,42,13,29.0,34,9,19.9,No,2013,No,No,No
Jabrille Williams,92,9,86,39,14,6,589.0,31,8,28.0,55,31,11.0,No,2013,No,No,No
Mike Horn,26,17,53,9,12,5,676.0,29,3,10.0,24,6,5.3,No,2013,No,No,No
Chris Rice,18,7,26,4,11,7,172.0,18,3,13.0,8,1,13.6,No,2013,No,No,No
Robert Mansell,526,62,462,169,207,151,1476.0,123,37,112.0,339,132,24.8,No,2013,No,No,No
Anthony Drmic,1942,244,1463,634,529,399,4117.0,786,275,223.0,677,359,24.5,No,2013,No,No,No
Derrick Marks,1912,370,1417,669,580,458,3538.0,293,116,332.0,1124,553,30.6,No,2013,No,No,No
Jeff Elorriaga,792,177,607,255,78,61,3111.0,518,221,70.0,89,34,12.0,No,2013,No,No,No
Ryan Watkins,1070,72,745,409,346,251,2651.0,3,1,122.0,742,408,20.2,No,2013,No,No,No
Mikey Thompson,1138,298,864,363,436,336,3394.0,214,76,211.0,650,287,19.8,No,2013,No,No,No
Igor Hadziomerovic,511,219,456,184,161,100,2365.0,140,43,150.0,316,141,15.5,No,2013,No,No,No
Kenny Buckner,393,29,275,169,97,55,1133.0,1,0,57.0,274,169,17.5,No,2013,No,No,No
Thomas Bropleh,715,84,567,238,175,125,2038.0,302,114,91.0,265,124,18.9,No,2013,No,No,No
Joe Hanstad,145,42,118,47,33,25,727.0,82,26,30.0,36,21,12.1,No,2013,No,No,No
Darrious Hamilton,17,1,12,5,12,7,73.0,0,0,8.0,12,5,18.4,No,2013,No,No,No
Vukasin Vujovic,11,0,13,3,4,4,36.0,5,1,3.0,8,2,26.0,No,2013,No,No,No
Jake Ness,12,3,9,2,10,8,188.0,2,0,5.0,7,2,5.4,No,2013,No,No,No
Olivier Hanlan,1727,303,1247,565,541,421,3493.0,487,176,236.0,760,389,27.9,No,2013,No,No,No
Ryan Anderson,1787,151,1295,630,706,495,3906.0,120,32,235.0,1175,598,25.9,Yes,2013,No,No,No
Joe Rahon,1277,607,1086,454,285,194,4773.0,491,175,248.0,595,279,17.3,No,2013,No,No,No
Lonnie Jackson,960,214,751,293,186,145,3203.0,598,229,167.0,153,64,17.2,No,2013,No,No,No
Patrick Heckmann,903,197,632,290,281,214,2691.0,320,109,194.0,312,181,19.9,No,2013,No,No,No
Eddie Odio,351,70,288,131,92,57,1856.0,109,32,75.0,179,99,12.3,No,2013,No,No,No
Dennis Clifford,889,118,669,336,320,209,2934.0,31,8,212.0,638,328,19.4,No,2013,No,No,No
Andrew Van Nest,171,21,160,61,30,24,622.0,89,25,36.0,71,36,18.4,No,2013,No,No,No
Danny Rubin,176,26,159,58,15,10,832.0,128,50,27.0,31,8,12.7,No,2013,No,No,No
Kyle Caudill,277,45,200,99,111,78,858.0,10,1,81.0,190,98,20.3,No,2013,No,No,No
Drew Jacobs,2,0,3,1,0,0,24.0,1,0,3.0,2,1,13.9,No,2013,No,No,No
John Cain Carney,17,5,22,8,3,0,240.0,4,1,8.0,18,7,7.3,No,2013,No,No,No
Steve Perpiglia,9,7,15,4,1,0,66.0,8,1,8.0,7,3,19.5,No,2013,No,No,No
D.J. Irving,1456,469,1146,458,475,370,4126.0,472,170,287.0,674,288,21.5,No,2013,No,No,No
Dom Morris,1139,94,856,439,312,220,3410.0,114,41,182.0,742,398,18.6,No,2013,No,No,No
Maurice Watson Jr.,1537,800,1220,590,387,270,3643.0,255,87,378.0,965,503,25.2,No,2013,No,No,No
John Papale,1289,249,1058,447,138,108,4315.0,712,287,106.0,346,160,15.2,No,2013,No,No,No
Malik Thomas,838,152,739,312,195,129,2610.0,267,85,160.0,472,227,20.2,No,2013,No,No,No
Travis Robinson,592,91,520,202,102,66,2269.0,344,122,107.0,176,80,15.9,No,2013,No,No,No
Nathan Dieudonne,863,136,651,312,299,196,2888.0,155,43,199.0,496,269,18.3,No,2013,No,No,No
Zach Chionuma,179,6,199,66,38,19,576.0,105,28,27.0,94,38,22.7,No,2013,No,No,No
Justin Alston,811,67,594,333,205,145,2075.0,2,0,133.0,592,333,20.8,No,2013,No,No,No
James Kennedy,31,4,35,15,7,1,241.0,2,0,15.0,33,15,11.9,No,2013,No,No,No
Jamaal Gill,2,1,1,1,0,0,5.0,0,0,1.0,1,1,21.7,No,2013,No,No,No
Dylan Brossman,12,4,15,3,4,4,84.0,12,2,4.0,3,1,20.5,No,2013,No,No,No
Chris Kurz,2,1,9,1,1,0,53.0,0,0,5.0,9,1,14.5,No,2013,No,No,No
A'uston Calhoun,1337,64,1166,529,324,240,2855.0,133,39,191.0,1033,490,27.9,No,2013,No,No,No
Jordon Crawford,1212,473,1101,455,240,180,3343.0,392,122,337.0,709,333,24.5,No,2013,No,No,No
Chauncey Orr,305,63,233,104,83,65,1108.0,90,32,58.0,143,72,15.9,No,2013,No,No,No
Richaun Holmes,1089,62,728,403,363,253,2518.0,85,30,143.0,643,373,21.8,Yes,2013,No,No,No
Luke Kraus,338,112,330,105,94,69,1663.0,207,59,72.0,123,46,14.2,No,2013,No,No,No
Cameron Black,590,86,516,266,121,58,2690.0,0,0,118.0,516,266,13.4,No,2013,No,No,No
Anthony Henderson,736,123,630,261,167,104,2451.0,304,110,83.0,326,151,17.0,No,2013,No,No,No
Craig Sealey,321,25,297,125,128,68,1068.0,13,3,70.0,284,122,21.0,No,2013,No,No,No
Jehvon Clarke,888,261,854,328,179,134,2423.0,313,98,227.0,541,230,25.2,No,2013,No,No,No
James Erger,87,32,101,32,18,10,677.0,63,13,26.0,38,19,10.6,No,2013,No,No,No
Spencer Parker,1160,135,882,395,438,312,3015.0,193,58,233.0,689,337,22.6,No,2013,No,No,No
Damarkeo Lyshe,62,14,59,19,20,13,241.0,36,11,11.0,23,8,17.1,No,2013,No,No,No
Walt Lemon,1721,367,1422,628,502,361,3935.0,324,104,404.0,1098,524,27.6,No,2013,No,No,No
Dyricus Simms-Edwards,1255,337,1084,429,378,274,3680.0,399,123,254.0,685,306,21.7,No,2013,No,No,No
Tyshon Pickett,773,75,631,300,208,157,1985.0,51,16,103.0,580,284,22.1,No,2013,No,No,No
Will Egolf,823,67,715,326,194,134,2447.0,120,37,141.0,595,289,20.8,No,2013,No,No,No
Jake Eastman,571,208,536,199,157,106,2846.0,244,67,110.0,292,132,13.3,No,2013,No,No,No
Jordan Prosser,684,37,566,279,213,126,2598.0,0,0,113.0,566,279,15.8,No,2013,No,No,No
Jalen Crawford,217,44,240,83,19,12,879.0,123,39,46.0,117,44,17.5,No,2013,No,No,No
Ka'Darryl Bell,478,128,441,155,176,120,2060.0,154,48,172.0,287,107,18.2,No,2013,No,No,No
Shayok M. Shayok,430,38,371,175,143,68,1684.0,38,12,109.0,333,163,16.8,No,2013,No,No,No
Jimmy Gavin,610,95,423,201,135,112,1108.0,235,96,67.0,188,105,24.4,No,2013,No,No,No
Milos Knezevic,92,8,83,31,19,13,333.0,57,17,24.0,26,14,18.5,No,2013,No,No,No
Nate Wells,136,16,128,56,40,21,633.0,14,3,27.0,114,53,14.9,No,2013,No,No,No
Mason Alwan,33,5,24,12,7,5,163.0,9,4,9.0,15,8,11.9,No,2013,No,No,No
Darrion Harris,9,3,7,3,4,2,35.0,1,1,2.0,6,2,16.5,No,2013,No,No,No
Tyler Haws,2720,257,1916,917,820,724,4427.0,427,162,244.0,1489,755,27.6,No,2013,No,No,No
Brandon Davies,1680,213,1166,609,691,456,3251.0,18,6,283.0,1148,603,26.4,Yes,2013,No,No,No
Matt Carlino,1620,525,1397,557,359,266,3604.0,666,240,307.0,731,317,25.4,No,2013,No,No,No
Brock Zylstra,607,147,487,209,129,87,2100.0,288,102,93.0,199,107,14.7,No,2013,No,No,No
Josh Sharp,250,63,168,93,90,59,1379.0,17,5,45.0,151,88,8.9,No,2013,No,No,No
Craig Cusick,247,148,207,78,61,40,1277.0,130,51,55.0,77,27,10.9,No,2013,No,No,No
Nate Austin,529,100,388,205,178,106,2780.0,49,13,99.0,339,192,9.7,No,2013,No,No,No
Anson Winder,808,170,582,267,248,174,2126.0,283,100,91.0,299,167,17.8,No,2013,No,No,No
Agustin Ambrosino,56,8,52,20,10,5,191.0,34,11,13.0,18,9,17.6,No,2013,No,No,No
Cory Calvert,80,40,98,29,20,14,375.0,49,8,29.0,49,21,17.6,No,2013,No,No,No
Raul Delgado,48,12,52,18,5,4,171.0,31,8,8.0,21,10,17.6,No,2013,No,No,No
Ian Harward,22,1,24,8,9,6,89.0,0,0,9.0,24,8,20.2,No,2013,No,No,No
Bronson Kaufusi,21,2,15,9,11,3,128.0,0,0,4.0,15,9,9.1,No,2013,No,No,No
Matt Sullivan,1033,206,842,333,270,202,3262.0,455,165,157.0,387,168,18.5,No,2013,No,No,No
Sean McGonagill,1618,522,1363,538,387,293,4110.0,683,249,327.0,680,289,23.8,No,2013,No,No,No
Rafael Maia,865,131,622,313,425,228,2661.0,37,11,184.0,585,302,19.6,No,2013,No,No,No
Tucker Halpern,816,164,733,282,138,108,2234.0,407,144,116.0,326,138,21.7,No,2013,No,No,No
Cedric Kuakumensah,1181,119,1007,439,368,245,3135.0,150,58,229.0,857,381,22.9,No,2013,No,No,No
Stephen Albrecht,514,98,485,177,74,48,1418.0,299,112,83.0,186,65,23.3,No,2013,No,No,No
Tyler Ponticelli,256,122,177,95,104,66,1634.0,1,0,114.0,176,95,11.1,No,2013,No,No,No
Joe Sharkey,37,15,45,14,0,0,333.0,31,9,18.0,14,5,10.2,No,2013,No,No,No
Longi Yiljep,45,10,41,15,20,11,306.0,16,4,20.0,25,11,12.3,No,2013,No,No,No
Jon Schmidt,41,15,56,17,14,7,297.0,0,0,14.0,56,17,13.8,No,2013,No,No,No
Dyami Starks,1779,162,1464,600,319,279,3545.0,807,300,204.0,657,300,27.0,No,2013,No,No,No
Alex Francis,2085,172,1457,791,815,490,4141.0,53,13,457.0,1404,778,28.9,No,2013,No,No,No
Frankie Dobbs,1232,505,920,355,416,331,3744.0,549,191,269.0,371,164,19.3,No,2013,No,No,No
Corey Maynard,1050,379,854,370,224,172,3406.0,417,138,211.0,437,232,17.9,No,2013,No,No,No
Joe O'Shea,865,161,602,273,294,225,2846.0,274,94,109.0,328,179,15.7,No,2013,No,No,No
Vlad Kondratyev,616,34,524,255,125,83,1921.0,79,23,123.0,445,232,19.5,No,2013,No,No,No
Shane McLaughlin,627,436,526,216,207,136,3313.0,165,59,249.0,361,157,13.8,No,2013,No,No,No
Curtis Oakley,352,49,342,127,71,44,1140.0,184,54,56.0,158,73,19.7,No,2013,No,No,No
Claybrin McMath,278,35,304,114,41,23,1252.0,122,27,60.0,182,87,16.3,No,2013,No,No,No
Andrew Scocca,84,25,64,27,45,30,547.0,1,0,26.0,63,27,10.9,No,2013,No,No,No
Daniel Calandrillo,142,31,149,54,17,11,686.0,79,23,17.0,70,31,13.3,No,2013,No,No,No
Tim McKinney,7,0,6,2,4,3,31.0,2,0,2.0,4,2,16.5,No,2013,No,No,No
Erick Smith,101,12,118,39,29,14,491.0,35,9,36.0,83,30,18.3,No,2013,No,No,No
Raphael Jordan,561,116,535,196,148,100,2033.0,213,69,139.0,322,127,19.5,No,2013,No,No,No
Patrick Matthews,0,1,1,0,0,0,11.0,0,0,0.0,1,0,4.8,No,2013,No,No,No
Mike Muscala,2036,211,1443,723,695,569,3815.0,67,21,217.0,1376,702,28.4,Yes,2013,No,No,No
Cameron Ayers,1526,220,1205,530,319,265,3985.0,488,201,144.0,717,329,20.7,No,2013,No,No,No
Bryson Johnson,1384,200,1022,401,319,259,3690.0,812,323,137.0,210,78,19.3,No,2013,No,No,No
Joe Willman,1162,154,1013,504,188,153,3232.0,10,1,152.0,1003,503,21.2,No,2013,No,No,No
Ryan Hill,250,166,209,77,130,84,1729.0,38,12,126.0,171,65,12.6,No,2013,No,No,No
Ryan Frazier,656,174,520,190,266,202,2677.0,234,74,111.0,286,116,14.9,No,2013,No,No,No
Steven Kaspar,532,413,442,181,252,144,2610.0,90,26,205.0,352,155,16.1,No,2013,No,No,No
Brian Fitzpatrick,530,49,373,206,152,111,1589.0,16,7,98.0,357,199,18.7,No,2013,No,No,No
Dom Hoffman,543,97,475,220,110,80,1731.0,63,23,88.0,412,197,18.8,No,2013,No,No,No
Ben Brackney,342,28,268,109,59,52,1065.0,163,72,40.0,105,37,17.3,No,2013,No,No,No
Chris Hass,1402,104,1076,460,351,292,2753.0,511,190,146.0,565,270,26.4,No,2013,No,No,No
Joshea Singleton,223,26,184,71,100,65,670.0,58,16,59.0,126,55,22.6,No,2013,No,No,No
Cory Starkey,179,46,150,74,50,31,828.0,0,0,52.0,150,74,14.8,No,2013,No,No,No
Colin Klebon,101,11,89,38,37,24,327.0,2,1,20.0,87,37,20.8,No,2013,No,No,No
Matt Banas,12,2,12,5,5,2,68.0,1,0,2.0,11,5,12.0,No,2013,No,No,No
Javon McCrea,2004,249,1386,798,653,407,3473.0,4,1,309.0,1382,797,29.4,No,2013,No,No,No
Will Regan,907,73,683,305,243,186,2669.0,304,111,107.0,379,194,17.3,No,2013,No,No,No
Tony Watson II,609,204,450,185,125,107,2057.0,333,132,110.0,117,53,15.4,No,2013,No,No,No
Jarryn Skeete,912,247,858,292,192,143,3320.0,549,185,170.0,309,107,16.8,No,2013,No,No,No
Auraum Nuiriankh,325,98,313,101,102,74,1525.0,186,49,104.0,127,52,15.7,No,2013,No,No,No
Cameron Downing,245,30,134,88,103,69,638.0,0,0,58.0,134,88,19.6,No,2013,No,No,No
Jarod Oldham,562,409,497,182,234,156,2558.0,168,42,235.0,329,140,16.6,No,2013,No,No,No
Xavier Ford,533,42,428,190,217,134,1474.0,56,19,113.0,372,171,21.9,No,2013,No,No,No
Raphell Thomas-Edwards,59,14,56,19,18,11,388.0,33,10,32.0,23,9,13.0,No,2013,No,No,No
Corey Raley-Ross,85,33,93,33,30,16,398.0,19,3,41.0,74,30,19.0,No,2013,No,No,No
Richie Sebuharara,24,16,20,7,4,4,183.0,14,6,10.0,6,1,9.1,No,2013,No,No,No
Andre McPhail,7,1,9,3,3,1,33.0,0,0,4.0,9,3,22.9,No,2013,No,No,No
Rotnei Clarke,1864,208,1398,598,320,279,4086.0,935,389,193.0,463,209,21.4,No,2013,No,No,No
Andrew Smith,1147,97,773,409,435,293,2968.0,112,36,133.0,661,373,19.6,No,2013,No,No,No
Roosevelt Jones,1533,464,1297,589,595,354,4422.0,4,1,322.0,1293,588,22.2,No,2013,No,No,No
Khyle Marshall,1373,52,1055,572,437,227,3001.0,19,2,123.0,1036,570,24.4,No,2013,No,No,No
Kellen Dunham,1946,173,1457,598,537,451,4280.0,776,299,203.0,681,299,23.3,No,2013,No,No,No
Kameron Woods,804,148,623,289,329,214,3315.0,65,12,188.0,558,277,15.4,No,2013,No,No,No
Erik Fromm,455,20,428,163,117,73,1547.0,196,56,77.0,232,107,19.1,No,2013,No,No,No
Alex Barlow,596,274,497,194,132,105,2931.0,290,103,146.0,207,91,12.7,No,2013,No,No,No
Chase Stigall,421,94,454,139,51,33,1858.0,369,110,86.0,85,29,15.9,No,2013,No,No,No
Jackson Aldridge,213,63,203,63,92,63,912.0,94,24,78.0,109,39,18.6,No,2013,No,No,No
Andy Smeathers,185,18,183,58,32,26,490.0,145,43,34.0,38,15,25.4,No,2013,No,No,No
Devontae Morgan,83,25,65,30,52,21,317.0,8,2,14.0,57,28,17.1,No,2013,No,No,No
Emerson Kampen,4,6,7,2,0,0,81.0,1,0,5.0,6,2,7.8,No,2013,No,No,No
Elliott Kampen,6,1,6,1,4,3,72.0,5,1,3.0,1,0,7.9,No,2013,No,No,No
Chris Eversley,1218,143,1037,444,348,244,2761.0,290,86,139.0,747,358,27.1,No,2013,No,No,No
Dylan Royer,612,59,478,201,47,41,1722.0,380,169,56.0,98,32,18.1,No,2013,No,No,No
Brian Bennett,1108,91,973,491,208,126,2849.0,5,0,110.0,968,491,22.8,No,2013,No,No,No
Kyle Odister,764,128,691,266,75,56,2059.0,454,176,97.0,237,90,21.7,No,2013,No,No,No
Reese Morgan,814,119,577,206,286,248,2017.0,426,154,65.0,151,52,20.9,No,2013,No,No,No
Drake U'u,428,132,400,143,181,109,1701.0,151,33,105.0,249,110,19.4,No,2013,No,No,No
Chris O'Brien,434,135,373,141,138,100,1993.0,152,52,102.0,221,89,14.9,No,2013,No,No,No
Jamal Johnson,444,300,390,134,186,129,2372.0,144,47,145.0,246,87,14.7,No,2013,No,No,No
Zach Gordon,327,17,240,110,179,107,1529.0,2,0,74.0,238,110,13.9,No,2013,No,No,No
Joel Awich,673,66,625,248,164,120,2280.0,191,57,118.0,434,191,19.5,No,2013,No,No,No
Anthony Silvestri,111,4,132,37,14,8,504.0,117,29,11.0,15,8,16.6,No,2013,No,No,No
Zach Allmon,0,0,0,0,0,0,0.0,0,0,0.0,0,0,0,No,2013,No,No,No
Stephon Carter,1628,330,1348,571,660,451,3622.0,159,35,358.0,1189,536,27.8,No,2013,No,No,No
Brandon Barnes,856,105,705,311,291,180,2273.0,168,54,173.0,537,257,22.4,No,2013,No,No,No
Javonte Maynor,1065,107,904,343,163,108,3330.0,720,271,111.0,184,72,17.2,No,2013,No,No,No
Tyrone White,537,99,471,188,76,53,1611.0,294,108,103.0,177,80,19.4,No,2013,No,No,No
Adam Young,460,80,448,162,125,85,1689.0,172,51,83.0,276,111,17.4,No,2013,No,No,No
Corey Hall,224,15,175,80,82,52,830.0,36,12,60.0,139,68,16.8,No,2013,No,No,No
Britton Williams,109,97,93,38,44,31,655.0,13,2,44.0,80,36,12.2,No,2013,No,No,No
Erik Kinney,164,30,139,49,100,66,765.0,9,0,58.0,130,49,16.4,No,2013,No,No,No
Matt Ratto,62,8,48,18,11,10,179.0,43,16,9.0,5,2,17.7,No,2013,No,No,No
Zach Lamb,424,70,344,156,94,70,1021.0,111,42,81.0,233,114,23.7,No,2013,No,No,No
Mo Hughley,234,57,165,80,119,74,879.0,2,0,62.0,163,80,16.7,No,2013,No,No,No
Kregg Jones,157,5,124,65,63,27,690.0,0,0,40.0,124,65,14.6,No,2013,No,No,No
Justin Omogun,12,0,9,5,3,2,52.0,0,0,2.0,9,5,12.1,No,2013,No,No,No
Dee Wallace,9,0,12,3,0,0,27.0,12,3,0.0,0,0,23.2,No,2013,No,No,No
Kwame Vaughn,1775,342,1246,556,640,508,3767.0,438,155,315.0,808,401,25.0,No,2013,No,No,No
D.J. Seeley,1147,194,846,373,344,260,2276.0,343,141,189.0,503,232,26.2,No,2013,No,No,No
Sammy Yeager,544,80,448,203,75,53,1162.0,209,85,77.0,239,118,24.7,No,2013,No,No,No
Alex Harris,1387,307,1120,457,465,318,3519.0,500,155,211.0,620,302,23.1,No,2013,No,No,No
Jared Brandon,310,69,269,125,78,51,1247.0,43,9,61.0,226,116,15.1,No,2013,No,No,No
James Johnson,306,10,206,123,98,60,1186.0,0,0,47.0,206,123,12.8,Yes,2013,No,No,No
James Douglas,435,98,383,155,88,65,1271.0,168,60,96.0,215,95,21.0,No,2013,No,No,No
Jordan Knox,43,19,34,16,7,3,201.0,21,8,8.0,13,8,11.4,No,2013,No,No,No
Marquis Horne,282,31,255,107,61,42,779.0,78,26,50.0,177,81,22.1,No,2013,No,No,No
Chris Collins,120,41,107,41,74,38,602.0,5,0,40.0,102,41,15.5,No,2013,No,No,No
Ronell Abaekobe,4,0,1,1,4,2,10.0,0,0,0.0,1,1,14.7,No,2013,No,No,No
Mike Gee,3,0,2,1,0,0,9.0,1,1,0.0,1,0,11.3,No,2013,No,No,No
Stephen Maxwell,1748,67,1199,635,657,478,3704.0,0,0,219.0,1199,635,23.3,No,2013,No,No,No
Josh Greene,1549,360,1167,455,472,411,3594.0,590,228,240.0,577,227,22.1,No,2013,No,No,No
Stephan Hicks,1959,137,1338,651,737,599,3938.0,185,58,227.0,1153,593,24.1,No,2013,No,No,No
Brandon Perry,435,26,306,153,243,129,982.0,0,0,83.0,306,153,26.1,No,2013,No,No,No
Trevone Williams,269,54,273,110,34,25,918.0,92,24,50.0,181,86,17.7,No,2013,No,No,No
Landon Drew,585,393,545,208,109,79,2525.0,249,90,193.0,296,118,15.6,No,2013,No,No,No
Allan Guei,250,118,253,90,65,48,972.0,48,22,65.0,205,68,17.0,No,2013,No,No,No
Tre Hale-Edmerson,813,303,682,325,177,128,3522.0,128,35,232.0,554,290,14.1,No,2013,No,No,No
Donovan Johnson,99,17,108,31,36,26,388.0,50,11,26.0,58,20,18.3,No,2013,No,No,No
Lonnie Watson,40,11,42,14,7,5,217.0,24,7,5.0,18,7,10.9,No,2013,No,No,No
Morgan Tilford,20,2,18,8,9,4,122.0,0,0,6.0,18,8,10.9,No,2013,No,No,No
Ian Clark,13,5,9,4,5,3,48.0,6,2,7.0,3,2,17.9,Yes,2013,No,No,No
Ilya Ilyayev,6,0,5,2,2,0,34.0,4,2,2.0,1,0,11.0,No,2013,No,No,No
Jordan Mitchell,28,3,21,9,17,10,297.0,0,0,19.0,21,9,7.8,No,2013,No,No,No
Ishmael Godfrey,0,2,0,0,0,0,9.0,0,0,0.0,0,0,0.0,No,2013,No,No,No
Corey Hawkins,1743,297,1200,561,555,445,3095.0,434,176,226.0,766,385,29.7,No,2013,No,No,No
Ryan Sypkens,1275,203,1038,435,117,90,3240.0,750,315,202.0,288,120,21.1,No,2013,No,No,No
J.T. Adenrele,947,80,707,373,311,199,2533.0,4,2,202.0,703,371,22.2,No,2013,No,No,No
Josh Ritchart,1333,116,1003,473,224,153,3014.0,568,234,168.0,435,239,22.9,No,2013,No,No,No
Ryan Howley,522,110,433,208,107,56,2322.0,161,50,108.0,272,158,13.4,No,2013,No,No,No
Paolo Mancasola,257,185,202,83,111,76,1506.0,47,15,116.0,155,68,13.1,No,2013,No,No,No
Tyler Les,751,147,533,235,85,72,2525.0,474,209,100.0,59,26,14.4,No,2013,No,No,No
Clint Bozner,193,17,136,74,76,45,655.0,1,0,60.0,135,74,18.9,No,2013,No,No,No
Darius Graham,923,418,758,299,281,200,3834.0,339,125,315.0,419,174,16.7,No,2013,No,No,No
Olivier-Paul Betu,38,30,32,13,19,10,376.0,14,2,30.0,18,11,10.1,No,2013,No,No,No
Spencer Clayton,12,1,11,4,5,4,76.0,0,0,7.0,11,4,14.2,No,2013,No,No,No
Tyler Ott,36,1,35,12,7,4,76.0,26,8,5.0,9,4,27.9,No,2013,No,No,No
Justin Dueck,20,4,16,8,12,4,272.0,0,0,10.0,16,8,6.3,No,2013,No,No,No
Daman Starring,1420,298,1186,478,357,266,4019.0,515,198,284.0,671,280,20.4,No,2013,No,No,No
Will Davis II,1384,90,1083,593,306,198,3406.0,2,0,206.0,1081,593,21.9,No,2013,No,No,No
Chris McNealy,1207,277,1062,439,278,198,3480.0,355,131,177.0,707,308,19.9,Yes,2013,No,No,No
Alex Young,1324,576,1143,466,355,262,4060.0,396,130,233.0,747,336,19.9,No,2013,No,No,No
Mike Wilder,1082,272,865,330,285,198,3473.0,632,224,176.0,233,106,16.9,No,2013,No,No,No
Adam Folker,706,70,567,302,244,102,2370.0,1,0,146.0,566,302,17.8,No,2013,No,No,No
Travis Souza,540,122,398,163,89,72,1945.0,342,142,61.0,56,21,13.6,No,2013,No,No,No
Derick Flowers,431,201,400,135,152,114,1635.0,169,47,156.0,231,88,19.1,No,2013,No,No,No
Conor Clifford,583,41,420,248,106,87,1297.0,2,0,116.0,418,248,23.5,No,2013,No,No,No
John Ryan,357,76,269,146,117,65,1240.0,0,0,91.0,269,146,17.7,No,2013,No,No,No
Mike Best,760,59,687,314,165,120,2090.0,51,12,117.0,636,302,21.9,No,2013,No,No,No
Aaron Wright,508,235,397,154,254,159,2151.0,122,41,193.0,275,113,17.2,No,2013,No,No,No
Reed McConnell,28,7,29,10,4,3,110.0,15,5,3.0,14,5,16.3,No,2013,No,No,No
Chris Patton,783,81,602,319,217,145,1605.0,2,0,149.0,600,319,27.7,No,2013,No,No,No
Chris Harriel,916,141,859,307,305,193,2614.0,383,109,164.0,476,198,22.9,No,2013,No,No,No
Josh Fox,964,129,724,375,332,209,2390.0,21,5,160.0,703,370,23.5,No,2013,No,No,No
Robert Smith,846,293,818,288,244,165,2914.0,347,105,274.0,471,183,21.6,Yes,2013,No,No,No
Taylor Johns,1383,163,1043,509,538,344,3229.0,86,21,299.0,957,488,25.7,No,2013,No,No,No
Austin Quick,478,202,440,158,121,83,2074.0,260,79,162.0,180,79,16.7,No,2013,No,No,No
Davin Guinn,178,26,181,66,46,28,831.0,64,18,39.0,117,48,14.5,No,2013,No,No,No
Steven Jones,376,184,393,144,92,49,1970.0,143,39,112.0,250,105,14.4,No,2013,No,No,No
Dayton Boddie,61,16,54,22,23,15,210.0,16,2,20.0,38,20,21.4,No,2013,No,No,No
Tre Owens,59,8,71,19,6,4,239.0,60,17,6.0,11,2,17.6,No,2013,No,No,No
Lucas Devenny,213,48,169,86,89,41,1348.0,0,0,51.0,169,86,10.2,No,2013,No,No,No
Tajai Johnson,34,9,32,13,8,7,129.0,9,1,13.0,23,12,20.0,No,2013,No,No,No
T.J. Burke,44,2,40,18,13,6,200.0,5,2,13.0,35,16,16.1,No,2013,No,No,No
Alan Williams,1732,117,1295,637,649,458,3026.0,3,0,196.0,1292,637,32.0,Yes,2013,No,No,No
Kyle Boswell,975,181,679,297,223,165,2633.0,505,216,118.0,174,81,18.4,No,2013,No,No,No
Taran Brown,561,105,524,203,81,59,1721.0,307,96,97.0,217,107,20.6,No,2013,No,No,No
Michael Bryson,1620,219,1243,561,316,257,3758.0,651,241,253.0,592,320,23.2,No,2013,No,No,No
T.J. Taylor,367,275,354,129,39,29,2053.0,231,80,120.0,123,49,12.6,No,2013,No,No,No
Nate Garth,468,316,421,145,171,117,2017.0,200,61,165.0,221,84,16.7,No,2013,No,No,No
Sam Beeler,454,29,315,193,146,68,1572.0,0,0,92.0,315,193,16.0,No,2013,No,No,No
Lewis Thomas,79,29,88,28,18,10,565.0,40,13,31.0,48,15,11.9,No,2013,No,No,No
Mitch Brewe,458,52,353,170,136,97,1684.0,58,21,61.0,295,149,15.1,No,2013,No,No,No
Shawn Moore,88,27,67,40,12,6,520.0,9,2,21.0,58,38,9.7,No,2013,No,No,No
Keegan Hornbuckle,184,43,164,75,20,11,811.0,52,23,41.0,112,52,13.9,No,2013,No,No,No
Duke DaRe,27,30,47,9,7,5,316.0,32,4,27.0,15,5,13.0,No,2013,No,No,No
Dalante Dunklin,6,0,6,1,6,4,19.0,1,0,4.0,5,1,35.9,No,2013,No,No,No
Aamahd Walker,22,2,21,8,9,5,73.0,5,1,5.0,16,7,22.5,No,2013,No,No,No
Allen Crabbe,1537,219,1195,533,320,262,3402.0,547,209,182.0,648,324,23.3,Yes,2013,No,No,No
Justin Cobbs,1539,575,1157,524,491,404,3839.0,256,87,278.0,901,437,22.6,No,2013,No,No,No
Richard Solomon,885,81,642,329,385,220,2457.0,28,7,143.0,614,322,20.4,No,2013,No,No,No
David Kravish,1266,127,1065,554,213,152,3943.0,22,6,158.0,1043,548,17.6,No,2013,No,No,No
Tyrone Wallace,1623,436,1417,588,537,329,4074.0,404,118,279.0,1013,470,24.9,Yes,2013,No,No,No
Robert Thurman,275,15,211,127,49,21,921.0,0,0,43.0,211,127,15.6,No,2013,No,No,No
Brandon Smith,388,267,344,126,168,102,2116.0,101,34,175.0,243,92,14.6,No,2013,No,No,No
Bak Bak,172,4,149,68,51,36,638.0,6,0,38.0,143,68,17.1,No,2013,No,No,No
Rick Kreklow,467,124,386,146,124,87,1819.0,258,88,106.0,128,58,15.8,No,2013,No,No,No
Jeff Powers,169,19,141,56,28,20,498.0,94,37,20.0,47,19,18.1,No,2013,No,No,No
Kahlil Johnson,6,0,6,2,2,1,17.0,3,1,4.0,3,1,33.2,No,2013,No,No,No
Christian Behrens,176,13,145,69,72,38,772.0,0,0,28.0,145,69,14.2,No,2013,No,No,No
Garrett Galvin,4,0,4,2,2,0,26.0,0,0,2.0,4,2,13.9,No,2013,No,No,No
Trey Freeman,2304,541,1969,858,554,450,4619.0,372,138,266.0,1597,720,28.2,No,2013,No,No,No
Darian Hooker,327,56,285,111,83,63,944.0,136,42,57.0,149,69,20.4,No,2013,No,No,No
Marvelle Harris,650,77,539,266,215,117,2443.0,5,1,147.0,534,265,16.5,No,2013,No,No,No
Reco McCarter,953,183,744,335,320,206,2461.0,287,77,239.0,457,258,24.5,No,2013,No,No,No
Darren White,1068,118,805,394,299,193,2295.0,266,87,163.0,539,307,24.4,No,2013,No,No,No
Andrew Ryan,1041,227,834,361,164,120,3333.0,512,199,134.0,322,162,16.6,No,2013,No,No,No
Darius Leonard,752,70,674,306,111,67,2177.0,214,73,83.0,460,233,19.2,No,2013,No,No,No
Leek Leek,345,50,292,116,73,57,1250.0,139,56,58.0,153,60,16.1,No,2013,No,No,No
Antwon Oliver,236,48,219,91,49,30,958.0,104,24,53.0,115,67,16.1,No,2013,No,No,No
D.J. Mason,932,148,755,371,254,145,2091.0,131,45,136.0,624,326,25.7,No,2013,No,No,No
Antonio Kalpic,63,6,45,25,18,13,306.0,0,0,21.0,45,25,12.3,No,2013,No,No,No
Trae Brenner,16,2,17,8,0,0,64.0,0,0,3.0,17,8,15.8,No,2013,No,No,No
Jordan Faciane,23,12,22,8,5,4,66.0,13,3,4.0,9,5,22.9,No,2013,No,No,No
Tyler Zegarzewski,8,1,4,3,0,0,12.0,3,2,0.0,1,1,16.7,No,2013,No,No,No
Casey Perrin,40,6,33,12,6,6,77.0,28,10,5.0,5,2,27.6,No,2013,No,No,No
Billy Baron,1716,416,1214,533,513,436,3342.0,558,214,246.0,656,319,25.8,No,2013,No,No,No
Harold Washington,977,160,756,334,289,223,2138.0,219,86,192.0,537,248,25.7,No,2013,No,No,No
Isaac Sosa,1241,126,996,427,137,102,3082.0,682,285,144.0,314,142,20.1,No,2013,No,No,No
Jordan Heath,642,53,456,243,167,83,1779.0,184,73,63.0,272,170,17.1,No,2013,No,No,No
Chris Manhertz,758,61,545,268,309,222,2694.0,2,0,152.0,543,268,15.8,No,2013,No,No,No
Alshwan Hymes,1047,156,985,370,115,87,2716.0,655,220,226.0,330,150,23.5,No,2013,No,No,No
Reggie Groves,489,211,496,153,142,95,2150.0,304,88,157.0,192,65,17.1,No,2013,No,No,No
Josiah Heath,638,80,520,252,218,134,2442.0,6,0,97.0,514,252,15.2,No,2013,No,No,No
Freddy Asprilla,461,39,363,184,217,93,1181.0,0,0,100.0,363,184,17.0,No,2013,No,No,No
Tyrel Edwards,10,0,14,4,4,2,39.0,5,0,3.0,9,4,24.7,No,2013,No,No,No
Jarvis Garner,750,68,654,280,160,110,1495.0,231,80,125.0,423,200,26.1,No,2013,No,No,No
Robert Crawford,646,79,481,214,142,96,1328.0,283,122,91.0,198,92,22.0,No,2013,No,No,No
LaQuentin Miles,1354,226,1127,512,562,311,2412.0,68,19,270.0,1059,493,32.0,No,2013,No,No,No
Jordan Harks,691,67,520,289,207,112,1691.0,4,1,83.0,516,288,19.8,No,2013,No,No,No
DeShone McClure,549,131,473,207,105,60,1499.0,219,75,84.0,254,132,18.8,No,2013,No,No,No
Anthony Borden,235,22,213,103,64,29,851.0,0,0,64.0,213,103,16.5,No,2013,No,No,No
Daouda Berete,255,92,230,85,95,71,1050.0,42,14,75.0,188,71,15.5,No,2013,No,No,No
Ryan Williams,423,142,466,145,115,80,1536.0,182,53,138.0,284,92,19.9,No,2013,No,No,No
Oliver Wells,181,78,167,67,45,30,908.0,49,17,55.0,118,50,12.3,No,2013,No,No,No
Terrell Brown,190,24,145,85,29,20,605.0,0,0,46.0,145,85,15.7,No,2013,No,No,No
Lenell Brown,198,67,198,75,41,20,958.0,98,28,78.0,100,47,14.3,No,2013,No,No,No
Zach Padgett,43,3,52,15,5,3,159.0,36,10,11.0,16,5,18.9,No,2013,No,No,No
Alexander Ridley,6,0,7,2,3,2,25.0,2,0,2.0,5,2,19.2,No,2013,No,No,No
Sean Young,6,0,10,3,0,0,22.0,1,0,2.0,9,3,25.2,No,2013,No,No,No
Kyle Vinales,1514,296,1300,518,334,271,2802.0,544,207,249.0,756,311,30.1,No,2013,No,No,No
Matt Hunter,565,91,517,207,154,110,1405.0,133,41,128.0,384,166,25.2,No,2013,No,No,No
Adonis Burbage,920,100,808,318,124,89,2897.0,524,195,141.0,284,123,17.1,No,2013,No,No,No
Malcolm McMillan,1133,462,842,348,457,343,4051.0,281,94,227.0,561,254,15.7,No,2013,No,No,No
Joe Efese,611,36,458,244,186,123,1915.0,0,0,128.0,458,244,17.9,No,2013,No,No,No
Terrell Allen,435,48,371,156,146,97,1699.0,89,26,75.0,282,130,15.0,No,2013,No,No,No
Brandon Peel,958,126,815,390,247,174,3126.0,15,4,184.0,800,386,18.1,No,2013,No,No,No
Andrew Hurd,16,6,19,5,4,3,116.0,16,3,7.0,3,2,11.8,No,2013,No,No,No
Erik Raleigh,7,0,6,3,2,1,17.0,0,0,0.0,6,3,20.2,No,2013,No,No,No
Greg Andrade,93,19,84,30,34,21,578.0,38,12,17.0,46,18,10.8,No,2013,No,No,No
Khalen Cumberlander,1138,242,1020,432,283,154,3386.0,381,120,251.0,639,312,21.2,No,2013,No,No,No
Isaiah Sykes,1545,336,1194,588,599,335,3574.0,103,34,344.0,1091,554,25.8,No,2013,No,No,No
Keith Clanton,1718,236,1246,622,621,399,4040.0,249,75,339.0,997,547,24.2,No,2013,No,No,No
Tristan Spurlock,928,111,759,305,267,196,2638.0,371,122,118.0,388,183,19.3,No,2013,No,No,No
Kasey Wilson,892,64,688,308,248,160,2487.0,296,116,135.0,392,192,19.3,No,2013,No,No,No
Calvin Newell,754,204,653,261,217,140,2135.0,310,92,175.0,343,169,22.0,No,2013,No,No,No
Matt Williams,1105,138,950,363,136,105,3115.0,740,274,126.0,210,89,18.7,No,2013,No,No,No
Daiquan Walker,711,268,657,250,128,97,2619.0,310,114,184.0,347,136,17.7,No,2013,No,No,No
Staphon Blair,525,9,368,214,177,97,1776.0,1,0,91.0,367,214,15.7,No,2013,No,No,No
Rod Days,339,58,300,115,99,60,1523.0,170,49,69.0,130,66,14.4,No,2013,No,No,No
Dylan Karell,59,16,43,24,35,11,487.0,0,0,25.0,43,24,9.1,No,2013,No,No,No
Tyler Coons,3,3,2,1,0,0,19.0,2,1,2.0,0,0,10.8,No,2013,No,No,No
Bobby Horodyski,10,5,5,3,2,1,57.0,5,3,5.0,0,0,9.6,No,2013,No,No,No
Isaac Lang,16,0,14,6,1,0,49.0,11,4,3.0,3,2,17.6,No,2013,No,No,No
Robert King,1,0,3,0,2,1,5.0,1,0,0.0,2,0,40.4,No,2013,No,No,No
Kyle Randall,1341,316,1187,445,387,315,3666.0,402,136,281.0,785,309,22.4,No,2013,No,No,No
Blake Hibbitts,727,48,617,231,120,89,2407.0,501,176,74.0,116,55,16.1,No,2013,No,No,No
Chris Fowler,1736,686,1209,593,680,475,3927.0,226,75,327.0,983,518,24.7,No,2013,No,No,No
John Simons,1279,111,893,398,294,227,3928.0,653,256,111.0,240,142,15.2,No,2013,No,No,No
Olivier Mbaigoto,435,27,390,159,116,81,1228.0,125,36,66.0,265,123,21.9,No,2013,No,No,No
Austin Keel,571,71,522,199,123,90,1687.0,305,83,84.0,217,116,20.7,No,2013,No,No,No
Derrick Richardson,141,25,116,46,67,39,687.0,37,10,45.0,79,36,14.7,No,2013,No,No,No
Finis Craddock,347,64,330,113,140,87,1565.0,132,34,114.0,198,79,17.1,No,2013,No,No,No
Austin Stewart,592,54,411,204,200,147,1857.0,111,37,105.0,300,167,17.2,No,2013,No,No,No
Spencer Krannitz,93,3,108,33,13,10,299.0,74,17,9.0,34,16,21.6,No,2013,No,No,No
Zach Saylor,107,13,125,46,34,15,681.0,1,0,37.0,124,46,13.3,No,2013,No,No,No
Luke Wiest,5,3,8,2,0,0,29.0,6,1,0.0,2,1,14.5,No,2013,No,No,No
DeAndray Buckley,121,28,94,33,87,50,508.0,25,5,21.0,69,28,16.5,No,2013,No,No,No
Rick Rowse,0,0,0,0,0,0,7.0,0,0,0.0,0,0,0.0,No,2013,No,No,No
Arlon Harper,1633,256,1287,557,435,324,3464.0,535,195,214.0,752,362,24.3,No,2013,No,No,No
Saah Nimley,1866,511,1484,544,633,490,3717.0,838,288,302.0,646,256,27.7,No,2013,No,No,No
Mathiang Muo,671,55,550,217,123,95,1915.0,341,142,103.0,209,75,18.4,No,2013,No,No,No
Jeremy Sexton,1253,248,1091,441,213,164,3507.0,572,207,240.0,519,234,20.0,No,2013,No,No,No
Cedrick Bowen,754,51,523,312,203,129,2129.0,7,1,83.0,516,311,16.3,No,2013,No,No,No
Paul Gombwer,620,88,515,229,177,116,2770.0,135,46,157.0,380,183,13.5,No,2013,No,No,No
Alhaji Fullah,264,15,184,115,62,34,931.0,2,0,35.0,182,115,13.2,No,2013,No,No,No
Sheldon Strickland,907,231,813,319,170,124,2487.0,390,145,160.0,423,174,20.8,No,2013,No,No,No
Malcolm Bernard,814,232,624,254,368,235,2687.0,213,71,196.0,411,183,18.4,No,2013,No,No,No
Matt Kennedy,501,70,358,173,103,92,1390.0,136,63,66.0,222,110,16.9,No,2013,No,No,No
Joe Williams,36,0,24,16,6,4,77.0,1,0,3.0,23,16,19.1,No,2013,No,No,No
Greg Dorleus,31,1,22,11,15,9,104.0,1,0,8.0,21,11,17.6,No,2013,No,No,No
Mitchell Deter,54,12,48,18,4,3,188.0,42,15,7.0,6,3,14.9,No,2013,No,No,No
Thomas Odom,25,1,24,8,3,2,80.0,20,7,3.0,4,1,17.4,No,2013,No,No,No
Chris Braswell,1465,142,1061,501,573,429,3173.0,125,34,307.0,936,467,26.0,No,2013,No,No,No
Pierria Henry,1238,566,997,413,481,335,3947.0,273,77,339.0,724,336,19.7,No,2013,No,No,No
Willie Clayton,1049,63,715,424,462,201,3088.0,0,0,243.0,715,424,18.9,No,2013,No,No,No
Terrence Williams,972,228,857,326,372,265,2930.0,195,55,244.0,662,271,21.6,Yes,2013,No,No,No
DeMario Mayfield,552,118,433,188,222,134,1479.0,143,42,103.0,290,146,21.6,No,2013,No,No,No
Darion Clark,602,53,467,229,282,144,1936.0,1,0,155.0,466,229,19.2,No,2013,No,No,No
Denzel Ingram,1332,399,1170,453,238,177,3784.0,677,249,198.0,493,204,18.9,No,2013,No,No,No
E. Victor Nickerson,614,162,550,195,287,191,2291.0,149,33,197.0,401,162,19.5,No,2013,No,No,No
J.T. Thompson,681,67,532,267,212,143,2128.0,21,4,107.0,511,263,17.2,No,2013,No,No,No
Ivan Benkovic,170,17,138,52,28,18,569.0,124,48,19.0,14,4,15.0,No,2013,No,No,No
Mike Thorne,857,47,685,355,276,147,2199.0,2,0,133.0,683,355,21.7,No,2013,No,No,No
Colby Lewis,52,6,49,18,0,0,157.0,43,16,6.0,6,2,17.9,No,2013,No,No,No
Lamar Bradbury,3,0,1,1,0,0,2.0,1,1,0.0,0,0,25.0,No,2013,No,No,No
Ilija Ivankovic,7,2,7,3,1,1,54.0,0,0,0.0,7,3,6.9,No,2013,No,No,No
Z Mason,1177,55,883,420,385,272,2206.0,199,65,146.0,684,355,26.6,No,2013,No,No,No
Gee McGhee,1189,277,879,354,575,378,3527.0,337,103,187.0,542,251,18.7,No,2013,No,No,No
Ronrico White,1100,285,822,304,429,336,2910.0,447,156,176.0,375,148,20.4,No,2013,No,No,No
Drazen Zlovaric,631,47,564,282,120,65,1914.0,21,2,107.0,543,280,18.7,No,2013,No,No,No
Farad Cobb,769,140,722,271,96,75,2126.0,446,152,93.0,276,119,21.3,No,2013,No,No,No
Eric Robertson,851,153,686,283,136,94,2560.0,467,191,104.0,219,92,16.7,No,2013,No,No,No
Martynas Bareika,500,57,430,165,133,90,1323.0,243,80,105.0,187,85,22.0,No,2013,No,No,No
Casey Jones,1321,215,995,508,400,283,3187.0,78,22,278.0,917,486,22.9,No,2013,No,No,No
Sam Watson,177,41,131,64,83,43,1014.0,16,6,65.0,115,58,11.3,No,2013,No,No,No
Jared Bryant,183,15,120,66,87,51,689.0,0,0,45.0,120,66,14.8,No,2013,No,No,No
Alex Bran,211,27,181,76,21,16,542.0,118,43,47.0,63,33,21.6,No,2013,No,No,No
Lance Stokes,285,50,193,93,171,99,1609.0,2,0,86.0,191,93,11.0,No,2013,No,No,No
Dontay Hampton,391,96,286,107,162,129,1046.0,146,48,74.0,140,59,20.4,No,2013,No,No,No
Quinton Pippen,802,147,698,274,119,96,1876.0,438,158,119.0,260,116,23.5,No,2013,No,No,No
Matt Ross,714,58,612,266,112,89,2044.0,272,93,96.0,340,173,18.8,No,2013,No,No,No
Jamere Dismukes,312,114,284,104,91,71,849.0,111,33,84.0,173,71,24.4,No,2013,No,No,No
Jeremy Robinson,700,72,626,277,173,118,1622.0,92,28,165.0,534,249,26.8,No,2013,No,No,No
Nate Duhon,556,80,463,200,182,137,1488.0,76,19,102.0,387,181,22.1,No,2013,No,No,No
Clarke Rosenberg,1241,237,1041,428,411,298,3252.0,292,87,258.0,749,341,23.3,No,2013,No,No,No
Corey Gray,448,137,422,151,109,69,1881.0,239,77,119.0,183,74,16.0,No,2013,No,No,No
Aaron Williams,240,29,279,91,60,36,936.0,95,22,73.0,184,69,20.2,Yes,2013,No,No,No
Greg Tucker,65,13,60,23,9,8,168.0,32,11,25.0,28,12,26.8,No,2013,No,No,No
Markus Starks,77,6,89,30,26,15,560.0,5,2,31.0,84,28,11.9,No,2013,No,No,No
Mashawn Chamberlain,14,9,20,6,2,1,250.0,5,1,11.0,15,5,6.4,No,2013,No,No,No
Arthur Gage,11,1,8,3,8,5,115.0,0,0,5.0,8,3,7.4,No,2013,No,No,No
Quincy Ukaigwe,48,6,46,22,19,4,401.0,1,0,28.0,45,22,9.9,No,2013,No,No,No
Nate Henry,0,0,4,0,0,0,23.0,3,0,4.0,1,0,17.2,No,2013,No,No,No
Sean Kilpatrick,2145,279,1687,707,536,418,4315.0,901,313,236.0,786,394,26.0,Yes,2013,No,No,No
Cashmere Wright,1317,482,1134,451,321,229,3650.0,533,186,268.0,601,265,21.8,No,2013,No,No,No
Jaquon Parker,799,137,679,272,285,169,2355.0,237,86,117.0,442,186,20.1,No,2013,No,No,No
Titus Rubles,449,134,400,149,205,147,1725.0,46,4,114.0,354,145,18.1,No,2013,No,No,No
Cheikh Mbodji,220,12,180,79,97,61,986.0,3,1,36.0,177,78,13.5,No,2013,No,No,No
Justin Jackson,770,166,633,322,267,124,2740.0,21,2,212.0,612,320,18.3,Yes,2013,No,No,No
Jermaine Sanders,505,103,449,176,127,74,2114.0,249,79,69.0,200,97,14.5,No,2013,No,No,No
Shaq Thomas,723,106,635,283,220,132,2473.0,80,25,138.0,555,258,18.8,No,2013,No,No,No
David Nyarsuk,117,9,87,51,23,15,521.0,0,0,30.0,87,51,12.5,No,2013,No,No,No
Ge'Lawn Guyn,963,135,831,333,213,153,2488.0,394,144,141.0,437,189,21.6,No,2013,No,No,No
Jeremiah Davis,375,138,360,134,90,67,1249.0,143,40,110.0,217,94,21.8,No,2013,No,No,No
Kelvin Gaines,37,4,44,17,17,3,418.0,0,0,26.0,44,17,9.4,No,2013,No,No,No
Alex Eppensteiner,13,7,13,4,8,4,50.0,4,1,3.0,9,3,20.2,No,2013,No,No,No
Mike Groselle,1359,120,930,548,371,263,2846.0,1,0,179.0,929,548,24.1,No,2013,No,No,No
Matt Van Scyoc,1331,101,1020,423,329,243,3450.0,661,242,195.0,359,181,20.7,No,2013,No,No,No
P.J. Horgan,653,54,467,248,232,155,2027.0,2,2,107.0,465,246,20.3,No,2013,No,No,No
Marshall Harris III,668,438,472,186,266,207,2895.0,253,89,257.0,219,97,16.0,No,2013,No,No,No
Ashton Moore,1399,321,1197,462,337,268,3497.0,542,207,269.0,655,255,25.6,No,2013,No,No,No
Dylen Setzekorn,182,12,154,63,45,32,463.0,66,24,33.0,88,39,24.1,No,2013,No,No,No
Lawrence Miller,284,62,250,94,46,28,788.0,179,68,53.0,71,26,22.0,No,2013,No,No,No
Raemond Robinson,628,153,539,205,69,49,2003.0,427,169,117.0,112,36,17.5,No,2013,No,No,No
Stephen Elmore,77,20,65,30,42,16,411.0,5,1,36.0,60,29,15.9,No,2013,No,No,No
Janeil Jenkins,249,90,155,79,93,70,945.0,54,21,80.0,101,58,15.6,No,2013,No,No,No
Quinton Marshall,824,133,715,313,224,132,2574.0,207,66,185.0,508,247,19.6,No,2013,No,No,No
C.J. Bray,371,36,330,141,84,54,1382.0,108,35,64.0,222,106,17.2,No,2013,No,No,No
Michael Hundley,9,0,10,4,4,1,47.0,0,0,3.0,10,4,17.1,No,2013,No,No,No
Devin Booker,1154,99,897,445,368,242,3089.0,80,22,199.0,817,423,21.8,Yes,2013,No,Yes,Yes
K.J. McDaniels,1035,85,804,362,300,230,2287.0,259,81,140.0,545,281,26.5,No,2013,No,No,No
Milton Jennings,954,121,843,349,250,170,2633.0,290,86,214.0,553,263,23.7,No,2013,No,No,No
Jordan Roper,971,238,897,337,207,156,2974.0,409,141,143.0,488,196,21.0,No,2013,No,No,No
Adonis Filer,989,219,837,315,348,264,2709.0,318,95,203.0,519,220,23.4,No,2013,No,No,No
Rod Hall,924,393,731,311,361,255,3697.0,141,47,224.0,590,264,16.8,No,2013,No,No,No
Damarcus Harrison,784,134,744,276,173,128,2468.0,334,104,130.0,410,172,20.9,No,2013,No,No,No
Bernard Sullivan,256,24,239,100,90,54,890.0,11,2,52.0,228,98,19.1,No,2013,No,No,No
Landry Nnoko,744,65,573,300,229,144,2632.0,0,0,146.0,573,300,17.2,No,2013,No,No,No
T.J. Sapp,884,172,689,284,224,177,2301.0,382,139,148.0,307,145,20.9,No,2013,No,No,No
Josh Smith,172,11,154,65,64,39,882.0,11,3,48.0,143,62,14.5,Yes,2013,No,No,No
Carson Fields,11,4,19,5,4,1,72.0,10,0,3.0,9,5,18.4,No,2013,No,No,No
Bryn Forbes,1742,182,1258,565,351,288,4010.0,745,324,164.0,513,241,20.9,Yes,2013,No,No,No
Charlie Lee,1147,458,889,359,299,262,3594.0,418,167,286.0,471,192,19.9,No,2013,No,No,No
Tim Kamczyc,892,188,682,328,176,127,3566.0,280,109,145.0,402,219,13.4,No,2013,No,No,No
Marlin Mason,773,98,594,283,188,137,2413.0,184,70,171.0,410,213,19.1,No,2013,No,No,No
Sebastian Douglas,464,97,380,194,114,68,1692.0,44,8,134.0,336,186,17.8,No,2013,No,No,No
Devon Long,307,22,232,134,77,39,1098.0,0,0,55.0,232,134,15.6,No,2013,No,No,No
Junior Lomomba,578,221,504,179,256,174,2582.0,144,46,188.0,360,133,16.2,No,2013,No,No,No
Anton Grady,1414,169,1124,559,458,288,3171.0,38,8,237.0,1086,551,25.4,No,2013,No,No,No
Ludovic Ndaye,167,11,161,67,54,29,880.0,18,4,32.0,143,63,13.1,No,2013,No,No,No
Josh Ivory,104,61,125,34,16,6,777.0,99,30,48.0,26,4,12.0,No,2013,No,No,No
Aaron Scales,291,18,213,111,128,69,1199.0,0,0,83.0,213,111,15.6,No,2013,No,No,No
Raphael Veira,6,0,14,2,4,2,41.0,10,0,6.0,4,2,28.2,No,2013,No,No,No
Anthony Raffa,1741,234,1330,608,486,365,3406.0,459,160,262.0,871,448,27.0,No,2013,No,No,No
Kierre Greenwood,1199,481,933,424,386,290,3448.0,179,61,282.0,754,363,20.4,No,2013,No,No,No
Warren Gillis,1352,286,1081,484,363,305,3416.0,251,79,271.0,830,405,22.4,No,2013,No,No,No
Michel Enanga,545,111,467,192,213,119,2289.0,156,42,158.0,311,150,15.8,No,2013,No,No,No
El Hadji Ndieguene,314,37,275,123,110,68,1563.0,0,0,84.0,275,123,13.1,No,2013,No,No,No
Badou Diagne,1071,97,843,386,313,201,3102.0,290,98,206.0,553,288,19.4,No,2013,No,No,No
Charles Ashford,97,20,69,33,48,30,317.0,5,1,28.0,64,32,19.1,No,2013,No,No,No
Tristian Curtis,456,35,312,181,185,92,2069.0,6,2,87.0,306,179,11.8,No,2013,No,No,No
Uros Ljeskovic,248,13,188,98,123,52,959.0,0,0,82.0,188,98,17.0,No,2013,No,No,No
Justin Daniel,31,4,26,13,10,5,165.0,6,0,6.0,20,13,11.2,No,2013,No,No,No
Bisi Latunde-Addey,48,3,36,21,11,6,151.0,0,0,11.0,36,21,17.6,No,2013,No,No,No
Tre'von James,5,0,4,1,5,3,17.0,0,0,1.0,4,1,21.8,No,2013,No,No,No
Richie Berry,2,2,4,1,0,0,16.0,3,0,2.0,1,1,19.0,No,2013,No,No,No
Murphy Burnatowski,1356,140,1157,484,268,200,3106.0,529,188,177.0,628,296,25.6,No,2013,No,No,No
Pat Moore,923,144,753,313,142,109,2771.0,463,188,148.0,290,125,18.8,No,2013,No,No,No
Mitch Rolls,938,365,851,314,178,139,3441.0,455,171,285.0,396,143,18.6,No,2013,No,No,No
Brandon James,532,82,441,185,144,105,1467.0,183,57,134.0,258,128,23.1,No,2013,No,No,No
Damon Sherman-Newsome,1030,147,807,357,232,176,2601.0,380,140,154.0,427,217,23.7,No,2013,No,No,No
John Brandenburg,403,46,337,154,139,95,1393.0,1,0,93.0,336,154,18.9,No,2013,No,No,No
Luke Roh,770,337,579,308,252,152,3516.0,7,2,224.0,572,306,14.9,No,2013,No,No,No
Clayton Graham,168,45,105,66,53,36,768.0,0,0,33.0,105,66,11.8,No,2013,No,No,No
Matt McMullen,564,134,448,193,134,102,2169.0,191,76,115.0,257,117,16.6,No,2013,No,No,No
Chad Johnson,200,52,195,80,49,26,933.0,61,14,73.0,134,66,16.8,No,2013,No,No,No
Lazar Bogdanovic,31,3,31,11,14,9,174.0,0,0,6.0,31,11,12.8,No,2013,No,No,No
Alex Ramon,314,77,230,110,73,51,1217.0,109,43,78.0,121,67,15.6,No,2013,No,No,No
Jared Accettura,2,1,7,1,0,0,12.0,4,0,2.0,3,1,40.1,No,2013,No,No,No
Andrew Lawrence,1219,393,940,381,336,250,3606.0,581,207,232.0,359,174,19.1,No,2013,No,No,No
Anthony Stitt,1091,309,1004,381,263,163,3570.0,460,166,240.0,544,215,20.6,No,2013,No,No,No
Adjehi Baru,1094,98,797,393,521,308,3606.0,0,0,200.0,797,393,18.5,No,2013,No,No,No
Anthony Thomas,533,84,479,217,142,79,1868.0,84,20,134.0,395,197,19.5,No,2013,No,No,No
Willis Hall,1152,119,914,453,196,149,3482.0,271,97,184.0,643,356,18.0,No,2013,No,No,No
Trent Wiedeman,1253,117,935,486,388,272,3349.0,40,9,203.0,895,477,20.3,No,2013,No,No,No
Nori Johnson,549,60,450,178,103,74,1754.0,315,119,82.0,135,59,17.4,No,2013,No,No,No
Theo Johnson,464,75,346,144,219,154,1434.0,90,22,98.0,256,122,20.0,No,2013,No,No,No
Matt Sundberg,385,31,352,127,69,47,1349.0,250,84,48.0,102,43,16.4,No,2013,No,No,No
Pat Branin,34,5,31,11,11,5,155.0,22,7,6.0,9,4,14.9,No,2013,No,No,No
Trevonte Dixon,29,4,34,10,10,7,122.0,11,2,15.0,23,8,22.6,No,2013,No,No,No
Bart Benton,9,1,15,3,2,1,36.0,10,2,5.0,5,1,30.3,No,2013,No,No,No
Harrison Bowne,6,1,7,2,5,1,47.0,3,1,0.0,4,1,10.7,No,2013,No,No,No
Chad Cooke,2,1,2,1,0,0,10.0,1,0,5.0,1,1,37.4,No,2013,No,No,No
Judson Hall,5,1,4,2,0,0,18.0,3,1,0.0,1,1,11.9,No,2013,No,No,No
Colton Iverson,1014,120,694,379,454,256,2760.0,0,0,208.0,694,379,20.9,No,2013,No,No,No
Dorian Green,1464,373,1081,441,478,385,4247.0,532,197,251.0,549,244,19.2,No,2013,No,No,No
Wes Eikmeier,1274,220,1098,425,291,256,3164.0,465,168,197.0,633,257,23.9,No,2013,No,No,No
Greg Smith,1051,133,839,356,391,282,2578.0,163,57,212.0,676,299,25.1,Yes,2013,No,No,No
Pierce Hornung,727,188,518,304,173,101,3038.0,62,18,134.0,456,286,12.6,No,2013,No,No,No
Daniel Bejarano,1125,231,1025,374,290,218,2902.0,481,159,140.0,544,215,23.0,No,2013,No,No,No
Jon Octeus,913,207,667,282,398,299,2739.0,159,50,126.0,508,232,18.4,No,2013,No,No,No
Gerson Santo,242,16,165,89,93,64,958.0,0,0,30.0,165,89,12.7,No,2013,No,No,No
Joe De Ciman,917,157,749,301,226,165,2987.0,402,150,119.0,347,151,16.4,No,2013,No,No,No
Jordan Mason,128,15,125,47,28,19,308.0,60,15,18.0,65,32,26.5,No,2013,No,No,No
Josh Morgan,21,2,17,8,4,2,49.0,10,3,4.0,7,5,23.8,No,2013,No,No,No
Trevor Williams,12,1,14,5,6,2,103.0,0,0,8.0,14,5,13.1,No,2013,No,No,No
Stephon Wynn,0,0,1,0,0,0,4.0,0,0,0.0,1,0,12.7,No,2013,No,No,No
Spencer Dinwiddie,1115,227,690,290,506,420,2590.0,298,115,153.0,392,175,21.8,Yes,2013,No,No,No
Askia Booker,1740,335,1551,595,480,380,3810.0,538,170,287.0,1013,425,28.1,No,2013,No,No,No
Andre Roberson,1012,119,741,382,340,198,2970.0,143,50,183.0,598,332,19.0,Yes,2013,No,No,No
Josh Scott,1711,128,1157,600,657,506,3761.0,16,5,151.0,1141,595,21.7,No,2013,No,No,No
Xavier Johnson,1461,91,1068,510,497,311,3387.0,340,130,215.0,728,380,22.9,No,2013,No,No,No
Sabatino Chen,362,100,301,140,97,59,2053.0,91,23,99.0,210,117,12.8,No,2013,No,No,No
Jeremy Adams,241,24,207,70,134,87,935.0,52,14,58.0,155,56,18.4,No,2013,No,No,No
Xavier Talton,525,190,475,171,134,101,2417.0,230,82,152.0,245,89,14.4,No,2013,No,No,No
Shane Harris-Tunks,191,30,160,76,81,39,1067.0,1,0,101.0,159,76,14.8,No,2013,No,No,No
Eli Stalzer,105,27,92,35,30,18,584.0,56,17,38.0,36,18,12.7,No,2013,No,No,No
Beau Gamble,24,11,21,8,4,2,41.0,16,6,5.0,5,2,34.7,No,2013,No,No,No
Ben Mills,71,5,62,29,21,12,235.0,1,1,17.0,61,28,19.2,No,2013,No,No,No
Brian Barbour,1216,346,903,356,447,401,3149.0,319,103,159.0,584,253,21.9,No,2013,No,No,No
Alex Rosenberg,1430,204,992,409,628,478,3352.0,371,134,207.0,621,275,24.7,No,2013,No,No,No
Grant Mullins,1316,277,938,407,334,284,3535.0,538,218,164.0,400,189,19.3,No,2013,No,No,No
Steve Frankoski,702,57,622,247,48,40,1953.0,421,168,73.0,201,79,20.1,No,2013,No,No,No
Mark Cisco,795,69,601,326,221,143,2222.0,0,0,131.0,601,326,20.5,No,2013,No,No,No
Maodo Lo,1756,264,1329,623,304,233,3678.0,692,277,235.0,637,346,25.7,No,2013,No,No,No
Cory Osetkowski,613,145,498,229,211,132,2142.0,79,23,124.0,419,206,19.1,No,2013,No,No,No
John Daniels,291,70,246,113,113,65,1733.0,5,0,131.0,241,113,13.4,No,2013,No,No,No
Isaac Cohen,371,303,276,159,97,42,2592.0,28,11,132.0,248,148,9.8,No,2013,No,No,No
Zach En'Wezoh,80,16,73,38,17,4,334.0,1,0,30.0,72,38,19.0,No,2013,No,No,No
Skylar Scrivano,21,0,18,9,6,3,82.0,0,0,8.0,18,9,20.0,No,2013,No,No,No
Brad Gilson,13,1,12,4,2,2,35.0,11,3,1.0,1,1,22.7,No,2013,No,No,No
Noah Springwater,143,27,122,40,34,29,714.0,105,34,24.0,17,6,12.7,No,2013,No,No,No
Dean Kowalski,7,22,3,2,10,3,182.0,0,0,15.0,3,2,6.7,No,2013,No,No,No
Samer Ozeir,6,1,6,2,2,1,26.0,2,1,2.0,4,1,19.3,No,2013,No,No,No
Paddy Quinn,11,1,4,3,6,5,36.0,1,0,1.0,3,3,12.5,No,2013,No,No,No
Shabazz Napier,1959,646,1447,595,626,509,4614.0,693,260,350.0,754,335,24.0,Yes,2013,No,No,No
Ryan Boatright,1786,491,1362,566,573,455,4322.0,524,199,302.0,838,367,24.3,No,2013,No,No,No
DeAndre Daniels,953,52,791,359,202,152,2356.0,238,83,128.0,553,276,23.1,No,2013,No,No,No
Omar Calhoun,750,100,641,243,193,148,2355.0,361,116,131.0,280,127,19.9,No,2013,No,No,No
Niels Giffey,640,79,454,216,152,120,2328.0,209,88,102.0,245,128,14.3,No,2013,No,No,No
Tyler Olander,383,91,353,154,105,72,1876.0,17,3,79.0,336,151,13.5,No,2013,No,No,No
R.J. Evans,1285,233,1140,517,428,224,3213.0,144,27,270.0,996,490,25.8,No,2013,No,No,No
Enosch Wolf,84,14,70,40,10,4,336.0,0,0,23.0,70,40,15.6,No,2013,No,No,No
Phillip Nolan,269,24,215,108,82,53,1670.0,0,0,66.0,215,108,10.4,No,2013,No,No,No
Leon Tolksdorf,118,33,133,42,20,11,605.0,94,23,21.0,39,19,15.2,No,2013,No,No,No
Brendan Allen,2,2,8,1,1,0,40.0,5,0,3.0,3,1,15.2,No,2013,No,No,No
Trey James,0,1,0,0,0,0,2.0,0,0,0.0,0,0,0.0,No,2013,No,No,No
Keifer Lammi,0,0,1,0,0,0,2.0,1,0,0.0,0,0,27.1,No,2013,No,No,No
Pat Lenehan,4,1,7,1,2,1,30.0,3,1,1.0,4,0,16.0,No,2013,No,No,No
Dave Vandal,0,0,0,0,0,0,2.0,0,0,0.0,0,0,0.0,No,2013,No,No,No
Tor Watts,2,0,4,1,0,0,16.0,1,0,1.0,3,1,16.7,No,2013,No,No,No
Javon Williams,0,0,0,0,0,0,1.0,0,0,0.0,0,0,0,No,2013,No,No,No
Michael Murray,1030,96,957,389,301,191,2982.0,268,61,169.0,689,328,21.1,No,2013,No,No,No
Andre Armstrong,702,35,541,181,256,210,1451.0,390,130,74.0,151,51,25.2,No,2013,No,No,No
Patrick Cole,1360,343,1143,423,525,386,2710.0,401,128,299.0,742,295,31.0,No,2013,No,No,No
Taariq Cephas,1084,451,921,366,280,200,3460.0,420,152,290.0,501,214,19.0,No,2013,No,No,No
Troy Franklin,787,320,703,242,258,196,2221.0,360,107,249.0,343,135,26.3,No,2013,No,No,No
Sterling Smith,1082,166,850,367,197,153,3166.0,498,195,126.0,352,172,16.6,No,2013,No,No,No
Charles Ieans,195,25,191,74,51,28,772.0,56,19,43.0,135,55,16.6,No,2013,No,No,No
Collin Johnson,198,28,186,74,33,25,831.0,83,25,44.0,103,49,14.6,No,2013,No,No,No
Zach Burnham,109,6,125,44,33,21,573.0,1,0,29.0,124,44,14.6,No,2013,No,No,No
Darryln Johnson,22,2,37,8,8,6,142.0,1,0,2.0,36,8,14.9,No,2013,No,No,No
Brandon St. Louis,124,17,130,48,54,28,967.0,1,0,41.0,129,48,10.1,No,2013,No,No,No
Niwayo Adjei,12,2,14,2,10,8,38.0,4,0,6.0,10,2,32.1,No,2013,No,No,No
Mike Simpson,52,10,63,19,9,3,249.0,37,11,26.0,26,8,18.6,No,2013,No,No,No
Desma Nicholson,0,1,1,0,0,0,5.0,1,0,0.0,0,0,9.9,No,2013,No,No,No
Shonn Miller,1507,92,1124,541,455,359,3341.0,237,66,161.0,887,475,23.9,No,2013,No,No,No
Nolan Cressler,1172,153,976,432,184,134,2827.0,464,174,156.0,512,258,22.6,No,2013,No,No,No
Errick Peck,826,116,721,311,219,148,2150.0,158,56,156.0,563,255,23.6,No,2013,No,No,No
Johnathan Gray,618,76,526,207,153,106,1591.0,284,98,104.0,242,109,23.0,No,2013,No,No,No
Eitan Chemerinski,385,40,248,153,121,79,1231.0,0,0,94.0,248,153,16.9,No,2013,No,No,No
Devin Cherry,851,240,745,295,278,194,2512.0,230,67,252.0,515,228,24.0,No,2013,No,No,No
Galal Cancer,812,288,711,266,297,207,2881.0,211,73,217.0,500,193,19.5,No,2013,No,No,No
Dominick Scelfo,222,54,224,72,51,28,818.0,172,50,36.0,52,22,18.2,No,2013,No,No,No
Josh Figini,300,21,278,109,62,46,886.0,101,36,35.0,177,73,20.2,No,2013,No,No,No
Miles Asafo-Adjei,174,142,178,63,84,41,1255.0,34,7,75.0,144,56,12.2,No,2013,No,No,No
Dwight Tarwater,437,59,419,159,71,48,1870.0,231,71,60.0,188,88,14.5,No,2013,No,No,No
Nenad Tomic,139,5,112,52,49,35,400.0,1,0,18.0,111,52,20.4,No,2013,No,No,No
Deion Giddens,81,4,62,33,23,15,508.0,0,0,11.0,62,33,8.8,No,2013,No,No,No
Peter McMillan,30,3,43,10,4,2,161.0,31,8,9.0,12,2,17.5,No,2013,No,No,No
Dave LaMore,114,11,93,46,41,22,634.0,1,0,27.0,92,46,11.7,No,2013,No,No,No
Holt Harmon,3,1,3,1,0,0,19.0,1,1,1.0,2,0,10.9,No,2013,No,No,No
Jamal Cherry,2,0,3,0,5,2,10.0,2,0,2.0,1,0,38.4,No,2013,No,No,No
Robert Mischler,67,11,42,22,10,6,267.0,34,17,10.0,8,5,10.9,No,2013,No,No,No
Doug McDermott,3150,194,2075,1141,715,594,4569.0,598,274,321.0,1477,867,32.3,Yes,2013,No,No,No
Gregory Echenique,1364,85,829,496,548,372,3417.0,1,0,220.0,828,496,20.3,No,2013,No,No,No
Grant Gibbs,811,519,555,287,255,173,3136.0,165,64,221.0,390,223,15.3,No,2013,No,No,No
Ethan Wragge,1155,72,816,360,116,101,2732.0,761,334,69.0,55,26,18.4,No,2013,No,No,No
Austin Chatman,1013,493,832,323,313,246,3739.0,334,121,244.0,498,202,17.7,No,2013,No,No,No
Jahenns Manigat,900,298,679,296,129,102,3592.0,508,206,139.0,171,90,13.2,No,2013,No,No,No
Avery Dingman,462,84,378,152,102,70,1800.0,244,88,75.0,134,64,15.0,No,2013,No,No,No
Will Artino,620,47,416,256,193,108,1498.0,0,0,81.0,416,256,21.2,No,2013,No,No,No
Josh Jones,538,131,445,188,92,56,1654.0,280,106,84.0,165,82,18.5,No,2013,No,No,No
Nevin Johnson,139,27,113,42,54,39,541.0,59,16,31.0,54,26,16.8,No,2013,No,No,No
Andre Yates,503,109,497,187,116,71,1727.0,194,58,109.0,303,129,22.9,No,2013,No,No,No
Alex Olsen,18,2,9,6,11,6,60.0,1,0,1.0,8,6,13.9,No,2013,No,No,No
Geoffrey Groselle,593,27,339,232,191,129,1220.0,0,0,83.0,339,232,21.4,No,2013,No,No,No
Taylor Stormberg,18,12,18,6,2,2,130.0,14,4,7.0,4,2,10.7,No,2013,No,No,No
Joe Kelling,4,4,2,2,3,0,15.0,0,0,3.0,2,2,23.4,No,2013,No,No,No
Mogboluwaga Oginni,15,1,14,6,7,3,62.0,0,0,3.0,14,6,17.8,No,2013,No,No,No
Gabas Maldunas,1084,153,908,431,373,221,2761.0,9,1,225.0,899,430,25.8,No,2013,No,No,No
Alex Mitola,1207,276,979,375,253,217,3390.0,625,240,172.0,354,135,20.0,No,2013,No,No,No
Connor Boehm,1127,137,906,457,256,163,3007.0,139,50,193.0,767,407,21.4,No,2013,No,No,No
John Golden,780,153,662,266,241,157,3044.0,287,91,136.0,375,175,16.2,No,2013,No,No,No
Tyler Melville,804,148,658,266,258,201,2153.0,198,71,184.0,460,195,24.0,No,2013,No,No,No
Jvonte Brooks,421,58,271,122,231,173,1318.0,12,4,102.0,259,118,20.1,No,2013,No,No,No
Malik Gill,491,252,410,146,208,148,1659.0,163,51,176.0,247,95,21.9,No,2013,No,No,No
Kevin Crescenzi,412,97,417,144,87,60,1736.0,197,64,84.0,220,80,16.5,No,2013,No,No,No
Tommy Carpenter,224,86,181,95,59,32,978.0,14,2,78.0,167,93,15.6,No,2013,No,No,No
Brandon McDonnell,248,31,202,95,65,51,857.0,32,7,46.0,170,88,16.9,No,2013,No,No,No
Matt LaBove,302,34,294,115,113,72,1277.0,0,0,76.0,294,115,17.9,No,2013,No,No,No
Will McConnell,20,0,10,7,2,1,38.0,8,5,1.0,2,2,17.1,No,2013,No,No,No
Mack McKearney,55,35,61,14,28,20,371.0,35,7,25.0,26,7,14.7,No,2013,No,No,No
Matt Rennie,60,15,53,19,41,22,395.0,1,0,18.0,52,19,12.1,No,2013,No,No,No
Kirill Savolainen,4,1,6,1,2,2,29.0,4,0,0.0,2,1,13.1,No,2013,No,No,No
Jake Cohen,1795,147,1260,611,560,451,3157.0,348,122,258.0,912,489,28.8,No,2013,No,No,No
De'Mon Brooks,1777,113,1209,647,590,430,2971.0,154,53,232.0,1055,594,29.7,No,2013,No,No,No
Nik Cochran,1105,318,682,296,401,358,3059.0,387,155,180.0,295,141,17.5,No,2013,No,No,No
Chris Czerapowicz,1004,70,891,371,126,90,2732.0,506,172,89.0,385,199,19.5,No,2013,No,No,No
Tyler Kalinoski,1311,336,1026,450,221,168,3570.0,623,243,141.0,403,207,18.4,No,2013,No,No,No
J.P. Kuhlman,1420,412,1111,464,424,320,4060.0,468,172,245.0,643,292,19.4,No,2013,No,No,No
Tom Droney,746,315,585,254,252,182,3208.0,200,56,197.0,385,198,14.3,No,2013,No,No,No
Clint Mann,558,57,464,226,167,94,1537.0,33,12,125.0,431,214,22.0,No,2013,No,No,No
Jordan Barham,866,67,590,340,289,175,1643.0,31,11,75.0,559,329,25.0,No,2013,No,No,No
Jake Belford,247,32,173,88,62,46,710.0,63,25,54.0,110,63,18.6,No,2013,No,No,No
Mason Archie,406,69,385,137,103,77,1595.0,182,55,92.0,203,82,17.3,No,2013,No,No,No
Ali Mackay,38,9,24,15,11,6,194.0,7,2,5.0,17,13,9.1,No,2013,No,No,No
Youssef Mejri,6,2,10,2,2,2,43.0,7,0,1.0,3,2,14.0,No,2013,No,No,No
Connor Perkey,15,0,5,4,6,6,46.0,1,1,1.0,4,3,10.0,No,2013,No,No,No
Clay Tormey,11,5,13,4,5,2,76.0,4,1,8.0,9,3,15.8,No,2013,No,No,No
Kevin Dillard,1647,614,1245,522,516,421,3898.0,482,182,365.0,763,340,24.9,No,2013,No,No,No
Vee Sanford,834,155,673,305,203,156,2005.0,198,68,138.0,475,237,23.6,No,2013,No,No,No
Josh Benson,765,66,558,312,221,141,2022.0,1,0,152.0,557,312,20.7,No,2013,No,No,No
Devin Oliver,923,188,723,328,283,200,2971.0,211,67,179.0,512,261,18.1,No,2013,No,No,No
Dyshawn Pierre,1423,276,1041,501,435,307,3772.0,297,114,220.0,744,387,20.7,No,2013,No,No,No
Jalen Robinson,373,30,312,138,151,91,1175.0,17,6,73.0,295,132,20.4,No,2013,No,No,No
Matt Derenbecker,458,67,399,159,78,52,1429.0,243,88,65.0,156,71,17.7,No,2013,No,No,No
Khari Price,619,251,478,185,167,142,2288.0,294,107,134.0,184,78,16.2,No,2013,No,No,No
Devon Scott,256,27,159,91,124,74,930.0,0,0,66.0,159,91,16.3,No,2013,No,No,No
Alex Gavrilovic,360,21,287,139,88,58,1187.0,75,24,63.0,212,115,17.2,No,2013,No,No,No
Brian Vonderhaar,5,4,2,2,0,0,34.0,1,1,1.0,1,1,4.5,No,2013,No,No,No
Mitch Asmus,3,1,3,1,0,0,17.0,1,1,0.0,2,0,9.1,No,2013,No,No,No
Tahj Tate,796,137,697,297,196,141,1960.0,198,61,148.0,499,236,26.4,No,2013,No,No,No
Marques Oliver,1094,123,771,401,430,290,3212.0,13,2,214.0,758,399,20.7,No,2013,No,No,No
Casey Walker,1449,101,1324,496,263,191,3980.0,835,266,140.0,489,230,22.3,No,2013,No,No,No
Tyshawn Bell,1207,90,996,414,207,173,3154.0,544,206,103.0,452,208,20.3,No,2013,No,No,No
Kendall Gray,1020,77,696,377,415,266,3224.0,3,0,182.0,693,377,17.8,No,2013,No,No,No
Amere May,985,119,853,346,227,170,1984.0,319,123,152.0,534,223,28.9,No,2013,No,No,No
Albert Thomas,253,154,205,89,99,66,1395.0,29,9,92.0,176,80,13.7,No,2013,No,No,No
Miles Bowman,667,35,448,226,205,172,1427.0,110,43,76.0,338,183,23.0,No,2013,No,No,No
Jabari Joyner,61,31,67,19,16,13,365.0,40,10,32.0,27,9,16.2,No,2013,No,No,No
Jordan Lawson,112,10,83,39,49,34,563.0,1,0,27.0,82,39,13.2,No,2013,No,No,No
Chris Lewis,34,16,24,11,13,8,111.0,10,4,9.0,14,7,19.5,No,2013,No,No,No
Cahli Thomas,67,35,63,20,25,18,410.0,38,9,29.0,25,11,13.4,No,2013,No,No,No
Nick Doyle,81,33,95,33,14,8,368.0,34,7,26.0,61,26,19.4,No,2013,No,No,No
Brandon Oliver,34,37,34,14,18,6,409.0,1,0,40.0,33,14,11.2,No,2013,No,No,No
Scott Sill,114,6,139,45,9,2,458.0,86,22,21.0,53,23,18.4,No,2013,No,No,No
Michael Coger,8,1,7,4,0,0,26.0,0,0,1.0,7,4,16.9,No,2013,No,No,No
"Bryan ""Freddie"" Scott",0,0,2,0,0,0,12.0,1,0,1.0,1,0,9.3,No,2013,No,No,No
Devon Saddler,2222,336,1750,748,713,534,4449.0,569,192,368.0,1181,556,28.5,No,2013,No,No,No
Jarvis Threatt,1191,308,868,338,613,462,2714.0,189,53,190.0,679,285,25.1,No,2013,No,No,No
Jamelle Hagins,1184,86,919,466,377,252,3602.0,2,0,226.0,917,466,19.2,No,2013,No,No,No
Kyle Anderson,1292,138,1152,435,198,153,4048.0,780,269,149.0,372,166,17.6,Yes,2013,No,No,No
Josh Brinkley,765,46,541,284,304,197,2385.0,3,0,124.0,538,284,17.8,No,2013,No,No,No
Carl Baptiste,607,31,451,250,158,105,1989.0,11,2,110.0,440,248,15.9,No,2013,No,No,No
Terrell Rogers,98,32,116,31,30,25,399.0,46,11,31.0,70,20,20.7,No,2013,No,No,No
Marvin King-Davis,849,52,661,309,330,231,2152.0,2,0,92.0,659,309,21.6,No,2013,No,No,No
Larry Savage,63,8,84,28,17,5,422.0,18,2,18.0,66,26,13.4,No,2013,No,No,No
Will Townsville,11,1,19,5,0,0,88.0,8,1,1.0,11,4,11.8,No,2013,No,No,No
Troy Thomas,2,0,0,0,2,2,2.0,0,0,0.0,0,0,24.3,No,2013,No,No,No
Thomas Allshouse,0,0,0,0,0,0,11.0,0,0,0.0,0,0,0.0,No,2013,No,No,No
Brendan McNulty,3,0,8,1,0,0,17.0,6,1,2.0,2,0,30.7,No,2013,No,No,No
Tommy Williams,1,0,2,0,2,1,19.0,0,0,2.0,2,0,13.0,No,2013,No,No,No
Chris Udofia,1501,349,1074,551,515,334,3661.0,225,65,228.0,849,486,25.6,No,2013,No,No,No
Brett Olson,1468,336,1018,489,254,225,4296.0,607,265,212.0,411,224,19.2,No,2013,No,No,No
Royce O'Neale,1268,400,862,411,401,301,4057.0,363,145,258.0,499,266,18.1,Yes,2013,No,No,No
Chase Hallam,1216,263,916,430,272,194,3853.0,382,162,187.0,534,268,19.6,No,2013,No,No,No
Jalen Love,678,169,565,246,125,85,2530.0,283,101,97.0,282,145,17.5,No,2013,No,No,No
Cam Griffin,784,191,526,269,319,230,2552.0,63,16,158.0,463,253,20.2,No,2013,No,No,No
Nate Engesser,849,145,590,302,117,98,2014.0,344,147,87.0,246,155,22.2,No,2013,No,No,No
Marcus Byrd,893,152,667,318,120,94,2679.0,389,163,119.0,278,155,19.1,No,2013,No,No,No
Blake Foeman,92,31,77,32,25,16,554.0,46,12,34.0,31,20,13.3,No,2013,No,No,No
Bryant Rucker,521,126,367,180,121,90,1752.0,172,71,97.0,195,109,18.1,No,2013,No,No,No
Dom Samac,64,10,50,25,10,7,235.0,20,7,6.0,30,18,15.6,No,2013,No,No,No
Charles Webb,6,1,10,2,4,2,26.0,0,0,3.0,10,2,34.6,No,2013,No,No,No
Jake Logan,1,3,2,0,3,1,33.0,2,0,3.0,0,0,11.8,No,2013,No,No,No
Brandon Young,1899,521,1530,660,624,449,4007.0,445,130,352.0,1085,530,26.6,No,2013,No,No,No
Cleveland Melvin,1792,87,1509,719,444,290,3349.0,192,64,217.0,1317,655,28.2,No,2013,No,No,No
Jamee Crockett,965,125,834,343,224,157,2483.0,378,122,133.0,456,221,21.4,No,2013,No,No,No
Worrel Clahar,420,167,325,144,127,96,1313.0,109,36,132.0,216,108,18.8,No,2013,No,No,No
Donnavan Kirk,551,24,476,220,124,84,2166.0,82,27,90.0,394,193,15.2,No,2013,No,No,No
Moses Morgan,796,94,800,276,135,93,2244.0,461,151,140.0,339,125,22.3,No,2013,No,No,No
Charles McKinney,398,116,311,155,133,76,1608.0,52,12,117.0,259,143,14.8,No,2013,No,No,No
Durrell McDonald,410,133,382,155,64,42,1766.0,159,58,112.0,223,97,15.0,No,2013,No,No,No
Derrell Robertson,118,10,98,48,35,22,867.0,1,0,48.0,97,48,9.3,No,2013,No,No,No
Montray Clemons,114,8,102,42,45,30,411.0,6,0,33.0,96,42,18.6,No,2013,No,No,No
Edwind McGhee,57,21,52,15,29,20,350.0,27,7,16.0,25,8,11.4,No,2013,No,No,No
Peter Ryckbosch,123,7,92,49,53,25,599.0,0,0,35.0,92,49,12.2,No,2013,No,No,No
Stuart Pirri,6,3,8,2,0,0,28.0,8,2,0.0,0,0,14.6,No,2013,No,No,No
Jodan Price,276,24,321,93,39,25,1043.0,237,65,40.0,84,28,18.1,No,2013,No,No,No
Cory Dolins,10,4,9,4,5,2,48.0,0,0,3.0,9,4,15.1,No,2013,No,No,No
Ray McCallum,1618,451,1173,546,593,429,3519.0,335,97,233.0,838,449,23.7,Yes,2013,No,No,No
Nick Minnerath,913,65,662,326,231,188,2003.0,199,73,115.0,463,253,21.7,No,2013,No,No,No
Jason Calliste,1539,261,1024,425,560,447,3991.0,614,242,228.0,410,183,18.8,No,2013,No,No,No
Doug Anderson,730,87,554,293,187,130,1758.0,46,14,81.0,508,279,20.5,No,2013,No,No,No
Juwan Howard Jr.,1720,248,1501,620,365,302,3733.0,494,178,219.0,1007,442,25.4,No,2013,No,No,No
Evan Bruinsma,760,111,543,260,264,194,2338.0,163,46,148.0,380,214,17.4,No,2013,No,No,No
Anton Wilson,1005,183,748,325,174,150,2755.0,499,205,140.0,249,120,17.0,No,2013,No,No,No
P.J. Boutte,486,328,468,163,171,115,1986.0,174,45,192.0,294,118,17.9,No,2013,No,No,No
Jermaine Lippert,90,20,60,36,29,16,408.0,6,2,32.0,54,34,12.9,No,2013,No,No,No
Ugochukwu Njoku,155,18,130,63,74,29,867.0,1,0,36.0,129,63,11.5,No,2013,No,No,No
Gabriel Dos Santos,12,3,11,5,4,1,36.0,1,1,5.0,10,4,24.9,No,2013,No,No,No
Olumide Solanke,7,1,6,1,6,5,31.0,0,0,2.0,6,1,17.3,No,2013,No,No,No
Ben Simons,1372,158,1084,484,196,170,3533.0,586,234,162.0,498,250,20.4,No,2013,No,No,No
Seth VanDeest,987,138,651,346,418,291,2802.0,16,4,148.0,635,342,19.5,No,2013,No,No,No
Chris Hines,813,76,716,263,159,116,2468.0,463,171,142.0,253,92,20.4,No,2013,No,No,No
Richard Carter,808,227,609,252,324,240,1790.0,194,64,146.0,415,188,27.4,No,2013,No,No,No
Jordan Clarke,614,98,458,223,324,161,2199.0,27,7,137.0,431,216,18.0,No,2013,No,No,No
Joey King,1140,146,829,372,268,223,3250.0,447,173,153.0,382,199,17.7,No,2013,No,No,No
Micah Mason,1431,376,1001,487,174,146,3366.0,671,311,162.0,330,176,18.4,No,2013,No,No,No
Gary Ricks,501,118,415,174,58,46,1526.0,266,107,53.0,149,67,18.9,No,2013,No,No,No
Jeremy Jeffers,353,56,281,116,91,72,1295.0,125,49,64.0,156,67,15.9,No,2013,No,No,No
Daddy Ugbede,147,5,94,52,63,43,400.0,0,0,27.0,94,52,20.5,No,2013,No,No,No
Kori Babineaux,1104,265,990,466,271,161,2375.0,61,11,222.0,929,455,28.7,No,2013,No,No,No
Robert Puleikis,12,0,6,5,5,2,23.0,0,0,0.0,6,5,19.9,No,2013,No,No,No
Matt Bowie,0,0,0,0,0,0,5.0,0,0,1.0,0,0,10.4,No,2013,No,No,No
Mitch McLaughlin,1,1,1,0,4,1,20.0,0,0,4.0,1,0,18.6,No,2013,No,No,No
Damion Lee,2016,244,1468,636,578,487,4104.0,710,257,217.0,758,379,26.0,Yes,2013,No,No,No
Frantz Massenat,1646,548,1261,505,649,484,4381.0,419,152,264.0,842,353,23.0,No,2013,No,No,No
Derrick Thomas,947,248,942,341,217,155,3763.0,368,110,180.0,574,231,17.5,No,2013,No,No,No
Dartaye Ruffin,809,58,632,322,269,165,3255.0,0,0,148.0,632,322,15.2,No,2013,No,No,No
Tavon Allen,1249,220,1206,434,291,221,3146.0,490,160,188.0,716,274,26.7,No,2013,No,No,No
Daryl McCoy,489,96,418,203,140,83,2784.0,0,0,142.0,418,203,12.2,No,2013,No,No,No
Kazembe Abif,552,42,422,201,226,148,2087.0,15,2,86.0,407,199,15.9,No,2013,No,No,No
Chris Fouch,1744,178,1464,568,426,333,3449.0,780,275,151.0,684,293,28.2,No,2013,No,No,No
Aquil Younger,63,39,68,22,24,17,483.0,12,2,56.0,56,20,15.6,No,2013,No,No,No
Goran Pantovic,40,6,37,17,9,6,384.0,0,0,14.0,37,17,7.9,No,2013,No,No,No
Casey Carroll,2,0,1,1,0,0,4.0,0,0,0.0,1,1,13.9,No,2013,No,No,No
Jake Lerner,2,2,7,1,2,0,27.0,4,0,1.0,3,1,17.8,No,2013,No,No,No
Mason Plumlee,1384,212,915,525,569,332,3652.0,10,2,282.0,905,523,20.2,Yes,2013,No,No,No
Seth Curry,2101,290,1582,682,498,412,4357.0,825,325,225.0,757,357,23.8,Yes,2013,No,No,No
Quinn Cook,1571,509,1235,534,313,267,4033.0,629,236,201.0,606,298,20.2,Yes,2013,No,No,No
Rasheed Sulaimon,1307,309,991,425,373,285,3491.0,429,172,173.0,562,253,19.9,No,2013,No,No,No
Ryan Kelly,949,117,682,314,272,219,2437.0,269,102,104.0,413,212,18.8,Yes,2013,No,No,No
Tyler Thornton,433,264,308,125,121,94,2590.0,231,89,118.0,77,36,9.5,No,2013,No,No,No
Amile Jefferson,1079,142,687,426,395,227,3344.0,0,0,140.0,687,426,15.4,Yes,2013,No,No,No
Josh Hairston,250,27,220,97,87,56,1139.0,3,0,52.0,217,97,13.9,No,2013,No,No,No
Alex Murphy,602,61,470,226,166,89,1520.0,192,61,98.0,278,165,22.5,No,2013,No,No,No
Todd Zafirovski,5,1,7,2,4,1,41.0,0,0,1.0,7,2,12.3,No,2013,No,No,No
Marshall Plumlee,427,59,233,155,209,116,1777.0,1,1,68.0,232,154,11.4,Yes,2013,No,No,No
Derrick Colter,1695,526,1383,550,472,356,3948.0,675,239,326.0,708,311,24.2,No,2013,No,No,No
Sean Johnson,1245,181,975,405,449,330,2659.0,322,105,204.0,653,300,25.8,No,2013,No,No,No
Quevyn Winters,378,45,351,139,37,28,958.0,214,72,83.0,137,67,23.7,No,2013,No,No,No
Jeremiah Jones,761,209,661,260,247,164,2755.0,243,77,139.0,418,183,16.7,No,2013,No,No,No
Jerry Jones,560,117,483,207,106,68,1915.0,233,78,94.0,250,129,16.3,No,2013,No,No,No
Andre Marhold,380,27,309,157,159,66,1568.0,1,0,86.0,308,157,14.9,No,2013,No,No,No
Kadeem Pantophlet,254,38,216,89,36,25,1038.0,137,51,41.0,79,38,13.1,No,2013,No,No,No
Marvin Binney,91,19,73,32,13,12,368.0,39,15,21.0,34,17,13.5,No,2013,No,No,No
Martins Abele,175,7,137,69,64,37,561.0,0,0,66.0,137,69,20.7,No,2013,No,No,No
P.J. Torres,46,20,49,16,12,7,124.0,26,7,14.0,23,9,27.5,No,2013,No,No,No
Mamadou Datt,83,7,80,36,30,11,445.0,1,0,29.0,79,36,13.9,No,2013,No,No,No
Derrick Martin,12,6,13,5,3,2,112.0,1,0,9.0,12,5,10.4,No,2013,No,No,No
Sam Bott,5,0,5,2,3,1,26.0,3,0,0.0,2,2,12.3,No,2013,No,No,No
Nick Foschia,6,1,15,3,2,0,47.0,5,0,2.0,10,3,18.8,No,2013,No,No,No
Christian Johnston,2,0,7,1,0,0,17.0,1,0,1.0,6,1,24.0,No,2013,No,No,No
Maurice Kemp,1122,132,818,401,387,286,2258.0,123,34,155.0,695,367,25.4,No,2013,No,No,No
Miguel Paul,1129,528,865,329,391,312,2878.0,462,159,263.0,403,170,22.8,No,2013,No,No,No
Akeem Richmond,1622,146,1338,514,216,178,3514.0,1082,416,128.0,256,98,22.6,No,2013,No,No,No
Ty Armstrong,406,27,309,169,117,68,996.0,3,0,64.0,306,169,21.3,No,2013,No,No,No
Robert Sampson,745,85,634,284,194,109,2687.0,228,68,150.0,406,216,16.6,No,2013,No,No,No
Paris Roberts-Campbell,872,212,734,275,222,162,3073.0,480,160,128.0,254,115,16.3,No,2013,No,No,No
Marshall Guilmette,295,49,244,111,93,62,935.0,37,11,67.0,207,100,19.9,No,2013,No,No,No
Shamarr Bowden,433,59,382,144,48,33,1137.0,307,112,56.0,75,32,20.4,No,2013,No,No,No
Corvonn Gaines,446,243,373,154,184,94,2478.0,150,44,136.0,223,110,12.4,No,2013,No,No,No
Prince Williams,704,280,533,232,264,193,2147.0,136,47,180.0,397,185,20.4,No,2013,No,No,No
Michael Zangari,580,51,465,211,212,143,2045.0,71,15,99.0,394,196,17.0,No,2013,No,No,No
Petar Torlak,119,32,95,41,23,14,379.0,57,23,29.0,38,18,18.5,No,2013,No,No,No
Yasin Kolo,71,4,48,23,31,21,162.0,13,4,14.0,35,19,25.6,No,2013,No,No,No
Francis Edosomwan,14,3,10,5,10,4,61.0,1,0,4.0,9,5,15.7,No,2013,No,No,No
Peyton Robbins,3,1,5,1,2,1,20.0,0,0,1.0,5,1,17.8,No,2013,No,No,No
Lester Wilson,1388,60,1194,487,197,142,3234.0,753,272,117.0,441,215,21.9,No,2013,No,No,No
Jarvis Jones,793,110,780,290,131,95,2222.0,381,118,123.0,399,172,22.8,No,2013,No,No,No
Rashawn Rembert,1326,147,1019,425,268,216,3210.0,658,260,155.0,361,165,20.4,No,2013,No,No,No
Hunter Harris,561,35,403,206,231,144,1688.0,27,5,84.0,376,201,18.0,No,2013,No,No,No
John Walton III,782,55,607,272,374,237,2513.0,4,1,162.0,603,271,19.2,No,2013,No,No,No
Kinard Gadsden-Gilliard,530,145,464,185,174,128,1810.0,99,32,144.0,365,153,19.2,No,2013,No,No,No
Mario Stramaglia,99,19,95,26,48,33,337.0,56,14,29.0,39,12,23.0,No,2013,No,No,No
Petey McClain,332,412,282,107,157,101,2579.0,74,17,187.0,208,90,10.6,No,2013,No,No,No
Yunio Barrueta,60,10,56,19,25,16,294.0,19,6,16.0,37,13,15.0,No,2013,No,No,No
Marcus Dubose,366,19,328,132,81,63,860.0,139,39,65.0,189,93,25.1,No,2013,No,No,No
Sheldon Cooley,668,177,577,238,229,163,2134.0,103,29,165.0,474,209,19.9,No,2013,No,No,No
Todd Halvorsen,27,9,24,9,5,4,111.0,15,5,10.0,9,4,16.8,No,2013,No,No,No
Morris Woods,381,50,277,143,160,92,912.0,17,3,93.0,260,140,27.7,No,2013,No,No,No
Sherman Blanford,771,119,575,277,318,217,1639.0,4,0,114.0,571,277,27.9,No,2013,No,No,No
Josh Piper,721,121,606,268,102,85,2400.0,278,100,109.0,328,168,17.6,No,2013,No,No,No
Alex Austin,530,84,422,176,137,102,1684.0,234,76,69.0,188,100,18.1,No,2013,No,No,No
Malcolm Herron,236,28,229,81,42,34,666.0,117,40,36.0,112,41,24.1,No,2013,No,No,No
Taylor Jones,288,79,247,94,38,33,1410.0,193,67,67.0,54,27,13.1,No,2013,No,No,No
Austin Akers,191,186,210,73,39,24,1495.0,77,21,68.0,133,52,11.1,No,2013,No,No,No
Cameron Harvey,564,62,568,198,76,54,2150.0,331,114,80.0,237,84,16.5,No,2013,No,No,No
Keenen Anderson,173,18,118,67,86,39,815.0,0,0,49.0,118,67,14.0,No,2013,No,No,No
Alex Lubsey,24,7,18,9,10,6,150.0,0,0,9.0,18,9,11.8,No,2013,No,No,No
R.J. McGhee,0,2,7,0,0,0,14.0,4,0,2.0,3,0,36.7,No,2013,No,No,No
Mike DiNunno,1377,406,1209,456,308,240,3710.0,672,225,301.0,537,231,22.5,No,2013,No,No,No
Corey Walden,1807,366,1164,585,562,471,3978.0,477,166,274.0,687,419,23.0,No,2013,No,No,No
Glenn Cosey,1077,235,765,328,272,226,2260.0,468,195,102.0,297,133,23.6,No,2013,No,No,No
Eric Stutz,1338,204,825,502,388,303,3392.0,76,31,217.0,749,471,19.8,No,2013,No,No,No
Tarius Johnson,560,79,414,193,183,119,1646.0,147,55,76.0,267,138,18.8,No,2013,No,No,No
Marcus Lewis,542,79,424,213,136,82,1672.0,134,34,71.0,290,179,18.0,No,2013,No,No,No
Jeff Johnson,489,159,415,178,89,63,2101.0,211,70,113.0,204,108,15.0,No,2013,No,No,No
Orlando Williams,824,138,637,278,183,131,2246.0,346,137,134.0,291,141,20.8,No,2013,No,No,No
Deverin Muff,159,14,123,60,65,39,814.0,0,0,37.0,123,60,12.8,No,2013,No,No,No
Timmy Knipp,641,93,519,213,101,77,1896.0,383,138,93.0,136,75,19.1,No,2013,No,No,No
Robbie Stenzel,27,13,25,8,6,5,99.0,22,6,4.0,3,2,17.4,No,2013,No,No,No
Jaylen Babb-Harrison,423,67,353,142,62,55,943.0,226,84,51.0,127,58,23.7,No,2013,No,No,No
Ryan Parsons,38,2,35,12,6,3,101.0,33,11,2.0,2,1,21.4,No,2013,No,No,No
Tommy Matthews,33,15,37,9,20,11,238.0,17,4,13.0,20,5,13.3,No,2013,No,No,No
Derek Thompson,1079,122,989,363,178,127,2541.0,629,226,138.0,360,137,25.5,No,2013,No,No,No
Glenn Bryant,899,42,739,356,260,169,2364.0,95,18,104.0,644,338,21.7,No,2013,No,No,No
Daylen Harrison,683,129,597,239,180,144,2524.0,192,61,146.0,405,178,17.4,No,2013,No,No,No
J.R. Sims,503,96,493,165,145,107,1949.0,236,66,113.0,257,99,18.9,No,2013,No,No,No
Jalen Ross,1112,233,921,345,380,287,2920.0,390,135,219.0,531,210,23.5,No,2013,No,No,No
Jamell Harris,528,60,442,203,232,121,2697.0,3,1,136.0,439,202,13.9,No,2013,No,No,No
DaShonte Riley,392,76,331,154,148,84,2336.0,4,0,172.0,327,154,13.3,No,2013,No,No,No
Matt Balkema,325,31,292,122,153,81,1352.0,3,0,77.0,289,122,17.8,No,2013,No,No,No
Austin Harper,150,84,139,52,50,38,651.0,38,8,62.0,101,44,19.4,No,2013,No,No,No
Anthony Strickland,157,28,135,56,67,45,934.0,2,0,40.0,133,56,12.3,No,2013,No,No,No
Ray Lee,1873,242,1426,595,591,470,3270.0,600,213,336.0,826,382,31.3,No,2013,No,No,No
Antoine Chandler,36,11,32,13,10,5,128.0,18,5,11.0,14,8,20.9,No,2013,No,No,No
James Still,31,3,33,13,14,5,173.0,2,0,11.0,31,13,13.4,No,2013,No,No,No
Josh Lyle,5,3,14,2,4,1,51.0,3,0,2.0,11,2,19.3,No,2013,No,No,No
Venky Jois,1803,276,1232,718,660,363,3927.0,22,4,302.0,1210,714,23.7,No,2013,No,No,No
Parker Kelly,1006,119,744,309,213,178,3466.0,515,210,90.0,229,99,13.6,No,2013,No,No,No
Colin Chiverton,704,27,625,237,129,97,1121.0,352,133,66.0,273,104,33.4,No,2013,No,No,No
Martin Seiferth,487,17,324,206,169,75,1429.0,0,0,72.0,324,206,16.7,No,2013,No,No,No
Justin Crosgile,516,147,485,168,113,81,1571.0,302,99,135.0,183,69,22.0,No,2013,No,No,No
Jeffrey Forbes,1022,225,859,342,193,167,3650.0,465,171,159.0,394,171,15.1,No,2013,No,No,No
Thomas Reuter,230,69,228,81,89,49,1010.0,79,19,75.0,149,62,17.2,No,2013,No,No,No
Kevin Winford,704,135,649,240,111,86,2166.0,409,138,112.0,240,102,18.8,No,2013,No,No,No
Tyler Harvey,1564,197,1066,494,373,316,2635.0,602,260,151.0,464,234,26.7,No,2013,No,No,No
Jordan Hickert,189,23,204,62,15,12,683.0,166,53,23.0,38,9,17.1,No,2013,No,No,No
Daniel Hill,67,47,62,17,41,28,421.0,28,5,38.0,34,12,14.3,No,2013,No,No,No
Ivan Dorsey,35,2,58,14,7,4,125.0,15,3,13.0,43,11,29.9,No,2013,No,No,No
Danny Powell,30,0,28,10,6,5,49.0,17,5,4.0,11,5,35.7,No,2013,No,No,No
Frederik Jorg,38,4,24,15,15,8,110.0,0,0,5.0,24,15,16.7,No,2013,No,No,No
Lucas Troutman,1626,80,1219,636,533,353,3168.0,4,1,218.0,1215,635,27.3,No,2013,No,No,No
Jack Isenbarger,1438,290,1147,446,335,282,3361.0,721,264,206.0,426,182,23.0,No,2013,No,No,No
Ryley Beaumont,1093,175,969,436,231,148,3354.0,242,73,191.0,727,363,19.4,No,2013,No,No,No
Sebastian Koch,1128,262,873,371,187,144,3502.0,599,242,177.0,274,129,16.6,No,2013,No,No,No
Tanner Samson,1320,220,1008,390,262,216,3616.0,862,324,116.0,146,66,17.4,No,2013,No,No,No
Austin Hamilton,833,303,695,295,239,157,2390.0,268,86,182.0,427,209,21.0,No,2013,No,No,No
Josh Bonney,486,258,533,180,152,102,1707.0,132,24,201.0,401,156,24.3,No,2013,No,No,No
Ryan Winters,285,47,216,106,104,73,1230.0,0,0,59.0,216,106,13.5,No,2013,No,No,No
Kevin Blake,504,89,371,168,230,138,1756.0,101,30,88.0,270,138,16.4,No,2013,No,No,No
Tony Sabato,199,51,207,84,60,31,1067.0,1,0,66.0,206,84,14.4,No,2013,No,No,No
Egheosa Edomwonyi,114,12,111,45,36,24,473.0,0,0,39.0,111,45,17.8,No,2013,No,No,No
John Moody,13,2,8,5,4,2,47.0,1,1,5.0,7,4,16.3,No,2013,No,No,No
Aaron Smith,14,0,19,5,2,2,31.0,12,2,1.0,7,3,34.7,No,2013,No,No,No
Roger Dugas,198,21,208,74,26,16,788.0,115,34,31.0,93,40,15.9,No,2013,No,No,No
Sam Hershberger,19,6,11,4,11,10,49.0,7,1,1.0,4,3,17.6,No,2013,No,No,No
Wes Brewer,12,1,9,6,2,0,33.0,0,0,8.0,9,6,27.3,No,2013,No,No,No
Colt Ryan,2279,406,1699,708,697,601,4379.0,656,262,295.0,1043,446,28.1,No,2013,No,No,No
Ned Cox,1115,308,960,400,222,170,3138.0,394,145,155.0,566,255,20.6,No,2013,No,No,No
D.J. Balentine,2464,472,1910,824,698,553,4644.0,702,263,295.0,1208,561,29.0,No,2013,No,No,No
Troy Taylor,637,416,498,224,295,186,3020.0,6,3,229.0,492,221,15.2,No,2013,No,No,No
Lewis Jones,543,63,475,197,217,135,1816.0,57,14,101.0,418,183,19.8,No,2013,No,No,No
Egidijus Mockevicius,1504,43,893,551,548,402,3497.0,0,0,178.0,893,551,20.2,No,2013,No,No,No
Jaylon Moore,430,17,287,177,141,76,1349.0,0,0,53.0,287,177,16.1,No,2013,No,No,No
Ryan Sawvell,812,103,593,329,178,123,2581.0,80,31,100.0,513,298,15.8,No,2013,No,No,No
Adam Wing,804,240,632,293,216,169,3328.0,124,49,186.0,508,244,14.7,No,2013,No,No,No
Jordan Jahr,235,27,217,80,53,42,708.0,108,33,42.0,109,47,21.4,No,2013,No,No,No
Jordan Nelson,104,15,99,36,9,7,382.0,75,25,9.0,24,11,15.5,No,2013,No,No,No
Rokas Cesnulevicius,29,7,23,11,19,7,200.0,0,0,11.0,23,11,11.1,No,2013,No,No,No
Andy Chinn,2,1,5,1,0,0,16.0,2,0,2.0,3,1,23.0,No,2013,No,No,No
Mike Leazer,0,1,2,0,0,0,10.0,0,0,2.0,2,0,21.4,No,2013,No,No,No
Brandon Williams,0,1,4,0,0,0,12.0,1,0,1.0,3,0,17.5,Yes,2013,No,No,No
Derek Needham,1875,537,1642,628,466,338,4435.0,849,281,436.0,793,347,26.9,No,2013,No,No,No
Maurice Barrow,1309,193,1041,484,429,298,3839.0,142,43,256.0,899,441,20.5,No,2013,No,No,No
Desmond Wade,761,487,739,258,211,148,3415.0,295,97,214.0,444,161,15.7,No,2013,No,No,No
Colin Nickerson,711,244,573,265,216,140,2993.0,158,41,176.0,415,224,14.9,No,2013,No,No,No
Amadou Sidibe,752,97,587,302,227,148,2701.0,0,0,155.0,587,302,16.6,No,2013,No,No,No
Marcus Gilbert,1661,154,1246,531,468,357,3820.0,675,242,271.0,571,289,23.9,No,2013,No,No,No
Keith Matthews,404,37,348,161,136,80,1387.0,10,2,73.0,338,159,18.6,No,2013,No,No,No
Josip Mikulic,143,16,140,54,9,6,472.0,93,29,33.0,47,25,20.6,No,2013,No,No,No
Coleman Johnson,452,72,440,183,131,86,1972.0,2,0,101.0,438,183,16.2,No,2013,No,No,No
Justin Jenkins,439,77,401,139,144,99,1485.0,213,62,104.0,188,77,20.2,No,2013,No,No,No
Steve Johnston,236,37,209,65,72,50,973.0,182,56,41.0,27,9,15.9,No,2013,No,No,No
Mike Hyland,0,0,0,0,0,0,2.0,0,0,0.0,0,0,0.0,No,2013,No,No,No
Melquan Bolding,1355,180,1181,464,413,297,3257.0,443,130,256.0,738,334,25.2,No,2013,No,No,No
Kinu Rochford,666,81,488,282,172,102,1521.0,1,0,121.0,487,282,23.2,No,2013,No,No,No
Lonnie Robinson,469,117,396,156,162,98,1749.0,152,59,131.0,244,97,17.6,No,2013,No,No,No
Mustafaa Jones,877,135,763,278,142,126,2700.0,537,195,140.0,226,83,18.5,No,2013,No,No,No
Mathias Seilund,661,71,574,234,135,112,2331.0,211,81,132.0,363,153,16.9,No,2013,No,No,No
Sidney Sanders Jr.,716,273,603,242,262,193,1675.0,119,39,128.0,484,203,26.3,No,2013,No,No,No
Sekou Harris,203,86,203,71,59,40,691.0,60,21,87.0,143,50,23.7,No,2013,No,No,No
Xavier Harris,411,37,337,171,128,69,1382.0,0,0,100.0,337,171,18.5,No,2013,No,No,No
Yves Jules,224,31,204,86,43,29,761.0,67,23,60.0,137,63,19.0,No,2013,No,No,No
Kyle Pearson,124,6,104,49,32,16,367.0,29,10,19.0,75,39,19.3,No,2013,No,No,No
Trevor Charles,164,8,114,64,68,36,414.0,0,0,46.0,114,64,23.5,No,2013,No,No,No
Dylan Moody,36,33,37,13,2,2,483.0,25,8,36.0,12,5,7.8,No,2013,No,No,No
Yosua Cordero-Collado,2,0,3,1,0,0,9.0,0,0,1.0,3,1,22.8,No,2013,No,No,No
Jamie Adams,970,211,795,293,321,251,1886.0,401,133,207.0,394,160,28.8,No,2013,No,No,No
Reggie Lewis,1176,167,1139,432,172,124,3169.0,517,188,143.0,622,244,20.3,Yes,2013,No,Yes,Yes
Muhammad Abdul-Aleem,365,49,344,127,133,84,883.0,96,27,96.0,248,100,27.1,No,2013,No,No,No
Jamari Bradshaw,589,66,509,216,164,91,1231.0,193,66,101.0,316,150,26.3,No,2013,No,No,No
Markee Teal,308,24,253,120,104,67,1099.0,10,1,86.0,243,119,16.9,No,2013,No,No,No
Trey Kellum,1050,70,803,400,385,250,2698.0,2,0,207.0,801,400,21.4,No,2013,No,No,No
D'Andre Bullard,307,138,362,117,69,45,1539.0,91,28,127.0,271,89,16.0,No,2013,No,No,No
Walter Davis,134,42,111,57,57,20,1112.0,2,0,40.0,109,57,7.6,Yes,2013,Yes,Yes,Yes
Onyekachukwu Odi,91,6,100,34,67,23,636.0,0,0,51.0,100,34,13.6,No,2013,No,No,No
Jakari Bush,28,18,24,10,8,7,143.0,3,1,18.0,21,9,15.4,No,2013,No,No,No
Michael Fabiyi,22,4,15,8,9,6,69.0,2,0,3.0,13,8,15.5,No,2013,No,No,No
McWisdom Badejo,16,1,18,8,0,0,80.0,0,0,0.0,18,8,10.8,No,2013,No,No,No
Chuka Eneh,0,0,0,0,0,0,0.0,0,0,0.0,0,0,0,No,2013,No,No,No
Greg Gantt,1972,125,1625,707,360,271,3799.0,774,287,169.0,851,420,26.6,No,2013,No,No,No
Stefan Moody,1749,278,1301,527,545,462,2955.0,641,233,277.0,660,294,31.0,No,2013,No,No,No
Pablo Bertone,1153,173,954,422,278,198,2625.0,316,111,211.0,638,311,25.6,No,2013,No,No,No
Jordan McCoy,596,23,426,227,238,142,2432.0,1,0,75.0,425,227,13.0,No,2013,No,No,No
Jackson Trapp,926,168,804,313,167,127,3323.0,479,173,161.0,325,140,16.5,No,2013,No,No,No
Dragan Sekelja,246,73,208,91,104,61,981.0,9,3,102.0,199,88,18.9,No,2013,No,No,No
Richard Morrow,136,23,117,50,60,34,580.0,6,2,47.0,111,48,17.1,No,2013,No,No,No
Andre Mattison,153,7,109,52,81,49,806.0,0,0,40.0,109,52,12.0,No,2013,No,No,No
Cavon Baker,459,69,385,160,121,87,1147.0,150,52,95.0,235,108,25.3,No,2013,No,No,No
Kelvin Penn,382,57,309,168,109,46,2804.0,0,0,115.0,309,168,8.9,No,2013,No,No,No
Chris Bryant,320,24,238,114,142,91,1179.0,4,1,64.0,234,113,16.8,No,2013,No,No,No
DeVonte Thornton,10,0,10,4,2,1,59.0,2,1,5.0,8,3,14.0,No,2013,No,No,No
Javier Lacunza,175,9,157,58,39,30,698.0,94,29,32.0,63,29,15.8,No,2013,No,No,No
Austin Hunt,0,0,1,0,0,0,2.0,0,0,0.0,1,0,25.8,No,2013,No,No,No
Sherwood Brown,1241,98,981,447,272,190,2910.0,411,157,154.0,570,290,21.5,No,2013,No,No,No
Bernard Thompson,1835,246,1466,636,487,344,4031.0,601,219,278.0,865,417,24.8,Yes,2013,No,No,No
Chase Fieler,1306,203,971,487,317,229,3458.0,327,103,201.0,644,384,19.2,No,2013,No,No,No
Brett Comer,1477,845,1247,536,459,304,4047.0,324,101,460.0,923,435,24.2,No,2013,No,No,No
Eric McKnight,506,24,343,210,175,86,1780.0,1,0,116.0,342,210,15.4,No,2013,No,No,No
Christophe Varidel,866,101,679,262,193,164,2193.0,462,178,163.0,217,84,21.0,No,2013,No,No,No
Eddie Murray,442,43,292,161,151,109,1755.0,40,11,67.0,252,150,12.2,No,2013,No,No,No
Filip Cvjeticanin,699,43,617,235,71,47,2129.0,496,182,85.0,121,53,17.3,No,2013,No,No,No
Dajuan Graf,971,417,751,347,301,224,3338.0,162,53,230.0,589,294,16.8,No,2013,No,No,No
L.J. Livingston,302,4,188,120,98,62,991.0,0,0,33.0,188,120,14.4,No,2013,No,No,No
Alexander Blessig,10,4,12,4,1,0,66.0,5,2,8.0,7,2,15.4,No,2013,No,No,No
Marcus Blake,45,10,43,14,28,17,284.0,1,0,18.0,42,14,13.3,No,2013,No,No,No
Tymell Murphy,984,132,680,394,258,171,2040.0,84,25,172.0,596,369,24.0,No,2013,No,No,No
Malik Smith,712,79,593,212,175,135,1745.0,439,153,91.0,154,59,22.4,No,2013,No,No,No
Jerome Frink,1623,159,1296,619,455,297,3910.0,270,88,286.0,1026,531,22.5,No,2013,No,No,No
Deric Hill,241,138,200,75,100,74,1041.0,60,17,97.0,140,58,16.7,No,2013,No,No,No
Cameron Bell,328,54,244,99,130,109,964.0,63,21,77.0,181,78,20.2,No,2013,No,No,No
Marco Porcher Jimenez,464,42,416,161,62,47,1383.0,278,95,57.0,138,66,18.5,No,2013,No,No,No
Tola Akomolafe,186,33,168,68,51,36,1052.0,59,14,54.0,109,54,11.8,No,2013,No,No,No
Juan Ferrales,119,26,98,36,40,29,402.0,47,18,29.0,51,18,18.0,No,2013,No,No,No
Gabby Belardo,727,226,709,271,148,95,2071.0,297,90,210.0,412,181,24.0,No,2013,No,No,No
Ivan Jurkovic,55,3,55,21,18,13,326.0,4,0,23.0,51,21,13.3,No,2013,No,No,No
Joey De La Rosa,58,4,61,24,28,10,350.0,0,0,22.0,61,24,14.2,No,2013,No,No,No
Manuel Nunez,9,5,26,4,4,1,155.0,13,0,8.0,13,4,13.1,No,2013,No,No,No
Dee Lewis,0,0,0,0,0,0,3.0,0,0,0.0,0,0,0.0,No,2013,No,No,No
Michael Snaer,1550,265,1236,525,387,304,3851.0,511,196,326.0,725,329,23.0,No,2013,No,No,No
Okaro White,1402,95,944,466,502,401,3417.0,211,69,217.0,733,397,21.0,Yes,2013,No,No,No
Devon Bookert,1120,347,856,359,270,214,3567.0,449,188,246.0,407,171,17.7,No,2013,No,No,No
Aaron Thomas,815,116,628,277,271,209,1938.0,163,52,152.0,465,225,24.5,No,2013,No,No,No
Kiel Turpin,347,13,264,141,98,65,948.0,2,0,61.0,262,141,20.6,No,2013,No,No,No
Terrance Shannon,432,38,357,160,201,112,1193.0,2,0,109.0,355,160,23.6,No,2013,No,No,No
Terry Whisnant,616,90,510,202,116,92,1750.0,338,120,59.0,172,82,19.2,No,2013,No,No,No
Ian Miller,977,193,802,324,227,183,2349.0,408,146,193.0,394,178,24.1,No,2013,No,No,No
Montay Brandon,899,196,669,311,409,252,3509.0,95,25,221.0,574,286,16.0,No,2013,No,No,No
Boris Bojanovsky,683,60,423,244,282,195,2257.0,4,0,127.0,419,244,15.5,No,2013,No,No,No
Robert Gilchrist,154,10,153,68,39,14,683.0,17,4,48.0,136,64,16.8,No,2013,No,No,No
Michael Ojo,351,25,240,126,174,99,1282.0,0,0,96.0,240,126,16.5,No,2013,No,No,No
Joey Moreau,22,0,15,4,10,10,36.0,12,4,2.0,3,0,30.6,No,2013,No,No,No
Rafael Portuondo,10,1,8,3,4,3,19.0,5,1,7.0,3,2,44.8,No,2013,No,No,No
Mike Rosario,1706,193,1486,602,321,254,3628.0,755,248,273.0,731,354,27.2,No,2013,No,No,No
Kenny Boynton,2033,392,1671,666,468,368,4674.0,978,333,221.0,693,333,23.6,No,2013,No,No,No
Erik Murphy,1052,95,773,397,152,115,2488.0,329,143,139.0,444,254,21.0,Yes,2013,No,No,No
Patric Young,1307,115,929,536,413,235,3638.0,0,0,187.0,929,536,19.3,No,2013,No,No,No
Scottie Wilbekin,953,419,769,320,246,175,3462.0,367,138,182.0,402,182,16.6,No,2013,No,No,No
Michael Frazier,998,114,718,318,158,135,2593.0,526,227,122.0,192,91,19.1,Yes,2013,No,No,No
Casey Prather,787,109,541,308,254,161,2019.0,32,10,149.0,509,298,21.5,No,2013,No,No,No
Will Yeguete,515,110,383,189,238,132,2347.0,25,5,124.0,358,184,14.2,No,2013,No,No,No
DeVon Walker,434,89,374,144,179,118,1797.0,110,28,83.0,264,116,15.2,No,2013,No,No,No
Braxton Ogbueze,1108,180,915,367,192,148,3064.0,550,226,110.0,365,141,17.9,No,2013,No,No,No
Jacob Kurtz,188,41,120,73,63,41,877.0,3,1,44.0,117,72,12.0,No,2013,No,No,No
Dillon Graham,11,5,22,5,0,0,92.0,12,1,4.0,10,4,15.4,No,2013,No,No,No
Branden Frazier,1642,495,1447,539,479,378,4138.0,634,186,317.0,813,353,23.4,No,2013,No,No,No
Mandell Thomas,1385,274,1227,483,363,255,3607.0,460,164,212.0,767,319,22.2,No,2013,No,No,No
Chris Gaston,1672,128,1434,652,585,363,3409.0,32,5,343.0,1402,647,29.1,No,2013,No,No,No
Bryan Smith,902,183,901,311,173,124,3053.0,535,156,173.0,366,155,18.6,No,2013,No,No,No
Travion Leonard,335,19,300,141,97,53,1019.0,2,0,82.0,298,141,20.3,No,2013,No,No,No
Ryan Canty,323,15,259,138,108,47,1267.0,0,0,59.0,259,138,14.2,No,2013,No,No,No
Jeff Short,1338,173,988,426,392,317,2670.0,469,169,214.0,519,257,26.5,No,2013,No,No,No
Jermaine Myers,154,96,136,47,55,42,914.0,68,18,64.0,68,29,12.0,No,2013,No,No,No
Ryan Rhoomes,953,94,631,389,308,175,3178.0,0,0,138.0,631,389,14.4,No,2013,No,No,No
Luka Zivkovic,39,5,46,13,6,4,156.0,36,9,10.0,10,4,18.4,No,2013,No,No,No
Jared Fay,11,0,9,4,2,0,32.0,6,3,2.0,3,1,18.1,No,2013,No,No,No
Devon McMillan,216,83,228,72,111,64,790.0,47,8,83.0,181,64,22.5,No,2013,No,No,No
Khalid Robinson,13,2,13,3,12,7,162.0,2,0,15.0,11,3,10.1,No,2013,No,No,No
Nihad Musovic,2,1,2,0,2,2,22.0,2,0,3.0,0,0,13.2,No,2013,No,No,No
Leo Walsh,4,1,4,2,0,0,16.0,0,0,2.0,4,2,18.1,No,2013,No,No,No
Tyler Johnson,1350,303,1077,491,348,249,3538.0,320,119,176.0,757,372,21.5,Yes,2013,No,No,No
Allen Huddleston,1163,170,889,341,467,307,2996.0,521,174,166.0,368,167,23.4,No,2013,No,No,No
Kevin Foster,633,12,546,224,223,151,1669.0,100,34,126.0,446,190,25.2,No,2013,No,No,No
Kevin Olekaibe,1533,187,1361,508,310,243,3716.0,802,274,178.0,559,234,23.9,No,2013,No,No,No
Marvelle Harris,2031,396,1595,667,678,506,4524.0,568,191,264.0,1027,476,25.3,No,2013,No,No,No
Jerry Brown,789,75,552,272,409,244,2803.0,6,1,128.0,546,271,16.8,No,2013,No,No,No
Robert Upshaw,299,15,243,123,120,53,834.0,1,0,46.0,242,123,22.1,No,2013,No,No,No
Tanner Giddings,112,12,116,49,21,12,813.0,6,2,25.0,110,47,10.1,No,2013,No,No,No
Aaron Anderson,390,198,274,124,145,109,1847.0,90,33,136.0,184,91,13.1,No,2013,No,No,No
Braeden Anderson,72,7,65,18,59,36,466.0,1,0,21.0,64,18,13.1,No,2013,No,No,No
Garrett Johnson,442,60,422,156,83,59,1444.0,231,71,64.0,191,85,18.8,No,2013,No,No,No
Brad Ely,2,0,3,1,2,0,30.0,1,0,2.0,2,1,10.9,No,2013,No,No,No
Colin Reddick,832,108,670,309,308,214,2202.0,1,0,176.0,669,309,23.9,No,2013,No,No,No
Stephen Croone,1936,385,1294,573,872,651,3744.0,463,139,365.0,831,434,29.6,No,2013,No,No,No
Larry Wideman,723,115,679,246,154,105,2686.0,389,126,162.0,290,120,18.3,No,2013,No,No,No
Bobby Austin,596,123,552,203,123,92,2499.0,266,98,155.0,286,105,16.3,No,2013,No,No,No
Charlie Reddick,746,132,609,250,181,131,2209.0,330,115,144.0,279,135,20.2,No,2013,No,No,No
Kendrec Ferrara,893,83,756,357,227,129,2998.0,163,50,204.0,593,307,19.2,No,2013,No,No,No
Bryant Irwin,643,46,641,231,132,84,2141.0,333,97,92.0,308,134,19.5,No,2013,No,No,No
Keith Belfield,186,26,159,58,54,38,681.0,81,32,41.0,78,26,17.8,No,2013,No,No,No
David Brown,125,53,113,42,21,18,519.0,68,23,37.0,45,19,16.4,No,2013,No,No,No
Kevin Chuisseu,63,7,59,22,51,19,445.0,1,0,28.0,58,22,13.6,No,2013,No,No,No
Jordan Loyd,165,51,150,55,62,41,588.0,54,14,46.0,96,41,20.1,Yes,2013,No,No,No
Aaron O'Neill,52,17,46,17,6,4,396.0,39,14,9.0,7,3,7.9,No,2013,No,No,No
Tyler Bisack,0,0,0,0,0,0,0.0,0,0,0.0,0,0,0,No,2013,No,No,No
Donta Harper,902,149,729,332,331,236,2231.0,30,2,225.0,699,330,25.7,No,2013,No,No,No
Tashan Newsome,1059,179,908,363,370,269,2383.0,247,64,176.0,661,299,26.9,No,2013,No,No,No
Kevin Hartley,502,63,402,173,74,49,1696.0,260,107,109.0,142,66,16.7,No,2013,No,No,No
Max Landis,1477,287,1133,466,340,276,3730.0,721,269,184.0,412,197,20.4,No,2013,No,No,No
Jerome Hill,1292,122,907,440,643,406,2703.0,40,6,200.0,867,434,26.5,No,2013,No,No,No
Tyler Strange,927,651,825,319,180,117,3921.0,499,172,269.0,326,147,15.4,No,2013,No,No,No
Onzie Branch,292,51,233,111,104,70,1013.0,12,0,64.0,221,111,17.6,No,2013,No,No,No
Jarvis Davis,522,74,397,165,131,113,1449.0,222,79,96.0,175,86,19.5,No,2013,No,No,No
Corey Hensley,135,8,121,60,27,15,573.0,0,0,29.0,121,60,14.7,No,2013,No,No,No
Michael Byron,457,25,322,173,180,111,1797.0,0,0,110.0,322,173,14.8,No,2013,No,No,No
Isaiah Ivey,572,85,485,183,152,122,1889.0,239,84,66.0,246,99,16.2,No,2013,No,No,No
Adam Sweeney,13,4,23,5,2,2,62.0,10,1,3.0,13,4,22.1,No,2013,No,No,No
Sherrod Wright,1593,138,1132,529,566,428,3530.0,316,107,263.0,816,422,24.1,No,2013,No,No,No
Jonathan Arledge,821,68,662,296,273,198,1991.0,103,31,135.0,559,265,24.5,No,2013,No,No,No
Bryon Allen,1048,380,871,380,283,220,3082.0,216,68,239.0,655,312,20.7,No,2013,No,No,No
Erik Copes,420,29,353,175,138,70,1836.0,0,0,101.0,353,175,14.5,No,2013,No,No,No
Patrick Holloway,786,62,746,286,97,72,1912.0,395,142,91.0,351,144,23.7,No,2013,No,No,No
Marko Gujanicic,715,130,622,258,200,140,2326.0,205,59,162.0,417,199,19.2,No,2013,No,No,No
Corey Edwards,480,284,395,149,147,108,2316.0,206,74,207.0,189,75,14.9,No,2013,No,No,No
Vertrail Vaughns,848,97,693,280,220,170,2300.0,315,118,106.0,378,162,20.0,No,2013,No,No,No
Johnny Williams,468,44,426,190,152,88,1693.0,6,0,99.0,420,190,18.2,No,2013,No,No,No
Anali Okoloji,355,37,308,115,152,106,1185.0,82,19,73.0,226,96,19.6,No,2013,No,No,No
Paris Bennett,128,26,123,51,37,24,646.0,12,2,38.0,111,49,14.4,No,2013,No,No,No
Vaughn Gray,289,23,288,100,77,40,1074.0,148,49,42.0,140,51,17.5,No,2013,No,No,No
Michael Rudy,5,0,5,2,2,1,26.0,0,0,1.0,5,2,13.5,No,2013,No,No,No
Bryce Lewis,2,4,2,1,0,0,17.0,0,0,3.0,2,1,15.0,No,2013,No,No,No
Isaiah Armwood,923,118,670,331,387,256,2859.0,25,5,181.0,645,326,18.0,No,2013,No,No,No
Lasan Kromah,1256,240,1092,481,293,183,3303.0,347,111,254.0,745,370,22.8,No,2013,No,No,No
Patricio Garino,1550,221,1116,567,468,314,3877.0,280,102,289.0,836,465,21.3,Yes,2013,No,No,No
Kevin Larsen,1470,282,1093,559,497,328,4209.0,59,24,226.0,1034,535,18.8,No,2013,No,No,No
Joe McDonald,1154,447,930,378,465,305,3965.0,270,93,273.0,660,285,18.3,No,2013,No,No,No
Dwayne Smith,805,62,720,305,257,154,1940.0,127,41,146.0,593,264,25.7,No,2013,No,No,No
Bryan Bynes,569,182,561,184,200,145,2406.0,198,56,127.0,363,128,16.4,No,2013,No,No,No
Nemanja Mikic,742,70,690,258,70,37,2438.0,497,189,109.0,193,69,17.4,No,2013,No,No,No
Kethan Savage,982,191,736,322,404,290,2488.0,171,48,178.0,565,274,23.1,No,2013,No,No,No
John Kopriva,430,45,351,163,149,85,1909.0,43,19,79.0,308,144,13.6,No,2013,No,No,No
Paris Maragkos,268,31,231,111,54,36,611.0,26,10,68.0,205,101,30.0,No,2013,No,No,No
Jonathan Davis,9,1,9,4,2,1,44.0,1,0,3.0,8,4,15.0,No,2013,No,No,No
Otto Porter,822,135,588,293,241,181,2077.0,155,55,85.0,433,238,20.9,No,2013,No,No,No
Markel Starks,1246,300,1026,438,252,205,3361.0,459,165,201.0,567,273,21.7,No,2013,No,No,No
D'Vauntes Smith-Rivera,1919,386,1419,600,565,469,4257.0,691,250,215.0,728,350,23.6,No,2013,No,No,No
Nate Lubick,640,252,460,260,196,113,3009.0,32,7,169.0,428,253,13.1,No,2013,No,No,No
Mikael Hopkins,629,129,503,213,313,200,2268.0,12,3,196.0,491,210,20.2,No,2013,No,No,No
Jabril Trawick,851,205,579,270,334,237,2884.0,221,74,176.0,358,196,17.1,No,2013,No,No,No
Greg Whittington,299,55,257,109,71,44,1120.0,111,37,63.0,146,72,17.4,No,2013,No,No,No
Aaron Bowen,451,66,375,181,124,61,1410.0,110,28,91.0,265,153,19.9,No,2013,No,No,No
Moses Abraham,141,25,99,52,79,37,919.0,0,0,62.0,99,52,11.8,No,2013,No,No,No
Stephen Domingo,153,46,202,52,54,22,935.0,134,27,21.0,68,25,13.8,No,2013,No,No,No
John Caprio,29,15,30,10,22,9,154.0,3,0,17.0,27,10,20.2,No,2013,No,No,No
David Allen,8,1,8,2,5,2,42.0,7,2,2.0,1,0,15.8,No,2013,No,No,No
Brandon Bolden,38,3,25,15,17,8,138.0,0,0,14.0,25,15,17.6,No,2013,No,No,No
Bradley Hayes,372,56,290,155,118,62,1066.0,0,0,81.0,290,155,20.4,No,2013,No,No,No
Eric Ferguson,1482,115,1117,556,499,318,3225.0,178,52,277.0,939,504,26.6,No,2013,No,No,No
Clifford Reed,2080,553,1869,685,643,501,4917.0,673,209,411.0,1196,476,28.3,No,2013,No,No,No
Tre Bussey,1206,138,1038,429,285,193,3303.0,426,155,176.0,612,274,21.4,No,2013,No,No,No
Cleon Roberts,1184,140,945,368,334,253,3666.0,524,195,175.0,421,173,18.6,No,2013,No,No,No
Cameron Baskerville,495,41,399,176,170,128,2212.0,54,15,165.0,345,161,15.1,No,2013,No,No,No
Marvin Baynham,580,49,396,221,249,138,2611.0,0,0,173.0,396,221,13.8,No,2013,No,No,No
Brian Holmes,435,132,353,140,133,94,1603.0,171,61,112.0,182,79,17.2,No,2013,No,No,No
Kameron Dunnican,84,13,67,36,28,12,594.0,0,0,44.0,67,36,11.2,No,2013,No,No,No
Sam Mike,110,3,87,45,40,20,781.0,0,0,41.0,87,45,9.8,No,2013,No,No,No
Jessie Pernell,109,22,106,40,12,9,553.0,61,20,25.0,45,20,13.2,No,2013,No,No,No
Chris Daniels,18,6,24,8,6,2,151.0,0,0,16.0,24,8,15.5,No,2013,No,No,No
Cole Rives,8,1,11,2,4,2,36.0,8,2,1.0,3,0,20.4,No,2013,No,No,No
Tracy Ham,0,1,3,0,2,0,19.0,1,0,3.0,2,0,19.6,No,2013,No,No,No
R.J. Hunter,1819,240,1321,559,525,448,3438.0,715,253,168.0,606,306,27.5,No,2013,No,No,No
Devonta White,1393,415,1120,465,431,336,3721.0,388,127,255.0,732,338,22.6,No,2013,No,No,No
Manny Atkins,1140,138,841,375,290,234,2885.0,381,156,141.0,460,219,20.8,No,2013,No,No,No
Rashaad Richardson,497,53,473,186,37,24,1687.0,295,101,52.0,178,85,17.1,No,2013,No,No,No
James Vincent,387,19,304,156,130,75,1536.0,0,0,93.0,304,156,15.8,No,2013,No,No,No
Markus Crider,824,132,598,330,249,164,3069.0,7,0,158.0,591,330,15.5,No,2013,No,No,No
Cameron Solomon,109,8,87,39,46,30,227.0,7,1,13.0,80,38,28.7,No,2013,No,No,No
David Travers,59,24,52,20,14,8,250.0,27,11,14.0,25,9,15.7,No,2013,No,No,No
Denny Burguillos,40,2,33,16,17,8,339.0,0,0,13.0,33,16,8.6,No,2013,No,No,No
T.J. Shipes,355,18,247,144,142,67,1809.0,0,0,71.0,247,144,11.6,No,2013,No,No,No
LaRon Smith,314,25,242,137,107,40,1220.0,0,0,61.0,242,137,14.2,No,2013,No,No,No
Kevin Shaw,23,4,24,7,4,2,56.0,22,7,4.0,2,0,28.4,No,2013,No,No,No
Ryann Green,141,60,119,43,50,36,931.0,74,19,34.0,45,24,10.4,No,2013,No,No,No
Tyler Gamble,6,1,7,3,0,0,19.0,1,0,1.0,6,3,22.0,No,2013,No,No,No
Marcus Georges-Hunt,1728,287,1314,569,625,468,4017.0,371,122,220.0,943,447,23.3,Yes,2013,No,No,No
Robert Carter,1012,123,792,391,252,172,2383.0,195,58,170.0,597,333,23.6,No,2013,No,No,No
Kammeon Holsey,912,95,677,373,282,166,2473.0,0,0,207.0,677,373,21.4,No,2013,No,No,No
Daniel Miller,1007,183,803,423,257,161,3627.0,1,0,186.0,802,423,15.9,No,2013,No,No,No
Mfon Udofia,977,283,875,329,322,202,3251.0,367,117,240.0,508,212,19.8,No,2013,No,No,No
Chris Bolden,560,102,591,209,67,45,1997.0,312,97,100.0,279,112,18.7,No,2013,No,No,No
Brandon Reed,1168,216,1062,400,287,204,3121.0,493,164,191.0,569,236,23.0,No,2013,No,No,No
Jason Morris,515,60,507,185,115,79,1651.0,196,66,123.0,311,119,21.5,No,2013,No,No,No
Julian Royal,244,25,244,95,56,40,892.0,57,14,63.0,187,81,19.6,No,2013,No,No,No
Solomon Poole,591,140,622,220,90,54,1608.0,313,97,184.0,309,123,28.0,No,2013,No,No,No
Stacey Poole,113,17,113,39,46,29,373.0,28,6,22.0,85,33,21.9,No,2013,No,No,No
Pierre Jordan,85,53,115,35,9,6,692.0,46,9,49.0,69,26,12.5,No,2013,No,No,No
Brooks Doyle,12,3,15,4,4,2,72.0,10,2,3.0,5,2,14.3,No,2013,No,No,No
Aaron Peek,2,0,6,1,0,0,27.0,2,0,2.0,4,1,15.5,No,2013,No,No,No
Kentavious Caldwell-Pope,1013,96,814,338,250,188,2114.0,439,149,100.0,375,189,27.0,Yes,2013,No,No,No
Nemanja Djurisic,1123,147,910,399,312,219,3188.0,291,106,238.0,619,293,21.9,No,2013,No,No,No
Charles Mann,1411,400,925,365,895,618,3645.0,192,63,399.0,733,302,25.1,No,2013,No,No,No
Vincent Williams,304,164,285,99,93,57,1424.0,146,49,109.0,139,50,16.7,No,2013,No,No,No
Donte Williams,588,44,476,225,243,137,2409.0,2,1,86.0,474,224,15.3,No,2013,No,No,No
Brandon Morris,398,67,270,124,220,140,1309.0,33,10,89.0,237,114,18.8,No,2013,No,No,No
Kenny Gaines,1324,125,1091,444,302,223,3138.0,569,213,154.0,522,231,23.0,No,2013,No,No,No
Sherrard Brantley,247,65,259,81,28,19,1255.0,209,66,54.0,50,15,14.1,No,2013,No,No,No
John Florveus,128,18,120,54,43,20,903.0,0,0,50.0,120,54,11.7,No,2013,No,No,No
John Cannon,172,7,140,73,34,26,480.0,2,0,30.0,138,73,20.5,No,2013,No,No,No
Tim Dixon,91,21,89,38,24,15,728.0,0,0,34.0,89,38,10.0,No,2013,No,No,No
Marcus Thornton,829,91,687,289,361,230,2885.0,72,21,165.0,615,268,18.9,Yes,2013,No,No,No
Taylor Echols,68,12,65,22,8,2,288.0,62,22,21.0,3,0,16.4,No,2013,No,No,No
Kelly Olynyk,903,107,569,338,285,202,1735.0,75,25,140.0,494,313,24.9,Yes,2013,No,No,No
Elias Harris,1857,177,1289,666,618,447,3785.0,219,78,242.0,1070,588,24.6,Yes,2013,No,No,No
Kevin Pangos,1824,536,1306,566,439,370,4689.0,776,322,222.0,530,244,19.3,No,2013,No,No,No
Gary Bell Jr.,1291,265,968,433,274,206,3823.0,536,219,162.0,432,214,17.2,No,2013,No,No,No
Sam Dower,1271,79,872,490,340,271,2552.0,61,20,152.0,811,470,23.9,No,2013,No,No,No
Przemek Karnowski,1495,165,1033,615,511,264,3212.0,3,1,245.0,1030,614,24.3,No,2013,No,No,No
David Stockton,661,423,526,223,207,145,2741.0,229,70,202.0,297,153,15.5,Yes,2013,No,No,No
Kyle Dranginis,703,298,548,255,153,98,2960.0,267,95,141.0,281,160,13.3,No,2013,No,No,No
Guy Edi,231,32,179,76,105,62,764.0,59,17,42.0,120,59,18.4,No,2013,No,No,No
Drew Barham,410,38,328,136,52,32,1161.0,257,106,39.0,71,30,17.2,No,2013,No,No,No
Mike Hart,154,68,114,51,50,34,1217.0,49,18,30.0,65,33,7.1,No,2013,No,No,No
Rem Bakamus,19,6,17,4,13,8,97.0,15,3,5.0,2,1,14.9,No,2013,No,No,No
Brian Bhaskar,9,1,8,3,4,1,32.0,3,2,1.0,5,1,17.6,No,2013,No,No,No
Terry Rose,619,46,546,217,63,48,1601.0,376,140,93.0,170,77,21.8,No,2013,No,No,No
"Peter ""PJ"" Roberson",479,29,522,197,136,84,1989.0,6,1,98.0,516,196,17.9,No,2013,No,No,No
Demetri Wheeler,188,26,193,81,44,25,1038.0,12,1,52.0,181,80,13.6,No,2013,No,No,No
Bryant Purvis,216,33,279,84,44,27,1097.0,96,21,42.0,183,63,17.5,No,2013,No,No,No
Brandon Dorsett,238,71,243,81,83,56,937.0,75,20,87.0,168,61,20.8,No,2013,No,No,No
Steven Danridge,309,30,255,126,126,57,1746.0,1,0,111.0,254,126,12.6,No,2013,No,No,No
Roman Higgins,131,12,153,46,39,28,517.0,48,11,60.0,105,35,23.7,No,2013,No,No,No
Will Hornsby,77,48,97,26,34,18,440.0,46,7,57.0,51,19,20.6,No,2013,No,No,No
David Copeland,146,101,122,46,75,50,985.0,19,4,87.0,103,42,13.2,No,2013,No,No,No
Carl Cobbins,65,10,71,25,22,10,236.0,21,5,19.0,50,20,22.7,No,2013,No,No,No
Derron Hobbs,194,70,199,53,91,66,745.0,82,22,103.0,117,31,23.8,No,2013,No,No,No
Brauhnye' Turner,33,5,52,14,16,5,195.0,2,0,9.0,50,14,18.7,No,2013,No,No,No
Justin Dobbs,15,0,17,6,0,0,39.0,7,3,7.0,10,3,32.9,No,2013,No,No,No
Eric Garcia,7,2,9,2,2,1,42.0,5,2,7.0,4,0,21.6,No,2013,No,No,No
Keifer Sykes,2096,522,1570,713,712,557,4236.0,346,113,286.0,1224,600,27.0,No,2013,No,No,No
Alec Brown,1678,111,1299,604,524,392,3693.0,195,78,263.0,1104,526,25.5,No,2013,No,No,No
Brennan Cougill,668,123,525,249,146,113,1902.0,182,57,158.0,343,192,21.1,No,2013,No,No,No
Jordan Fouse,1136,397,924,421,396,242,4171.0,187,52,248.0,737,369,16.1,No,2013,No,No,No
Greg Mays,989,69,735,387,308,198,2608.0,63,17,158.0,672,370,20.7,No,2013,No,No,No
Sultan Muhammad,197,44,157,63,34,27,798.0,118,44,36.0,39,19,14.0,No,2013,No,No,No
Ken Cerroni,411,68,308,120,83,74,1380.0,253,97,60.0,55,23,15.5,No,2013,No,No,No
Carrington Love,1289,356,1052,421,444,287,3575.0,502,160,205.0,550,261,20.0,No,2013,No,No,No
Cole Stefan,295,70,277,96,46,35,1026.0,197,68,47.0,80,28,16.8,No,2013,No,No,No
Daniel Turner,292,49,232,95,135,91,1199.0,50,11,89.0,182,84,16.6,No,2013,No,No,No
Nick Arenz,13,2,10,4,6,5,96.0,3,0,3.0,7,4,8.8,No,2013,No,No,No
Deron Powers,1497,561,1196,469,517,425,4199.0,426,134,331.0,770,335,20.6,No,2013,No,No,No
Du'Vaughn Maxwell,965,87,741,379,384,202,2481.0,24,5,165.0,717,374,21.3,No,2013,No,No,No
Emmanuel Okoroba,565,33,452,188,313,189,1736.0,0,0,150.0,452,188,21.0,No,2013,No,No,No
Ramon Mercado,402,49,378,131,82,63,1161.0,258,77,69.0,120,54,20.3,No,2013,No,No,No
Dwight Meikle,738,56,585,288,197,138,1836.0,82,24,184.0,503,264,22.9,No,2013,No,No,No
Ke'Ron Brown,454,128,448,151,234,131,2155.0,128,21,156.0,320,130,16.1,No,2013,No,No,No
Jasper Williams,440,158,460,130,123,82,1783.0,336,98,155.0,124,32,18.4,No,2013,No,No,No
Wesley Dunning,273,23,237,103,80,52,1301.0,52,15,71.0,185,88,13.3,No,2013,No,No,No
David Bruce,350,11,283,139,113,72,867.0,0,0,73.0,283,139,23.5,No,2013,No,No,No
Aaron Austin,127,72,133,44,60,32,727.0,32,7,71.0,101,37,15.7,No,2013,No,No,No
Dionte Adams,226,29,191,86,85,54,1027.0,3,0,48.0,188,86,12.9,No,2013,No,No,No
Reggie Price,55,3,69,21,4,1,198.0,44,12,11.0,25,9,20.0,No,2013,No,No,No
Miles Jackson,30,7,20,11,7,4,127.0,8,4,7.0,12,7,11.4,No,2013,No,No,No
Mark Nwakamma,1550,203,1174,598,477,315,3235.0,120,39,342.0,1054,559,29.9,No,2013,No,No,No
Yolonzo Moore II,1078,289,846,349,340,250,3945.0,403,130,255.0,443,219,17.8,No,2013,No,No,No
Evan Cooper,634,135,486,199,162,125,2020.0,297,111,116.0,189,88,18.4,No,2013,No,No,No
Nate Sikma,752,228,703,265,148,103,2663.0,409,119,205.0,294,146,20.3,No,2013,No,No,No
Wes Cole,845,85,789,284,77,58,2300.0,612,219,108.0,177,65,22.6,No,2013,No,No,No
John Peterson,436,57,323,139,114,83,1545.0,207,75,65.0,116,64,16.6,No,2013,No,No,No
Jamie Schneck,250,48,200,104,95,42,1321.0,0,0,76.0,200,104,13.5,No,2013,No,No,No
Corban Wroe,641,181,475,228,137,103,2772.0,221,82,153.0,254,146,13.9,No,2013,No,No,No
Taylor Dyson,773,56,670,244,144,118,1968.0,460,167,90.0,210,77,23.1,No,2013,No,No,No
Oren Faulk,220,58,180,84,99,52,945.0,6,0,82.0,174,84,18.2,No,2013,No,No,No
Parker U'u,47,11,57,15,9,7,241.0,42,10,24.0,15,5,19.4,No,2013,No,No,No
Glenn Akerland,0,0,0,0,0,0,3.0,0,0,0.0,0,0,0.0,No,2013,No,No,No
Jeremiah Aska,2,1,3,0,3,2,24.0,3,0,1.0,0,0,12.7,No,2013,No,No,No
Antoine Burrell,0,0,0,0,1,0,6.0,0,0,0.0,0,0,4.4,No,2013,No,No,No
Wesley Saunders,1511,383,1032,496,620,468,3580.0,127,51,273.0,905,445,24.7,No,2013,No,No,No
Siyani Chambers,1287,601,1016,393,430,342,4140.0,432,159,300.0,584,234,20.0,No,2013,No,No,No
Laurent Rivard,1270,95,872,377,276,229,3694.0,700,287,106.0,172,90,16.7,No,2013,No,No,No
Christian Webster,1016,161,797,314,254,212,3129.0,479,176,200.0,318,138,19.6,No,2013,No,No,No
Steve Moundou-Missi,1010,67,732,372,361,260,2749.0,18,6,151.0,714,366,21.3,No,2013,No,No,No
Jonah Travis,529,42,319,175,249,179,1492.0,1,0,85.0,318,175,19.5,No,2013,No,No,No
Kenyatta Smith,264,12,188,107,75,50,719.0,0,0,65.0,188,107,22.6,No,2013,No,No,No
Agunwa Okolie,530,101,392,208,187,107,1997.0,26,7,109.0,366,201,15.7,No,2013,No,No,No
Michael Hall,7,1,6,3,4,1,24.0,0,0,5.0,6,3,30.2,No,2013,No,No,No
Alex Nesbitt,11,8,11,3,9,5,126.0,3,0,5.0,8,3,8.9,No,2013,No,No,No
Evan Cummins,323,88,232,137,86,49,1269.0,0,0,77.0,232,137,14.5,No,2013,No,No,No
Jeff Georgatos,39,1,42,17,8,4,265.0,4,1,9.0,38,16,11.2,No,2013,No,No,No
Tom Hamel,0,0,1,0,0,0,11.0,0,0,2.0,1,0,15.0,No,2013,No,No,No
Christian Standhardinger,1250,106,866,417,527,382,2304.0,113,34,170.0,753,383,27.7,No,2013,No,No,No
Vander Joaquim,1205,85,880,456,405,280,2658.0,35,13,197.0,845,443,23.5,No,2013,No,No,No
Isaac Fotu,785,53,514,308,239,168,1757.0,11,1,102.0,503,307,20.3,No,2013,No,No,No
Hauns Brereton,613,57,519,225,115,89,1580.0,220,74,82.0,299,151,20.3,No,2013,No,No,No
Brandon Spearman,667,91,562,233,181,116,1925.0,246,85,86.0,316,148,18.7,No,2013,No,No,No
Brandon Jawato,178,16,153,59,28,14,542.0,119,46,24.0,34,13,17.1,No,2013,No,No,No
Jace Tavita,152,262,165,54,29,11,1644.0,106,33,139.0,59,21,9.8,No,2013,No,No,No
Manroop Clair,378,55,340,118,61,46,1118.0,281,96,68.0,59,22,20.0,No,2013,No,No,No
Ozren Pavlovic,60,8,63,17,19,17,195.0,36,9,21.0,27,8,23.3,No,2013,No,No,No
Davis Rozitis,262,21,178,105,84,52,905.0,0,0,44.0,178,105,14.1,No,2013,No,No,No
Garrett Jefferson,149,42,119,46,114,56,656.0,14,1,49.0,105,45,16.5,No,2013,No,No,No
Michael Harper,12,1,11,4,2,1,70.0,7,3,5.0,4,1,11.8,No,2013,No,No,No
John Brown,2229,180,1550,858,712,512,3535.0,12,1,187.0,1538,857,30.8,Yes,2013,No,No,No
Allan Chaney,581,54,425,221,164,129,1135.0,47,10,83.0,378,211,27.5,No,2013,No,No,No
Adam Weary,1258,297,940,449,386,289,2987.0,212,71,221.0,728,378,23.5,No,2013,No,No,No
Dejuan McGaughy,299,117,285,115,55,38,1105.0,78,31,77.0,207,84,17.9,No,2013,No,No,No
Corey Law,887,54,634,342,377,203,2371.0,6,0,135.0,628,342,19.9,No,2013,No,No,No
Derrell Edwards,263,108,266,91,75,54,1432.0,106,27,72.0,160,64,13.3,No,2013,No,No,No
Lorenzo Cugini,1045,140,838,390,117,92,3137.0,420,173,112.0,418,217,16.8,No,2013,No,No,No
Branimir Mikulic,272,41,220,90,37,30,1213.0,163,62,53.0,57,28,12.4,No,2013,No,No,No
Devante Wallace,973,137,779,334,158,121,2599.0,434,184,120.0,345,150,20.0,No,2013,No,No,No
Jairus Simms,301,260,302,116,62,38,1754.0,89,31,139.0,213,85,13.4,No,2013,No,No,No
Justin Cheek,212,35,201,68,62,47,843.0,96,29,47.0,105,39,16.9,No,2013,No,No,No
Haiishen McIntyre,401,226,324,130,176,128,1735.0,53,13,100.0,271,117,15.4,No,2013,No,No,No
Tre Duncan,21,5,20,8,10,4,71.0,7,1,8.0,13,7,23.9,No,2013,No,No,No
Landon Harris,26,2,20,12,2,1,120.0,6,1,1.0,14,11,9.5,No,2013,No,No,No
Quincy Drye,29,2,32,12,9,5,79.0,4,0,3.0,28,12,26.3,No,2013,No,No,No
Stevie Mejia,748,384,634,225,326,223,2786.0,222,75,234.0,412,150,19.6,No,2013,No,No,No
Taran Buie,435,57,456,144,131,87,1131.0,211,60,100.0,245,84,28.7,No,2013,No,No,No
David Imes,701,79,648,272,174,117,2796.0,150,40,118.0,498,232,15.7,No,2013,No,No,No
Moussa Kone,773,47,561,327,219,119,2475.0,0,0,110.0,561,327,15.9,No,2013,No,No,No
Stephen Nwaukoni,576,35,409,186,314,204,2284.0,0,0,140.0,409,186,15.8,No,2013,No,No,No
Jordan Allen,935,171,666,360,425,214,3018.0,6,1,193.0,660,359,17.4,No,2013,No,No,No
Jimmy Hall,1772,217,1381,708,480,345,3215.0,45,11,283.0,1336,697,29.4,No,2013,No,No,No
Shaquille Stokes,321,84,311,99,106,80,800.0,135,43,73.0,176,56,26.8,No,2013,No,No,No
Daquan Brown,135,8,119,54,47,27,450.0,0,0,30.0,119,54,20.0,No,2013,No,No,No
Matt Grogan,98,11,106,31,18,14,523.0,75,22,24.0,31,9,13.6,No,2013,No,No,No
Adam Savion,25,9,21,8,19,9,226.0,0,0,19.0,21,8,11.2,No,2013,No,No,No
Darren Payen,607,23,430,248,165,107,1591.0,24,4,102.0,406,244,19.9,No,2013,No,No,No
Dallas Anglin,319,60,231,95,121,99,738.0,95,30,65.0,136,65,24.1,No,2013,No,No,No
Kentrell Washington,17,5,20,6,8,5,116.0,4,0,7.0,16,6,13.7,No,2013,No,No,No
Jody Card,0,0,0,0,0,0,1.0,0,0,0.0,0,0,0.0,No,2013,No,No,No
George Davis III,2,1,2,1,0,0,11.0,1,0,2.0,1,1,19.5,No,2013,No,No,No
Dave Dudzinski,1366,66,1029,498,397,311,3048.0,182,59,162.0,847,439,24.5,No,2013,No,No,No
Justin Burrell,1143,414,1017,380,292,243,3439.0,406,140,253.0,611,240,22.3,No,2013,No,No,No
Phil Beans,470,37,388,167,93,76,1495.0,155,60,83.0,233,107,18.6,No,2013,No,No,No
Cullen Hamilton,827,125,784,289,167,128,2677.0,378,121,109.0,406,168,20.0,No,2013,No,No,No
Jordan Stevens,518,149,494,190,85,54,1997.0,242,84,105.0,252,106,17.1,No,2013,No,No,No
Malcolm Miller,1013,164,746,332,319,244,2917.0,284,105,175.0,462,227,20.1,Yes,2013,No,No,No
Eric Obeysekere,335,49,293,135,99,63,1549.0,12,2,85.0,281,133,14.5,No,2013,No,No,No
Dee Goens,289,148,246,93,111,81,1295.0,73,22,121.0,173,71,17.1,No,2013,No,No,No
Taylor Abt,271,13,231,111,70,30,1359.0,65,19,66.0,166,92,13.2,No,2013,No,No,No
Christopher Morgan,102,2,68,43,24,16,454.0,0,0,21.0,68,43,12.1,No,2013,No,No,No
De'Vaughn Reid,55,26,54,17,24,17,293.0,13,4,23.0,41,13,16.5,No,2013,No,No,No
Chris Jayne,3,1,3,1,4,1,22.0,1,0,2.0,2,1,17.3,No,2013,No,No,No
Isaiah Baker,7,2,8,2,10,3,72.0,0,0,5.0,8,2,13.5,No,2013,No,No,No
Patrick Kerrigan,3,0,1,1,0,0,25.0,1,1,1.0,0,0,4.3,No,2013,No,No,No
Art Bernardi,720,64,579,276,219,147,1420.0,62,21,121.0,517,255,27.2,No,2013,No,No,No
Rob Lewis,622,126,473,199,253,183,1363.0,122,41,136.0,351,158,26.4,No,2013,No,No,No
Marcel Smith,762,276,603,248,178,148,2739.0,311,118,168.0,292,130,15.1,No,2013,No,No,No
Caleb Crayton,635,102,546,225,204,136,2082.0,183,49,172.0,363,176,19.2,No,2013,No,No,No
Tyler Russell,914,162,844,342,222,175,2322.0,180,55,188.0,664,287,23.4,No,2013,No,No,No
Dauson Womack,277,46,230,96,135,83,1167.0,9,2,86.0,221,94,16.1,No,2013,No,No,No
Anthony Hill,584,196,587,188,114,83,2622.0,388,125,140.0,199,63,15.0,No,2013,No,No,No
James Harper,133,17,121,46,41,28,408.0,50,13,35.0,71,33,21.2,No,2013,No,No,No
Cody Joyce,1048,71,778,400,392,248,2756.0,1,0,164.0,777,400,21.3,No,2013,No,No,No
Marcus Davis,422,52,340,141,117,98,957.0,115,42,97.0,225,99,23.8,No,2013,No,No,No
Dewayne Bowden,50,9,47,16,24,16,167.0,9,2,20.0,38,14,22.6,No,2013,No,No,No
Spenser Gales,30,4,24,12,9,6,133.0,1,0,12.0,23,12,14.9,No,2013,No,No,No
Lamar Thomas,142,11,155,61,48,20,946.0,2,0,43.0,153,61,11.0,No,2013,No,No,No
Jon Evans,222,113,210,66,71,50,1193.0,132,40,98.0,78,26,13.2,No,2013,No,No,No
Mike Turner,87,7,70,29,11,7,189.0,54,22,13.0,16,7,22.9,No,2013,No,No,No
Joe Young,2304,351,1718,778,519,460,4333.0,739,288,221.0,979,490,25.3,Yes,2013,No,No,No
TaShawn Thomas,1793,226,1318,737,510,317,4001.0,20,2,258.0,1298,735,22.8,No,2013,No,No,No
Danuel House,1683,238,1315,547,554,387,3587.0,598,202,228.0,717,345,25.4,No,2013,No,No,No
Jherrod Stiggers,1077,142,928,351,183,132,2571.0,679,243,167.0,249,108,23.5,No,2013,No,No,No
Leon Gibson,310,28,237,115,113,75,857.0,13,5,50.0,224,110,19.7,No,2013,No,No,No
J.J. Thompson,771,373,682,266,237,165,2845.0,218,74,238.0,464,192,18.3,No,2013,No,No,No
Tione Womack,207,150,186,79,48,30,1240.0,54,19,75.0,132,60,11.5,No,2013,No,No,No
Brandon Morris,293,81,234,98,53,45,1055.0,126,52,50.0,108,46,14.8,No,2013,No,No,No
J.J. Richardson,216,18,167,86,76,44,696.0,1,0,58.0,166,86,19.0,No,2013,No,No,No
Mikhail McLean,245,25,183,87,130,71,1125.0,3,0,58.0,180,87,13.7,No,2013,No,No,No
Valentine Izundu,202,13,130,84,84,34,1034.0,0,0,39.0,130,84,10.3,No,2013,No,No,No
LeRon Barnes,553,96,472,202,130,85,2411.0,181,64,83.0,291,138,13.1,No,2013,No,No,No
Jimmie Jones,28,28,21,11,6,3,223.0,11,3,20.0,10,8,9.9,No,2013,No,No,No
Lawrence Paye,3,0,6,1,1,1,11.0,4,0,1.0,2,1,33.9,No,2013,No,No,No
Donald Brooks,2,1,2,1,0,0,18.0,0,0,1.0,2,1,8.2,No,2013,No,No,No
Mike Phillips,1193,95,1040,427,502,335,3527.0,23,4,268.0,1017,423,22.7,No,2013,No,No,No
Simuel Frazier,496,212,437,161,195,128,1707.0,155,46,207.0,282,115,22.4,No,2013,No,No,No
Prince Okoroh,936,89,853,332,378,247,2745.0,98,25,214.0,755,307,23.3,No,2013,No,No,No
Anton Dickerson,629,60,608,209,129,91,1626.0,374,120,104.0,234,89,24.6,No,2013,No,No,No
Calvin Thompson,860,146,775,272,370,265,2231.0,183,51,201.0,592,221,26.9,No,2013,No,No,No
Alphonso Leary,551,25,437,191,273,169,2349.0,0,0,143.0,437,191,15.5,No,2013,No,No,No
Tre Lee,248,51,250,80,90,61,1066.0,113,27,83.0,137,53,18.5,No,2013,No,No,No
Brandon Ford,231,44,209,77,95,68,946.0,49,9,58.0,160,68,17.2,No,2013,No,No,No
Theodore Boyomo,92,10,64,36,39,20,744.0,0,0,42.0,64,36,8.7,No,2013,No,No,No
Oliver Ellison,265,23,184,104,116,57,1861.0,0,0,75.0,184,104,8.6,No,2013,No,No,No
Anthony Smith,2,0,3,1,1,0,14.0,0,0,0.0,3,1,13.4,No,2013,No,No,No
Emmanuel Okoro,3,0,6,1,5,1,78.0,1,0,3.0,5,1,7.8,No,2013,No,No,No
Faret Estriplet,0,0,1,0,0,0,3.0,1,0,0.0,0,0,18.0,No,2013,No,No,No
Melvin Morgan,728,156,668,248,173,133,1909.0,298,99,185.0,370,149,27.2,No,2013,No,No,No
Chris Hansen,1355,157,1027,411,376,304,2962.0,595,229,141.0,432,182,24.9,No,2013,No,No,No
Tomas Sanchez,743,237,539,219,256,213,2069.0,255,92,170.0,284,127,22.1,No,2013,No,No,No
Andre Hatchett,930,173,777,321,451,263,2866.0,101,25,162.0,676,296,21.8,No,2013,No,No,No
Neveij Walters,154,7,130,65,50,24,568.0,0,0,36.0,130,65,19.6,No,2013,No,No,No
Sherrod Baldwin,305,73,314,118,60,40,1359.0,79,29,78.0,235,89,16.9,No,2013,No,No,No
Nnamdi Ezenwa,351,66,264,113,140,89,1495.0,88,36,79.0,176,77,15.2,No,2013,No,No,No
Avibakuro Preh,155,19,93,64,48,27,1183.0,0,0,40.0,93,64,7.2,No,2013,No,No,No
Jakub Kusmieruk,182,5,118,66,93,50,538.0,0,0,32.0,118,66,19.2,No,2013,No,No,No
Nick Mason,102,17,127,36,9,8,597.0,92,22,17.0,35,14,13.6,No,2013,No,No,No
Dejan Kostur,97,6,93,40,22,14,406.0,10,3,33.0,83,37,18.0,No,2013,No,No,No
Andy Harrington,0,1,0,0,0,0,2.0,0,0,0.0,0,0,0.0,No,2013,No,No,No
Brian Hosman,0,0,0,0,0,0,4.0,0,0,1.0,0,0,14.6,No,2013,No,No,No
Grant Jones,0,0,1,0,0,0,1.0,0,0,0.0,1,0,58.6,No,2013,No,No,No
Kyle Barone,1431,147,898,525,536,381,3424.0,3,0,237.0,895,525,21.8,No,2013,No,No,No
Stephen Madison,1626,238,1173,544,537,403,3418.0,400,135,258.0,773,409,26.3,No,2013,No,No,No
Connor Hill,1506,111,1152,503,201,160,3305.0,800,340,110.0,352,163,21.6,No,2013,No,No,No
Mike McChristian,320,108,254,121,51,35,1153.0,114,43,59.0,140,78,16.0,No,2013,No,No,No
Mansa Habeeb,267,65,186,83,136,94,934.0,38,7,92.0,148,76,20.0,No,2013,No,No,No
Robert Harris,112,42,112,44,16,8,421.0,41,16,43.0,71,28,21.2,No,2013,No,No,No
Denzel Douglas,59,47,50,20,15,12,358.0,23,7,34.0,27,13,13.9,No,2013,No,No,No
Wendell Faines,90,10,80,35,32,20,456.0,0,0,36.0,80,35,15.7,No,2013,No,No,No
Joe Kammerer,156,19,144,71,27,14,1095.0,2,0,48.0,142,71,9.9,No,2013,No,No,No
Marcus Bell,36,2,39,17,8,2,160.0,0,0,11.0,39,17,18.4,No,2013,No,No,No
Matt Borton,102,35,97,35,22,11,476.0,66,21,25.0,31,14,15.1,No,2013,No,No,No
Westin Hill,2,0,4,1,0,0,6.0,3,0,0.0,1,1,36.5,No,2013,No,No,No
Max Salesky,2,0,1,1,0,0,2.0,0,0,0.0,1,1,27.4,No,2013,No,No,No
Antwan Scott,939,168,693,298,254,199,1879.0,356,144,152.0,337,154,25.4,No,2013,No,No,No
Gary Talton,768,250,664,251,237,205,2092.0,208,61,175.0,456,190,24.4,No,2013,No,No,No
Daniel Barnes,731,80,658,248,128,86,2096.0,426,149,121.0,232,99,21.3,No,2013,No,No,No
Josh Crittle,652,96,513,228,286,196,2082.0,5,0,159.0,508,228,20.5,No,2013,No,No,No
Hayden Humes,970,131,774,338,216,162,3608.0,347,132,161.0,427,206,15.4,No,2013,No,No,No
Marc Brown,1022,158,842,300,415,323,3427.0,311,99,188.0,531,201,18.9,No,2013,No,No,No
Joey Miller,445,115,397,130,162,127,1345.0,190,58,109.0,207,72,23.3,No,2013,No,No,No
Anthony Kelley,103,26,103,36,22,16,519.0,52,15,38.0,51,21,15.6,No,2013,No,No,No
Will Simonton,182,25,183,75,59,31,977.0,3,1,54.0,180,74,14.1,No,2013,No,No,No
Jake Wiegand,687,27,535,239,278,200,1871.0,47,9,115.0,488,230,21.4,No,2013,No,No,No
Jay Parker,133,99,133,37,69,53,674.0,40,6,73.0,93,31,18.7,No,2013,No,No,No
Ahman Fells,331,22,272,134,54,30,1126.0,95,33,42.0,177,101,15.9,No,2013,No,No,No
Gabe Snider,289,38,271,102,13,7,890.0,200,78,32.0,71,24,17.5,No,2013,No,No,No
Ngijol Songolo,3,0,5,1,0,0,12.0,4,1,0.0,1,0,22.7,No,2013,No,No,No
Tyler Brown,1046,165,748,334,274,219,1999.0,379,159,180.0,369,175,27.7,No,2013,No,No,No
Jackie Carmichael,1580,88,1113,575,619,426,3273.0,18,4,241.0,1095,571,26.6,No,2013,No,No,No
Bryant Allen,474,83,445,170,59,46,1445.0,252,88,59.0,193,82,19.1,No,2013,No,No,No
Johnny Hill,697,271,468,231,290,217,2225.0,68,18,183.0,400,213,17.8,No,2013,No,No,No
John Wilkins,670,61,500,219,192,148,2053.0,243,84,95.0,257,135,17.9,No,2013,No,No,No
Jon Ekey,925,131,777,336,108,82,3359.0,468,171,89.0,309,165,14.7,No,2013,No,No,No
Nick Zeisloft,801,101,613,259,80,67,2620.0,532,216,59.0,81,43,13.7,No,2013,No,No,No
Kaza Keane,311,233,304,111,112,61,1701.0,100,28,142.0,204,83,16.4,No,2013,No,No,No
Jordan Threloff,692,47,443,231,335,230,2013.0,0,0,122.0,443,231,18.9,No,2013,No,No,No
Zeke Upshaw,755,78,588,230,250,187,1583.0,327,108,112.0,261,122,26.7,No,2013,No,No,No
Anthony Cousin,394,168,348,124,131,97,1835.0,160,49,114.0,188,75,15.6,No,2013,No,No,No
Geoffrey Allen,65,18,60,26,18,7,262.0,22,6,20.0,38,20,17.1,No,2013,No,No,No
Matt Stacho,4,1,11,2,0,0,21.0,5,0,3.0,6,2,34.0,No,2013,No,No,No
Brandon Paul,1654,310,1356,521,554,401,3665.0,650,211,312.0,706,310,27.5,Yes,2013,No,No,No
D.J. Richardson,1477,251,1284,498,258,203,4351.0,782,278,193.0,502,220,19.2,No,2013,No,No,No
Tracy Abrams,1191,374,1041,399,369,272,3605.0,387,121,255.0,654,278,21.4,No,2013,No,No,No
Tyler Griffey,552,50,480,211,82,60,1719.0,211,70,78.0,269,141,18.1,No,2013,No,No,No
Joseph Bertrand,778,94,622,314,153,110,2366.0,116,40,140.0,506,274,18.7,No,2013,No,No,No
Nnanna Egwu,750,73,722,316,144,102,3246.0,62,16,134.0,660,300,15.1,No,2013,No,No,No
Sam McLaurin,809,117,556,325,286,158,3209.0,4,1,149.0,552,324,13.2,No,2013,No,No,No
Myke Henry,991,76,808,384,209,147,2344.0,228,76,178.0,580,308,23.9,Yes,2013,No,No,No
Mike La Tulip,279,50,200,78,75,64,963.0,155,59,28.0,45,19,13.6,No,2013,No,No,No
Mike Shaw,87,27,94,32,41,17,638.0,23,6,50.0,71,26,14.0,No,2013,No,No,No
Devin Langford,10,4,11,4,5,1,94.0,1,1,1.0,10,3,7.9,No,2013,No,No,No
Kevin Berardini,11,3,1,1,12,9,33.0,0,0,3.0,1,1,15.3,No,2013,No,No,No
Ibby Djimde,126,17,113,51,43,24,643.0,0,0,41.0,113,51,14.3,No,2013,No,No,No
Jake Odum,1568,603,1008,452,781,590,4199.0,230,74,326.0,778,378,21.9,No,2013,No,No,No
Manny Arop,977,104,805,355,227,165,2674.0,305,102,164.0,500,253,21.3,No,2013,No,No,No
R.J. Mahurin,696,39,541,230,197,136,1631.0,289,100,73.0,252,130,23.5,No,2013,No,No,No
Justin Gant,951,88,794,354,254,175,2797.0,187,68,149.0,607,286,20.4,No,2013,No,No,No
Dawon Cummings,546,138,458,185,129,95,1613.0,255,81,91.0,203,104,20.2,No,2013,No,No,No
Khristian Smith,1172,172,1014,415,376,266,3402.0,276,76,174.0,738,339,21.0,No,2013,No,No,No
Lucas Eitel,327,86,264,109,46,25,1489.0,209,84,54.0,55,25,12.3,No,2013,No,No,No
Devonte Brown,1170,281,824,339,623,431,3309.0,214,61,312.0,610,278,22.5,No,2013,No,No,No
Jake Kitchell,452,76,314,166,145,94,1766.0,66,26,95.0,248,140,14.5,No,2013,No,No,No
Brandon Burnett,149,22,139,48,49,38,619.0,70,15,44.0,69,33,17.3,No,2013,No,No,No
Rhett Smith,0,0,1,0,0,0,19.0,0,0,0.0,1,0,2.8,No,2013,No,No,No
Cody Zeller,1157,92,674,399,475,359,2087.0,2,0,141.0,672,399,25.4,Yes,2013,No,No,No
Victor Oladipo,1117,175,754,406,359,257,2558.0,142,48,203.0,612,358,22.7,Yes,2013,Yes,Yes,Yes
Christian Watford,1730,129,1293,531,616,504,3759.0,388,164,246.0,905,367,25.0,No,2013,No,No,No
Jordan Hulls,1318,365,952,444,205,176,3898.0,575,254,210.0,377,190,16.6,No,2013,No,No,No
Will Sheehey,1120,149,873,424,275,186,2875.0,251,86,171.0,622,338,20.7,No,2013,No,No,No
Yogi Ferrell,1986,633,1475,637,530,440,4496.0,681,272,312.0,794,365,22.7,Yes,2013,No,No,No
Remy Abell,769,145,555,251,236,178,2567.0,222,89,110.0,333,162,15.3,No,2013,No,No,No
Jeremy Hollowell,1202,145,988,411,353,270,2825.0,349,110,213.0,639,301,24.9,No,2013,No,No,No
Maurice Creek,841,108,664,280,178,135,1791.0,382,146,119.0,282,134,24.5,No,2013,No,No,No
Derek Elston,498,37,404,194,126,80,1485.0,80,30,91.0,324,164,19.1,No,2013,No,No,No
Hanner Mosquera-Perea,556,39,341,197,278,162,1611.0,1,0,99.0,340,197,17.6,No,2013,No,No,No
Austin Etherington,280,50,205,88,86,64,1200.0,120,40,66.0,85,48,13.2,No,2013,No,No,No
Jeff Howard,27,7,19,7,23,13,206.0,0,0,10.0,19,7,9.8,No,2013,No,No,No
Raphael Smith,6,0,6,2,2,2,30.0,1,0,5.0,5,2,20.3,No,2013,No,No,No
Peter Jurkin,462,7,312,170,145,115,1112.0,20,7,81.0,292,163,20.6,No,2013,No,No,No
Taylor Wayer,3,0,8,1,2,0,36.0,6,1,0.0,2,0,12.7,No,2013,No,No,No
MoMo Jones,1851,351,1488,651,483,405,3929.0,460,144,298.0,1028,507,25.5,No,2013,No,No,No
Sean Armand,1694,294,1244,566,279,214,3447.0,807,348,192.0,437,218,22.4,No,2013,No,No,No
David Laury,1465,222,1050,534,581,370,2930.0,72,27,213.0,978,507,26.0,No,2013,No,No,No
Tre Bowman,708,66,483,244,143,120,1757.0,250,100,55.0,233,144,17.1,No,2013,No,No,No
Taaj Ridley,482,45,383,191,133,94,1392.0,29,6,83.0,354,185,18.6,No,2013,No,No,No
Tavon Sledge,284,143,221,111,84,53,1150.0,28,9,70.0,193,102,14.2,No,2013,No,No,No
A.J. English,2004,510,1447,612,590,467,3855.0,836,313,330.0,611,299,26.3,Yes,2013,No,No,No
Curtis Dennis,565,68,483,198,107,81,1424.0,282,88,64.0,201,110,21.4,No,2013,No,No,No
Da'Shawn Gomez,117,85,107,36,23,16,589.0,84,29,27.0,23,7,12.1,No,2013,No,No,No
Nyandigsi Moikubo,44,10,34,19,15,3,198.0,4,3,12.0,30,16,13.1,No,2013,No,No,No
Shawn Jackson,124,3,100,49,42,26,406.0,0,0,27.0,100,49,18.8,No,2013,No,No,No
DeSean Anderson,4,1,4,1,2,2,21.0,0,0,3.0,4,1,18.5,No,2013,No,No,No
Spencer Boateng,0,1,1,0,0,0,2.0,0,0,0.0,1,0,24.4,No,2013,No,No,No
Will Clyburn,1036,104,737,329,360,275,2144.0,287,103,167.0,450,226,25.0,No,2013,No,No,No
Tyrus McGee,722,68,510,237,123,102,1516.0,334,146,49.0,176,91,20.3,No,2013,No,No,No
Georges Niang,2228,421,1697,849,448,342,4110.0,502,188,318.0,1195,661,26.9,Yes,2013,No,No,No
Melvin Ejim,1643,188,1198,596,491,359,3752.0,302,92,246.0,896,504,22.0,No,2013,No,No,No
Korie Lucious,792,434,744,265,128,98,2696.0,488,164,263.0,256,101,19.7,No,2013,No,No,No
Chris Babb,942,215,802,302,161,118,3448.0,613,220,102.0,189,82,14.5,Yes,2013,No,No,No
Percy Gibson,689,32,522,283,187,122,1545.0,5,1,78.0,517,282,21.4,No,2013,No,No,No
Anthony Booker,509,37,462,204,139,76,1616.0,88,25,107.0,374,179,20.3,No,2013,No,No,No
Bubu Palo,239,89,150,57,147,107,951.0,52,18,60.0,98,39,14.6,No,2013,No,No,No
Nazareth Mitrou-Long,1250,235,954,430,173,130,3206.0,685,260,154.0,269,170,18.6,No,2013,No,No,No
Kerwin Okoro,247,36,239,88,46,32,678.0,119,39,62.0,120,49,23.7,No,2013,No,No,No
Aaron Law,26,12,29,10,6,4,121.0,12,2,6.0,17,8,15.7,No,2013,No,No,No
Tyler Ellerman,9,0,10,4,4,1,43.0,0,0,1.0,10,4,14.6,No,2013,No,No,No
Austin McBeth,0,1,2,0,2,0,32.0,1,0,5.0,1,0,12.2,No,2013,No,No,No
Roy Devyn Marble,1694,397,1359,564,595,432,3749.0,396,134,232.0,963,430,24.8,No,2013,No,No,No
Aaron White,1859,190,1142,590,800,618,3939.0,217,61,211.0,925,529,22.1,No,2013,No,No,No
Mike Gesell,1072,557,973,384,290,210,3490.0,302,94,227.0,671,290,19.2,No,2013,No,No,No
Melsahn Basabe,1119,48,807,431,378,256,2731.0,2,1,180.0,805,430,21.3,No,2013,No,No,No
Zach McCabe,871,149,736,298,223,170,2472.0,312,105,174.0,424,193,20.5,No,2013,No,No,No
Eric May,859,183,768,318,191,127,3053.0,288,96,173.0,480,222,17.6,No,2013,No,No,No
Adam Woodbury,851,108,651,332,295,187,2718.0,0,0,173.0,651,332,17.8,No,2013,No,No,No
Anthony Clemmons,701,344,567,235,237,159,2654.0,209,72,180.0,358,163,16.2,No,2013,No,No,No
Josh Oglesby,633,154,615,211,84,65,2289.0,450,146,65.0,165,65,15.8,No,2013,No,No,No
Gabriel Olaseni,612,40,407,208,269,196,1672.0,0,0,89.0,407,208,18.8,No,2013,No,No,No
Patrick Ingram,240,75,193,84,102,60,912.0,33,12,77.0,160,72,17.8,No,2013,No,No,No
Darius Stokes,105,8,100,46,38,13,665.0,3,0,22.0,97,46,10.7,No,2013,No,No,No
Kyle Denning,31,8,24,12,2,2,100.0,17,5,5.0,7,7,15.0,No,2013,No,No,No
Christopher Rickert,6,1,6,3,2,0,22.0,0,0,0.0,6,3,15.9,No,2013,No,No,No
Frank Gaines,1841,114,1363,601,672,500,3287.0,429,139,219.0,934,462,29.8,No,2013,No,No,No
Luis Jacobo,1167,120,935,413,221,170,2806.0,452,171,174.0,483,242,22.4,No,2013,No,No,No
Demario Hines,471,59,354,186,178,99,1346.0,0,0,108.0,354,186,20.9,No,2013,No,No,No
Joseph Edwards,1020,218,771,386,264,156,3051.0,238,92,198.0,533,294,18.9,No,2013,No,No,No
Michael Kibiloski,671,73,538,234,85,63,1967.0,358,140,88.0,180,94,17.5,No,2013,No,No,No
Isaiah McCray,697,247,596,222,328,162,2672.0,268,91,161.0,328,131,18.0,No,2013,No,No,No
Joe Reed,1037,150,700,379,383,245,3241.0,113,34,136.0,587,345,16.3,No,2013,No,No,No
Pierre Bland,452,251,328,163,154,101,1907.0,61,25,124.0,267,138,14.3,No,2013,No,No,No
Kevin Harden,108,30,127,41,21,10,493.0,50,16,32.0,77,25,18.0,No,2013,No,No,No
Herbert Graham,84,9,65,29,11,7,195.0,51,19,13.0,14,10,22.5,No,2013,No,No,No
Michael Onuorah,2,0,1,1,2,0,8.0,0,0,2.0,1,1,25.1,No,2013,No,No,No
Mitchell Patton,938,55,744,376,260,181,2150.0,21,5,112.0,723,371,24.3,No,2013,No,No,No
Donovan Gibbs,735,91,584,307,145,92,2680.0,79,29,126.0,505,278,15.5,No,2013,No,No,No
Greg Rice,368,142,325,130,103,66,1328.0,118,42,113.0,207,88,19.7,No,2013,No,No,No
John Hart,434,70,394,158,58,43,1172.0,206,75,87.0,188,83,23.2,No,2013,No,No,No
Sean Esposito,536,123,493,181,49,42,1959.0,355,132,64.0,138,49,15.8,No,2013,No,No,No
Jordan Shanklin,192,53,182,64,40,27,791.0,108,37,39.0,74,27,16.3,No,2013,No,No,No
Lyonell Gaines,718,101,572,296,181,115,2419.0,46,11,103.0,526,285,16.0,No,2013,No,No,No
P.J. Hubert,293,49,259,97,31,25,919.0,200,74,41.0,59,23,18.4,No,2013,No,No,No
Ian Chiles,773,108,645,272,219,161,1911.0,196,68,115.0,449,204,23.7,No,2013,No,No,No
Nick Kitcoff,28,4,39,10,6,4,178.0,28,4,4.0,11,6,13.9,No,2013,No,No,No
Cameron Loepker,14,3,11,6,4,2,59.0,1,0,8.0,10,6,19.2,No,2013,No,No,No
Marcellus Barksdale,950,275,758,308,408,295,3544.0,161,39,228.0,597,269,17.4,No,2013,No,No,No
Kevin Rose,2,0,3,1,0,0,5.0,0,0,0.0,3,1,32.5,No,2013,No,No,No
Christian Williams,733,121,657,245,170,139,1746.0,315,104,123.0,342,141,25.4,No,2013,No,No,No
Kelsey Howard,850,46,709,290,234,169,1836.0,287,101,121.0,422,189,26.8,No,2013,No,No,No
Dundrecous Massey,638,106,532,196,224,158,1147.0,291,88,128.0,241,108,33.6,No,2013,No,No,No
Jeff Stubbs,422,76,335,132,163,136,1174.0,82,22,127.0,253,110,23.1,No,2013,No,No,No
Willie Readus,283,27,254,98,127,87,869.0,1,0,68.0,253,98,22.9,No,2013,No,No,No
Derrell Taylor,672,67,461,236,274,200,2464.0,2,0,135.0,459,236,15.0,No,2013,No,No,No
Sydney Coleman,217,19,181,81,94,55,1284.0,0,0,50.0,181,81,11.2,No,2013,No,No,No
Phillip Williams,390,95,405,145,119,75,1904.0,114,25,130.0,291,120,15.8,No,2013,No,No,No
Keeslee Stewart,167,57,215,60,34,19,792.0,92,28,65.0,123,32,19.8,No,2013,No,No,No
Raymond Gregory,214,9,178,78,117,58,900.0,1,0,77.0,177,78,17.7,No,2013,No,No,No
Jonathan Lewis,141,160,125,42,64,35,1594.0,59,22,93.0,66,20,8.1,No,2013,No,No,No
Kenneth Smith,18,2,17,5,9,6,49.0,13,2,3.0,4,3,25.0,No,2013,No,No,No
Kenny Demouchet,17,2,32,8,2,1,114.0,6,0,10.0,26,8,19.0,No,2013,No,No,No
Davon Jones,177,14,179,80,51,17,724.0,0,0,55.0,179,80,18.7,No,2013,No,No,No
Travis Ballard,7,0,8,2,3,1,73.0,4,2,3.0,4,0,9.1,No,2013,No,No,No
Kendall Deese,0,0,1,0,0,0,0.0,0,0,0.0,1,0,0,No,2013,No,No,No
Tarvin Gaines,781,35,547,251,276,225,1599.0,185,54,74.0,362,197,25.0,No,2013,No,No,No
Brian Williams,1267,368,1182,466,305,187,3645.0,461,148,209.0,721,318,22.5,No,2013,No,No,No
Ronnie Boggs,560,118,440,222,122,84,1869.0,97,32,98.0,343,190,16.9,No,2013,No,No,No
Darion Rackley,1326,201,945,361,646,480,2943.0,428,124,231.0,517,237,26.7,No,2013,No,No,No
Nick Cook,579,111,448,219,294,141,2396.0,3,0,130.0,445,219,16.0,No,2013,No,No,No
Rinaldo Mafra,212,17,152,78,98,56,817.0,0,0,46.0,152,78,15.8,No,2013,No,No,No
Mason Leggett,237,81,214,80,99,66,1137.0,36,11,87.0,178,69,16.1,No,2013,No,No,No
Rico Sanders,169,20,176,60,18,14,557.0,113,35,21.0,63,25,19.0,No,2013,No,No,No
Chris Deanes,34,9,22,12,19,10,164.0,1,0,12.0,21,12,14.2,No,2013,No,No,No
Alex Anderson,876,154,674,283,134,117,2488.0,469,193,104.0,205,90,17.9,No,2013,No,No,No
Mike Louder,48,0,39,19,8,7,137.0,5,3,4.0,34,16,18.3,No,2013,No,No,No
Giovanni Smith,52,9,47,15,10,8,255.0,39,14,5.0,8,1,11.9,No,2013,No,No,No
Gus Klaus,5,1,5,2,0,0,7.0,3,1,2.0,2,1,53.9,No,2013,No,No,No
Rod McReynolds,10,7,12,4,1,1,36.0,5,1,8.0,7,3,30.3,No,2013,No,No,No
Darrius Moore,2,2,2,0,2,2,27.0,0,0,1.0,2,0,7.9,No,2013,No,No,No
Keith McDougald,1192,158,1022,405,302,230,2548.0,461,152,217.0,561,253,26.6,No,2013,No,No,No
Jarvis Haywood,787,110,579,276,254,192,1582.0,114,43,157.0,465,233,26.4,No,2013,No,No,No
Glenn Powell,924,42,728,377,294,170,2751.0,0,0,201.0,728,377,19.2,No,2013,No,No,No
Dylan Fritsch,257,12,226,85,35,28,569.0,171,59,20.0,55,26,22.8,No,2013,No,No,No
Kordario Fleming,281,65,239,109,121,63,1068.0,3,0,85.0,236,109,17.6,No,2013,No,No,No
Javon Dawson,538,68,468,207,161,109,1813.0,46,15,119.0,422,192,18.4,No,2013,No,No,No
Russell Powell,778,384,708,261,285,212,3103.0,159,44,215.0,549,217,16.8,No,2013,No,No,No
Marcellous Bell,337,40,314,104,68,56,876.0,225,73,26.0,89,31,21.6,No,2013,No,No,No
Evin Graham,132,75,113,41,77,43,880.0,21,7,70.0,92,34,12.4,No,2013,No,No,No
Tyler Alderman,115,15,102,45,39,25,493.0,1,0,25.0,101,45,14.4,No,2013,No,No,No
Jeremy Bogus,113,10,128,38,14,11,406.0,96,26,14.0,32,12,18.2,No,2013,No,No,No
Chris Spurling,5,1,4,2,0,0,47.0,3,1,0.0,1,1,4.2,No,2013,No,No,No
Conner Coleman,0,1,0,0,0,0,6.0,0,0,0.0,0,0,0.0,No,2013,No,No,No
A.J. Davis,1242,120,933,422,375,270,2678.0,398,128,219.0,535,294,25.9,No,2013,No,No,No
Rayshawn Goins,725,48,630,264,275,181,1696.0,49,16,107.0,581,248,27.1,No,2013,No,No,No
Devon Moore,1317,501,934,441,491,375,4177.0,176,60,316.0,758,381,18.7,No,2013,No,No,No
Andre Nation,648,98,517,222,236,157,1756.0,177,47,89.0,340,175,22.1,No,2013,No,No,No
Ron Curry,1550,417,1222,493,518,373,4205.0,564,191,209.0,658,302,21.3,No,2013,No,No,No
Charles Cooke,1570,221,1166,506,568,399,3725.0,436,159,208.0,730,347,23.1,Yes,2013,No,No,No
Alioune Diouf,405,87,395,156,128,75,1778.0,71,18,119.0,324,138,17.0,No,2013,No,No,No
Taylor Bessick,462,32,398,193,125,76,1858.0,0,0,99.0,398,193,15.5,No,2013,No,No,No
Enoch Hood,385,25,320,160,122,65,1485.0,1,0,70.0,319,160,15.9,No,2013,No,No,No
Andrey Semenov,1203,170,945,393,319,249,3321.0,441,168,182.0,504,225,20.3,No,2013,No,No,No
Arman Marks,152,20,135,49,41,29,541.0,74,25,29.0,61,24,17.9,No,2013,No,No,No
Gene Swindle,94,9,76,35,40,24,552.0,0,0,32.0,76,35,12.0,No,2013,No,No,No
Rodney McGruder,1576,186,1257,568,332,252,3702.0,494,188,171.0,763,380,21.3,Yes,2013,No,No,No
Angel Rodriguez,1462,558,1193,449,488,373,3585.0,583,191,326.0,610,258,25.7,No,2013,No,No,No
Shane Southwell,741,271,669,269,156,108,2605.0,270,95,167.0,399,174,17.7,No,2013,No,No,No
Thomas Gipson,1232,70,844,450,497,332,2972.0,0,0,214.0,844,450,22.6,No,2013,No,No,No
Will Spradling,1027,331,810,309,281,227,3698.0,524,182,162.0,286,127,15.0,No,2013,No,No,No
Martavious Irving,530,171,485,190,113,71,2117.0,224,79,106.0,261,111,15.0,No,2013,No,No,No
Jordan Henriquez,589,55,454,227,270,135,1906.0,0,0,108.0,454,227,17.9,No,2013,No,No,No
Nino Williams,712,73,560,267,225,172,1835.0,23,6,92.0,537,261,21.8,No,2013,No,No,No
Adrian Diaz,1061,88,653,401,436,259,2418.0,0,0,190.0,653,401,22.8,No,2013,No,No,No
D.J. Johnson,864,30,551,327,323,210,2271.0,1,0,139.0,550,327,19.0,No,2013,No,No,No
Omari Lawrence,235,59,225,87,88,50,938.0,51,11,60.0,174,76,17.9,No,2013,No,No,No
Michael Orris,397,262,394,146,132,84,2275.0,104,21,162.0,290,125,13.9,No,2013,No,No,No
Ryan Schultz,17,5,23,5,8,5,61.0,14,2,6.0,9,3,27.7,No,2013,No,No,No
Shawn Meyer,11,2,12,4,11,3,43.0,1,0,3.0,11,4,24.3,No,2013,No,No,No
Ben McLemore,589,73,400,198,138,120,1191.0,174,73,77.0,226,125,23.2,Yes,2013,No,No,No
Jeff Withey,938,69,576,327,390,283,2319.0,1,1,138.0,575,326,19.7,Yes,2013,No,No,No
Travis Releford,965,190,645,346,275,191,2985.0,219,82,133.0,426,264,15.4,No,2013,No,No,No
Elijah Johnson,942,399,804,341,156,113,3045.0,430,147,233.0,374,194,18.4,No,2013,No,No,No
Kevin Young,1057,119,869,418,299,179,3264.0,164,42,203.0,705,376,18.8,No,2013,No,No,No
Perry Ellis,1798,148,1286,653,576,436,3604.0,130,56,174.0,1156,597,24.2,No,2013,No,No,No
Naadir Tharpe,521,304,457,175,104,87,1892.0,242,84,143.0,215,91,17.3,No,2013,No,No,No
Jamari Traylor,516,88,370,197,193,122,2122.0,0,0,159.0,370,197,14.7,No,2013,No,No,No
Andrew White III,1291,63,944,427,280,220,2514.0,550,217,127.0,394,210,24.4,Yes,2013,No,No,No
Rio Adams,27,6,25,10,13,5,83.0,5,2,11.0,20,8,25.9,No,2013,No,No,No
Evan Manning,26,5,22,9,2,1,108.0,18,7,9.0,4,2,14.9,No,2013,No,No,No
Justin Wesley,81,12,61,25,57,30,654.0,7,1,32.0,54,24,9.1,No,2013,No,No,No
Niko Roberts,8,7,20,2,10,4,84.0,11,0,8.0,9,2,19.6,No,2013,No,No,No
Tyler Self,19,12,26,7,4,2,95.0,15,3,20.0,11,4,25.0,No,2013,No,No,No
Christian Garrett,2,4,9,1,2,0,67.0,1,0,11.0,8,1,15.8,No,2013,No,No,No
Markeith Cummings,2048,227,1590,723,752,514,4160.0,293,88,342.0,1297,635,28.5,No,2013,No,No,No
Delbert Love,1369,337,1208,463,316,226,4080.0,633,217,285.0,575,246,21.1,No,2013,No,No,No
Aaron Anderson,765,85,616,325,246,112,2854.0,16,3,114.0,600,322,15.7,No,2013,No,No,No
Myles Hamilton,348,149,331,121,107,78,1304.0,103,28,119.0,228,93,19.9,No,2013,No,No,No
Nigel Pruitt,950,106,794,306,252,188,2448.0,445,150,166.0,349,156,22.5,No,2013,No,No,No
Yonel Brown,1344,277,1107,433,366,303,3749.0,502,175,256.0,605,258,20.8,No,2013,No,No,No
Brandon Dawson,267,8,221,94,113,75,1064.0,28,4,49.0,193,90,16.2,No,2013,No,No,No
Jordan Montgomery,115,22,91,34,45,25,361.0,61,22,24.0,30,12,19.8,No,2013,No,No,No
Andrew Osemhen,248,21,216,87,125,74,1475.0,0,0,83.0,216,87,12.6,No,2013,No,No,No
Kris Drees,27,3,21,11,10,5,221.0,0,0,8.0,21,11,7.7,No,2013,No,No,No
Cole Hobbs,5,1,9,2,0,0,32.0,6,1,4.0,3,1,21.6,No,2013,No,No,No
Chris Evans,962,104,684,337,321,230,2035.0,203,58,148.0,481,279,24.7,No,2013,No,No,No
Randal Holt,1417,280,1210,476,266,218,3618.0,686,247,219.0,524,229,21.8,No,2013,No,No,No
Kris Brewer,1128,304,897,354,402,293,3291.0,362,127,226.0,535,227,21.0,No,2013,No,No,No
Darren Goodson,577,126,518,216,163,102,1381.0,144,43,111.0,374,173,26.4,No,2013,No,No,No
Bryson Pope,506,124,422,167,245,145,1895.0,107,27,135.0,315,140,18.2,No,2013,No,No,No
Mark Henniger,510,32,327,179,219,152,1858.0,4,0,91.0,323,179,14.4,No,2013,No,No,No
Devareaux Manley,970,55,753,300,170,133,2341.0,598,237,74.0,155,63,20.6,No,2013,No,No,No
Melvin Tabb,217,17,165,74,114,68,769.0,3,1,52.0,162,73,18.1,No,2013,No,No,No
Kellon Thomas,1043,277,862,321,382,298,3176.0,316,103,174.0,546,218,19.2,No,2013,No,No,No
Chris Ortiz,633,54,534,215,236,155,2274.0,175,48,117.0,359,167,17.4,No,2013,No,No,No
Khaliq Spicer,568,33,398,227,224,114,2120.0,0,0,80.0,398,227,14.3,No,2013,No,No,No
Earvin Morris,806,97,611,276,218,148,1677.0,284,106,112.0,327,170,25.1,No,2013,No,No,No
Justin Brunswick,0,1,1,0,2,0,23.0,0,0,0.0,1,0,4.4,No,2013,No,No,No
Brian Frank,6,1,14,2,2,1,31.0,13,1,0.0,1,1,24.4,No,2013,No,No,No
Archie Goodwin,466,88,357,157,212,135,1048.0,64,17,101.0,293,140,27.2,Yes,2013,No,No,No
Alex Poythress,966,51,646,356,328,225,2480.0,96,29,149.0,550,327,19.3,Yes,2013,No,No,No
Kyle Wiltjer,1909,190,1417,690,341,281,3504.0,583,248,186.0,834,442,26.0,Yes,2013,No,No,No
Julius Mays,999,268,765,299,299,252,3091.0,393,149,176.0,372,150,18.7,No,2013,No,No,No
Ryan Harrow,1692,426,1423,636,396,314,3528.0,338,106,211.0,1085,530,27.3,No,2013,No,No,No
Nerlens Noel,251,38,166,98,104,55,765.0,0,0,45.0,166,98,17.4,Yes,2013,No,No,No
Willie Cauley-Stein,843,90,583,346,297,151,2575.0,0,0,127.0,583,346,16.9,Yes,2013,No,No,No
Jarrod Polson,140,53,113,48,43,29,800.0,48,15,42.0,65,33,11.1,No,2013,No,No,No
Jon Hood,95,17,95,32,19,15,425.0,55,16,13.0,40,16,13.8,No,2013,No,No,No
Twany Beckham,96,72,108,38,39,19,558.0,13,1,62.0,95,37,17.0,No,2013,No,No,No
Tod Lanter,3,0,4,1,0,0,17.0,3,1,2.0,1,0,18.1,No,2013,No,No,No
Brian Long,2,0,6,0,4,2,40.0,3,0,0.0,3,0,10.1,No,2013,No,No,No
Sam Malone,7,1,7,3,2,1,30.0,0,0,7.0,7,3,25.5,No,2013,No,No,No
Ramon Galloway,1588,323,1315,541,340,261,3567.0,635,245,313.0,680,296,25.3,No,2013,No,No,No
Tyreek Duren,1726,500,1267,568,543,430,4600.0,414,160,295.0,853,408,20.2,No,2013,No,No,No
Jerrell Wright,1512,123,1053,591,540,330,3196.0,0,0,242.0,1053,591,25.5,No,2013,No,No,No
Tyrone Garland,859,159,782,295,271,199,1861.0,271,70,118.0,511,225,28.9,No,2013,No,No,No
Sam Mills,1020,276,897,366,130,92,4132.0,480,196,169.0,417,170,13.9,No,2013,No,No,No
Steve Zack,774,131,647,304,243,165,2875.0,8,1,177.0,639,303,17.2,No,2013,No,No,No
D.J. Peterson,451,174,373,148,84,65,2920.0,255,90,83.0,118,58,8.9,No,2013,No,No,No
Rohan Brown,226,29,178,86,70,41,1175.0,49,13,52.0,129,73,11.8,No,2013,No,No,No
Taylor Dunn,98,14,95,30,21,11,462.0,83,27,10.0,12,3,12.9,No,2013,No,No,No
O.J. Lewis,23,3,22,7,12,5,62.0,7,4,5.0,15,3,27.8,No,2013,No,No,No
Garvin Hunt,4,4,5,1,5,2,71.0,0,0,6.0,5,1,9.6,No,2013,No,No,No
Seth Hinrichs,1535,205,1075,520,352,286,3268.0,485,209,238.0,590,311,24.6,No,2013,No,No,No
Tony Johnson,935,374,631,333,274,214,2859.0,145,55,181.0,486,278,17.7,No,2013,No,No,No
Dan Trist,1491,141,1128,608,382,274,2825.0,5,1,271.0,1123,607,30.4,No,2013,No,No,No
Joey Ptasinski,1105,199,839,384,109,88,3419.0,581,249,119.0,258,135,16.0,No,2013,No,No,No
Bryce Scott,1240,270,944,419,231,189,3606.0,523,213,139.0,421,206,17.7,No,2013,No,No,No
Levi Giese,480,54,441,172,83,46,1807.0,271,90,92.0,170,82,17.0,No,2013,No,No,No
Alan Flannigan,178,38,164,65,56,41,928.0,24,7,50.0,140,58,14.1,No,2013,No,No,No
Zach Rufer,464,141,406,152,96,60,1974.0,273,100,86.0,133,52,14.5,No,2013,No,No,No
Les Smith,130,31,126,38,42,34,647.0,66,20,46.0,60,18,15.9,No,2013,No,No,No
Nathaniel Musters,99,27,86,46,21,7,930.0,0,0,43.0,86,46,7.9,No,2013,No,No,No
Ben Freeland,137,13,118,61,26,15,718.0,0,0,52.0,118,61,13.5,No,2013,No,No,No
Billy Murphy,26,3,28,11,1,0,67.0,16,4,2.0,12,7,24.5,No,2013,No,No,No
Jack Detmer,7,5,20,2,4,3,133.0,12,0,11.0,8,2,13.4,No,2013,No,No,No
Stan Brown,679,38,544,252,273,175,2085.0,4,0,120.0,540,252,18.1,Yes,2013,No,No,No
Rhon Mitchell,612,70,606,245,156,120,1594.0,22,2,149.0,584,243,25.9,No,2013,No,No,No
Donley Minor,662,211,636,226,148,117,2388.0,284,93,180.0,352,133,17.6,No,2013,No,No,No
Amos Wilson,582,46,507,228,165,126,1574.0,3,0,115.0,504,228,22.2,No,2013,No,No,No
Donnell Minton,248,80,256,96,81,55,1116.0,8,1,114.0,248,95,18.1,No,2013,No,No,No
Keilan Blanks,213,72,193,68,69,54,743.0,64,23,77.0,129,45,20.1,No,2013,No,No,No
Hondo Webb,95,27,73,37,26,20,411.0,10,1,54.0,63,36,16.5,No,2013,No,No,No
Nikko Acosta,130,20,120,46,70,38,690.0,0,0,47.0,120,46,14.1,No,2013,No,No,No
Don MuepoKelly,469,57,392,183,174,102,1376.0,7,1,83.0,385,182,20.0,No,2013,No,No,No
Brennan Doty,28,3,19,7,18,13,79.0,2,1,18.0,17,6,28.1,No,2013,No,No,No
Matt Hancock,50,17,63,20,4,2,425.0,36,8,21.0,27,12,10.0,No,2013,No,No,No
Sebastian Norman,87,4,74,29,44,29,479.0,1,0,19.0,73,29,11.8,No,2013,No,No,No
Osas Ebomwonyi,108,7,96,45,57,18,671.0,0,0,30.0,96,45,10.7,No,2013,No,No,No
Brian Curran,2,0,1,0,2,2,6.0,1,0,1.0,0,0,24.0,No,2013,No,No,No
Gabe Knutson,1526,114,1049,536,578,434,3536.0,58,20,166.0,991,516,21.3,No,2013,No,No,No
Holden Greiner,1013,118,781,369,226,170,2753.0,291,105,145.0,490,264,19.2,No,2013,No,No,No
Mackey McKnight,1327,578,1040,419,472,366,3914.0,379,123,284.0,661,296,20.6,No,2013,No,No,No
C.J. McCollum,2361,304,1746,767,739,610,3657.0,576,217,267.0,1170,550,32.4,No,2013,No,No,No
Anthony D'Orazio,525,144,506,200,97,51,2075.0,232,74,100.0,274,126,16.4,No,2013,No,No,No
B.J. Bailey,237,43,164,74,69,50,856.0,85,39,38.0,79,35,14.2,No,2013,No,No,No
Stefan Cvrkalj,363,44,335,124,34,25,1201.0,250,90,52.0,85,34,17.7,No,2013,No,No,No
Corey Schaefer,638,228,528,224,136,112,2825.0,211,78,110.0,317,146,13.2,No,2013,No,No,No
Justin Goldsborough,568,42,407,233,171,102,2034.0,0,0,127.0,407,233,16.0,No,2013,No,No,No
Conroy Baltimore,136,10,110,52,46,32,545.0,0,0,32.0,110,52,15.7,No,2013,No,No,No
Cory Goodman,18,9,15,7,2,1,70.0,9,3,5.0,6,4,15.6,No,2013,No,No,No
Devon Carter,156,35,154,56,33,24,712.0,66,20,27.0,88,36,14.4,No,2013,No,No,No
Tyrone Staggers,7,1,11,2,4,3,47.0,3,0,1.0,8,2,15.3,No,2013,No,No,No
John Caleb Sanders,1384,335,1098,457,388,290,3306.0,506,180,245.0,592,277,23.8,No,2013,No,No,No
Davon Marshall,803,173,646,253,150,124,2097.0,442,173,120.0,204,80,20.6,No,2013,No,No,No
Tavares Speaks,801,67,674,299,231,185,2101.0,57,18,126.0,617,281,22.5,No,2013,No,No,No
Tomasz Gielo,1041,143,878,370,214,168,3109.0,368,133,176.0,510,237,18.8,No,2013,No,No,No
Casey Roberts,249,44,213,82,49,33,753.0,133,52,25.0,80,30,18.0,No,2013,No,No,No
JR Coronado,328,34,244,130,132,68,1437.0,0,0,66.0,244,130,13.4,No,2013,No,No,No
Andrew Smith,730,75,538,298,211,133,2161.0,8,1,130.0,530,297,18.3,No,2013,No,No,No
Joel Vander Pol,472,24,311,165,229,142,1645.0,0,0,110.0,311,165,16.5,No,2013,No,No,No
Chad Donley,146,25,137,47,26,16,453.0,111,36,18.0,26,11,19.0,No,2013,No,No,No
Sommy Ogukwe,71,6,56,28,36,15,487.0,1,0,37.0,55,28,11.5,No,2013,No,No,No
Jarred Jourdan,27,7,26,11,9,4,110.0,4,1,10.0,22,10,19.0,No,2013,No,No,No
Larry Taylor,12,12,14,5,8,2,127.0,5,0,15.0,9,5,13.4,No,2013,No,No,No
Kelly Assibesi,20,20,18,5,10,7,170.0,10,3,13.0,8,2,10.9,No,2013,No,No,No
Wesley Alcegaire,746,67,637,269,163,109,1824.0,287,99,112.0,350,170,22.2,No,2013,No,No,No
Deonte Alexander,663,105,592,246,80,56,1675.0,322,115,86.0,270,131,20.4,No,2013,No,No,No
Stephen Hurt,678,63,527,250,222,157,1748.0,73,21,153.0,454,229,22.3,No,2013,No,No,No
Martin Smith,1095,177,856,344,337,265,2873.0,422,142,172.0,434,202,20.1,No,2013,No,No,No
Malcolm Smith,1360,114,882,415,761,515,2594.0,58,15,216.0,824,400,27.5,No,2013,No,No,No
Khion Sankey,443,140,342,155,165,89,1553.0,126,44,107.0,216,111,16.5,No,2013,No,No,No
Carter Sanderson,352,65,315,112,121,72,1010.0,174,56,85.0,141,56,21.9,No,2013,No,No,No
John Ross Glover,171,21,155,62,55,36,488.0,33,11,42.0,122,51,22.7,No,2013,No,No,No
Talbott Denny,391,66,287,119,243,137,1736.0,46,16,91.0,241,103,14.0,No,2013,No,No,No
Oscar Garcia,61,5,55,21,40,19,341.0,0,0,31.0,55,21,14.7,No,2013,No,No,No
J.J. Butler,128,109,130,49,40,19,986.0,50,11,86.0,80,38,11.6,No,2013,No,No,No
J.C. Hampton,1409,331,1170,455,343,270,3652.0,643,229,229.0,527,226,21.0,No,2013,No,No,No
Chad Johnson,89,50,82,23,34,27,727.0,59,16,39.0,23,7,9.2,No,2013,No,No,No
Dylan Greene,8,5,14,2,8,3,76.0,7,1,4.0,7,1,14.1,No,2013,No,No,No
Zack Ellis,2,0,3,1,2,0,17.0,2,0,0.0,1,1,11.1,No,2013,No,No,No
James Ennis,886,158,606,299,241,190,2080.0,277,98,168.0,329,201,21.5,No,2013,No,No,No
Mike Caffey,1649,457,1429,595,422,282,4001.0,532,177,320.0,897,418,24.7,No,2013,No,No,No
Dan Jennings,649,42,476,265,259,119,1876.0,0,0,122.0,476,265,19.3,No,2013,No,No,No
Tony Freeland,629,68,472,234,275,161,1686.0,1,0,122.0,471,234,21.8,No,2013,No,No,No
Peter Pappageorge,265,55,214,81,52,44,997.0,160,59,31.0,54,22,13.6,No,2013,No,No,No
Keala King,500,142,404,178,185,118,1410.0,94,26,147.0,310,152,24.0,No,2013,No,No,No
Deng Deng,234,12,201,81,65,39,687.0,111,33,46.0,90,48,20.5,No,2013,No,No,No
Kris Gulley,368,55,346,128,67,45,1610.0,224,67,89.0,122,61,14.9,No,2013,No,No,No
Kyle Richardson,421,39,333,174,123,73,1439.0,2,0,113.0,331,174,18.4,No,2013,No,No,No
Nick Shepherd,162,12,123,57,81,48,1052.0,0,0,35.0,123,57,9.7,No,2013,No,No,No
Edgar Garibay,163,25,148,63,53,37,648.0,0,0,40.0,148,63,16.2,No,2013,No,No,No
Gatete Djuma,8,0,7,4,0,0,23.0,0,0,1.0,7,4,17.4,No,2013,No,No,No
Branford Jones,560,173,479,187,158,120,1984.0,198,66,120.0,281,121,17.2,No,2013,No,No,No
Jamal Olasewere,1873,164,1235,630,859,570,3384.0,150,43,405.0,1085,587,28.5,No,2013,No,No,No
C.J. Garner,1386,343,1032,476,542,395,3504.0,101,39,265.0,931,437,21.0,No,2013,No,No,No
Jason Brickman,1180,1007,792,348,337,281,4241.0,491,203,432.0,301,145,15.6,No,2013,No,No,No
Brandon Thompson,433,66,365,142,78,60,1525.0,268,89,57.0,97,53,14.5,No,2013,No,No,No
E.J. Reed,619,23,446,208,272,175,1410.0,94,28,115.0,352,180,24.3,No,2013,No,No,No
Booker Hucks,302,9,218,113,52,36,781.0,109,40,50.0,109,73,17.8,No,2013,No,No,No
Julian Boyd,1467,96,992,530,546,374,2674.0,96,33,173.0,896,497,24.9,No,2013,No,No,No
Kenny Onyechi,794,28,529,274,465,246,2235.0,0,0,159.0,529,274,19.2,No,2013,No,No,No
Gerrell Martin,834,59,660,277,158,133,2089.0,349,147,100.0,311,130,19.8,No,2013,No,No,No
Troy Joseph,294,26,254,97,70,51,1127.0,149,49,48.0,105,48,14.8,No,2013,No,No,No
Khalil Murphy,63,5,61,26,32,10,260.0,12,1,13.0,49,25,16.9,No,2013,No,No,No
D.J. Griggs,110,19,104,30,43,35,437.0,50,15,20.0,54,15,16.4,No,2013,No,No,No
T.T. Carey,1544,194,1322,571,228,165,3273.0,644,237,185.0,678,334,24.3,No,2013,No,No,No
Michael Kessens,1137,125,825,447,347,232,3178.0,52,11,251.0,773,436,20.1,No,2013,No,No,No
Jeylani Dublin,789,27,647,344,167,101,1797.0,0,0,122.0,647,344,23.3,No,2013,No,No,No
David Robinson,578,88,465,178,160,131,1800.0,264,91,93.0,201,87,17.1,Yes,2013,Yes,Yes,Yes
Karl Ziegler,618,74,445,222,230,173,1711.0,8,1,113.0,437,221,19.4,No,2013,No,No,No
Lucas Woodhouse,1215,662,924,400,278,235,3731.0,444,180,285.0,480,220,18.1,No,2013,No,No,No
Nik Brown,165,62,167,56,64,44,475.0,47,9,67.0,120,47,27.0,No,2013,No,No,No
Mark Parker,172,16,133,59,10,5,444.0,105,49,25.0,28,10,17.7,No,2013,No,No,No
Jeff Havenstein,126,24,118,48,47,30,1238.0,1,0,52.0,117,48,7.6,No,2013,No,No,No
Anthony Taylor,89,24,91,29,46,28,357.0,14,3,50.0,77,26,22.1,Yes,2013,No,No,No
Stephen Shockley,68,24,53,19,24,15,248.0,37,15,22.0,16,4,16.7,No,2013,No,No,No
Frank Holloway,15,1,16,6,5,2,41.0,2,1,7.0,14,5,30.1,No,2013,No,No,No
Kirk Staine,7,1,6,3,0,0,26.0,3,1,1.0,3,2,13.1,No,2013,No,No,No
Elfrid Payton,1426,486,1032,501,645,394,3155.0,112,30,336.0,920,471,25.6,Yes,2013,No,No,No
Shawn Long,2342,148,1732,871,722,488,4017.0,328,112,328.0,1404,759,28.4,Yes,2013,No,No,No
Bryant Mbamalu,1077,119,878,385,286,205,2949.0,297,102,183.0,581,283,19.6,No,2013,No,No,No
Alan-Michael Thompson,395,26,334,133,71,52,1083.0,231,77,39.0,103,56,18.4,No,2013,No,No,No
Steven Wronkoski,579,86,469,186,147,110,2448.0,281,97,137.0,188,89,13.2,No,2013,No,No,No
Elridge Moore,337,103,311,129,143,78,1936.0,13,1,132.0,298,128,13.1,No,2013,No,No,No
Kasey Shepherd,1013,192,789,331,222,189,2190.0,441,162,177.0,348,169,23.1,No,2013,No,No,No
Josh Soto,74,4,74,25,17,8,285.0,44,16,14.0,30,9,16.5,No,2013,No,No,No
Kevin Brown,523,86,457,164,148,105,1588.0,260,90,103.0,197,74,19.1,No,2013,No,No,No
Braylon Lazare,40,7,41,16,11,8,181.0,0,0,9.0,41,16,14.7,No,2013,No,No,No
Cornell Barnett,13,1,16,5,9,3,103.0,0,0,8.0,16,5,13.5,No,2013,No,No,No
Aaron Leblanc,28,3,26,13,6,1,141.0,2,1,9.0,24,12,12.9,No,2013,No,No,No
Matthew Moss,208,17,205,76,26,16,767.0,135,40,33.0,70,36,16.2,No,2013,No,No,No
Donovan Williams,59,10,50,19,16,11,136.0,30,10,9.0,20,9,23.5,No,2013,No,No,No
Amos Olatayo,652,40,517,238,198,120,1312.0,183,56,100.0,334,182,28.7,No,2013,No,No,No
Trent Mackey,1181,175,879,381,140,116,3589.0,681,303,144.0,198,78,15.7,No,2013,No,No,No
Jayon James,519,267,460,199,233,117,1814.0,42,4,213.0,418,195,22.8,No,2013,No,No,No
R.J. McCray,437,133,372,157,127,82,1951.0,116,41,133.0,256,116,15.4,No,2013,No,No,No
Millaun Brown,191,15,150,84,59,23,905.0,0,0,55.0,150,84,13.6,No,2013,No,No,No
Marcelis Hansberry,390,110,353,142,124,80,1387.0,107,26,94.0,246,116,19.6,No,2013,No,No,No
Trey Lindsey,185,71,183,63,53,37,1010.0,70,22,50.0,113,41,13.7,No,2013,No,No,No
Kyle Koszuta,141,55,129,46,24,15,606.0,89,34,50.0,40,12,16.6,No,2013,No,No,No
Ifeanyi Eke,13,1,12,6,5,1,79.0,0,0,3.0,12,6,11.7,No,2013,No,No,No
Taylor Birchett,6,0,12,2,2,2,36.0,7,0,2.0,5,2,22.0,No,2013,No,No,No
Colton Ponder,0,0,1,0,0,0,3.0,0,0,0.0,1,0,17.6,No,2013,No,No,No
Johnny O'Bryant,1155,115,956,446,415,257,2465.0,27,6,267.0,929,440,28.2,No,2013,No,No,No
Shavon Coleman,636,90,517,224,181,131,1730.0,166,57,108.0,351,167,19.9,No,2013,No,No,No
Anthony Hickey,1219,469,1165,456,161,81,4007.0,652,226,209.0,513,230,18.3,No,2013,No,No,No
Andre Stringer,1365,314,1122,421,357,281,3709.0,680,242,229.0,442,179,20.4,No,2013,No,No,No
Charles Carmouche,1052,266,831,334,396,256,3163.0,355,128,215.0,476,206,20.9,No,2013,No,No,No
Malik Morgan,983,278,853,345,248,164,2964.0,394,129,215.0,459,216,19.7,No,2013,No,No,No
Andrew Del Piero,135,4,104,55,48,25,435.0,0,0,27.0,104,55,17.3,No,2013,No,No,No
Corban Collins,887,218,751,285,225,162,2628.0,408,155,151.0,343,130,19.1,No,2013,No,No,No
Jalen Courtney,123,7,121,46,28,19,464.0,36,12,17.0,85,34,16.3,No,2013,No,No,No
Shane Hammink,883,166,633,309,256,197,2215.0,221,68,184.0,412,241,21.0,No,2013,No,No,No
Eddie Ludwig,278,56,220,85,136,101,1282.0,34,7,78.0,186,78,14.5,No,2013,No,No,No
Joshua Badeaux,0,0,1,0,0,0,8.0,0,0,1.0,1,0,12.2,No,2013,No,No,No
Dave Jackson,0,0,0,0,0,0,5.0,0,0,1.0,0,0,9.8,No,2013,No,No,No
Mychal Williams,0,0,2,0,0,0,7.0,0,0,1.0,2,0,21.0,No,2013,No,No,No
Raheem Appleby,1770,188,1583,672,320,240,3476.0,560,186,170.0,1023,486,27.0,No,2013,No,No,No
Cordarius Johnson,1003,107,919,347,226,144,2750.0,533,165,164.0,386,182,21.1,No,2013,No,No,No
Alex Hamilton,1986,501,1387,636,834,604,3895.0,391,110,316.0,996,526,26.1,No,2013,No,No,No
Brandon Gibson,702,93,644,236,236,137,2022.0,324,93,133.0,320,143,22.2,No,2013,No,No,No
Kenyon McNeaill,1147,223,927,351,293,221,3049.0,613,224,203.0,314,127,20.3,No,2013,No,No,No
Speedy Smith,865,858,718,279,280,193,4109.0,320,114,340.0,398,165,14.2,No,2013,No,No,No
Michale Kyser,858,56,644,350,283,158,2963.0,1,0,92.0,643,350,14.4,No,2013,No,No,No
Jaron Johnson,494,36,349,167,159,116,1308.0,143,44,53.0,206,123,17.2,No,2013,No,No,No
Chris Anderson,594,55,501,220,178,116,1365.0,129,38,99.0,372,182,23.7,No,2013,No,No,No
Isaiah Massey,223,16,165,83,80,56,759.0,2,1,30.0,163,82,14.6,No,2013,No,No,No
J.L. Lewis,313,28,268,121,104,61,1565.0,37,10,91.0,231,111,13.1,No,2013,No,No,No
Gilbert Talbot,101,4,78,42,37,17,246.0,0,0,18.0,78,42,21.8,No,2013,No,No,No
Stojan Gjuroski,45,8,61,16,8,3,193.0,44,10,12.0,17,6,19.0,No,2013,No,No,No
J.D. Wilkerson,4,1,2,1,2,1,10.0,2,1,0.0,0,0,14.0,No,2013,No,No,No
Demario Johnson,1,2,3,0,2,1,9.0,2,0,0.0,1,0,20.9,No,2013,No,No,No
Russ Smith,1908,378,1501,620,642,488,3228.0,521,180,316.0,980,440,32.6,Yes,2013,No,No,No
Peyton Siva,1215,677,989,412,396,292,3774.0,340,99,384.0,649,313,20.7,Yes,2013,No,No,No
Chane Behanan,852,86,641,333,324,179,2280.0,48,7,150.0,593,326,20.7,No,2013,No,No,No
Luke Hancock,1370,373,950,430,439,345,3439.0,453,165,239.0,497,265,20.6,No,2013,No,No,No
Gorgui Dieng,851,127,620,338,272,174,2789.0,3,1,166.0,617,337,16.4,Yes,2013,No,No,No
Wayne Blackshear,1046,95,838,342,278,206,2723.0,454,156,89.0,384,186,19.5,No,2013,No,No,No
Montrezl Harrell,1294,102,910,533,407,217,2961.0,40,11,145.0,870,522,21.0,Yes,2013,No,No,No
Kevin Ware,816,220,674,287,267,191,2839.0,154,51,195.0,520,236,18.7,No,2013,No,No,No
Stephan Van Treese,279,48,181,119,80,40,1719.0,2,1,62.0,179,118,8.1,No,2013,No,No,No
Tim Henderson,115,32,106,41,14,8,444.0,75,25,19.0,31,16,14.6,No,2013,No,No,No
Zach Price,227,5,171,86,101,55,806.0,0,0,46.0,171,86,16.1,No,2013,No,No,No
Michael Baffour,2,0,3,0,4,2,12.0,2,0,0.0,1,0,20.5,No,2013,No,No,No
Logan Baumann,2,0,4,0,2,2,11.0,0,0,1.0,4,0,27.2,No,2013,No,No,No
Jordan Bond,0,1,3,0,0,0,17.0,2,0,0.0,1,0,8.9,No,2013,No,No,No
Christian Thomas,1353,120,917,508,460,302,3593.0,87,35,186.0,830,473,20.8,No,2013,No,No,No
Ben Averkamp,1360,183,1101,510,364,281,3273.0,182,59,175.0,919,451,24.1,No,2013,No,No,No
Jordan Hicks,722,110,593,275,125,85,2255.0,240,87,129.0,353,188,18.8,No,2013,No,No,No
Devon Turk,1205,96,973,413,143,117,3046.0,650,262,147.0,323,151,21.9,No,2013,No,No,No
Cully Payne,494,244,439,154,151,109,1895.0,237,77,186.0,202,77,20.3,No,2013,No,No,No
Jeff White,656,312,579,242,168,127,2954.0,135,45,202.0,444,197,16.3,No,2013,No,No,No
Joe Crisman,617,192,536,226,158,103,3044.0,192,62,144.0,344,164,14.0,No,2013,No,No,No
Matt O'Leary,1018,238,809,380,219,140,2916.0,346,118,190.0,463,262,19.4,No,2013,No,No,No
Nick Osborne,478,38,421,194,97,68,1437.0,64,22,83.0,357,172,20.3,No,2013,No,No,No
Tanner Williams,20,4,14,9,4,2,32.0,0,0,2.0,14,9,30.9,No,2013,No,No,No
London Dokubo,23,39,25,8,10,4,538.0,12,3,30.0,13,5,6.3,No,2013,No,No,No
Bill Clark,18,13,30,7,4,2,136.0,13,2,12.0,17,5,18.1,No,2013,No,No,No
Derrick Boone,1,0,5,0,2,1,15.0,3,0,0.0,2,0,22.4,No,2013,No,No,No
Jeremy King,27,1,14,12,9,3,77.0,0,0,7.0,14,12,18.4,No,2013,No,No,No
Kody Williams,4,4,1,0,5,4,26.0,0,0,2.0,1,0,10.8,No,2013,No,No,No
Anthony Ireland,2172,557,1774,736,633,504,4633.0,568,196,363.0,1206,540,26.2,No,2013,No,No,No
Ashley Hamilton,1172,108,911,400,459,334,3020.0,119,38,292.0,792,362,23.6,No,2013,No,No,No
Ayodeji Egbeyemi,849,143,764,305,223,149,2932.0,285,90,148.0,479,215,17.8,No,2013,No,No,No
Alex Osborne,536,45,428,218,200,100,2119.0,0,0,104.0,428,218,14.7,No,2013,No,No,No
Godwin Okonji,649,83,491,243,267,163,2879.0,2,0,141.0,489,243,13.6,No,2013,No,No,No
Nick Stover,892,140,741,310,256,181,2568.0,286,91,163.0,455,219,19.7,No,2013,No,No,No
Chase Flint,264,227,264,97,42,28,1730.0,145,42,91.0,119,55,11.1,No,2013,No,No,No
Bruce English,112,31,134,38,47,26,549.0,55,10,37.0,79,28,18.0,No,2013,No,No,No
Taylor Walker,86,15,82,30,21,15,356.0,35,11,35.0,47,19,18.3,No,2013,No,No,No
C.J. Blackwell,412,43,409,158,51,34,1188.0,188,62,57.0,221,96,20.4,No,2013,No,No,No
Marin Mornar,662,60,504,245,162,118,2176.0,158,54,93.0,346,191,16.0,No,2013,No,No,No
Adam Drexler,13,2,17,4,7,4,105.0,7,1,5.0,10,3,12.4,No,2013,No,No,No
Taj Adams,1,0,0,0,4,1,10.0,0,0,2.0,0,0,20.0,No,2013,No,No,No
Dylon Cormier,1659,210,1280,552,662,459,3662.0,340,96,182.0,940,456,25.1,No,2013,No,No,No
Erik Etherly,1257,140,936,455,508,342,2969.0,23,5,202.0,913,450,24.0,No,2013,No,No,No
Robert Olson,1264,233,1040,429,252,195,3495.0,563,211,176.0,477,218,19.7,No,2013,No,No,No
Anthony Winbush,605,180,533,223,187,129,2911.0,103,30,177.0,430,193,14.0,No,2013,No,No,No
Julius Brooks,295,17,243,129,92,37,1312.0,1,0,80.0,242,129,14.5,No,2013,No,No,No
Jordan Latham,414,55,386,159,148,94,1604.0,7,2,103.0,379,157,18.2,No,2013,No,No,No
Jarred Jones,1188,140,909,433,424,311,2853.0,46,11,234.0,863,422,24.2,No,2013,No,No,No
R.J. Williams,438,261,367,133,191,140,2183.0,104,32,154.0,263,101,14.6,No,2013,No,No,No
Tyler Hubbard,879,84,776,273,194,144,2655.0,553,189,92.0,223,84,19.0,No,2013,No,No,No
Franz Rassman,745,71,626,299,178,122,2375.0,79,25,132.0,547,274,18.7,No,2013,No,No,No
Eric Laster,892,121,845,330,217,126,2706.0,316,106,134.0,529,224,21.1,No,2013,No,No,No
Chido Onyiuke,5,1,4,1,4,3,46.0,0,0,3.0,4,1,10.1,No,2013,No,No,No
Luke Wandrusch,4,5,11,2,3,0,66.0,0,0,5.0,11,2,13.6,No,2013,No,No,No
Justin Edwards,1508,342,1272,544,459,317,3573.0,352,103,312.0,920,441,25.7,No,2013,No,No,No
Alasdair Fraser,913,80,758,393,191,114,2366.0,44,13,163.0,714,380,21.9,No,2013,No,No,No
Xavier Pollard,989,302,829,373,307,196,2452.0,190,47,221.0,639,326,24.1,No,2013,No,No,No
Mike Allison,527,25,397,196,209,133,2107.0,12,2,85.0,385,194,14.2,No,2013,No,No,No
Zarko Valjarevic,781,90,670,261,104,77,2213.0,488,182,89.0,182,79,18.6,No,2013,No,No,No
Jon Mesghna,172,30,140,55,33,21,655.0,107,41,30.0,33,14,14.2,No,2013,No,No,No
Till Gloger,911,37,699,376,222,159,2256.0,3,0,137.0,696,376,20.8,No,2013,No,No,No
Shaun Lawton,787,303,624,255,309,221,2647.0,185,56,259.0,439,199,19.3,No,2013,No,No,No
Dimitry Akanda-Coronel,318,43,290,113,93,57,704.0,113,35,64.0,177,78,27.3,No,2013,No,No,No
Jon McAllian,67,25,83,21,11,11,360.0,59,14,18.0,24,7,15.1,No,2013,No,No,No
Kilian Cato,225,21,209,79,23,18,798.0,142,49,33.0,67,30,15.8,No,2013,No,No,No
Stefan Micovic,28,1,26,10,14,8,175.0,2,0,15.0,24,10,13.2,No,2013,No,No,No
Leon Cooper,7,3,13,3,2,1,63.0,2,0,11.0,11,3,19.8,No,2013,No,No,No
Ethan Mackey,190,15,148,86,38,18,604.0,0,0,28.0,148,86,15.9,No,2013,No,No,No
Luke Hetterman,0,0,0,0,0,0,4.0,0,0,0.0,0,0,0.0,No,2013,No,No,No
Rhamel Brown,1172,79,867,478,463,216,3155.0,4,0,202.0,863,478,21.1,No,2013,No,No,No
Emmy Andujar,1345,367,1004,492,465,324,3505.0,116,37,369.0,888,455,23.2,No,2013,No,No,No
Michael Alvarado,1170,364,884,346,565,420,3175.0,193,58,299.0,691,288,23.4,No,2013,No,No,No
Shane Richards,1472,149,1103,443,330,274,3569.0,801,312,158.0,302,131,20.5,No,2013,No,No,No
Donovan Kates,570,105,475,146,251,201,2601.0,276,77,147.0,199,69,14.7,No,2013,No,No,No
RaShawn Stores,768,314,592,223,258,179,3127.0,364,143,173.0,228,80,14.7,No,2013,No,No,No
Roberto Colonette,329,37,242,112,155,101,1186.0,16,4,79.0,226,108,17.1,No,2013,No,No,No
Mohamed Koita,274,50,261,90,60,47,1250.0,148,47,69.0,113,43,14.8,No,2013,No,No,No
George Beamon,1843,136,1367,608,645,504,3414.0,342,123,226.0,1025,485,28.0,No,2013,No,No,No
CJ Jones,68,36,96,24,26,15,427.0,30,5,39.0,66,19,18.5,No,2013,No,No,No
Ryan McCoy,91,39,96,31,22,12,691.0,54,17,60.0,42,14,12.5,No,2013,No,No,No
Mark Jackson,17,4,22,7,0,0,98.0,9,3,10.0,13,4,17.6,Yes,2013,No,Yes,Yes
Adam Lacey,2,0,3,1,0,0,23.0,0,0,3.0,3,1,14.3,No,2013,No,No,No
Chavaughn Lewis,2119,308,1756,728,810,543,4140.0,386,120,407.0,1370,608,32.0,No,2013,No,No,No
Devin Price,1244,274,1050,385,377,300,3375.0,513,174,232.0,537,211,22.6,No,2013,No,No,No
Adam Kemp,973,61,718,356,432,261,3055.0,0,0,185.0,718,356,18.6,No,2013,No,No,No
Isaiah Morton,505,224,462,159,158,102,2007.0,281,85,179.0,181,74,18.2,No,2013,No,No,No
Jay Bowie,988,116,762,341,201,163,2962.0,344,143,155.0,418,198,17.6,No,2013,No,No,No
Manny Thomas,611,133,519,188,185,137,2570.0,269,98,150.0,250,90,15.3,No,2013,No,No,No
T.J. Curry,461,162,385,142,123,89,2001.0,242,88,109.0,143,54,14.4,No,2013,No,No,No
Dorvell Carter,410,49,354,152,96,59,1268.0,144,47,58.0,210,105,19.0,No,2013,No,No,No
Phillip Lawrence-Ricks,417,51,345,150,115,74,1533.0,137,43,60.0,208,107,15.9,No,2013,No,No,No
Eric Truog,298,114,283,127,75,33,1643.0,39,11,88.0,244,116,13.1,No,2013,No,No,No
Anell Alexis,576,53,438,192,186,147,1643.0,129,45,116.0,309,147,20.1,No,2013,No,No,No
Pieter Prinsolo,149,6,141,54,39,26,932.0,47,15,39.0,94,39,10.9,No,2013,No,No,No
Patrick Ramsey,14,0,10,5,1,0,31.0,8,4,0.0,2,1,17.4,No,2013,No,No,No
Jesse Martin,3,1,1,1,0,0,8.0,1,1,1.0,0,0,12.9,No,2013,No,No,No
Rob Delle Bovi,0,0,0,0,0,0,2.0,0,0,2.0,0,0,51.0,No,2013,No,No,No
Tourron Whitfield,11,3,10,2,6,5,53.0,8,2,2.0,2,0,14.8,No,2013,No,No,No
Vander Blue,982,212,820,352,321,226,2727.0,188,52,208.0,632,300,22.0,Yes,2013,No,No,No
Davante Gardner,1287,103,767,427,544,430,2410.0,23,3,144.0,744,424,24.8,No,2013,No,No,No
Jamil Wilson,1077,205,908,397,277,196,3067.0,259,87,175.0,649,310,20.3,Yes,2013,No,No,No
Junior Cadougan,661,435,567,231,256,174,2713.0,115,25,238.0,452,206,17.3,No,2013,No,No,No
Trent Lockett,1181,219,844,408,451,317,3341.0,140,48,263.0,704,360,21.7,No,2013,No,No,No
Chris Otule,615,19,409,240,256,135,2075.0,0,0,128.0,409,240,16.2,No,2013,No,No,No
Todd Mayo,738,119,544,231,256,203,1777.0,229,73,140.0,315,158,22.9,No,2013,No,No,No
Steve Taylor Jr.,854,154,715,355,236,121,2303.0,106,23,175.0,609,332,22.6,No,2013,No,No,No
Juan Anderson,464,120,406,171,150,89,1864.0,114,33,131.0,292,138,17.3,No,2013,No,No,No
Jake Thomas,1143,201,859,327,291,237,3224.0,658,252,145.0,201,75,17.2,No,2013,No,No,No
Derrick Wilson,400,366,387,150,195,89,2789.0,63,11,127.0,324,139,11.4,No,2013,No,No,No
Jamal Ferguson,180,32,162,73,51,33,629.0,4,1,42.0,158,72,19.2,No,2013,No,No,No
Dylan Flood,2,0,3,1,0,0,11.0,1,0,0.0,2,1,14.0,No,2013,No,No,No
Elijah Pittman,709,54,484,234,233,148,1281.0,250,93,90.0,234,141,25.8,No,2013,No,No,No
DeAndre Kane,2110,645,1694,732,817,492,4511.0,511,154,438.0,1183,578,27.4,No,2013,No,No,No
D.D. Scarver,647,80,593,211,153,118,1511.0,346,107,86.0,247,104,24.4,No,2013,No,No,No
Dennis Tinnon,691,78,532,274,187,128,2003.0,44,15,116.0,488,259,17.9,No,2013,No,No,No
Nigel Spikes,527,41,353,183,310,161,2170.0,1,0,112.0,352,183,13.8,No,2013,No,No,No
Robert Goff,351,35,300,143,148,65,1360.0,3,0,65.0,297,143,15.7,No,2013,No,No,No
Jamir Hanner,139,15,100,54,63,27,379.0,8,4,31.0,92,50,20.7,No,2013,No,No,No
Chris Martin,652,99,620,219,134,95,1831.0,380,119,101.0,240,100,22.2,No,2013,No,No,No
Tamron Manning,280,125,270,88,111,75,1539.0,114,29,93.0,156,59,13.1,No,2013,No,No,No
DeVince Boykins,343,99,317,132,119,34,1701.0,125,45,119.0,192,87,14.0,No,2013,No,No,No
Kelvin Amayo,417,156,338,159,187,86,1431.0,47,13,116.0,291,146,18.8,No,2013,No,No,No
J.P. Kambola,202,5,150,82,44,27,529.0,45,11,31.0,105,71,18.6,No,2013,No,No,No
Youssoupha Mbao,30,9,28,9,28,12,491.0,0,0,39.0,28,9,8.1,No,2013,No,No,No
Ryan Cook,790,99,660,274,202,171,1732.0,214,71,128.0,446,203,25.7,No,2013,No,No,No
Chase Plummer,1307,144,1140,457,538,332,2708.0,202,61,302.0,938,396,31.6,No,2013,No,No,No
Brian Neller,966,84,961,332,61,41,2709.0,804,261,95.0,157,71,20.4,No,2013,No,No,No
Brett Roseboro,419,24,376,171,122,73,1320.0,15,4,109.0,361,167,21.0,No,2013,No,No,No
Joey Getz,302,96,282,111,81,58,1210.0,64,22,90.0,218,89,17.1,No,2013,No,No,No
Aaron Morgan,255,110,251,73,97,67,1274.0,151,42,125.0,100,31,17.1,No,2013,No,No,No
Adrian Satchell,534,73,504,233,140,65,2167.0,11,3,107.0,493,230,16.2,No,2013,No,No,No
Malik Garner,274,57,243,105,78,44,1244.0,72,20,60.0,171,85,13.8,No,2013,No,No,No
Quentin Jones,337,123,301,111,92,64,1522.0,131,51,100.0,170,60,14.7,No,2013,No,No,No
Jamar Wertz,271,35,258,96,66,43,1039.0,100,36,43.0,158,60,16.2,No,2013,No,No,No
Jordan Wejnert,31,4,28,11,15,8,109.0,8,1,10.0,20,10,20.8,No,2013,No,No,No
Jarrel Lane,54,51,79,23,16,7,519.0,17,1,46.0,62,22,12.7,No,2013,No,No,No
Nate Basalyga,34,9,30,16,5,2,201.0,0,0,9.0,30,16,10.2,No,2013,No,No,No
Will Wise,48,3,46,20,21,8,274.0,0,0,18.0,46,20,13.3,No,2013,No,No,No
Troy Snyder,777,104,645,279,251,166,2108.0,181,53,144.0,464,226,22.1,No,2013,No,No,No
Kevin Mays,967,92,770,367,328,224,2311.0,33,9,151.0,737,358,24.2,No,2013,No,No,No
Louis Bell,643,120,646,219,82,56,2329.0,459,149,118.0,187,70,17.3,No,2013,No,No,No
Kyree Jones,501,88,437,145,151,132,1231.0,253,79,71.0,184,66,24.1,No,2013,No,No,No
Ishaq Pitt,672,306,543,230,366,208,2686.0,25,4,245.0,518,226,18.2,No,2013,No,No,No
Olatunji Kosile,190,9,177,74,70,42,915.0,1,0,68.0,176,74,15.4,No,2013,No,No,No
Dominique Cowell,105,59,116,37,27,21,739.0,40,10,49.0,76,27,12.4,No,2013,No,No,No
Donald Williams,92,5,149,34,15,9,322.0,76,15,33.0,73,19,30.3,No,2013,No,No,No
Ronald Spencer,337,16,268,123,157,91,1295.0,1,0,73.0,267,123,15.8,No,2013,No,No,No
Francis Ezeiru,158,3,136,63,78,32,664.0,0,0,41.0,136,63,16.5,No,2013,No,No,No
Travis Trim,79,68,92,31,30,13,689.0,14,4,50.0,78,27,11.8,No,2013,No,No,No
Jarrod Davis,11,1,15,4,2,1,62.0,5,2,9.0,10,2,20.8,No,2013,No,No,No
Reginald Ekeanyanwu,0,0,0,0,0,0,1.0,0,0,0.0,0,0,0.0,No,2013,No,No,No
Dez Wells,1710,294,1238,612,524,401,3756.0,227,85,321.0,1011,527,24.8,No,2013,No,No,No
Alex Len,583,50,418,225,199,132,1470.0,9,1,93.0,409,224,20.7,Yes,2013,No,No,No
Nick Faust,1553,304,1279,518,471,323,3827.0,581,194,299.0,698,324,23.5,No,2013,No,No,No
Seth Allen,1487,338,1125,484,443,335,3297.0,529,184,292.0,596,300,24.9,No,2013,No,No,No
Logan Aronhalt,1320,110,1138,445,245,198,3122.0,623,232,191.0,515,213,24.4,No,2013,No,No,No
Charles Mitchell,1085,59,893,462,298,161,2786.0,0,0,227.0,893,462,22.9,No,2013,No,No,No
Jake Layman,1436,156,1083,482,361,274,3938.0,547,198,204.0,536,284,19.3,Yes,2013,No,No,No
James Padgett,652,42,470,246,303,160,1834.0,0,0,98.0,470,246,19.3,No,2013,No,No,No
Shaquille Cleare,618,32,458,257,161,104,1997.0,1,0,105.0,457,257,16.3,No,2013,No,No,No
Pe'Shon Howard,721,410,631,230,223,169,2833.0,305,92,252.0,326,138,17.2,No,2013,No,No,No
Conner Lipinski,7,1,1,1,6,4,17.0,1,1,2.0,0,0,17.3,No,2013,No,No,No
John Auslander,21,2,20,7,11,6,132.0,8,1,8.0,12,6,12.7,No,2013,No,No,No
Spencer Barks,7,0,8,0,12,7,44.0,0,0,2.0,8,0,18.2,No,2013,No,No,No
Jacob Susskind,0,1,9,0,0,0,38.0,4,0,4.0,5,0,17.4,No,2013,No,No,No
Chaz Williams,1978,840,1559,634,667,514,4665.0,521,196,437.0,1038,438,23.5,No,2013,No,No,No
Terrell Vinson,1276,132,1005,453,417,279,3256.0,303,91,208.0,702,362,20.6,No,2013,No,No,No
Freddie Riley,1006,100,980,365,91,45,2627.0,688,231,118.0,292,134,20.7,No,2013,No,No,No
Cady Lalanne,1107,26,767,424,374,249,2799.0,47,10,206.0,720,414,19.9,No,2013,No,No,No
Raphiael Putney,1019,155,862,385,172,128,2785.0,380,121,210.0,482,264,19.7,No,2013,No,No,No
Sampson Carter,963,104,765,316,370,272,2946.0,224,59,179.0,541,257,18.2,No,2013,No,No,No
Jesse Morgan,930,153,878,322,154,116,2304.0,485,170,128.0,393,152,22.8,No,2013,No,No,No
Maxie Esho,1019,68,764,383,383,243,2734.0,37,10,196.0,727,373,20.1,No,2013,No,No,No
Trey Davis,1353,348,1076,420,394,325,3141.0,530,188,222.0,546,232,23.2,No,2013,No,No,No
Tyler Bergantino,160,18,114,73,41,14,1136.0,1,0,21.0,113,73,6.7,No,2013,No,No,No
Izzy Freeman,0,0,3,0,2,0,6.0,0,0,0.0,3,0,31.9,No,2013,No,No,No
Desharick Guidry,1352,123,1103,510,375,258,3504.0,216,74,195.0,887,436,21.2,No,2013,No,No,No
Dontae Cannon,967,228,842,346,271,209,2804.0,216,66,186.0,626,280,20.9,No,2013,No,No,No
Kevin Hardy,1169,430,998,465,366,202,3750.0,109,37,220.0,889,428,18.6,No,2013,No,No,No
Jeremie Mitchell,742,110,669,264,110,67,2167.0,395,147,120.0,274,117,19.7,No,2013,No,No,No
Craig McFerrin,834,67,686,353,224,128,2484.0,7,0,185.0,679,353,19.5,No,2013,No,No,No
Adrian Fields,474,56,478,157,156,110,1784.0,179,50,96.0,299,107,18.3,No,2013,No,No,No
Ledrick Eackles,1008,159,834,301,398,291,2131.0,360,115,181.0,474,186,27.3,No,2013,No,No,No
Austin Lewis,406,16,319,175,107,56,1609.0,1,0,63.0,318,175,13.4,No,2013,No,No,No
Keelan Garrett,548,66,534,193,69,51,1422.0,332,111,64.0,202,82,22.1,No,2013,No,No,No
Brandon Regis,181,47,211,65,56,32,670.0,89,19,54.0,122,46,21.6,No,2013,No,No,No
Pete Kpan,63,7,41,22,28,19,268.0,1,0,10.0,40,22,12.1,No,2013,No,No,No
Jordan Wells,63,7,74,27,16,7,302.0,8,2,18.0,66,25,16.8,No,2013,No,No,No
Shaun Johnson,324,62,363,104,44,35,1038.0,280,81,37.0,83,23,20.2,No,2013,No,No,No
Josh Jagneaux,0,2,1,0,0,0,9.0,0,0,0.0,1,0,5.7,No,2013,No,No,No
Joe Jackson,1687,564,1184,540,661,508,3983.0,293,99,373.0,891,441,23.3,No,2013,No,No,No
Adonis Thomas,589,84,523,223,137,102,1511.0,126,41,82.0,397,182,22.1,Yes,2013,No,No,No
Chris Crawford,1223,468,1102,431,158,119,3911.0,659,242,258.0,443,189,18.2,Yes,2013,No,No,No
Geron Johnson,644,237,560,239,154,100,1897.0,213,66,178.0,347,173,20.8,No,2013,No,No,No
D.J. Stephens,512,45,330,207,128,81,1703.0,46,17,49.0,284,190,12.8,No,2013,No,No,No
Shaq Goodwin,1440,206,1003,518,602,395,3504.0,36,9,266.0,967,509,21.5,No,2013,No,No,No
Tarik Black,1130,41,722,443,440,244,2797.0,1,0,158.0,721,443,19.5,Yes,2013,No,No,No
Antonio Barton,936,218,743,317,226,151,2966.0,390,151,145.0,353,166,17.1,No,2013,No,No,No
Damien Wilson,310,54,293,118,93,67,871.0,53,7,89.0,240,111,24.9,No,2013,No,No,No
Ferrakohn Hall,262,31,221,108,87,45,1093.0,11,1,59.0,210,107,14.7,No,2013,No,No,No
Stan Simpson,75,6,78,30,20,15,307.0,2,0,24.0,76,30,18.6,No,2013,No,No,No
Trey Draper,8,1,17,1,11,5,44.0,10,1,6.0,7,0,31.5,No,2013,No,No,No
Anthony Cole,6,0,5,1,4,4,19.0,1,0,0.0,4,1,17.6,No,2013,No,No,No
Charles Holt,16,2,15,4,8,5,57.0,9,3,5.0,6,1,21.5,No,2013,No,No,No
Hippolyte Tsafack,15,0,9,5,8,5,56.0,0,0,3.0,9,5,14.4,No,2013,No,No,No
Travis Smith,984,211,698,316,254,214,2515.0,332,138,209.0,366,178,22.3,No,2013,No,No,No
Langston Hall,1579,633,1221,481,447,361,4541.0,677,256,322.0,544,225,20.5,No,2013,No,No,No
Jake Gollon,1153,320,891,392,345,279,3762.0,260,90,297.0,631,302,19.1,No,2013,No,No,No
Bud Thomas,1059,275,857,397,176,104,3748.0,477,161,170.0,380,236,15.8,No,2013,No,No,No
Daniel Coursey,935,40,686,390,231,155,2277.0,0,0,129.0,686,390,21.7,No,2013,No,No,No
Monty Brown,522,26,333,180,234,162,1332.0,0,0,111.0,333,180,22.3,No,2013,No,No,No
Anthony White Jr.,451,51,340,150,100,81,1143.0,175,70,37.0,165,80,19.8,No,2013,No,No,No
T.J. Hallice,547,88,431,217,197,106,2264.0,38,7,87.0,393,210,14.8,No,2013,No,No,No
Chris Smith,271,40,233,83,127,80,1125.0,82,25,78.0,151,58,17.5,Yes,2013,No,No,No
Jibri Bryan,513,69,441,164,130,93,1706.0,280,92,86.0,161,72,18.8,No,2013,No,No,No
Darious Moten,585,75,417,208,201,142,1528.0,71,27,75.0,346,181,21.0,No,2013,No,No,No
Kevin Canevari,136,129,116,45,25,22,1011.0,66,24,81.0,50,21,11.0,No,2013,No,No,No
Dylan Poston,502,52,464,165,75,54,1345.0,348,118,56.0,116,47,20.2,No,2013,No,No,No
Lawrence Brown,152,14,114,60,46,31,627.0,2,1,25.0,112,59,13.5,No,2013,No,No,No
Shane Larkin,760,245,585,256,182,147,2131.0,269,101,142.0,316,155,20.4,Yes,2013,No,No,No
Kenny Kadji,996,57,773,370,290,181,2395.0,202,75,146.0,571,295,23.8,No,2013,No,No,No
Durand Scott,1650,404,1285,580,507,392,4238.0,290,98,292.0,995,482,22.4,No,2013,No,No,No
Trey McKinney-Jones,998,202,772,343,254,188,3323.0,342,124,171.0,430,219,17.7,Yes,2013,No,No,No
Julian Gamble,550,57,412,224,193,101,1898.0,4,1,102.0,408,223,16.6,No,2013,No,No,No
Rion Brown,1124,144,930,377,262,196,3192.0,523,174,127.0,407,203,20.4,No,2013,No,No,No
Reggie Johnson,1039,104,723,370,416,294,2524.0,21,5,186.0,702,365,22.9,Yes,2013,No,No,No
Tonye Jekiri,769,97,623,312,225,144,3053.0,5,1,142.0,618,311,15.7,No,2013,No,No,No
Erik Swoope,291,31,206,107,130,75,1190.0,10,2,31.0,196,105,13.9,No,2013,No,No,No
Bishop Daniels,530,146,503,198,147,104,1613.0,98,30,162.0,405,168,23.1,No,2013,No,No,No
Raphael Akpejiori,97,5,66,28,67,41,593.0,0,0,22.0,66,28,10.9,No,2013,No,No,No
Justin Heller,4,2,9,2,2,0,20.0,5,0,4.0,4,2,38.5,No,2013,No,No,No
Steve Sorenson,1,0,0,0,3,1,12.0,0,0,3.0,0,0,19.9,No,2013,No,No,No
Will Felder,1411,118,1056,517,391,306,3431.0,237,71,256.0,819,446,23.1,No,2013,No,No,No
Allen Roberts,827,122,673,260,271,209,2295.0,311,98,172.0,362,162,23.1,No,2013,No,No,No
Jon Harris,895,126,694,318,145,106,2851.0,412,153,108.0,282,165,16.7,No,2013,No,No,No
Reggie Johnson,1254,225,1124,418,434,292,2917.0,427,126,211.0,697,292,26.1,Yes,2013,No,No,No
Geovonie McKnight,1215,237,1101,452,400,285,3510.0,116,26,277.0,985,426,23.9,No,2013,No,No,No
Quinten Rollins,734,391,613,269,284,175,3447.0,87,21,259.0,526,248,16.0,No,2013,No,No,No
Drew McGhee,312,17,251,140,47,32,957.0,0,0,49.0,251,140,18.7,No,2013,No,No,No
Will Sullivan,793,130,587,265,166,127,2950.0,344,136,122.0,243,129,14.5,No,2013,No,No,No
Josh Sewell,330,34,277,114,74,51,1084.0,131,51,72.0,146,63,19.9,No,2013,No,No,No
Vince Legarza,97,39,89,38,27,21,654.0,3,0,34.0,86,38,11.5,No,2013,No,No,No
Bill Edwards,289,59,279,104,55,47,921.0,107,34,84.0,172,70,23.2,Yes,2013,No,No,No
Jared Tadlock,8,1,16,3,2,1,57.0,10,1,2.0,6,2,18.2,No,2013,No,No,No
Joe Mezher,0,0,0,0,0,0,15.0,0,0,2.0,0,0,7.4,No,2013,No,No,No
Keith Appling,1509,465,1140,491,520,389,4229.0,413,138,296.0,727,353,20.7,Yes,2013,No,No,No
Gary Harris,1025,140,784,345,240,189,2141.0,388,146,111.0,396,199,24.6,Yes,2013,No,No,No
Adreian Payne,1232,85,850,447,367,277,2759.0,149,61,187.0,701,386,22.9,Yes,2013,No,No,No
Derrick Nix,823,111,602,321,315,181,2219.0,0,0,138.0,602,321,20.8,No,2013,No,No,No
Branden Dawson,1309,181,1013,566,317,177,3456.0,9,0,219.0,1004,566,21.2,Yes,2013,No,No,No
Denzel Valentine,1645,639,1309,579,285,222,4182.0,650,265,317.0,659,314,22.1,Yes,2013,No,No,No
Travis Trice,1135,387,952,371,267,191,3164.0,512,202,177.0,440,169,21.1,No,2013,No,No,No
Matt Costello,828,107,573,325,247,176,2281.0,12,2,98.0,561,323,18.0,Yes,2013,No,No,No
Russell Byrd,110,25,121,35,32,18,526.0,95,22,28.0,26,13,16.3,No,2013,No,No,No
Alex Gauna,144,10,113,63,40,18,562.0,1,0,33.0,112,63,15.3,No,2013,No,No,No
Brandan Kearney,301,99,268,109,70,46,1354.0,110,37,81.0,158,72,14.5,No,2013,No,No,No
Trevor Bohnhoff,7,0,2,1,10,5,39.0,0,0,0.0,2,1,9.1,No,2013,No,No,No
Dan Chapman,5,2,14,2,0,0,52.0,6,1,2.0,8,1,16.0,No,2013,No,No,No
Emmett Dacey,0,0,1,0,0,0,2.0,1,0,0.0,0,0,26.2,No,2013,No,No,No
Bella Sibedwo,0,1,1,0,0,0,2.0,0,0,0.0,1,0,26.2,No,2013,No,No,No
Keenan Wetzel,16,1,22,6,2,1,71.0,14,3,3.0,8,3,19.4,No,2013,No,No,No
Trey Burke,1231,416,969,436,291,226,2605.0,362,133,180.0,607,303,27.4,Yes,2013,No,No,No
Tim Hardaway Jr.,1532,225,1239,527,381,276,3560.0,589,202,182.0,650,325,25.2,Yes,2013,No,No,No
Nik Stauskas,1060,170,692,323,291,242,2471.0,390,172,111.0,302,151,21.0,Yes,2013,No,No,No
Glenn Robinson III,912,87,665,349,220,158,2506.0,179,56,78.0,486,293,18.6,Yes,2013,No,No,No
Mitch McGary,367,37,279,164,76,39,967.0,2,0,60.0,277,164,21.0,Yes,2013,No,No,No
Jordan Morgan,973,64,664,419,239,135,2988.0,0,0,171.0,664,419,17.9,No,2013,No,No,No
Jon Horford,511,42,393,205,119,87,1706.0,61,14,66.0,332,191,16.7,No,2013,No,No,No
Spike Albrecht,499,271,398,159,111,96,2277.0,224,85,82.0,174,74,13.1,No,2013,No,No,No
Caris LeVert,1070,275,843,366,265,204,2721.0,334,134,136.0,509,232,22.8,Yes,2013,No,No,No
Matt Vogrich,260,41,236,94,25,16,1152.0,162,56,35.0,74,38,13.9,No,2013,No,No,No
Max Bielfeldt,478,42,389,190,89,58,1241.0,105,40,64.0,284,150,21.1,No,2013,No,No,No
Eso Akunne,53,11,44,20,6,4,177.0,20,9,8.0,24,11,17.1,No,2013,No,No,No
Blake McLimans,91,9,107,37,6,5,415.0,63,12,12.0,44,25,16.3,No,2013,No,No,No
Corey Person,23,5,16,8,10,5,57.0,5,2,5.0,11,6,25.3,No,2013,No,No,No
Josh Bartelstein,6,4,16,2,3,0,56.0,11,2,2.0,5,0,19.6,No,2013,No,No,No
Marcos Knight,830,181,666,309,268,176,1839.0,118,36,137.0,548,273,26.1,No,2013,No,No,No
Shawn Jones,1120,49,827,447,346,226,2516.0,2,0,160.0,825,447,23.5,No,2013,No,No,No
Raymond Cintron,568,84,394,175,92,80,1473.0,317,138,79.0,77,37,18.1,No,2013,No,No,No
Neiko Hunter,698,43,541,264,196,136,1541.0,100,34,102.0,441,230,24.6,No,2013,No,No,No
Bruce Massey,433,245,339,149,191,123,1721.0,54,12,125.0,285,137,16.6,No,2013,No,No,No
Kerry Hammonds,869,206,644,273,245,183,2699.0,375,140,153.0,269,133,17.3,No,2013,No,No,No
J.T. Sulton,1019,57,758,375,363,261,2808.0,30,8,204.0,728,367,20.7,No,2013,No,No,No
Trantell Knight,388,238,279,136,183,103,1483.0,51,13,138.0,228,123,17.5,No,2013,No,No,No
James Gallman,746,126,604,241,163,120,2269.0,381,144,116.0,223,97,18.0,No,2013,No,No,No
Jason Jones,732,101,545,259,300,193,2003.0,68,21,138.0,477,238,22.4,No,2013,No,No,No
Torin Walker,105,4,89,38,39,29,377.0,0,0,24.0,89,38,18.0,No,2013,No,No,No
Jacquez Rozier,406,47,307,142,203,120,1572.0,11,2,96.0,296,140,17.0,No,2013,No,No,No
Gavin Gibson,8,3,15,2,2,2,66.0,13,2,3.0,2,0,15.1,No,2013,No,No,No
Zane Gibson,22,21,23,5,11,8,251.0,18,4,10.0,5,1,7.8,No,2013,No,No,No
Finoy Perkins,2,1,4,0,2,2,12.0,1,0,1.0,3,0,25.5,No,2013,No,No,No
Jordan Aaron,918,205,773,288,247,207,2161.0,392,135,188.0,381,153,25.9,No,2013,No,No,No
Paris Gulley,670,67,614,223,150,113,1904.0,300,111,88.0,314,112,21.3,No,2013,No,No,No
Demetrius Harris,330,22,259,121,202,87,950.0,6,1,90.0,253,120,24.5,No,2013,No,No,No
Austin Arians,1236,153,984,422,179,145,3529.0,671,247,109.0,313,175,17.0,No,2013,No,No,No
James Haarsma,1009,78,735,358,357,252,2863.0,116,41,164.0,619,317,19.6,No,2013,No,No,No
J.J. Panoske,826,103,692,312,133,109,2227.0,278,93,151.0,414,219,21.2,No,2013,No,No,No
Kyle Kelm,904,122,668,309,359,241,2805.0,182,45,171.0,486,264,18.7,No,2013,No,No,No
Ryan Haggerty,192,53,170,70,78,36,1281.0,72,16,50.0,98,54,10.4,No,2013,No,No,No
Evan Richard,137,20,140,46,36,31,638.0,59,14,31.0,81,32,15.5,No,2013,No,No,No
Thierno Niang,98,31,101,36,24,14,494.0,41,12,45.0,60,24,16.5,No,2013,No,No,No
Mitch Roelke,68,19,53,20,17,11,287.0,41,17,17.0,12,3,14.2,No,2013,No,No,No
Christian Wolf,174,20,153,56,90,62,821.0,1,0,39.0,152,56,13.0,No,2013,No,No,No
Quinton Gustavson,39,4,31,14,11,5,133.0,16,6,4.0,15,8,15.7,No,2013,No,No,No
Andre Hollins,1765,359,1341,539,499,413,3907.0,701,274,284.0,640,265,24.9,No,2013,No,No,No
Austin Hollins,1321,293,1050,452,303,236,3875.0,530,181,198.0,520,271,18.9,No,2013,No,No,No
Trevor Mbakwe,885,89,538,306,434,273,2107.0,1,0,164.0,537,306,22.2,No,2013,No,No,No
Rodney Williams,1145,197,879,450,342,199,3289.0,181,46,172.0,698,404,19.3,No,2013,No,No,No
Joe Coleman,519,94,408,190,181,128,1623.0,38,11,121.0,370,179,19.8,No,2013,No,No,No
Maverick Ahanmisi,356,143,275,106,132,96,1413.0,138,48,113.0,137,58,16.7,No,2013,No,No,No
Julian Welch,673,191,522,223,196,143,1847.0,220,84,154.0,302,139,21.7,No,2013,No,No,No
Elliott Eliason,451,116,351,184,162,83,2179.0,2,0,106.0,349,184,12.9,No,2013,No,No,No
Oto Osenieks,334,67,308,122,102,64,1231.0,111,26,74.0,197,96,18.5,No,2013,No,No,No
Maurice Walker,752,70,517,285,266,180,1704.0,5,2,145.0,512,283,23.9,No,2013,No,No,No
Andre Ingram,115,8,93,45,52,25,604.0,0,0,34.0,93,45,13.1,Yes,2013,No,No,No
Wally Ellenson,89,14,99,35,22,11,364.0,38,8,14.0,61,27,17.1,No,2013,No,No,No
Kendal Shell,17,10,21,7,2,1,86.0,7,2,6.0,14,5,16.8,No,2013,No,No,No
Chris Halvorsen,14,9,8,5,11,4,71.0,0,0,5.0,8,5,13.3,No,2013,No,No,No
Craig Sword,1492,305,1152,517,603,383,3354.0,285,75,391.0,867,442,27.9,No,2013,No,No,No
Fred Thomas,1050,143,931,340,274,204,3229.0,551,166,153.0,380,174,19.4,No,2013,No,No,No
Gavin Ware,1362,52,943,532,435,298,3328.0,1,0,185.0,942,532,20.5,No,2013,No,No,No
Colin Borchert,546,80,500,203,94,67,1651.0,229,73,133.0,271,130,20.9,No,2013,No,No,No
Roquez Johnson,862,46,609,289,448,279,2386.0,24,5,189.0,585,284,22.0,No,2013,No,No,No
Trivante Bloodman,532,221,371,152,285,206,2336.0,91,22,196.0,280,130,15.5,No,2013,No,No,No
Jalen Steele,622,72,542,200,113,97,1747.0,345,125,94.0,197,75,20.4,No,2013,No,No,No
Tyson Cunningham,133,56,123,43,28,20,918.0,75,27,51.0,48,16,10.4,No,2013,No,No,No
Wendell Lewis,628,53,487,264,166,100,2127.0,1,0,122.0,486,264,16.2,No,2013,No,No,No
Baxter Price,2,2,9,1,0,0,129.0,2,0,9.0,7,1,7.1,No,2013,No,No,No
Davon Usher,1205,102,858,374,409,311,2197.0,388,146,134.0,470,228,26.2,No,2013,No,No,No
Matt Smith,746,36,564,290,312,166,2033.0,7,0,122.0,557,290,20.0,No,2013,No,No,No
Darryl Marshall,302,113,262,89,115,79,1075.0,144,45,86.0,118,44,17.9,No,2013,No,No,No
Darius Tomlin,132,37,115,48,59,36,421.0,8,0,57.0,107,48,22.9,No,2013,No,No,No
Cameron Dobbs,227,28,248,82,29,18,549.0,168,45,28.0,80,37,25.1,No,2013,No,No,No
Julius Francis,239,15,268,95,81,47,1002.0,8,2,86.0,260,93,18.7,No,2013,No,No,No
Blake Ralling,259,39,246,85,76,53,1079.0,116,36,59.0,130,49,15.1,No,2013,No,No,No
Ervin Thomas,127,41,147,49,36,19,671.0,47,10,39.0,100,39,14.5,No,2013,No,No,No
Cordarius Samples,133,36,104,43,57,37,405.0,22,10,50.0,82,33,21.3,No,2013,No,No,No
Cortlan Henry,84,13,97,32,17,14,525.0,25,6,29.0,72,26,12.2,No,2013,No,No,No
Marcus Johnson,48,8,47,13,13,12,245.0,39,10,10.0,8,3,12.4,No,2013,No,No,No
Nate Brandt,7,5,23,3,1,0,78.0,11,1,6.0,12,2,18.2,No,2013,No,No,No
Montreal Holley,5,1,8,2,7,1,89.0,0,0,4.0,8,2,8.3,No,2013,No,No,No
Arthur Framery,0,0,0,0,0,0,10.0,0,0,0.0,0,0,0.0,No,2013,No,No,No
Marshall Henderson,1647,151,1341,495,382,325,2891.0,965,332,168.0,376,163,28.8,No,2013,No,No,No
Murphy Holloway,1476,134,1130,615,478,245,3674.0,11,1,198.0,1119,614,21.0,No,2013,No,No,No
Reginald Buckner,911,83,616,353,425,203,3212.0,4,2,169.0,612,351,15.1,No,2013,No,No,No
Jarvis Summers,1629,530,1285,520,640,463,3885.0,354,126,291.0,931,394,23.9,No,2013,No,No,No
Nick Williams,1100,157,1012,423,210,158,3598.0,311,96,172.0,701,327,18.0,No,2013,No,No,No
LaDarius White,964,175,844,336,243,170,2581.0,357,122,174.0,487,214,21.6,No,2013,No,No,No
Derrick Millinghaus,371,127,358,123,125,85,1001.0,139,40,61.0,219,83,23.0,No,2013,No,No,No
Aaron Jones,379,37,335,156,91,64,1777.0,20,3,56.0,315,153,12.0,No,2013,No,No,No
Anthony Perez,564,68,456,175,204,139,1860.0,224,75,111.0,232,100,17.3,No,2013,No,No,No
Martavious Newby,403,158,317,122,182,130,2062.0,116,29,120.0,201,93,12.4,No,2013,No,No,No
Terry Brutus,116,16,97,44,46,28,606.0,5,0,35.0,92,44,12.6,No,2013,No,No,No
Demarco Cox,573,40,447,230,219,113,2110.0,0,0,97.0,447,230,15.5,No,2013,No,No,No
Will Norman,2,0,1,1,1,0,13.0,0,0,1.0,1,1,9.3,No,2013,No,No,No
Cade Peeper,0,1,0,0,0,0,6.0,0,0,1.0,0,0,7.9,No,2013,No,No,No
Estan Tyler,796,238,653,259,192,156,2517.0,305,122,208.0,348,137,20.2,No,2013,No,No,No
Thomas Staton,621,145,557,231,153,106,1849.0,150,53,145.0,407,178,22.3,No,2013,No,No,No
Nelson Kirksey,623,89,452,221,199,135,1513.0,129,46,134.0,323,175,22.8,No,2013,No,No,No
Fred Chatmon,589,21,470,246,208,95,1911.0,30,2,134.0,440,244,19.1,No,2013,No,No,No
Nate Rogers,431,119,380,149,109,70,1328.0,183,63,124.0,197,86,22.6,No,2013,No,No,No
Kirk Korver,597,67,479,193,141,111,2038.0,308,100,107.0,171,93,17.1,No,2013,No,No,No
Trinity Hall,923,75,785,324,341,220,2675.0,217,55,196.0,568,269,22.3,No,2013,No,No,No
Brad Reid,134,10,107,56,36,22,507.0,0,0,19.0,107,56,15.2,No,2013,No,No,No
Alton Tanner,44,6,40,12,20,15,208.0,19,5,12.0,21,7,15.8,No,2013,No,No,No
Mason Wedel,50,27,62,18,7,5,384.0,41,9,16.0,21,9,11.3,No,2013,No,No,No
John Burke,125,10,103,44,32,26,405.0,39,11,34.0,64,33,19.1,No,2013,No,No,No
Aaron Washington,52,30,58,24,7,4,363.0,6,0,21.0,52,24,11.8,No,2013,No,No,No
Caleb Johnson,149,15,112,50,44,31,595.0,38,18,26.0,74,32,13.4,No,2013,No,No,No
Trevor Franklin,18,1,18,5,11,8,86.0,6,0,4.0,12,5,16.9,No,2013,No,No,No
Anthony Downing,822,162,677,282,226,182,2104.0,261,76,110.0,416,206,23.9,No,2013,No,No,No
Marcus Marshall,1502,242,1046,445,474,391,3029.0,586,221,141.0,460,224,24.6,No,2013,No,No,No
Christian Kirk,718,64,570,301,195,116,2292.0,1,0,123.0,569,301,19.1,No,2013,No,No,No
Gavin Thurman,536,55,570,202,89,68,1507.0,211,64,88.0,359,138,26.0,No,2013,No,No,No
Keith Pickens,568,105,420,199,247,159,2237.0,35,11,116.0,385,188,16.1,No,2013,No,No,No
Nathan Scheer,503,97,423,157,116,85,2416.0,308,104,91.0,115,53,13.1,No,2013,No,No,No
Dorrian Williams,663,373,656,231,196,135,3102.0,235,66,207.0,421,165,16.8,No,2013,No,No,No
Drew Wilson,147,18,116,67,62,13,857.0,1,0,31.0,115,67,11.3,No,2013,No,No,No
Bruce Marshall,61,2,53,19,20,13,286.0,31,10,12.0,22,9,14.6,No,2013,No,No,No
Michael Simpson,38,9,67,15,0,0,203.0,46,8,2.0,21,7,19.2,No,2013,No,No,No
Tomie Aromona,27,6,26,9,10,6,163.0,14,3,6.0,12,6,12.8,No,2013,No,No,No
Ryan Carmichael,5,1,4,1,2,2,15.0,3,1,0.0,1,0,18.8,No,2013,No,No,No
Laurence Bowers,1248,132,944,513,273,191,2608.0,92,31,130.0,852,482,22.1,No,2013,No,No,No
Phil Pressey,959,580,812,321,268,203,2943.0,329,114,270.0,483,207,20.5,Yes,2013,No,No,No
Alex Oriakhi,1171,49,843,447,432,277,3640.0,1,0,168.0,842,447,16.8,No,2013,No,No,No
Earnest Ross,1339,178,1064,417,442,336,3391.0,525,169,228.0,539,248,22.5,No,2013,No,No,No
Keion Bell,1708,267,1318,581,569,437,3193.0,352,109,382.0,966,472,30.7,No,2013,No,No,No
Jabari Brown,1052,103,696,307,385,301,2164.0,355,137,136.0,341,170,24.0,Yes,2013,No,No,No
Anthony Criswell,335,38,283,129,97,68,1268.0,32,9,62.0,251,120,15.7,No,2013,No,No,No
Negus Webster-Chan,347,72,332,119,46,29,1330.0,215,80,74.0,117,39,15.7,No,2013,No,No,No
Stefan Jankovic,856,67,558,283,301,227,1531.0,175,63,109.0,383,220,25.8,No,2013,No,No,No
Ryan Rosburg,530,40,353,213,204,104,2106.0,0,0,92.0,353,213,13.4,No,2013,No,No,No
Danny Feldmann,21,3,22,10,2,0,166.0,10,1,9.0,12,9,9.7,No,2013,No,No,No
Corey Haith,17,5,15,5,4,2,65.0,15,5,6.0,0,0,17.9,No,2013,No,No,No
Dominique Bull,1,1,1,0,2,1,14.0,0,0,1.0,1,0,10.3,No,2013,No,No,No
Jesse Steele,970,291,883,324,195,162,2697.0,450,160,189.0,433,164,21.5,No,2013,No,No,No
Ed Waite,1045,150,857,397,382,235,2668.0,71,16,257.0,786,381,24.8,No,2013,No,No,No
Dion Nesmith,1308,330,1110,451,315,238,3587.0,478,168,230.0,632,283,20.8,No,2013,No,No,No
Andrew Nicholas,1180,164,1129,431,218,149,2919.0,512,169,183.0,617,262,24.2,No,2013,No,No,No
Stephen Spinella,311,38,277,106,99,66,1210.0,114,33,61.0,163,73,15.5,No,2013,No,No,No
Marcus Ware,848,70,698,293,422,262,2331.0,3,0,186.0,695,293,23.1,No,2013,No,No,No
Christian White,115,33,94,37,30,17,389.0,66,24,25.0,28,13,16.7,No,2013,No,No,No
Khalil Brown,163,14,131,55,59,40,555.0,47,13,37.0,84,42,17.2,No,2013,No,No,No
Tyrone O'Garro,324,73,270,132,135,60,1773.0,2,0,105.0,268,132,12.1,No,2013,No,No,No
Gary Cox,131,2,114,39,53,41,375.0,36,12,43.0,78,27,24.7,No,2013,No,No,No
Max DiLeo,490,107,367,155,174,128,1803.0,151,52,75.0,216,103,14.9,No,2013,No,No,No
Jalen Palm,62,20,68,19,23,16,285.0,37,8,21.0,31,11,17.1,No,2013,No,No,No
Flavien Davis,700,58,511,247,294,195,1519.0,43,11,103.0,468,236,26.2,No,2013,No,No,No
Christian Moon,608,68,439,200,137,106,1500.0,261,102,57.0,178,98,18.9,No,2013,No,No,No
Antonio Biglow,494,154,423,169,168,120,1422.0,121,36,101.0,302,133,22.3,No,2013,No,No,No
Xavier Johnson-Blount,533,78,431,165,207,148,1363.0,166,55,85.0,265,110,22.8,No,2013,No,No,No
Paul Egwuonwu,534,65,429,205,171,124,1594.0,5,0,101.0,424,205,20.2,No,2013,No,No,No
Calen Coleman,392,45,328,135,65,46,1126.0,205,76,55.0,123,59,19.3,No,2013,No,No,No
Marcus Colbert,1372,453,1108,468,343,260,3400.0,460,176,269.0,648,292,23.1,No,2013,No,No,No
Michael Dison,804,162,733,282,196,132,2234.0,305,108,141.0,428,174,22.5,No,2013,No,No,No
Jamie Stewart,194,36,142,59,96,65,481.0,32,11,44.0,110,48,24.4,No,2013,No,No,No
Blake Brumwell,149,16,121,65,43,19,911.0,0,0,44.0,121,65,10.6,No,2013,No,No,No
Jeff Budinich,229,11,235,84,19,14,607.0,149,47,24.0,86,37,22.4,No,2013,No,No,No
Danny Robison,554,37,402,181,212,144,1948.0,148,48,95.0,254,133,15.7,No,2013,No,No,No
Eric Norman,318,90,312,112,69,49,1441.0,159,45,90.0,153,67,15.9,No,2013,No,No,No
Kareem Jamar,1673,407,1193,565,556,381,4032.0,426,162,263.0,767,403,23.8,No,2013,No,No,No
Mathias Ward,933,50,660,346,263,208,2213.0,76,33,114.0,584,313,22.2,No,2013,No,No,No
Will Cherry,1484,397,1138,489,564,405,3565.0,354,101,273.0,784,388,25.6,Yes,2013,No,No,No
Jordan Gregory,1234,210,903,380,340,282,3102.0,503,192,142.0,400,188,22.0,No,2013,No,No,No
Spencer Coleman,242,25,173,87,57,44,686.0,61,24,37.0,112,63,19.3,No,2013,No,No,No
Keron DeShields,1100,233,860,374,328,243,2741.0,312,109,148.0,548,265,22.8,No,2013,No,No,No
Michael Weisner,652,93,474,213,110,96,2197.0,311,130,108.0,163,83,16.3,No,2013,No,No,No
Eric Hutchison,262,10,183,96,101,70,1155.0,0,0,55.0,183,96,14.0,No,2013,No,No,No
Kevin Henderson,111,14,101,42,20,14,437.0,42,13,27.0,59,29,17.3,Yes,2013,No,No,No
Andy Martin,127,9,92,45,48,37,532.0,0,0,23.0,92,45,14.9,No,2013,No,No,No
Jacob Wiley,713,80,428,273,196,162,1225.0,8,5,133.0,420,268,27.8,Yes,2013,No,No,No
Morgan Young,3,0,4,1,2,0,18.0,4,1,0.0,0,0,15.5,No,2013,No,No,No
Nick Emerson,6,0,10,3,1,0,33.0,5,0,6.0,5,3,28.7,No,2013,No,No,No
Angelo Warner,1557,299,1105,488,520,417,3606.0,468,164,272.0,637,324,22.1,No,2013,No,No,No
Milton Chavis,586,42,480,235,124,81,1288.0,100,35,113.0,380,200,25.6,No,2013,No,No,No
Bakari Turner,355,38,294,114,132,83,776.0,157,44,61.0,137,70,25.3,No,2013,No,No,No
Devon Atkinson,289,191,241,101,69,55,1167.0,82,32,114.0,159,69,16.0,No,2013,No,No,No
Chad Posthumus,574,20,427,214,249,146,1480.0,0,0,98.0,427,214,20.5,No,2013,No,No,No
Drew Kelly,1013,103,758,339,365,271,2785.0,213,64,179.0,545,275,20.0,No,2013,No,No,No
Jarrett Stokes,155,37,156,49,32,28,505.0,103,29,27.0,53,20,18.4,No,2013,No,No,No
Kahlil Owens,278,17,196,117,97,44,774.0,0,0,58.0,196,117,19.6,No,2013,No,No,No
Maurice Lewis-Briggs,141,14,120,53,37,26,304.0,39,9,33.0,81,44,26.3,No,2013,No,No,No
Bruce Reed,113,28,75,39,40,29,402.0,15,6,34.0,60,33,14.9,No,2013,No,No,No
Jason Holmes,445,28,362,178,140,76,1497.0,37,13,104.0,325,165,17.0,No,2013,No,No,No
Cordell James,47,12,39,17,8,5,142.0,18,8,23.0,21,9,21.7,No,2013,No,No,No
Jourdan Stickler,421,55,362,144,77,57,1179.0,186,76,65.0,176,68,19.0,No,2013,No,No,No
Taariq Muhammad,16,32,25,7,6,2,208.0,7,0,29.0,18,7,12.8,No,2013,No,No,No
Jordan Percell,104,12,85,37,51,28,640.0,8,2,23.0,77,35,10.2,No,2013,No,No,No
Justin Black,1399,274,1177,486,479,297,3173.0,439,130,280.0,738,356,25.9,No,2013,No,No,No
DeWayne Jackson,1600,187,1323,562,406,287,3620.0,616,189,238.0,707,373,23.7,No,2013,No,No,No
Anthony Hubbard,701,111,535,244,314,186,1785.0,116,27,146.0,419,217,22.7,No,2013,No,No,No
Ian Chiles,1051,78,788,430,297,191,2197.0,0,0,128.0,788,430,23.5,No,2013,No,No,No
Shaquille Duncan,438,44,338,186,143,66,1505.0,2,0,93.0,336,186,16.3,No,2013,No,No,No
Blake Bozeman,914,246,939,296,195,139,3717.0,601,183,202.0,338,113,16.4,No,2013,No,No,No
Tauron Bailey,64,7,49,24,35,16,255.0,0,0,13.0,49,24,15.2,No,2013,No,No,No
Donte Pretlow,538,340,659,199,184,109,2789.0,157,31,202.0,502,168,16.7,No,2013,No,No,No
Cedric Blossom,1084,76,879,403,414,272,2886.0,31,6,126.0,848,397,20.5,No,2013,No,No,No
Thair Heath,85,11,65,37,26,11,341.0,0,0,27.0,65,37,15.0,No,2013,No,No,No
Rasean Simpson,455,32,384,157,188,127,1343.0,51,14,67.0,333,143,19.8,No,2013,No,No,No
Daon Riley,2,0,1,0,2,2,7.0,0,0,0.0,1,0,13.8,No,2013,No,No,No
Tyrece Edwards,0,0,0,0,0,0,4.0,0,0,0.0,0,0,0.0,No,2013,No,No,No
Willis Turnipseed,6,0,3,3,0,0,12.0,0,0,1.0,3,3,16.0,No,2013,No,No,No
Rashad Whack,1075,103,851,345,274,214,2269.0,482,171,133.0,369,174,25.0,No,2013,No,No,No
Sam Prescott,1210,150,1053,418,288,210,3148.0,478,164,200.0,575,254,22.9,No,2013,No,No,No
Julian Norfleet,1605,423,1402,569,312,225,4175.0,713,242,279.0,689,327,22.7,No,2013,No,No,No
Shivaughn Wiggins,1194,335,818,357,545,391,3344.0,247,89,160.0,571,268,18.6,No,2013,No,No,No
Kristijan Krajina,592,56,503,251,141,78,2035.0,69,12,160.0,434,239,19.0,No,2013,No,No,No
Raven Barber,737,31,491,287,271,163,2116.0,0,0,141.0,491,287,18.9,No,2013,No,No,No
Kelvin Parker,410,63,363,148,64,43,1306.0,212,71,64.0,151,77,18.4,No,2013,No,No,No
Xavier Owens,164,18,165,64,50,21,665.0,56,15,42.0,109,49,18.1,No,2013,No,No,No
Taylor Danaher,685,47,482,263,206,152,2375.0,31,7,120.0,451,256,15.1,No,2013,No,No,No
Josh Castellanos,619,369,541,173,280,204,2814.0,230,69,258.0,311,104,17.4,No,2013,No,No,No
Gregory Graves,827,77,662,275,339,229,2606.0,153,48,135.0,509,227,19.0,No,2013,No,No,No
Oliver Brown,10,2,13,4,2,2,42.0,5,0,4.0,8,4,22.3,No,2013,No,No,No
Aaron Brown,16,2,22,7,3,0,68.0,15,2,4.0,7,5,21.0,No,2013,No,No,No
Christian Crockett,36,3,38,11,38,14,165.0,3,0,8.0,35,11,20.9,No,2013,No,No,No
Aaron DeVan,0,0,2,0,0,0,4.0,1,0,0.0,1,0,25.8,No,2013,No,No,No
Isaiah Canaan,2050,385,1411,635,593,476,3876.0,725,304,311.0,686,331,26.7,Yes,2013,No,No,No
Stacy Wilson,554,94,467,201,102,71,1276.0,236,81,116.0,231,120,25.4,No,2013,No,No,No
Edward Daniel,931,81,560,311,508,306,2602.0,9,3,181.0,551,308,19.5,No,2013,No,No,No
Brandon Garrett,291,31,207,118,104,55,1199.0,0,0,75.0,207,118,14.2,No,2013,No,No,No
Dexter Fields,849,123,722,290,85,57,2836.0,565,212,101.0,157,78,15.7,No,2013,No,No,No
Jeffery Moss,1409,249,1047,469,309,253,4057.0,538,218,152.0,509,251,17.0,No,2013,No,No,No
Latreze Mushatt,839,120,758,327,260,146,2788.0,138,39,164.0,620,288,18.1,No,2013,No,No,No
Erik McCree,1518,107,1158,532,428,316,3082.0,404,138,228.0,754,394,25.5,Yes,2013,No,No,No
C.J. Ford,99,48,95,34,47,28,512.0,21,3,32.0,74,31,14.7,No,2013,No,No,No
Tyler Rambo,279,43,176,95,152,89,985.0,0,0,53.0,176,95,15.4,No,2013,No,No,No
Terron Gilmore,55,4,38,18,31,19,338.0,0,0,25.0,38,18,11.6,No,2013,No,No,No
Zay Henderson,29,1,18,13,13,3,166.0,0,0,9.0,18,13,10.1,No,2013,No,No,No
Jordan Burge,0,1,8,0,0,0,26.0,4,0,1.0,4,0,17.8,No,2013,No,No,No
Worth Smith,1172,89,1058,477,218,146,3205.0,231,72,180.0,827,405,23.4,No,2013,No,No,No
Tilman Dunbar,1094,434,926,379,450,310,3240.0,83,26,259.0,843,353,23.8,No,2013,No,No,No
Brandon Venturini,1017,230,1008,374,97,62,2787.0,612,207,188.0,396,167,24.9,No,2013,No,No,No
Kendall Knorr,498,138,446,169,96,80,2100.0,265,80,75.0,181,89,14.8,No,2013,No,No,No
Thurgood Wynn,339,65,265,114,160,94,1169.0,61,17,70.0,204,97,19.3,No,2013,No,No,No
Kevin Alter,193,34,161,54,45,37,619.0,148,48,25.0,13,6,18.9,No,2013,No,No,No
Will Kelly,770,86,532,298,319,174,2676.0,0,0,174.0,532,298,17.4,No,2013,No,No,No
James Loupos,283,40,254,96,132,79,1529.0,40,12,78.0,214,84,13.9,No,2013,No,No,No
Jerome Alexander,74,5,83,32,18,10,245.0,1,0,16.0,82,32,25.2,No,2013,No,No,No
Phil Guglielmo,64,3,63,22,10,8,206.0,35,12,10.0,28,10,21.7,No,2013,No,No,No
Brennan Wyatt,210,118,210,59,95,66,1031.0,111,26,89.0,99,33,17.5,No,2013,No,No,No
Jared Smoot,49,0,36,19,23,11,353.0,0,0,23.0,36,19,11.2,No,2013,No,No,No
Isaiah Roberts,406,108,336,142,149,95,1472.0,94,27,123.0,242,115,19.0,No,2013,No,No,No
Donya Jackson,97,11,92,40,17,9,345.0,26,8,26.0,66,32,20.4,No,2013,No,No,No
Ryan Spadaford,15,1,19,4,8,5,50.0,12,2,2.0,7,2,28.5,No,2013,No,No,No
Earl McLaurin,84,80,73,23,40,25,644.0,37,13,42.0,36,10,11.5,No,2013,No,No,No
Justin Simmons,823,110,709,305,180,143,1511.0,216,70,146.0,493,235,30.4,No,2013,No,No,No
John Karhoff,794,134,634,312,211,164,1694.0,25,6,98.0,609,306,23.8,No,2013,No,No,No
C.J. Carter,1199,267,957,422,322,241,2817.0,366,114,227.0,591,308,22.8,No,2013,No,No,No
Alex Welhouse,256,22,198,87,44,33,836.0,116,49,43.0,82,38,15.6,No,2013,No,No,No
Alex Phillips,411,86,326,146,90,67,1161.0,135,52,100.0,191,94,19.7,No,2013,No,No,No
Marcus Tyus,1334,168,967,451,357,268,2648.0,398,164,203.0,569,287,24.0,No,2013,No,No,No
Caleb Steffensmeier,218,102,185,69,46,35,1072.0,125,45,41.0,60,24,11.2,No,2013,No,No,No
Matt Hagerbaumer,201,37,120,90,42,21,1068.0,0,0,32.0,120,90,7.8,No,2013,No,No,No
Jacques Coleman,57,14,47,20,23,14,171.0,12,3,23.0,35,17,23.5,No,2013,No,No,No
Simon Krych,86,3,69,34,42,18,340.0,2,0,7.0,67,34,13.7,No,2013,No,No,No
Tyler Egli,33,4,34,9,10,8,130.0,27,7,3.0,7,2,16.0,No,2013,No,No,No
Koang Doluony,202,16,181,69,43,32,799.0,106,32,54.0,75,37,17.2,No,2013,No,No,No
Dylan Talley,982,180,890,344,240,177,2528.0,345,117,182.0,545,227,26.1,No,2013,No,No,No
Ray Gallegos,791,109,816,292,79,49,2786.0,517,158,79.0,299,134,18.5,No,2013,No,No,No
Brandon Ubel,893,109,646,312,299,240,3020.0,98,29,165.0,548,283,17.6,No,2013,No,No,No
Shavon Shields,1630,223,1236,562,565,429,3861.0,260,77,254.0,976,485,24.5,No,2013,No,No,No
David Rivers,411,59,377,160,138,81,2195.0,46,10,56.0,331,150,12.7,Yes,2013,No,No,No
Andre Almeida,290,37,234,123,78,44,869.0,0,0,71.0,234,123,21.7,No,2013,No,No,No
Benny Parker,459,226,416,159,137,103,2910.0,135,38,134.0,281,121,11.4,No,2013,No,No,No
Jordan Tyrance,24,4,23,8,11,8,126.0,5,0,9.0,18,8,16.8,No,2013,No,No,No
Mike Peltz,17,18,18,4,14,7,267.0,3,2,16.0,15,2,8.6,No,2013,No,No,No
Sergej Vucetic,12,0,8,6,5,0,34.0,0,0,0.0,8,6,17.1,No,2013,No,No,No
Trevor Menke,10,5,13,3,2,1,95.0,10,3,1.0,3,0,8.8,No,2013,No,No,No
Kye Kurkowski,6,0,4,3,1,0,34.0,0,0,2.0,4,3,10.6,No,2013,No,No,No
Max Ritchie,2,0,0,0,2,2,7.0,0,0,0.0,0,0,7.7,No,2013,No,No,No
Anthony Bennett,564,34,379,202,177,124,950.0,96,36,65.0,283,166,27.5,Yes,2013,No,No,No
Anthony Marshall,1280,514,973,444,472,321,3803.0,263,71,311.0,710,373,19.9,No,2013,No,No,No
Bryce Dejean-Jones,1266,272,1028,441,386,264,2888.0,357,120,212.0,671,321,25.0,Yes,2013,No,No,No
Katin Reinhardt,1444,249,1272,503,230,195,3571.0,656,243,213.0,616,260,22.0,No,2013,No,No,No
Mike Moser,1149,177,995,430,226,172,2729.0,352,117,221.0,643,313,24.1,No,2013,No,No,No
Khem Birch,611,55,392,208,292,195,1755.0,0,0,82.0,392,208,17.6,Yes,2013,No,No,No
Justin Hawkins,728,181,635,245,234,156,2696.0,290,82,90.0,345,163,15.6,No,2013,No,No,No
Quintrell Thomas,523,28,350,182,240,159,1432.0,0,0,93.0,350,182,19.5,No,2013,No,No,No
Savon Goodman,647,41,470,257,256,133,1486.0,8,0,113.0,462,257,23.8,No,2013,No,No,No
Carlos Lopez-Sosa,430,48,298,159,192,110,1202.0,9,2,85.0,289,157,19.8,No,2013,No,No,No
Daquan Cook,237,54,246,80,59,42,785.0,116,35,49.0,130,45,21.0,No,2013,No,No,No
Barry Cheaney,32,3,27,11,10,7,95.0,12,3,3.0,15,8,18.5,No,2013,No,No,No
Malik Story,1658,249,1390,563,368,262,3699.0,724,270,280.0,666,293,25.6,No,2013,No,No,No
Deonte Burton,2102,515,1479,649,826,620,4393.0,546,184,280.0,933,465,25.3,Yes,2013,No,No,No
Jerry Evans,985,100,805,344,251,188,3259.0,314,109,149.0,491,235,17.1,No,2013,No,No,No
Jordan Burris,386,91,349,132,117,84,1460.0,150,38,88.0,199,94,17.3,No,2013,No,No,No
Devonte Elliott,539,54,487,199,202,133,2026.0,41,8,121.0,446,191,18.1,No,2013,No,No,No
Kevin Panzer,454,88,433,162,120,76,1979.0,178,54,118.0,255,108,17.0,No,2013,No,No,No
Marqueze Coleman,1098,226,837,333,505,379,2694.0,186,53,226.0,651,280,24.1,No,2013,No,No,No
Cole Huff,1242,82,944,416,270,219,3132.0,487,191,120.0,457,225,19.3,No,2013,No,No,No
Ali Fall,108,16,91,39,44,30,543.0,0,0,40.0,91,39,14.7,No,2013,No,No,No
Patrick Nyeko,111,49,94,27,67,47,974.0,46,10,42.0,48,17,8.8,No,2013,No,No,No
Keith Fuetsch,50,21,44,16,20,11,238.0,21,7,20.0,23,9,15.8,No,2013,No,No,No
Brice Crook,5,0,7,1,2,2,18.0,6,1,0.0,1,0,23.0,No,2013,No,No,No
Richard Bell,2,3,4,1,0,0,50.0,1,0,1.0,3,1,5.3,No,2013,No,No,No
Ferg Myrick,979,78,868,329,344,226,2213.0,284,95,208.0,584,234,29.9,No,2013,No,No,No
Patrick Konan,1043,94,877,365,308,196,2795.0,342,117,212.0,535,248,23.6,No,2013,No,No,No
Chandler Rhoads,1015,308,955,322,485,276,3495.0,351,95,237.0,604,227,21.8,No,2013,No,No,No
Chris Pelcher,570,47,450,235,166,100,1600.0,0,0,88.0,450,235,20.6,No,2013,No,No,No
Chris Matagrano,280,29,244,117,60,41,1151.0,34,5,68.0,210,112,15.8,No,2013,No,No,No
Scott Morris,391,43,386,135,14,10,1403.0,313,111,53.0,73,24,17.2,No,2013,No,No,No
Jordon Bronner,692,260,607,223,233,160,3128.0,275,86,129.0,332,137,14.7,No,2013,No,No,No
Jeron Trotman,378,33,279,146,184,85,1247.0,13,1,83.0,266,145,18.2,No,2013,No,No,No
Logan Mortenson,28,7,33,9,6,5,140.0,19,5,7.0,14,4,16.5,No,2013,No,No,No
Chris Orozco,20,11,27,2,21,15,232.0,9,1,16.0,18,1,12.3,No,2013,No,No,No
Frank Okeke,257,42,249,81,63,41,1161.0,175,54,49.0,74,27,15.4,No,2013,No,No,No
Tommy McDonnell,96,51,91,36,34,20,815.0,12,4,50.0,79,32,10.5,No,2013,No,No,No
Garrett Jones,18,6,19,6,2,1,98.0,15,5,6.0,4,1,14.1,No,2013,No,No,No
Daniel Mullings,1677,342,1240,579,651,463,4008.0,178,56,322.0,1062,523,23.6,No,2013,No,No,No
Bandja Sy,912,122,786,330,236,161,2711.0,303,91,194.0,483,239,20.0,No,2013,No,No,No
Sim Bhullar,665,68,417,264,276,137,1643.0,0,0,107.0,417,264,20.4,Yes,2013,No,No,No
Tyrone Watson,825,266,573,296,350,209,2994.0,94,24,210.0,479,272,15.6,No,2013,No,No,No
Renaldo Dixon,578,62,394,202,215,164,1835.0,33,10,106.0,361,192,16.6,No,2013,No,No,No
Terrel de Rouen,449,127,409,157,123,79,1405.0,180,56,115.0,229,101,21.5,No,2013,No,No,No
K.C. Ross-Miller,656,256,476,181,302,240,2390.0,176,54,199.0,300,127,17.5,No,2013,No,No,No
Remi Barry,656,56,504,224,200,149,1696.0,158,59,94.0,346,165,21.3,No,2013,No,No,No
Kevin Aronis,380,23,305,125,30,19,1039.0,273,111,26.0,32,14,17.0,No,2013,No,No,No
Tshilidzi Nephawe,1087,67,692,359,550,369,2979.0,1,0,216.0,691,359,19.8,No,2013,No,No,No
B.J. West,435,30,327,169,135,96,1074.0,8,1,81.0,319,168,22.0,No,2013,No,No,No
Matej Buovac,486,40,417,148,102,80,1508.0,325,110,51.0,92,38,16.5,No,2013,No,No,No
Eric Weary,217,28,242,77,35,24,735.0,169,39,38.0,73,38,20.9,No,2013,No,No,No
Emery Coleman,0,0,1,0,0,0,12.0,0,0,2.0,1,0,12.9,No,2013,No,No,No
Kendall Williams,1813,617,1216,526,725,556,4450.0,539,205,286.0,677,321,21.7,No,2013,No,No,No
Tony Snell,952,213,738,311,201,165,2583.0,434,165,154.0,304,146,20.1,Yes,2013,No,No,No
Alex Kirk,1010,64,791,386,297,203,2552.0,139,35,132.0,652,351,22.1,Yes,2013,No,No,No
Cameron Bairstow,1239,102,808,418,559,401,2787.0,6,2,157.0,802,416,23.3,Yes,2013,No,No,No
Hugh Greenwood,1006,372,885,342,198,135,3843.0,547,187,166.0,338,155,16.0,No,2013,No,No,No
Chad Adams,396,62,295,138,113,83,1447.0,87,37,64.0,208,101,14.9,No,2013,No,No,No
Jamal Fenton,638,225,543,213,180,116,1985.0,297,96,144.0,246,117,20.1,No,2013,No,No,No
Demetrius Walker,616,115,479,181,244,180,1461.0,212,74,126.0,267,107,26.2,No,2013,No,No,No
Pancake Thomas,1179,208,911,378,301,245,2883.0,443,178,124.0,468,200,21.3,No,2013,No,No,No
Nick Banyard,456,90,419,166,123,66,2100.0,151,58,141.0,268,108,15.3,No,2013,No,No,No
Kory Alford,9,2,10,2,6,4,74.0,6,1,3.0,4,1,11.1,No,2013,No,No,No
Chris Perez,9,2,9,3,6,3,26.0,2,0,3.0,7,3,29.5,No,2013,No,No,No
Lovell Cook,369,7,278,150,87,65,718.0,7,4,40.0,271,146,23.8,No,2013,No,No,No
Rarlensee Nelson,262,172,213,90,116,79,790.0,22,3,104.0,191,87,22.4,No,2013,No,No,No
Cory Dixon,603,65,393,196,301,209,1346.0,5,2,155.0,388,194,24.2,No,2013,No,No,No
Tradarrius McPhearson,380,76,316,126,138,89,1222.0,120,39,94.0,196,87,18.4,No,2013,No,No,No
Eddie Denard,346,44,309,138,151,70,1165.0,6,0,79.0,303,138,19.5,No,2013,No,No,No
Isaac Mack,348,103,347,129,83,56,1184.0,119,34,103.0,228,95,19.5,No,2013,No,No,No
Kevin Hill,928,61,687,330,363,268,2176.0,0,0,200.0,687,330,22.9,No,2013,No,No,No
Corey Blake,108,17,112,37,33,26,372.0,40,8,40.0,72,29,21.4,No,2013,No,No,No
Evans Ganapamo,117,9,126,40,28,15,336.0,74,22,29.0,52,18,23.9,No,2013,No,No,No
Max Banchy,67,11,63,24,5,4,354.0,44,15,27.0,19,9,12.4,No,2013,No,No,No
Maurice County,44,20,45,18,6,5,225.0,16,3,12.0,29,15,12.7,No,2013,No,No,No
Tommy Hobbs,40,2,29,15,9,6,70.0,9,4,4.0,20,11,25.3,No,2013,No,No,No
Travis Avery,56,13,48,21,29,14,196.0,0,0,12.0,48,21,17.7,No,2013,No,No,No
Mitchell Parker,9,2,3,2,6,5,27.0,0,0,2.0,3,2,13.8,No,2013,No,No,No
John Reese,23,6,23,9,2,1,99.0,11,4,4.0,12,5,13.3,No,2013,No,No,No
Joseph Hebert,0,0,1,0,0,0,4.0,1,0,0.0,0,0,11.9,No,2013,No,No,No
Benjamin James,0,0,0,0,0,0,5.0,0,0,3.0,0,0,28.3,No,2013,No,No,No
Darrell Williams,0,7,2,0,0,0,21.0,2,0,4.0,0,0,13.6,No,2013,No,No,No
Juan'ya Green,2317,773,1752,695,842,681,5002.0,719,246,391.0,1033,449,25.0,No,2013,No,No,No
Antoine Mason,2308,192,1734,727,941,685,4282.0,543,169,288.0,1191,558,28.0,No,2013,No,No,No
Ameen Tanksley,1750,174,1380,574,534,384,4193.0,599,218,220.0,781,356,21.7,No,2013,No,No,No
T.J. Cline,1909,398,1397,730,408,267,3575.0,519,182,250.0,878,548,27.4,No,2013,No,No,No
Marvin Jordan,1278,253,1152,420,234,164,3889.0,814,274,184.0,338,146,18.1,No,2013,No,No,No
Devon White,544,44,464,225,169,94,1758.0,1,0,128.0,463,225,18.9,No,2013,No,No,No
Tahjere McCall,1170,363,908,388,536,363,3047.0,135,31,322.0,773,357,23.9,Yes,2013,No,No,No
Malcolm Lemmons,476,72,417,153,177,132,1722.0,144,38,113.0,273,115,17.7,No,2013,No,No,No
Joe Thomas,332,37,271,151,99,30,1550.0,0,0,70.0,271,151,12.3,Yes,2013,No,No,No
Scooter Gillette,600,33,395,220,245,160,2122.0,2,0,112.0,393,220,14.7,No,2013,No,No,No
Lawrence Johnson,1,1,1,0,2,1,5.0,0,0,0.0,1,0,19.2,No,2013,No,No,No
Skylar Jones,183,10,209,64,45,29,681.0,99,26,33.0,110,38,19.3,No,2013,No,No,No
Fred Hunter,1595,152,1076,584,581,373,2994.0,196,54,248.0,880,530,29.7,No,2013,No,No,No
Dantrell Thomas,1215,207,902,431,401,300,2575.0,180,53,187.0,722,378,26.0,No,2013,No,No,No
T.J. Carpenter,1221,219,1094,403,317,218,3271.0,637,197,241.0,457,206,23.1,No,2013,No,No,No
Jeremy Smith,846,112,604,327,235,162,2181.0,88,30,171.0,516,297,21.1,No,2013,No,No,No
Amin Torres,575,89,476,191,142,111,1222.0,237,82,122.0,239,109,28.0,No,2013,No,No,No
Schane Rillieux,730,322,608,231,411,228,3594.0,154,40,266.0,454,191,15.2,No,2013,No,No,No
JaMarkus Horace,259,26,238,111,92,37,927.0,0,0,85.0,238,111,20.4,No,2013,No,No,No
Linden Smith-Hyde,166,25,160,60,28,17,849.0,97,29,35.0,63,31,12.6,No,2013,No,No,No
Pedro Maciel,66,59,60,21,13,8,595.0,49,16,34.0,11,5,8.7,No,2013,No,No,No
Sam McBeath,698,138,577,240,202,127,1988.0,289,91,165.0,288,149,21.6,No,2013,No,No,No
Lachlan Prest,113,29,104,40,7,6,523.0,75,27,30.0,29,13,13.5,No,2013,No,No,No
Sterling Bailey,65,6,55,22,15,7,263.0,39,14,19.0,16,8,15.8,No,2013,No,No,No
Travis Julien,99,18,95,41,50,17,485.0,12,0,36.0,83,41,16.3,No,2013,No,No,No
Zachary West,6,7,8,2,2,1,91.0,5,1,5.0,3,1,7.9,No,2013,No,No,No
Chris Flores,1726,330,1463,587,442,315,3726.0,664,237,265.0,799,350,26.0,No,2013,No,No,No
Ryan Woods,682,78,532,218,133,108,1627.0,331,138,67.0,201,80,20.4,No,2013,No,No,No
P.J. Miller,819,323,695,296,371,223,2943.0,45,4,254.0,650,292,19.1,No,2013,No,No,No
Ky Howard,1139,416,795,380,479,333,3172.0,124,46,319.0,671,334,21.3,No,2013,No,No,No
Daquan Holiday,470,58,310,179,180,112,1679.0,0,0,99.0,310,179,15.0,No,2013,No,No,No
Nigel Sydnor,243,44,197,79,96,60,818.0,79,25,46.0,118,54,17.6,No,2013,No,No,No
Odera Nweke,329,71,261,112,167,104,1540.0,7,1,92.0,254,111,14.2,No,2013,No,No,No
Sean McCarthy,172,15,179,74,61,24,925.0,0,0,68.0,179,74,14.8,No,2013,No,No,No
Quentin Bastian,260,15,247,107,70,46,837.0,2,0,51.0,245,107,20.7,No,2013,No,No,No
Terrence Smith,621,44,469,275,111,71,1613.0,0,0,77.0,469,275,18.7,No,2013,No,No,No
Mitch Farrell,43,2,32,14,10,7,99.0,21,8,7.0,11,6,21.8,No,2013,No,No,No
Pendarvis Williams,1646,269,1166,545,417,339,3913.0,566,217,214.0,600,328,20.2,No,2013,No,No,No
Malcolm Hawkins,911,118,712,280,355,253,2112.0,278,98,191.0,434,182,25.7,No,2013,No,No,No
Rob Johnson,693,111,697,254,193,128,2185.0,225,57,146.0,472,197,22.0,No,2013,No,No,No
Brandon Goode,679,27,459,274,225,131,1825.0,1,0,116.0,458,274,18.8,No,2013,No,No,No
Rashid Gaston,1191,86,835,485,414,221,2798.0,0,0,189.0,835,485,22.3,No,2013,No,No,No
Kris Brown,174,44,172,64,50,26,776.0,67,20,53.0,105,44,15.8,No,2013,No,No,No
Jamel Fuentes,565,552,499,178,361,205,3141.0,27,4,284.0,472,174,15.4,No,2013,No,No,No
Marese Phelps,195,104,226,73,39,22,886.0,98,27,82.0,128,46,18.7,No,2013,No,No,No
Kievyn Lila-St. Rose,151,17,173,56,29,18,630.0,81,21,44.0,92,35,18.5,No,2013,No,No,No
Zieyik Estime,56,1,59,19,2,2,148.0,50,16,6.0,9,3,22.2,No,2013,No,No,No
A.J. Rogers,132,13,107,52,54,28,628.0,0,0,39.0,107,52,13.7,No,2013,No,No,No
Jordan Weathers,94,20,101,33,37,21,461.0,41,7,25.0,60,26,15.6,No,2013,No,No,No
Riley Maye,174,14,141,74,29,17,558.0,19,9,30.0,122,65,16.9,No,2013,No,No,No
Paulius Vinogradovas,26,2,29,10,18,6,240.0,0,0,13.0,29,10,10.9,No,2013,No,No,No
Quasim Pugh,86,41,78,23,48,35,387.0,26,5,34.0,52,18,17.4,No,2013,No,No,No
Jeremy Atkinson,967,156,660,334,330,256,2107.0,132,43,137.0,528,291,22.2,No,2013,No,No,No
Keith Hornsby,1291,213,1015,446,269,223,3217.0,451,176,158.0,564,270,19.7,No,2013,No,No,No
Trent Meyer,436,181,408,147,76,57,1681.0,263,85,107.0,145,62,16.1,No,2013,No,No,No
Will Weeks,805,211,566,309,346,187,2883.0,0,0,174.0,566,309,15.6,No,2013,No,No,No
D.J. Cunningham,998,97,815,394,317,209,2650.0,4,1,221.0,811,393,21.6,No,2013,No,No,No
Jon Nwannunu,342,28,272,139,85,64,965.0,2,0,55.0,270,139,18.6,No,2013,No,No,No
Sam Hughes,904,127,749,340,249,177,2568.0,138,47,181.0,611,293,20.0,No,2013,No,No,No
Corey Littlejohn,424,135,353,140,139,105,1674.0,122,39,133.0,231,101,16.2,No,2013,No,No,No
Marcus Neely,164,48,188,65,55,33,1043.0,25,1,41.0,163,64,12.1,No,2013,No,No,No
Jaleel Roberts,373,24,265,154,100,65,1106.0,1,0,71.0,264,154,17.1,No,2013,No,No,No
Josh Seligson,19,3,18,7,8,5,70.0,4,0,9.0,14,7,21.5,No,2013,No,No,No
Zack Davis,3,1,3,1,0,0,10.0,3,1,1.0,0,0,19.6,No,2013,No,No,No
Drew Combs,0,0,0,0,0,0,1.0,0,0,0.0,0,0,0.0,No,2013,No,No,No
Lamont Middleton,1016,149,783,274,518,388,2267.0,275,80,198.0,508,194,27.6,No,2013,No,No,No
Adrian Powell,1054,161,897,382,263,172,2910.0,343,118,219.0,554,264,21.3,No,2013,No,No,No
Jean Louisme,494,76,447,154,142,105,1443.0,287,81,97.0,160,73,21.4,No,2013,No,No,No
Bruce Beckford,1443,107,1115,509,477,361,3473.0,231,64,286.0,884,445,24.2,No,2013,No,No,No
Austin Witter,705,221,686,268,123,61,3269.0,370,108,220.0,316,160,14.6,No,2013,No,No,No
Jeremy Underwood,769,255,634,207,348,241,2761.0,345,114,313.0,289,93,20.1,No,2013,No,No,No
DaMetrius Upchurch,479,37,370,184,208,110,1559.0,4,1,124.0,366,183,18.8,No,2013,No,No,No
R.J. Buck,435,81,306,143,224,141,1725.0,39,8,89.0,267,135,14.3,No,2013,No,No,No
Lawrence Smith,189,26,163,63,93,62,961.0,12,1,58.0,151,62,13.5,No,2013,No,No,No
Shaun Stewart,176,40,179,62,26,18,627.0,117,34,29.0,62,28,18.0,No,2013,No,No,No
Khalid King,16,2,21,5,5,3,48.0,13,3,3.0,8,2,28.4,No,2013,No,No,No
Dominique Behonh-Tolly,19,2,12,6,13,7,75.0,0,0,4.0,12,6,14.8,No,2013,No,No,No
Waylan Siverand,134,10,96,49,65,36,581.0,0,0,35.0,96,49,13.9,No,2013,No,No,No
Corvon Butler,428,37,341,178,97,71,1063.0,25,1,52.0,316,177,20.1,No,2013,No,No,No
Ahmad Abdullah,554,198,492,188,148,113,2194.0,181,65,127.0,311,123,16.2,No,2013,No,No,No
Jeremy Ingram,1525,123,1062,459,568,437,3035.0,464,170,201.0,598,289,26.6,No,2013,No,No,No
Stanton Kidd,841,93,632,321,200,143,2020.0,143,56,114.0,489,265,22.0,Yes,2013,No,No,No
Ray Willis,926,140,691,287,359,290,2264.0,199,62,186.0,492,225,24.2,No,2013,No,No,No
Jay Copeland,523,16,343,187,240,149,1613.0,0,0,114.0,343,187,18.6,No,2013,No,No,No
Emanuel Chapman,533,617,480,194,113,83,3158.0,181,62,276.0,299,132,13.5,No,2013,No,No,No
Alfonzo Houston,430,62,326,143,182,135,1263.0,41,9,57.0,285,134,19.6,No,2013,No,No,No
Drimir Ferguson,105,53,70,27,54,44,375.0,20,7,32.0,50,20,18.3,No,2013,No,No,No
Antonin Galaya,101,12,111,33,12,9,284.0,93,26,15.0,18,7,24.8,No,2013,No,No,No
Karamo Jawara,620,213,479,222,191,133,2841.0,142,43,131.0,337,179,13.3,No,2013,No,No,No
DavRon Williams,281,25,194,112,99,57,886.0,1,0,55.0,193,112,18.1,No,2013,No,No,No
Ebuka Anyaorah,457,50,356,147,152,108,1327.0,160,55,100.0,196,92,20.6,No,2013,No,No,No
Jordan Marrow,6,0,3,1,4,3,16.0,2,1,1.0,1,0,19.9,No,2013,No,No,No
Nathaniel Sims,4,0,4,2,4,0,15.0,0,0,0.0,4,2,21.2,No,2013,No,No,No
Rashawn King,2,1,4,1,0,0,3.0,1,0,1.0,3,1,89.7,No,2013,No,No,No
Trevis Simpson,1409,83,1213,488,368,279,2315.0,466,154,171.0,747,334,32.1,No,2013,No,No,No
Derrell Armstrong,842,133,693,298,234,178,1566.0,201,68,165.0,492,230,29.4,No,2013,No,No,No
Kayel Locke,1522,134,1261,569,512,341,3557.0,162,43,226.0,1099,526,24.4,No,2013,No,No,No
Nicholas Paulos,1030,112,835,352,77,64,3147.0,666,262,127.0,169,90,15.6,No,2013,No,No,No
Kelvin McNeil,523,72,454,194,249,130,2229.0,34,5,130.0,420,189,16.3,No,2013,No,No,No
David Williams,474,104,356,175,232,111,2059.0,35,13,184.0,321,162,15.1,No,2013,No,No,No
Korey VanDussen,739,220,641,268,163,125,2565.0,226,78,189.0,415,190,17.0,No,2013,No,No,No
Drew Parker,371,294,351,120,70,50,2467.0,227,81,169.0,124,39,10.8,No,2013,No,No,No
Jordan Potts,792,240,666,240,225,176,2233.0,411,136,161.0,255,104,20.5,No,2013,No,No,No
Taylor Hoffer,52,9,51,17,25,15,464.0,11,3,22.0,40,14,8.7,No,2013,No,No,No
RJ White,1460,130,1053,591,383,235,3122.0,127,43,222.0,926,548,23.5,No,2013,No,No,No
Brian Cole,366,12,336,151,54,34,970.0,86,30,52.0,250,121,20.7,No,2013,No,No,No
Tyler McNeely,7,0,6,2,4,3,18.0,0,0,3.0,6,2,26.8,No,2013,No,No,No
Kendall Bethea,4,1,2,1,2,2,13.0,1,0,1.0,1,1,14.5,No,2013,No,No,No
Thomas Sumpter,2,0,1,1,0,0,8.0,0,0,0.0,1,1,6.0,No,2013,No,No,No
Demetrius Robinson,0,0,3,0,0,0,14.0,0,0,0.0,3,0,10.2,No,2013,No,No,No
C.J. Leslie,1359,113,1020,507,564,332,2859.0,48,13,236.0,972,494,26.6,No,2013,No,No,No
Richard Howell,1214,147,936,485,379,240,3058.0,18,4,194.0,918,481,21.5,No,2013,No,No,No
Scott Wood,1467,190,1065,450,263,233,4372.0,809,334,141.0,256,116,15.3,No,2013,No,No,No
T.J. Warren,1296,68,951,528,298,195,2182.0,143,45,117.0,808,483,28.6,Yes,2013,No,No,No
Lorenzo Brown,1167,589,955,410,382,283,3289.0,210,64,304.0,745,346,21.8,Yes,2013,No,No,No
Rodney Purvis,1593,243,1367,568,354,226,4097.0,636,231,227.0,731,337,22.9,Yes,2013,No,No,No
Tyler Lewis,669,402,507,207,241,192,2435.0,209,63,116.0,298,144,15.6,No,2013,No,No,No
Jordan Vandenberg,238,47,175,107,48,24,1317.0,1,0,45.0,174,107,9.5,No,2013,No,No,No
Thomas de Thaey,38,7,44,15,4,3,134.0,20,5,6.0,24,10,19.4,No,2013,No,No,No
Jay Lewis,6,3,12,2,0,0,33.0,9,2,4.0,3,0,24.2,No,2013,No,No,No
Staats Battle,19,2,25,7,3,0,39.0,23,5,1.0,2,2,35.9,No,2013,No,No,No
Jevoni Robinson,7,0,5,2,4,3,19.0,0,0,2.0,5,2,23.6,No,2013,No,No,No
Chase Cannon,7,2,14,3,2,0,32.0,8,1,2.0,6,2,27.0,No,2013,No,No,No
Keith Rendleman,1516,95,1103,594,538,318,3657.0,29,10,217.0,1074,584,22.3,No,2013,No,No,No
Chris Dixon,517,161,488,181,138,98,1571.0,198,57,139.0,290,124,22.8,No,2013,No,No,No
Craig Ponder,1160,257,965,393,367,252,3216.0,321,122,222.0,644,271,21.3,No,2013,No,No,No
Cedrick Williams,974,89,793,376,316,213,3319.0,37,9,139.0,756,367,16.7,No,2013,No,No,No
Tanner Milson,719,211,659,228,123,92,2714.0,471,171,195.0,188,57,17.6,No,2013,No,No,No
Freddie Jackson,932,206,833,352,232,148,3168.0,266,80,207.0,567,272,18.6,No,2013,No,No,No
Tyree Graham,127,38,133,39,30,25,386.0,81,24,41.0,52,15,28.0,No,2013,No,No,No
Luke Hager,190,27,203,74,63,34,777.0,39,8,53.0,164,66,19.0,No,2013,No,No,No
Dylan Sherwood,462,26,402,170,60,42,1325.0,238,80,49.0,164,90,18.2,No,2013,No,No,No
Shane Reybold,237,19,183,91,96,55,977.0,0,0,46.0,183,91,14.6,No,2013,No,No,No
Nate Anderson,70,1,53,24,13,8,175.0,31,14,9.0,22,10,19.8,No,2013,No,No,No
C.J. Gettys,551,64,432,222,165,107,1648.0,0,0,90.0,432,222,18.0,No,2013,No,No,No
Matt Wilson,235,30,180,90,99,54,1143.0,1,1,76.0,179,89,14.1,No,2013,No,No,No
Marcus Graham,32,5,30,11,12,8,76.0,8,2,2.0,22,9,25.7,No,2013,No,No,No
Zack Allen,0,1,3,0,0,0,14.0,3,0,0.0,0,0,11.1,No,2013,No,No,No
Alex Kilmartin,0,0,0,0,0,0,1.0,0,0,0.0,0,0,0.0,No,2013,No,No,No
James Michael McAdoo,1232,111,1044,467,524,298,2696.0,9,0,173.0,1035,467,25.5,Yes,2013,No,No,No
P.J. Hairston,707,74,567,220,175,140,1286.0,364,127,66.0,203,93,25.8,No,2013,No,No,No
Reggie Bullock,989,169,815,358,118,85,2457.0,486,188,94.0,329,170,18.2,Yes,2013,No,No,No
Marcus Paige,1844,602,1471,599,411,347,4570.0,798,299,274.0,673,300,20.2,Yes,2013,No,No,No
Dexter Strickland,899,342,702,323,339,233,3083.0,91,20,189.0,611,303,15.8,No,2013,No,No,No
Leslie McDonald,841,115,786,287,173,120,2129.0,442,147,96.0,344,140,21.1,No,2013,No,No,No
Brice Johnson,1716,133,1242,714,407,288,3102.0,0,0,188.0,1242,714,24.9,Yes,2013,No,No,No
J.P. Tokoto,722,293,617,285,241,131,2383.0,79,21,180.0,538,264,18.3,No,2013,No,No,No
Joel James,293,18,272,123,75,47,1188.0,0,0,73.0,272,123,15.2,No,2013,No,No,No
Jackson Simmons,129,19,89,53,42,23,562.0,0,0,14.0,89,53,10.3,No,2013,No,No,No
Desmond Hubert,84,14,73,36,53,12,729.0,0,0,35.0,73,36,8.6,No,2013,No,No,No
Luke Davis,241,171,219,75,68,48,1251.0,134,43,108.0,85,32,14.8,No,2013,No,No,No
Wade Moody,14,8,13,5,0,0,43.0,8,4,5.0,5,1,19.8,No,2013,No,No,No
James Manor,12,1,17,5,0,0,30.0,8,2,0.0,9,3,26.7,No,2013,No,No,No
Denzel Robinson,4,1,4,2,0,0,30.0,0,0,2.0,4,2,9.5,No,2013,No,No,No
Frank Tanner,2,1,8,1,0,0,20.0,3,0,3.0,5,1,25.9,No,2013,No,No,No
Marshall Bjorklund,1440,122,907,592,405,256,3221.0,0,0,173.0,907,592,21.4,No,2013,No,No,No
Taylor Braun,1651,338,1105,536,581,454,3495.0,302,125,268.0,803,411,25.5,No,2013,No,No,No
Lawrence Alexander,1755,408,1362,587,491,374,4629.0,532,207,320.0,830,380,23.1,No,2013,No,No,No
TrayVonn Wright,1131,84,957,443,201,143,3128.0,320,102,114.0,637,341,20.3,No,2013,No,No,No
Mike Felt,978,72,779,315,124,104,2294.0,607,244,76.0,172,71,21.5,No,2013,No,No,No
Kory Brown,934,244,687,349,293,204,3344.0,106,32,203.0,581,317,17.1,No,2013,No,No,No
Chris Kading,499,39,379,197,126,77,2350.0,113,28,37.0,266,169,11.3,No,2013,No,No,No
Nate Zastrow,369,153,304,91,147,121,1284.0,188,66,101.0,116,25,19.0,No,2013,No,No,No
Brett VandenBergh,59,24,50,20,8,3,505.0,37,16,15.0,13,4,7.7,No,2013,No,No,No
Jordan Aaberg,401,24,270,167,85,67,1287.0,0,0,68.0,270,167,15.7,No,2013,No,No,No
Fred Newell,41,13,39,13,21,12,154.0,13,3,9.0,26,10,20.6,No,2013,No,No,No
Jamie Mauch,12,1,16,3,4,3,33.0,13,3,2.0,3,0,34.3,No,2013,No,No,No
Troy Huff,2005,172,1609,698,686,468,3596.0,479,141,271.0,1130,557,31.4,No,2013,No,No,No
Aaron Anderson,1430,359,943,415,555,451,3772.0,362,149,207.0,581,266,19.2,No,2013,No,No,No
Jamal Webb,1165,483,969,438,296,173,3935.0,334,116,389.0,635,322,19.5,No,2013,No,No,No
Josh Schuler,852,179,712,273,229,180,2904.0,365,126,93.0,347,147,16.2,No,2013,No,No,No
Mitch Wilmer,271,11,224,86,138,98,1085.0,5,1,97.0,219,85,18.4,No,2013,No,No,No
Lenny Antwi,494,83,445,167,80,60,1796.0,277,100,74.0,168,67,16.0,No,2013,No,No,No
Brandon Brekke,567,33,370,229,188,109,1466.0,0,0,111.0,370,229,20.0,No,2013,No,No,No
Jordan Allard,431,79,422,157,178,98,1972.0,94,19,119.0,328,138,16.6,No,2013,No,No,No
Shane Benton,138,28,130,45,57,32,638.0,59,16,31.0,71,29,15.1,No,2013,No,No,No
Doug Archer,153,32,124,60,51,28,829.0,25,5,60.0,99,55,13.1,No,2013,No,No,No
Alonzo Traylor,283,4,202,119,79,45,647.0,0,0,35.0,202,119,21.4,No,2013,No,No,No
Dan Stockdale,15,0,14,6,6,3,48.0,4,0,2.0,10,6,20.4,No,2013,No,No,No
Parker Smith,1665,130,1222,500,359,304,3314.0,903,361,214.0,319,139,24.8,No,2013,No,No,No
Travis Wallace,1338,100,1048,552,384,233,2670.0,4,1,173.0,1044,551,26.7,No,2013,No,No,No
Beau Beech,1557,184,1193,505,322,245,3817.0,769,302,227.0,424,203,20.8,No,2013,No,No,No
Charles McRoy,651,101,563,230,200,139,2249.0,188,52,149.0,375,178,18.3,No,2013,No,No,No
Andy Diaz,1094,95,844,460,425,174,2666.0,3,0,283.0,841,460,26.1,No,2013,No,No,No
BaeBae Daniels,1022,111,780,375,251,178,2601.0,275,94,126.0,505,281,19.9,No,2013,No,No,No
David Jeune,434,81,369,151,174,115,2518.0,85,17,170.0,284,134,12.9,No,2013,No,No,No
William Wilson,238,379,264,91,75,39,2321.0,57,17,201.0,207,74,11.3,No,2013,No,No,No
Ray Rodriguez,306,102,275,100,45,31,1260.0,213,75,108.0,62,25,16.9,No,2013,No,No,No
Jerron Granberry,1273,167,978,365,378,310,3766.0,654,233,204.0,324,132,19.4,No,2013,No,No,No
Cameron Naylor,567,41,508,217,180,127,1661.0,37,6,106.0,471,211,22.5,No,2013,No,No,No
Jibril Smith,2,0,2,1,0,0,4.0,0,0,0.0,2,1,26.0,No,2013,No,No,No
Fred Landers,79,11,80,31,15,9,302.0,31,8,11.0,49,23,16.8,No,2013,No,No,No
Jordan Williams,1501,126,1249,504,469,350,3389.0,477,143,253.0,772,361,25.6,Yes,2013,No,No,No
Tony Mitchell,755,62,526,258,272,191,1713.0,141,48,143.0,385,210,23.2,Yes,2013,No,No,No
Roger Franklin,760,81,658,301,215,153,2343.0,22,5,124.0,636,296,18.8,No,2013,No,No,No
Alzee Williams,1064,144,858,381,381,285,3137.0,77,17,125.0,781,364,18.4,No,2013,No,No,No
Chris Jones,648,282,573,237,216,148,1769.0,100,26,180.0,473,211,24.0,No,2013,No,No,No
P.J. Hardwick,265,230,240,87,115,88,1676.0,15,3,137.0,225,84,13.0,No,2013,No,No,No
Jacob Holmen,539,49,511,208,109,85,1493.0,127,38,74.0,384,170,21.4,No,2013,No,No,No
Niko Stojilkovic,193,62,185,63,91,57,860.0,52,10,58.0,133,53,16.6,No,2013,No,No,No
Justin Patton,495,53,433,171,227,137,1122.0,67,16,108.0,366,155,28.9,Yes,2013,No,No,No
Keith Coleman,126,8,138,54,44,18,671.0,0,0,67.0,138,54,16.7,No,2013,No,No,No
Clarke Overlander,31,5,52,10,7,4,207.0,46,7,5.0,6,3,14.6,No,2013,No,No,No
Austin Mitchell,0,0,1,0,0,0,18.0,0,0,2.0,1,0,8.3,No,2013,No,No,No
Brandan Walton,502,53,417,160,129,86,1351.0,265,96,66.0,152,64,19.9,No,2013,No,No,No
Joel Smith,1328,248,996,440,241,205,3278.0,609,243,218.0,387,197,22.0,No,2013,No,No,No
Quincy Ford,1617,245,1277,526,478,361,4148.0,585,204,269.0,692,322,23.1,No,2013,No,No,No
Jonathan Lee,1161,293,811,374,382,305,2914.0,267,108,255.0,544,266,23.2,No,2013,No,No,No
Reggie Spencer,992,128,744,375,361,241,3192.0,2,1,186.0,742,374,18.6,No,2013,No,No,No
David Walker,1631,420,1200,517,418,347,4710.0,653,250,244.0,547,267,18.8,No,2013,No,No,No
Demetrius Pollard,707,145,630,230,173,119,2153.0,394,128,128.0,236,102,20.4,No,2013,No,No,No
Zach Stahl,1030,198,787,397,327,226,3125.0,39,10,253.0,748,387,20.6,No,2013,No,No,No
Dinko Marshavelski,187,8,151,76,47,35,498.0,0,0,40.0,151,76,23.5,No,2013,No,No,No
Marco Banegas-Flores,363,131,315,113,141,97,1655.0,113,40,141.0,202,73,17.2,No,2013,No,No,No
Derrico Peck,382,68,266,168,109,45,1686.0,7,1,91.0,259,167,12.4,No,2013,No,No,No
Chris Avenant,57,13,62,21,8,6,386.0,35,9,21.0,27,12,12.1,No,2013,No,No,No
Gabe Rogers,1419,245,1289,500,220,173,3265.0,636,246,236.0,653,254,25.9,No,2013,No,No,No
Dewayne Russell,1711,525,1397,565,623,459,3962.0,330,122,297.0,1067,443,25.4,No,2013,No,No,No
Max Jacobsen,727,85,542,315,143,92,1767.0,18,5,131.0,524,310,22.1,No,2013,No,No,No
Stallon Saldivar,553,505,519,188,147,114,3117.0,220,63,217.0,299,125,13.4,No,2013,No,No,No
Gaellen Bewernick,774,142,664,337,148,81,3329.0,76,19,185.0,588,318,14.4,No,2013,No,No,No
Michael Dunn,400,109,332,129,133,102,1518.0,140,40,102.0,192,89,16.9,No,2013,No,No,No
Ephraim Ekanem,254,9,218,106,97,42,815.0,0,0,41.0,218,106,19.2,No,2013,No,No,No
Blake Hamilton,1072,233,838,364,308,229,2048.0,314,115,226.0,524,249,28.1,No,2013,No,No,No
Jordyn Martin,881,117,681,366,217,140,3143.0,21,9,156.0,660,357,15.0,No,2013,No,No,No
Luis Flores,77,19,66,26,20,10,312.0,42,15,23.0,24,11,16.3,Yes,2013,No,No,No
Ben Olayinka,55,7,44,21,25,13,265.0,0,0,21.0,44,21,14.9,No,2013,No,No,No
Chris Heine,12,3,12,4,4,3,56.0,8,1,8.0,4,3,20.6,No,2013,No,No,No
Bryce Gosar,0,1,1,0,0,0,7.0,1,0,2.0,0,0,22.1,No,2013,No,No,No
Nick Wahl,0,0,0,0,0,0,0.0,0,0,0.0,0,0,0,No,2013,No,No,No
Derrick Barden,872,69,613,343,230,153,1973.0,79,33,83.0,534,310,21.5,No,2013,No,No,No
Tate Unruh,1194,139,890,406,150,141,2963.0,559,241,142.0,331,165,19.5,No,2013,No,No,No
Tevin Svihovec,1391,331,1080,474,473,359,3539.0,230,84,260.0,850,390,23.3,No,2013,No,No,No
Tim Huskisson,1058,165,731,378,335,222,2576.0,211,80,186.0,520,298,22.0,No,2013,No,No,No
Paul Garnica,609,172,509,218,84,66,1658.0,259,107,144.0,250,111,21.6,No,2013,No,No,No
Connor Osborne,542,63,408,210,232,121,1977.0,4,1,126.0,404,209,17.0,No,2013,No,No,No
Emmanuel Addo,729,66,520,258,243,174,1811.0,96,39,139.0,424,219,22.2,No,2013,No,No,No
Greg Tucker,757,146,612,207,280,225,2143.0,366,118,139.0,246,89,21.7,No,2013,No,No,No
Bryce Douvier,707,54,491,235,225,177,1858.0,153,60,131.0,338,175,20.2,No,2013,No,No,No
James Davis,40,22,52,14,6,5,246.0,32,7,15.0,20,7,14.8,Yes,2013,No,No,No
Brendan Keane,99,8,106,38,39,22,461.0,4,1,25.0,102,37,16.9,No,2013,No,No,No
Cody McDavis,264,12,215,110,61,43,873.0,3,1,39.0,212,109,17.3,No,2013,No,No,No
Dylan Elias,7,2,4,2,2,2,18.0,3,1,1.0,1,1,17.2,No,2013,No,No,No
Xzaivier James,18,9,11,6,9,4,109.0,7,2,9.0,4,4,11.7,No,2013,No,No,No
Abdel Nader,1207,127,1106,432,294,215,2845.0,420,128,267.0,686,304,27.5,Yes,2013,No,No,No
Aksel Bolin,671,123,516,223,216,151,2633.0,223,74,160.0,293,149,15.5,No,2013,No,No,No
Darrell Bowie,871,91,709,302,465,250,2532.0,62,17,248.0,647,285,24.2,No,2013,No,No,No
Akeem Springs,1151,159,981,406,266,190,3014.0,449,149,155.0,532,257,21.7,No,2013,No,No,No
Kevin Gray,251,33,254,97,111,57,1479.0,1,0,73.0,253,97,13.6,No,2013,No,No,No
Keith Gray,311,18,236,95,170,121,1206.0,0,0,93.0,236,95,18.0,No,2013,No,No,No
Travon Baker,996,356,866,293,362,265,3306.0,469,145,257.0,397,148,20.1,No,2013,No,No,No
Mike Davis,109,7,110,37,53,32,400.0,16,3,20.0,94,34,20.7,Yes,2013,No,No,No
Daveon Balls,225,99,249,73,70,56,1157.0,95,23,91.0,154,50,17.0,No,2013,No,No,No
Sam Mader,89,10,88,37,18,13,384.0,7,2,20.0,81,35,16.2,No,2013,No,No,No
Antone Christian,422,62,440,143,85,66,1323.0,242,70,82.0,198,73,22.0,No,2013,No,No,No
J.J. Cravatta,145,12,136,39,49,35,513.0,110,32,21.0,26,7,18.5,No,2013,No,No,No
Tony Nixon,468,52,452,162,101,61,1597.0,260,83,71.0,192,79,18.2,No,2013,No,No,No
Brandon Hayes,2,0,1,0,2,2,18.0,0,0,0.0,1,0,5.8,No,2013,No,No,No
Anthony James,1305,148,1107,481,280,213,3074.0,328,130,182.0,779,351,26.4,No,2013,No,No,No
Seth Tuttle,1747,282,1041,600,675,508,3672.0,109,39,270.0,932,561,25.5,No,2013,No,No,No
Marc Sonnen,932,157,748,309,144,113,3351.0,480,201,107.0,268,108,15.7,No,2013,No,No,No
Jake Koch,1113,262,792,325,426,340,3334.0,383,123,222.0,409,202,20.9,No,2013,No,No,No
Deon Mitchell,1200,373,964,406,414,283,3207.0,285,105,283.0,679,301,25.5,No,2013,No,No,No
Matt Bohannon,1092,115,846,351,156,122,3837.0,690,268,74.0,156,83,14.8,No,2013,No,No,No
Chip Rank,592,53,503,200,110,81,2233.0,336,111,53.0,167,89,15.3,No,2013,No,No,No
Nate Buss,657,20,483,241,103,83,1427.0,208,92,52.0,275,149,23.6,No,2013,No,No,No
Marvin Singleton,301,40,230,119,87,57,1378.0,33,6,63.0,197,113,14.2,No,2013,No,No,No
Matt Morrison,190,54,166,65,29,26,740.0,82,34,45.0,84,31,17.1,No,2013,No,No,No
Max Martino,95,12,97,34,12,5,627.0,67,22,26.0,30,12,11.4,No,2013,No,No,No
Austin Pehl,153,15,144,62,46,29,693.0,0,0,45.0,144,62,17.4,No,2013,No,No,No
Chris Olivier,831,47,625,327,295,177,1566.0,1,0,105.0,624,327,30.2,No,2013,No,No,No
Eshaunte Jones,719,106,572,233,145,103,1754.0,384,150,76.0,188,83,23.0,No,2013,No,No,No
Chad Jackson,609,144,441,219,265,168,2156.0,19,3,151.0,422,216,18.3,No,2013,No,No,No
Ethan Faulkner,179,89,162,55,57,48,872.0,72,21,50.0,90,34,16.0,No,2013,No,No,No
Ernest Watson,161,33,183,68,22,13,714.0,45,12,16.0,138,56,17.1,No,2013,No,No,No
Tyler White,1114,216,1061,394,190,140,3084.0,566,186,175.0,495,208,22.9,No,2013,No,No,No
Jack Flournoy,232,21,206,81,30,22,658.0,142,48,27.0,64,33,21.1,No,2013,No,No,No
Nate Snodgrass,78,32,79,25,11,9,434.0,53,19,17.0,26,6,13.6,No,2013,No,No,No
Todd Johnson,505,136,422,160,94,64,1839.0,326,121,90.0,96,39,16.4,No,2013,No,No,No
Jalen Billups,1061,48,710,438,282,184,1959.0,5,1,169.0,705,437,27.4,No,2013,No,No,No
Anthony Monaco,227,69,202,68,67,58,1221.0,116,33,75.0,86,35,13.7,No,2013,No,No,No
John Staley,30,7,29,14,8,2,247.0,1,0,14.0,28,14,11.0,No,2013,No,No,No
Justin Rossi,6,1,8,2,0,0,30.0,7,2,2.0,1,0,19.4,No,2013,No,No,No
Quinnten Fuller,0,0,0,0,0,0,3.0,0,0,0.0,0,0,0.0,No,2013,No,No,No
Bill Pecora,0,0,2,0,0,0,7.0,2,0,0.0,0,0,16.6,No,2013,No,No,No
DeQuan Hicks,875,132,628,327,318,219,1343.0,15,2,169.0,613,325,31.6,No,2013,No,No,No
Shamir Davis,1136,296,830,341,542,386,2876.0,224,68,279.0,606,273,22.0,No,2013,No,No,No
James Hulbin,976,61,774,346,331,209,2152.0,222,75,131.0,552,271,22.7,No,2013,No,No,No
Jalan West,1690,652,1158,522,474,410,3191.0,579,236,248.0,579,286,23.2,No,2013,No,No,No
Brison White,661,133,575,263,145,95,1399.0,157,40,84.0,418,223,23.3,No,2013,No,No,No
Gary Roberson,393,44,332,151,94,57,1143.0,100,34,76.0,232,117,18.5,No,2013,No,No,No
Gary Stewart,609,106,497,206,144,106,1908.0,259,91,151.0,238,115,17.2,No,2013,No,No,No
Marvin Frazier,546,57,454,202,176,119,1735.0,70,23,86.0,384,179,16.4,No,2013,No,No,No
Patrick Robinson,398,116,326,138,172,103,2084.0,93,19,136.0,233,119,12.0,No,2013,No,No,No
O.J. Evans,245,26,220,104,76,37,1132.0,1,0,56.0,219,104,12.7,No,2013,No,No,No
Dadrian Harris,33,9,48,12,7,4,172.0,24,5,17.0,24,7,17.8,No,2013,No,No,No
Dustin Adams,18,1,15,6,8,6,65.0,0,0,3.0,15,6,15.1,No,2013,No,No,No
Matt Killian,258,34,244,93,68,44,1285.0,88,28,63.0,156,65,12.2,No,2013,No,No,No
Austin Adams,15,1,16,5,6,3,35.0,10,2,5.0,6,3,30.7,No,2013,No,No,No
David Ulak,1,1,5,0,4,1,28.0,4,0,2.0,1,0,14.8,No,2013,No,No,No
Brandon Williams,0,0,5,0,2,0,16.0,0,0,0.0,5,0,16.9,Yes,2013,No,No,No
Reggie Hearn,671,95,484,221,202,152,1923.0,218,77,110.0,266,144,20.3,Yes,2013,No,No,No
Dave Sobolewski,806,334,647,236,307,215,3194.0,379,119,158.0,268,117,16.9,No,2013,No,No,No
Tre Demps,1518,292,1404,554,297,199,3867.0,619,211,149.0,785,343,24.6,No,2013,No,No,No
Jared Swopshire,657,121,545,220,212,159,2313.0,184,58,114.0,361,162,16.8,No,2013,No,No,No
Alex Olah,1161,171,902,439,367,253,3225.0,112,30,181.0,790,409,22.0,No,2013,No,No,No
Alex Marcotullio,684,213,540,222,112,83,2497.0,425,157,117.0,115,65,15.9,No,2013,No,No,No
Kale Abrahamson,714,64,623,234,184,114,2122.0,391,132,89.0,232,102,20.5,No,2013,No,No,No
Drew Crawford,1920,286,1575,687,432,314,4627.0,658,232,235.0,917,455,24.4,No,2013,No,No,No
Mike Turner,61,56,71,24,12,7,504.0,15,6,28.0,56,18,11.8,No,2013,No,No,No
Nikola Cerina,402,43,323,156,154,82,1623.0,32,8,101.0,291,148,16.3,No,2013,No,No,No
James Mongomery III,23,10,35,9,13,3,197.0,20,2,4.0,15,7,13.0,No,2013,No,No,No
Chier Ajou,11,3,11,3,5,4,70.0,1,1,4.0,10,2,13.6,No,2013,No,No,No
Sanjay Lumpkin,607,158,441,213,190,127,3475.0,171,54,143.0,270,159,10.7,No,2013,No,No,No
Omar Jimenez,7,3,10,2,4,2,60.0,6,1,4.0,4,1,15.0,No,2013,No,No,No
Jerian Grant,1739,690,1276,556,567,448,4337.0,519,179,266.0,757,377,23.1,Yes,2013,No,No,No
Jack Cooley,1017,66,656,394,344,228,2435.0,2,1,110.0,654,393,21.1,Yes,2013,No,No,No
Eric Atkins,1421,589,1149,480,412,283,4628.0,469,178,249.0,680,302,18.8,No,2013,No,No,No
Pat Connaughton,1465,257,1145,515,215,167,4484.0,695,268,135.0,450,247,16.9,Yes,2013,No,No,No
Garrick Sherman,806,54,627,342,194,122,2024.0,0,0,165.0,627,342,23.3,No,2013,No,No,No
Cam Biedscheid,240,38,227,81,45,37,670.0,137,41,36.0,90,40,23.2,No,2013,No,No,No
Tom Knight,365,49,305,154,82,57,1192.0,0,0,53.0,305,154,18.2,No,2013,No,No,No
Scott Martin,1048,183,906,369,283,189,3389.0,367,121,164.0,539,248,17.9,No,2013,No,No,No
Zach Auguste,1274,80,894,507,424,260,2726.0,1,0,194.0,893,507,25.6,No,2013,No,No,No
Austin Burgett,160,29,123,58,38,28,709.0,66,16,31.0,57,42,13.1,No,2013,No,No,No
Patrick Crowley,9,3,16,4,0,0,49.0,4,1,2.0,12,3,20.4,No,2013,No,No,No
Travis Bader,2351,171,1726,703,502,441,4705.0,1246,504,150.0,480,199,22.3,No,2013,No,No,No
Corey Petros,1636,174,1152,664,603,308,4516.0,1,0,195.0,1151,664,18.3,No,2013,No,No,No
Duke Mondy,1054,358,949,363,275,199,3167.0,420,129,240.0,529,234,20.4,No,2013,No,No,No
Drew Valentine,1069,241,779,396,276,184,3494.0,262,93,237.0,517,303,16.0,No,2013,No,No,No
Ryan Bass,608,194,542,207,176,143,1835.0,155,51,127.0,387,156,20.3,No,2013,No,No,No
Dante Williams,733,124,625,263,133,87,2734.0,348,120,93.0,277,143,14.6,No,2013,No,No,No
Matt Poches,78,25,66,28,33,22,381.0,2,0,27.0,64,28,14.2,No,2013,No,No,No
Raphael Carter,49,4,36,21,18,7,236.0,0,0,9.0,36,21,11.3,No,2013,No,No,No
Lloyd Neely II,65,11,57,25,23,12,317.0,8,3,19.0,49,22,13.9,No,2013,No,No,No
Joey Asbury,47,1,42,15,16,14,278.0,15,3,8.0,27,12,10.3,No,2013,No,No,No
Mitch Baenziger,138,18,116,44,29,19,545.0,83,31,18.0,33,13,13.9,No,2013,No,No,No
Korab Imami,2,0,1,1,0,0,13.0,0,0,0.0,1,1,3.8,No,2013,No,No,No
Jordan Howenstine,8,2,16,2,7,4,42.0,2,0,4.0,14,2,27.2,No,2013,No,No,No
Deshaun Thomas,1628,100,1269,607,338,271,3052.0,418,143,129.0,851,464,26.7,No,2013,No,No,No
Aaron Craft,1314,694,958,440,464,342,4818.0,276,92,324.0,682,348,16.4,No,2013,No,No,No
Lenzelle Smith Jr.,1014,194,795,349,266,185,3104.0,372,131,136.0,423,218,17.9,No,2013,No,No,No
LaQuinton Ross,858,47,662,299,242,181,1676.0,217,79,124.0,445,220,28.6,No,2013,No,No,No
Sam Thompson,1001,155,801,378,260,172,3344.0,231,73,123.0,570,305,16.4,No,2013,No,No,No
Evan Ravenel,426,37,317,159,161,108,1426.0,1,0,86.0,316,159,17.3,No,2013,No,No,No
Shannon Scott,786,528,730,296,201,133,3164.0,218,61,229.0,512,235,17.5,No,2013,No,No,No
Amir Williams,660,27,392,236,317,188,2254.0,0,0,123.0,392,236,15.5,No,2013,No,No,No
Amedeo Della Valle,171,10,153,54,46,29,501.0,100,34,27.0,53,20,21.5,No,2013,No,No,No
Trey McDonald,195,16,153,80,88,35,1016.0,0,0,49.0,153,80,12.6,No,2013,No,No,No
Jake Lorbach,8,0,9,3,7,2,31.0,1,0,3.0,8,3,26.2,No,2013,No,No,No
Alex Rogers,2,2,9,1,0,0,21.0,0,0,2.0,9,1,27.9,No,2013,No,No,No
D.J. Cooper,2075,934,1707,648,681,505,4835.0,851,274,447.0,856,374,25.9,No,2013,No,No,No
Reggie Keely,1131,86,847,445,384,240,2823.0,6,1,203.0,841,444,22.2,No,2013,No,No,No
Walter Offutt,849,141,633,276,266,195,2255.0,291,102,123.0,342,174,20.2,No,2013,No,No,No
Nick Kellogg,1449,265,1084,479,238,201,3998.0,728,290,163.0,356,189,17.6,No,2013,No,No,No
Ivo Baltic,1066,177,898,441,271,169,3197.0,51,15,246.0,847,426,20.2,No,2013,No,No,No
Jon Smith,620,74,414,257,161,106,2599.0,0,0,99.0,414,257,11.9,No,2013,No,No,No
T.J. Hall,670,135,632,232,170,115,2126.0,330,91,151.0,302,141,21.0,No,2013,No,No,No
Ricardo Johnson,431,92,347,139,206,133,1609.0,81,20,106.0,266,119,17.6,No,2013,No,No,No
Stevie Taylor,755,246,737,269,167,111,2322.0,363,106,151.0,374,163,21.8,No,2013,No,No,No
Travis Wilkins,348,76,266,116,50,38,1255.0,183,78,32.0,83,38,13.5,No,2013,No,No,No
Kadeem Green,68,2,37,27,25,14,179.0,0,0,8.0,37,27,16.7,No,2013,No,No,No
David McKinley,39,8,29,13,4,4,134.0,22,9,6.0,7,4,13.9,No,2013,No,No,No
Nick Goff,19,6,16,5,7,6,46.0,11,3,4.0,5,2,26.0,No,2013,No,No,No
Marcus Smart,1064,287,760,314,465,349,2120.0,295,87,193.0,465,227,28.2,Yes,2013,No,No,No
Markel Brown,1655,308,1255,551,555,407,4088.0,421,146,239.0,834,405,22.2,Yes,2013,No,No,No
Le'Bryan Nash,1839,217,1381,635,715,539,3893.0,144,30,322.0,1237,605,27.6,No,2013,No,No,No
Phil Forte,1746,178,1237,512,445,393,3994.0,832,329,132.0,405,183,20.1,No,2013,No,No,No
Michael Cobbins,613,57,469,251,178,111,2669.0,2,0,108.0,467,251,13.1,No,2013,No,No,No
Kamari Murphy,740,79,610,309,210,120,3219.0,12,2,149.0,598,307,13.9,No,2013,No,No,No
Philip Jurick,137,31,100,63,31,11,1016.0,0,0,55.0,100,63,8.7,No,2013,No,No,No
Brian Williams,850,95,664,310,267,190,2523.0,141,40,108.0,523,270,18.1,No,2013,No,No,No
Kirby Gardner,42,30,54,16,15,8,314.0,15,2,19.0,39,14,13.1,No,2013,No,No,No
Jean-Paul Olukemi,516,44,345,153,244,186,1147.0,79,24,87.0,266,129,25.0,No,2013,No,No,No
Christien Sager,58,16,45,16,35,16,384.0,33,10,11.0,12,6,9.9,No,2013,No,No,No
Marek Soucek,48,13,45,19,10,5,277.0,21,5,16.0,24,14,12.5,No,2013,No,No,No
Ford Stuen,15,5,13,6,1,1,53.0,7,2,3.0,6,4,16.2,No,2013,No,No,No
Alex Budke,9,2,8,3,0,0,32.0,6,3,4.0,2,0,19.6,No,2013,No,No,No
Mason Cox,7,2,3,2,10,3,57.0,1,0,5.0,2,2,11.3,No,2013,No,No,No
Romero Osby,1211,102,868,427,430,317,2757.0,102,40,160.0,766,387,22.5,No,2013,No,No,No
Steven Pledger,1392,167,1129,469,248,205,3424.0,675,249,177.0,454,220,21.4,No,2013,No,No,No
Amath M'Baye,813,56,669,313,250,165,2158.0,110,22,172.0,559,291,22.5,No,2013,No,No,No
Buddy Hield,2291,254,1748,783,450,376,4182.0,894,349,285.0,854,434,26.6,Yes,2013,No,No,No
Cameron Clark,1284,122,1079,497,297,222,3385.0,171,68,160.0,908,429,20.5,No,2013,No,No,No
Andrew Fitzgerald,1086,66,913,433,311,220,2763.0,2,0,149.0,911,433,22.8,No,2013,No,No,No
Je'lon Hornbeak,1035,249,786,317,305,233,2859.0,437,168,194.0,349,149,18.9,No,2013,No,No,No
Sam Grooms,363,285,314,123,152,103,1617.0,55,14,103.0,259,109,15.2,No,2013,No,No,No
Isaiah Cousins,1326,365,1162,474,284,202,3794.0,432,176,254.0,730,298,20.2,No,2013,No,No,No
Tyler Neal,466,54,361,145,136,103,1410.0,210,73,86.0,151,72,18.2,No,2013,No,No,No
Casey Arent,32,1,32,13,6,6,178.0,0,0,15.0,32,13,14.0,No,2013,No,No,No
James Fraschilla,8,3,5,1,10,6,41.0,3,0,5.0,2,1,17.8,No,2013,No,No,No
DeShawn Painter,782,44,691,298,266,173,2171.0,41,13,123.0,650,285,21.6,No,2013,No,No,No
Dimitri Batten,1227,161,1048,425,324,211,3250.0,490,166,197.0,558,259,22.3,No,2013,No,No,No
Donte Hill,489,148,436,169,164,98,1804.0,191,53,122.0,245,116,17.5,No,2013,No,No,No
Keenan Palmore,686,219,556,257,277,171,2159.0,19,1,173.0,537,256,20.7,No,2013,No,No,No
Aaron Bacote,1609,354,1233,495,560,446,3773.0,525,173,283.0,708,322,24.8,No,2013,No,No,No
Richard Ross,981,110,772,424,242,127,3250.0,19,6,170.0,753,418,17.0,No,2013,No,No,No
Nick Wright,552,40,504,188,233,151,1795.0,92,25,104.0,412,163,20.1,No,2013,No,No,No
Deion Clark,104,21,98,39,24,16,438.0,38,10,23.0,60,29,15.3,No,2013,No,No,No
Anton Larsen,97,11,107,40,20,12,480.0,29,5,24.0,78,35,14.8,No,2013,No,No,No
Stuart McEwen,4,2,8,2,0,0,56.0,5,0,2.0,3,2,8.9,No,2013,No,No,No
Martin Shaw,21,5,32,7,10,7,102.0,7,0,8.0,25,7,23.3,No,2013,No,No,No
Warren Niles,1982,257,1593,673,440,344,4451.0,780,292,286.0,813,381,24.0,No,2013,No,No,No
Damen Bell-Holter,1389,143,1018,496,510,371,3446.0,90,26,228.0,928,470,22.2,No,2013,No,No,No
Shawn Glover,1467,154,1255,586,290,224,3356.0,221,71,192.0,1034,515,24.5,No,2013,No,No,No
Steven Roundtree,982,142,684,370,367,241,2411.0,11,1,207.0,673,369,22.8,No,2013,No,No,No
Korey Billbury,1524,294,1276,543,480,336,3855.0,284,102,269.0,992,441,23.5,No,2013,No,No,No
D.J. Jackson,307,186,245,83,116,96,1649.0,130,45,100.0,115,38,12.6,No,2013,No,No,No
Mikey Manghum,178,99,132,54,32,26,1237.0,111,44,52.0,21,10,8.4,No,2013,No,No,No
Brandon Conley,631,74,432,249,219,133,2243.0,0,0,167.0,432,249,16.0,No,2013,No,No,No
Jorden Kaufman,639,67,516,280,144,79,1612.0,0,0,87.0,516,280,20.4,No,2013,No,No,No
Jake Lliteras,88,27,91,28,19,13,454.0,65,19,28.0,26,9,14.9,No,2013,No,No,No
Corbin Byford,41,6,28,14,17,10,136.0,11,3,13.0,17,11,18.8,No,2013,No,No,No
P.J. Purnell,5,1,4,2,1,1,8.0,2,0,0.0,2,2,28.6,No,2013,No,No,No
Caleb Tannehill,0,0,1,0,0,0,8.0,0,0,0.0,1,0,6.4,No,2013,No,No,No
Roberto Nelson,1745,307,1270,540,614,486,3217.0,479,179,280.0,791,361,28.4,No,2013,No,No,No
Devon Collier,1489,181,935,539,668,411,3158.0,0,0,205.0,935,539,22.8,No,2013,No,No,No
Joe Burton,1009,315,823,416,291,173,3117.0,12,4,290.0,811,412,19.9,No,2013,No,No,No
Ahmad Starks,1246,289,1186,445,144,123,3478.0,652,233,167.0,534,212,20.3,No,2013,No,No,No
Eric Moreland,640,116,445,238,294,156,2227.0,24,8,161.0,421,230,16.6,Yes,2013,No,No,No
Olaf Schaftenaar,623,130,537,201,110,89,2335.0,373,132,95.0,164,69,15.4,No,2013,No,No,No
Challe Barton,231,105,205,77,62,48,1336.0,97,29,98.0,108,48,12.3,No,2013,No,No,No
Jarmal Reid,412,84,358,144,187,123,1634.0,7,1,99.0,351,143,17.8,No,2013,No,No,No
Langston Morris-Walker,613,86,547,201,178,121,2259.0,272,90,80.0,275,111,16.8,No,2013,No,No,No
Angus Brandt,918,126,703,344,239,166,2420.0,159,64,154.0,544,280,20.0,No,2013,No,No,No
Victor Robbins,248,32,196,82,104,67,682.0,56,17,39.0,140,65,22.4,No,2013,No,No,No
Michael Moyer,3,0,2,1,0,0,9.0,1,1,0.0,1,0,10.9,No,2013,No,No,No
Daniel Jones,10,0,12,4,3,1,42.0,4,1,0.0,8,3,15.6,No,2013,No,No,No
Jullian Powers,2,0,3,1,0,0,22.0,1,0,3.0,2,1,13.3,No,2013,No,No,No
C.J. Mitchell,7,1,4,1,6,4,36.0,3,1,5.0,1,0,16.0,No,2013,No,No,No
E.J. Singler,1546,286,1134,507,429,364,4165.0,451,168,253.0,683,339,19.2,No,2013,No,No,No
Damyean Dotson,1732,149,1390,645,250,199,3906.0,639,243,154.0,751,402,21.5,Yes,2013,No,No,No
Carlos Emory,640,70,481,221,200,148,1581.0,162,50,116.0,319,171,21.9,No,2013,No,No,No
Tony Woods,793,41,569,310,298,173,2110.0,0,0,165.0,569,310,21.2,No,2013,No,No,No
Arsalan Kazemi,1523,197,895,500,771,523,3776.0,2,0,232.0,893,500,20.2,No,2013,No,No,No
Dominic Artis,1215,502,1065,430,359,235,3321.0,376,120,269.0,689,310,22.9,No,2013,No,No,No
Johnathan Loyd,723,458,615,229,258,192,3021.0,243,73,229.0,372,156,16.0,No,2013,No,No,No
Waverly Austin,164,15,144,63,67,38,712.0,0,0,48.0,144,63,15.6,No,2013,No,No,No
Ben Carter,357,93,258,121,153,115,1407.0,4,0,86.0,254,121,14.3,No,2013,No,No,No
Willie Moore,596,118,502,188,205,154,1937.0,219,66,181.0,283,122,21.4,No,2013,No,No,No
Fred Richardson III,181,26,150,57,56,44,677.0,76,23,30.0,74,34,15.2,No,2013,No,No,No
Austin Kuemper,22,1,14,8,6,5,51.0,1,1,1.0,13,7,17.3,No,2013,No,No,No
Coleton Baker,4,1,4,1,2,1,32.0,2,1,1.0,2,0,9.2,No,2013,No,No,No
Nicholas Lucenti,5,4,16,2,2,1,50.0,10,0,1.0,6,2,18.1,No,2013,No,No,No
Lorenzo McCloud,704,238,511,210,310,241,1790.0,139,43,153.0,372,167,24.8,No,2013,No,No,No
Travis Fulton,613,115,511,224,118,90,1723.0,209,75,78.0,302,149,20.5,No,2013,No,No,No
Sama Taku,660,141,612,241,178,136,1834.0,139,42,117.0,473,199,23.5,No,2013,No,No,No
Tony Gill,640,64,456,237,148,106,1491.0,152,60,85.0,304,177,21.6,No,2013,No,No,No
Ross Rivera,861,46,608,279,310,254,1910.0,132,49,99.0,476,230,23.9,No,2013,No,No,No
Colin Beatty,348,88,328,142,44,24,1406.0,114,40,57.0,214,102,15.8,No,2013,No,No,No
Khalil Kelley,629,57,507,252,301,125,2044.0,1,0,139.0,506,252,20.7,No,2013,No,No,No
Rodrigo De Souza,200,86,154,64,66,42,787.0,82,30,41.0,72,34,15.8,No,2013,No,No,No
Trevin Harris,476,125,364,160,92,68,1575.0,222,88,62.0,142,72,15.9,No,2013,No,No,No
Markus Duran,299,48,239,92,44,36,1070.0,216,79,38.0,23,13,15.2,No,2013,No,No,No
Tim Thomas,140,12,120,59,37,22,432.0,2,0,28.0,118,59,20.0,Yes,2013,No,No,No
Andrew Bock,557,176,387,138,275,235,1721.0,151,46,113.0,236,92,19.2,No,2013,No,No,No
Spencer Llewellyn,38,3,38,14,1,1,168.0,29,9,9.0,9,5,15.2,No,2013,No,No,No
Jordan Turner,15,12,24,6,3,1,182.0,7,2,7.0,17,4,9.8,No,2013,No,No,No
Aaron Short,156,37,116,54,21,19,583.0,57,29,32.0,59,25,13.9,No,2013,No,No,No
Reed Kamler,0,0,2,0,0,0,9.0,2,0,1.0,0,0,18.3,No,2013,No,No,No
D.J. Newbill,2105,340,1621,727,715,518,4542.0,395,133,342.0,1226,594,26.6,No,2013,No,No,No
Jermaine Marshall,1362,171,1111,455,356,262,3176.0,534,190,200.0,577,265,24.6,No,2013,No,No,No
Sasa Borovnjak,400,23,299,162,120,76,1411.0,2,0,64.0,297,162,15.8,No,2013,No,No,No
Ross Travis,831,92,752,318,300,174,3391.0,108,21,162.0,644,297,16.4,No,2013,No,No,No
Brandon Taylor,1289,106,1169,463,239,180,3366.0,558,183,199.0,611,280,23.2,No,2013,No,No,No
Nick Colella,196,46,193,60,37,26,1215.0,162,50,31.0,31,10,10.5,No,2013,No,No,No
Tim Frazier,1543,641,1214,508,585,453,4132.0,239,74,355.0,975,434,24.0,Yes,2013,No,No,No
Jonathan Graham,283,22,258,116,101,51,1551.0,0,0,72.0,258,116,12.9,No,2013,No,No,No
Donovon Jack,524,42,415,193,164,104,1671.0,118,34,69.0,297,159,17.7,No,2013,No,No,No
Kevin Montminy,24,0,20,9,7,2,101.0,12,4,2.0,8,5,13.3,No,2013,No,No,No
Patrick Ackerman,57,2,58,26,8,5,406.0,0,0,14.0,58,26,9.6,No,2013,No,No,No
Alan Wisniewski,21,2,11,7,15,7,151.0,0,0,5.0,11,7,8.1,No,2013,No,No,No
Akosa Maduegbunam,6,2,12,2,4,2,53.0,8,0,0.0,4,2,14.0,No,2013,No,No,No
Zach Cooper,0,0,0,0,0,0,5.0,0,0,0.0,0,0,0.0,No,2013,No,No,No
Kevin Onyeaka,0,0,1,0,0,0,2.0,1,0,0.0,0,0,26.6,No,2013,No,No,No
Miles Jackson-Cartwright,1401,353,1051,441,448,364,3896.0,449,155,325.0,602,286,21.8,No,2013,No,No,No
Tony Hicks,1146,223,990,400,305,234,2410.0,328,112,262.0,662,288,30.2,No,2013,No,No,No
Darien Nelson-Henry,1054,110,745,414,346,224,2443.0,6,2,237.0,739,412,24.4,No,2013,No,No,No
Henry Brooks,632,57,627,287,95,58,2160.0,2,0,156.0,625,287,19.9,No,2013,No,No,No
Fran Dougherty,740,63,560,295,235,139,2057.0,43,11,150.0,517,284,21.0,No,2013,No,No,No
Patrick Lucas-Perry,161,25,134,53,20,16,557.0,95,39,14.0,39,14,14.8,No,2013,No,No,No
Greg Louis,280,24,222,110,89,51,1051.0,27,9,70.0,195,101,17.0,No,2013,No,No,No
Dau Jok,169,17,166,51,34,27,668.0,140,40,20.0,26,11,15.7,No,2013,No,No,No
Jamal Lewis,232,133,233,81,79,47,1288.0,85,23,102.0,148,58,14.8,No,2013,No,No,No
Steve Rennard,248,89,194,75,68,49,1329.0,143,49,70.0,51,26,11.8,No,2013,No,No,No
Camryn Crocker,121,105,109,36,59,37,902.0,42,12,85.0,67,24,13.2,No,2013,No,No,No
Cameron Gunter,97,6,78,36,50,25,566.0,2,0,38.0,76,36,13.0,No,2013,No,No,No
Simeon Esprit,5,3,7,2,1,0,69.0,3,1,4.0,4,1,9.1,No,2013,No,No,No
Lorne Jackson,1297,311,1013,422,399,309,3129.0,439,144,314.0,574,278,24.9,No,2013,No,No,No
Jordan Baker,696,202,653,251,178,119,1991.0,230,75,213.0,423,176,25.8,No,2013,No,No,No
Stacy Davis,1786,211,1318,607,654,503,3941.0,196,69,301.0,1122,538,25.8,No,2013,No,No,No
Nikolas Skouen,497,51,421,163,69,57,1567.0,304,114,75.0,117,49,18.0,No,2013,No,No,No
Jett Raines,1037,44,781,398,303,222,2739.0,76,19,100.0,705,379,19.7,No,2013,No,No,No
Caleb Willis,338,224,269,112,127,85,1771.0,86,29,123.0,183,83,13.5,No,2013,No,No,No
Moriba De Freitas,81,21,63,32,34,17,584.0,0,0,31.0,63,32,10.3,No,2013,No,No,No
Atif Russell,581,93,484,211,180,117,1804.0,140,42,110.0,344,169,19.2,No,2013,No,No,No
Austin Mills,143,54,127,40,60,44,584.0,80,19,53.0,47,21,18.9,No,2013,No,No,No
Jan Maehlen,47,4,37,21,17,5,386.0,0,0,18.0,37,21,8.6,No,2013,No,No,No
Manny Ochenje,50,0,44,19,17,12,216.0,0,0,11.0,44,19,15.6,No,2013,No,No,No
Malte Kramer,138,22,108,46,24,14,439.0,78,32,18.0,30,14,16.4,No,2013,No,No,No
Allen Stevens,4,0,2,1,2,2,10.0,1,0,0.0,1,1,16.0,No,2013,No,No,No
Travon Woodall,1108,580,898,374,283,213,3327.0,437,147,276.0,461,227,20.8,No,2013,No,No,No
Lamar Patterson,1410,427,1097,477,394,285,3628.0,463,171,244.0,634,306,22.5,Yes,2013,No,No,No
Talib Zanna,1117,56,743,411,454,295,2924.0,3,0,137.0,740,411,20.0,No,2013,No,No,No
J.J. Moore,1005,74,784,337,281,217,2380.0,360,114,103.0,424,223,22.1,No,2013,No,No,No
Steven Adams,231,20,175,100,70,31,749.0,0,0,35.0,175,100,17.7,Yes,2013,No,No,No
James Robinson,1115,604,937,353,381,303,4204.0,332,106,175.0,605,247,16.4,Yes,2013,No,No,No
Dante Taylor,681,50,464,271,227,139,2170.0,1,0,92.0,463,271,16.2,No,2013,No,No,No
Trey Zeigler,1481,251,1312,572,548,300,3463.0,130,37,282.0,1182,535,28.0,No,2013,No,No,No
Durand Johnson,659,92,573,222,149,112,1572.0,301,103,90.0,272,119,23.4,No,2013,No,No,No
Cameron Wright,834,225,754,341,217,131,2719.0,89,21,147.0,665,320,19.9,No,2013,No,No,No
Aaron Moore,475,56,360,184,148,106,1119.0,8,1,75.0,352,183,24.1,No,2013,No,No,No
Renado Parker,555,36,439,218,170,119,1354.0,1,0,79.0,438,218,23.0,No,2013,No,No,No
Michael Harthun,625,112,501,227,106,81,2063.0,220,90,89.0,281,137,16.0,No,2013,No,No,No
Lateef McMullan,760,249,632,238,235,173,2481.0,315,111,163.0,317,127,19.0,No,2013,No,No,No
Gary Winston,1070,298,877,372,196,153,3122.0,400,173,211.0,477,199,19.8,No,2013,No,No,No
Dre' Winston,488,135,354,162,195,142,1620.0,88,22,101.0,266,140,18.1,No,2013,No,No,No
Michael Harvey,124,16,108,44,40,30,497.0,32,6,30.0,76,38,16.5,No,2013,No,No,No
Martin Whitmore,106,9,93,35,24,18,317.0,59,18,16.0,34,17,19.7,No,2013,No,No,No
Brandon Cataldo,235,13,179,101,52,33,680.0,0,0,36.0,179,101,18.6,No,2013,No,No,No
Lamont Prosser,38,4,26,14,20,10,153.0,0,0,16.0,26,14,17.9,No,2013,No,No,No
Marcus Hall,384,77,306,124,81,55,1544.0,215,81,57.0,91,43,13.6,No,2013,No,No,No
Alyx Foster,32,11,23,10,14,8,318.0,9,4,9.0,14,6,6.5,No,2013,No,No,No
Joel King,8,4,11,3,3,2,34.0,2,0,2.0,9,3,21.9,No,2013,No,No,No
Ryan Nicholas,1238,113,968,450,364,270,3000.0,180,68,181.0,788,382,22.7,No,2013,No,No,No
Kevin Bailey,1362,156,1068,457,451,344,2750.0,289,104,256.0,779,353,28.9,No,2013,No,No,No
Thomas van der Mars,1252,98,893,497,392,258,3218.0,1,0,176.0,892,497,20.2,No,2013,No,No,No
Derrick Rodgers,390,192,331,139,153,106,1732.0,22,6,161.0,309,133,16.9,No,2013,No,No,No
Tanner Riley,458,64,455,166,44,38,1300.0,273,88,76.0,182,78,22.0,No,2013,No,No,No
Korey Thieleke,209,49,206,79,68,43,1015.0,40,8,58.0,166,71,15.1,No,2013,No,No,No
Riley Barker,379,38,311,145,135,86,1593.0,10,3,79.0,301,142,14.8,No,2013,No,No,No
Oskar Reinfelds,146,48,132,50,51,27,541.0,57,19,47.0,75,31,19.5,No,2013,No,No,No
Bryce Pressley,1104,314,882,388,234,173,3372.0,388,155,163.0,494,233,17.2,No,2013,No,No,No
David Carr,244,118,265,88,60,28,1202.0,129,40,56.0,136,48,14.9,No,2013,No,No,No
Jake Ehlers,40,3,32,13,17,10,163.0,9,4,10.0,23,9,16.0,No,2013,No,No,No
John Bailey,67,16,72,25,26,15,295.0,6,2,19.0,66,23,18.0,No,2013,No,No,No
David Ahern,6,3,6,2,3,2,32.0,2,0,3.0,4,2,16.9,No,2013,No,No,No
Jourdan Demunyck,825,103,774,305,235,162,1680.0,160,53,151.0,614,252,29.0,No,2013,No,No,No
Carl Blair,947,495,742,283,412,311,3311.0,257,70,371.0,485,213,20.2,No,2013,No,No,No
Jules Montgomery,585,69,623,248,119,68,2128.0,83,21,99.0,540,227,17.4,No,2013,No,No,No
Ryan Gesiakowski,538,57,541,184,82,55,1631.0,382,115,76.0,159,69,18.9,No,2013,No,No,No
Josh Eleby,188,5,163,87,33,14,447.0,0,0,41.0,163,87,23.2,No,2013,No,No,No
Demondre Chapman,918,39,704,352,466,214,2323.0,2,0,153.0,702,352,22.4,No,2013,No,No,No
Montrael Scott,1227,199,1018,428,300,218,3142.0,447,153,222.0,571,275,21.5,No,2013,No,No,No
Rasi Jenkins,110,20,89,39,56,32,844.0,1,0,45.0,88,39,9.1,No,2013,No,No,No
Mayol Riathin,127,12,112,46,66,35,662.0,0,0,52.0,112,46,13.9,No,2013,No,No,No
Ronald Wright,187,99,229,83,55,19,993.0,15,2,69.0,214,81,15.3,No,2013,No,No,No
Cory Jones,28,13,20,8,21,10,185.0,6,2,19.0,14,6,12.5,No,2013,No,No,No
Louis Munks,663,47,587,222,187,139,1466.0,251,80,106.0,336,142,25.8,No,2013,No,No,No
Patrick Agho,56,3,47,22,32,12,224.0,0,0,19.0,47,22,17.6,No,2013,No,No,No
Wesley Afolayan,38,2,45,16,17,6,166.0,3,0,15.0,42,16,19.9,No,2013,No,No,No
John Love,13,1,14,3,6,5,24.0,10,2,2.0,4,1,37.1,No,2013,No,No,No
Babajidne Aina,10,0,9,5,5,0,46.0,2,0,2.0,7,5,13.7,No,2013,No,No,No
Jimmie Duplessis,154,75,150,54,64,34,652.0,43,12,74.0,107,42,19.3,No,2013,No,No,No
Khalid Mutakabbir,1576,283,1311,567,368,281,4542.0,435,161,340.0,876,406,22.7,No,2013,No,No,No
Jordan Downing,1626,143,1414,595,273,211,3456.0,594,225,207.0,820,370,27.7,No,2013,No,No,No
Joshua Clyburn,428,27,331,170,152,87,1399.0,3,1,115.0,328,169,21.1,No,2013,No,No,No
William Truss,906,45,602,368,255,164,2666.0,13,6,154.0,589,362,18.1,No,2013,No,No,No
Ryan McTavish,237,24,220,90,40,32,1170.0,94,25,51.0,126,65,14.1,No,2013,No,No,No
Eric Washington,1251,560,892,389,469,380,3498.0,282,93,340.0,610,296,22.8,Yes,2013,No,No,No
Ryan Hargrave,394,29,343,144,69,54,1215.0,162,52,55.0,181,92,19.9,No,2013,No,No,No
Austin Anderson,312,196,332,110,60,44,1942.0,184,48,117.0,148,62,13.6,No,2013,No,No,No
Mac Lake,14,10,15,5,2,2,95.0,8,2,3.0,7,3,11.4,No,2013,No,No,No
Matthew Citron,11,0,8,5,5,1,30.0,0,0,5.0,8,5,29.3,No,2013,No,No,No
Jarvis Thibodeaux,10,0,6,3,5,3,23.0,2,1,3.0,4,2,28.3,No,2013,No,No,No
Jake Campbell,19,4,17,7,9,5,229.0,0,0,9.0,17,7,7.3,No,2013,No,No,No
Russell McCray,7,6,6,2,10,3,34.0,0,0,6.0,6,2,27.8,No,2013,No,No,No
Ian Hummer,1625,308,1225,625,524,349,3523.0,84,26,282.0,1141,599,28.2,No,2013,No,No,No
Denton Koon,982,132,777,367,244,169,2956.0,223,79,171.0,554,288,19.3,No,2013,No,No,No
T.J. Bray,1024,374,696,338,283,213,3293.0,348,135,174.0,348,203,17.1,No,2013,No,No,No
Will Barrett,686,114,517,222,152,113,2028.0,321,129,113.0,196,93,19.6,No,2013,No,No,No
Hans Brase,913,173,704,300,280,208,2645.0,306,105,173.0,398,195,21.2,No,2013,No,No,No
Brendan Connolly,408,96,313,165,127,78,1542.0,1,0,82.0,312,165,16.6,No,2013,No,No,No
Clay Wilson,398,42,321,132,58,42,1189.0,249,92,40.0,72,40,18.5,No,2013,No,No,No
Mack Darrow,465,152,361,150,123,92,1703.0,204,73,61.0,157,77,15.9,No,2013,No,No,No
Chris Clement,113,31,93,32,36,31,663.0,57,18,28.0,36,14,11.8,No,2013,No,No,No
Bobby Garbade,30,17,27,9,13,10,164.0,8,2,15.0,19,7,16.6,No,2013,No,No,No
Ameer Elbuluk,0,1,1,0,2,0,15.0,0,0,3.0,1,0,19.1,No,2013,No,No,No
Brian Fabrizius,3,0,2,1,0,0,10.0,2,1,0.0,0,0,11.2,No,2013,No,No,No
Edo Lawrence,0,0,0,0,0,0,1.0,0,0,0.0,0,0,0.0,No,2013,No,No,No
Isaac Serwanga,0,1,2,0,0,0,12.0,1,0,0.0,1,0,9.7,No,2013,No,No,No
Mike Washington Jr.,21,9,32,10,3,0,113.0,14,1,10.0,18,9,20.5,No,2013,No,No,No
Bryce Cotton,1975,384,1452,611,581,487,4314.0,736,266,193.0,716,345,22.7,Yes,2013,No,No,No
Kadeem Batts,1289,103,1019,455,521,366,3257.0,40,13,198.0,979,442,22.6,No,2013,No,No,No
LaDontae Henton,2059,158,1655,724,560,424,4909.0,555,187,246.0,1100,537,22.6,No,2013,No,No,No
Vincent Council,1499,725,1365,514,523,362,4024.0,349,109,353.0,1016,405,23.5,No,2013,No,No,No
Josh Fortune,1037,247,924,351,207,158,3413.0,526,177,233.0,398,174,18.3,No,2013,No,No,No
Kris Dunn,1214,552,943,424,423,293,2997.0,206,73,315.0,737,351,24.6,Yes,2013,No,No,No
Lee Goldsbrough,89,24,78,34,28,16,802.0,16,5,51.0,62,29,8.9,No,2013,No,No,No
Sidiki Johnson,44,2,50,17,31,10,172.0,0,0,13.0,50,17,22.9,No,2013,No,No,No
Brice Kofane,335,29,248,124,157,87,1672.0,0,0,123.0,248,124,14.1,No,2013,No,No,No
Ted Bancroft,55,17,69,19,22,9,563.0,45,8,25.0,24,11,9.4,No,2013,No,No,No
Terone Johnson,1318,299,1207,496,376,206,3507.0,365,120,197.0,842,376,23.0,No,2013,No,No,No
A.J. Hammons,1593,104,1138,613,523,361,3201.0,23,6,271.0,1115,607,26.2,No,2013,No,No,No
Ronnie Johnson,1238,420,1082,441,417,283,3177.0,228,73,248.0,854,368,23.8,No,2013,No,No,No
D.J. Byrd,890,206,735,281,184,133,2663.0,529,195,122.0,206,86,18.3,No,2013,No,No,No
Rapheal Davis,1009,231,766,333,376,273,3224.0,219,70,176.0,547,263,17.6,No,2013,No,No,No
Anthony Johnson,643,101,593,237,180,112,1756.0,184,57,91.0,409,180,22.8,Yes,2013,No,No,No
Donnie Hale,122,9,120,52,31,17,463.0,1,1,18.0,119,51,16.7,No,2013,No,No,No
Sandi Marcius,316,17,219,120,126,76,1200.0,0,0,89.0,219,120,15.6,No,2013,No,No,No
Jacob Lawson,425,41,323,167,139,91,1475.0,2,0,87.0,321,167,16.2,No,2013,No,No,No
Travis Carroll,229,40,189,100,45,25,1341.0,10,4,36.0,179,96,9.5,No,2013,No,No,No
Jay Simpson,138,17,136,58,41,21,388.0,10,1,29.0,126,57,23.5,No,2013,No,No,No
Dru Anthrop,34,24,26,13,8,5,260.0,11,3,16.0,15,10,9.0,No,2013,No,No,No
Neal Beshears,9,2,8,3,2,2,61.0,4,1,7.0,4,2,13.5,No,2013,No,No,No
Stephen Toyra,24,5,19,6,18,12,102.0,8,0,11.0,11,6,18.9,No,2013,No,No,No
Ike Azotam,1603,97,1240,628,561,347,3444.0,1,0,191.0,1239,628,23.2,No,2013,No,No,No
Zaid Hearst,1610,224,1254,542,492,389,3764.0,402,137,193.0,852,405,21.2,No,2013,No,No,No
Ousmane Drame,1363,86,1022,497,535,368,3037.0,3,1,242.0,1019,496,23.7,No,2013,No,No,No
Evan Conti,740,228,654,251,190,130,2444.0,314,108,157.0,340,143,17.6,No,2013,No,No,No
Jamee Jackson,714,39,577,277,332,160,2396.0,0,0,142.0,577,277,17.5,No,2013,No,No,No
Darien Johnson,679,340,577,204,286,220,2422.0,148,51,194.0,429,153,17.9,No,2013,No,No,No
Shaq Shannon,387,145,321,119,139,91,1469.0,157,58,96.0,164,61,15.4,No,2013,No,No,No
Garvey Young,695,131,595,229,255,176,2565.0,201,61,160.0,394,168,16.8,No,2013,No,No,No
Kendrick Ray,1322,220,1085,493,278,206,2461.0,357,130,184.0,728,363,27.7,No,2013,No,No,No
James Ford Jr.,498,92,453,157,136,93,1725.0,262,91,86.0,191,66,16.5,No,2013,No,No,No
Justin Harris,332,32,295,118,129,95,1112.0,19,1,63.0,276,117,18.2,No,2013,No,No,No
Tariq Carey,7,0,8,1,4,4,25.0,3,1,4.0,5,0,26.7,No,2013,No,No,No
Marquis Barnett,33,4,27,14,9,5,189.0,0,0,8.0,27,14,9.8,No,2013,No,No,No
T'ziah Wood-Smith,7,1,10,3,2,1,32.0,2,0,3.0,8,3,20.3,No,2013,No,No,No
Emanuel Binyam,2,0,7,0,4,2,15.0,3,0,1.0,4,0,31.3,No,2013,No,No,No
Samir Kalil,0,0,1,0,0,0,17.0,1,0,1.0,0,0,5.7,No,2013,No,No,No
Javonte Green,1911,141,1350,701,739,485,3378.0,101,24,245.0,1249,677,29.0,Yes,2013,No,No,No
R.J. Price,1649,369,1477,544,367,260,3900.0,848,301,248.0,629,243,24.5,No,2013,No,No,No
Ya Ya Anderson,1141,213,961,392,194,135,3336.0,615,222,120.0,346,170,17.6,No,2013,No,No,No
Rashun Davis,1304,457,1062,441,449,336,3237.0,301,86,323.0,761,355,24.7,No,2013,No,No,No
Kion Brown,614,39,495,245,227,124,1908.0,0,0,146.0,495,245,19.6,No,2013,No,No,No
Blake Smith,806,199,764,289,188,128,2580.0,308,100,180.0,456,189,19.6,No,2013,No,No,No
Kyle Noreen,498,183,442,189,97,50,3037.0,237,70,73.0,205,119,9.3,No,2013,No,No,No
Jalen Carethers,553,52,462,216,173,121,1611.0,3,0,63.0,459,216,19.0,No,2013,No,No,No
Brandon Holcomb,681,86,517,273,208,135,2566.0,0,0,176.0,517,273,15.5,No,2013,No,No,No
Lucas Dyer,104,7,75,31,62,42,480.0,0,0,23.0,75,31,13.3,No,2013,No,No,No
Taj Owens,206,91,174,68,71,59,764.0,34,11,46.0,140,57,16.6,No,2013,No,No,No
Juwan Wells,31,8,43,13,3,1,147.0,21,4,11.0,22,9,18.6,No,2013,No,No,No
Allen Dickerson,113,27,111,39,26,16,531.0,70,19,29.0,41,20,14.3,No,2013,No,No,No
Matt Murphy,8,3,5,2,4,4,33.0,0,0,2.0,5,2,13.3,No,2013,No,No,No
Xavier Munford,1045,134,884,352,297,211,2166.0,388,130,165.0,496,222,29.0,Yes,2013,No,No,No
Andre Malone,606,55,568,220,100,73,1773.0,291,93,59.0,277,127,19.7,No,2013,No,No,No
Nikola Malesevic,895,121,737,310,240,158,2377.0,321,117,136.0,416,193,21.4,No,2013,No,No,No
Mike Powell,551,229,513,166,209,154,2128.0,212,65,189.0,301,101,19.3,No,2013,No,No,No
Jordan Hare,141,10,106,62,38,17,529.0,0,0,31.0,106,62,16.1,No,2013,No,No,No
Mike Aaman,847,44,695,329,295,189,2037.0,1,0,130.0,694,329,23.7,No,2013,No,No,No
T.J. Buchanan,591,233,433,192,288,186,2679.0,73,21,149.0,360,171,13.7,No,2013,No,No,No
Ryan Brooks,114,20,115,51,36,12,814.0,0,0,33.0,115,51,10.6,No,2013,No,No,No
Alwayne Bigby,271,82,238,98,120,64,1755.0,54,11,114.0,184,87,12.7,No,2013,No,No,No
Eric Youncofski,7,0,5,1,6,5,14.0,2,0,1.0,3,1,33.5,No,2013,No,No,No
Biggie Minnis,504,255,441,195,187,95,2174.0,63,19,192.0,378,176,17.6,No,2013,No,No,No
Jonathan Nazarko,0,0,4,0,0,0,13.0,3,0,0.0,1,0,16.3,No,2013,No,No,No
Shane Plunkett,3,1,7,1,2,0,23.0,5,1,1.0,2,0,20.5,No,2013,No,No,No
Tamir Jackson,1684,387,1453,573,616,422,4118.0,423,116,342.0,1030,457,26.9,No,2013,No,No,No
Julian DeBose,1081,148,949,410,236,156,3284.0,319,105,161.0,630,305,19.5,No,2013,No,No,No
Max Guercy,1115,503,893,338,366,304,4035.0,428,135,282.0,465,203,18.3,No,2013,No,No,No
Austin Ramljak,615,62,493,193,95,68,1737.0,418,161,55.0,75,32,19.0,No,2013,No,No,No
Seth Gearhart,875,142,653,267,255,203,2698.0,380,138,135.0,273,129,18.8,No,2013,No,No,No
Keith Washington,326,128,323,110,111,75,1200.0,116,31,125.0,207,79,23.2,No,2013,No,No,No
Ross Wilson,144,41,130,63,34,18,875.0,0,0,55.0,130,63,12.9,No,2013,No,No,No
Bahrom Firozgary,55,5,31,16,36,23,319.0,0,0,19.0,31,16,11.8,No,2013,No,No,No
Dan Peera,123,48,99,46,14,3,852.0,65,28,33.0,34,18,9.1,No,2013,No,No,No
Elliot Franshaw,8,0,7,2,6,4,76.0,1,0,3.0,6,2,9.6,No,2013,No,No,No
Nizar Kapic,70,12,75,25,10,6,296.0,43,14,13.0,32,11,17.3,No,2013,No,No,No
Darien Brothers,1274,146,958,399,321,271,2926.0,511,205,129.0,447,194,23.2,No,2013,No,No,No
Kendall Anthony,1909,236,1504,628,475,383,3918.0,689,270,193.0,815,358,27.3,No,2013,No,No,No
Cedrick Lindsay,1276,355,937,403,489,372,3272.0,296,98,209.0,641,305,23.0,No,2013,No,No,No
Derrick Williams,816,80,477,250,372,277,2056.0,112,39,141.0,365,211,21.1,Yes,2013,No,No,No
Greg Robbins,386,130,328,151,71,36,1693.0,143,48,85.0,185,103,14.4,No,2013,No,No,No
Terry Allen,1491,168,1080,547,471,333,3409.0,214,64,209.0,866,483,24.3,No,2013,No,No,No
Alonzo Nelson-Ododa,556,84,447,195,220,132,2414.0,124,34,118.0,323,161,15.3,No,2013,No,No,No
Wayne Sparrow,577,135,565,208,158,89,1990.0,242,72,139.0,323,136,21.5,No,2013,No,No,No
Deion Taylor,460,135,388,164,160,76,2696.0,198,56,99.0,190,108,11.5,No,2013,No,No,No
Trey Davis,531,256,457,200,219,107,3410.0,93,24,153.0,364,176,11.5,No,2013,No,No,No
Zach Chu,14,2,6,4,2,2,15.0,6,4,2.0,0,0,33.4,No,2013,No,No,No
Jonathan Benjamin,5,1,6,2,0,0,22.0,4,1,0.0,2,1,14.9,No,2013,No,No,No
Luke Piotrowski,292,30,238,115,89,62,1027.0,3,0,60.0,235,115,17.8,No,2013,No,No,No
John Moran,109,32,109,32,21,13,472.0,97,32,38.0,12,0,16.2,No,2013,No,No,No
Luke Moyer,237,46,174,76,32,23,641.0,135,62,45.0,39,14,19.7,No,2013,No,No,No
Jonathan Thompson,952,372,664,309,315,227,3473.0,272,107,209.0,392,202,15.2,No,2013,No,No,No
Anthony Myles,1417,196,1105,449,447,329,3519.0,531,190,251.0,574,259,22.9,No,2013,No,No,No
Danny Stewart,1414,98,907,456,665,476,3722.0,70,26,252.0,837,430,20.4,No,2013,No,No,No
Nurideen Lindsey,363,78,293,130,144,87,1004.0,72,16,139.0,221,114,25.9,No,2013,No,No,No
Zedric Sadler,816,250,731,286,208,140,3085.0,313,104,182.0,418,182,17.2,No,2013,No,No,No
Junior Fortunat,415,18,315,164,213,87,1429.0,0,0,102.0,315,164,18.9,No,2013,No,No,No
Tommy Pereira,347,52,297,116,16,11,1297.0,273,104,35.0,24,12,13.5,No,2013,No,No,No
Shawn Valentine,487,125,448,166,138,90,2359.0,211,65,144.0,237,101,14.6,No,2013,No,No,No
Dera Nd-Ezuma,170,20,149,73,42,24,753.0,1,0,50.0,148,73,15.1,No,2013,No,No,No
Khalil Alford,535,54,481,208,101,69,1507.0,154,50,87.0,327,158,21.5,No,2013,No,No,No
Derrick Stewart,26,1,17,8,10,10,69.0,0,0,4.0,17,8,19.7,No,2013,No,No,No
Jamal Nwaniemeka,11,1,17,4,2,2,41.0,8,1,0.0,9,3,23.1,No,2013,No,No,No
Emerson Bursis,10,0,10,5,1,0,42.0,3,0,1.0,7,5,14.3,No,2013,No,No,No
Myles Melville,2,0,1,1,0,0,7.0,0,0,0.0,1,1,7.5,No,2013,No,No,No
Karvel Anderson,1123,85,787,391,166,140,1925.0,444,201,82.0,343,190,25.5,No,2013,No,No,No
Lucky Jones,1632,186,1219,494,562,448,3769.0,558,196,264.0,661,298,23.9,No,2013,No,No,No
Russell Johnson,1208,192,1060,424,324,227,3300.0,395,133,267.0,665,291,22.9,No,2013,No,No,No
Velton Jones,1588,551,1261,469,688,495,3686.0,484,155,347.0,777,314,26.8,No,2013,No,No,No
Coron Williams,1288,165,1021,442,158,123,3360.0,673,281,92.0,348,161,18.2,No,2013,No,No,No
Mike McFadden,777,67,589,300,293,176,2353.0,1,1,148.0,588,299,19.2,No,2013,No,No,No
Anthony Myers,805,449,677,263,268,197,3367.0,256,82,232.0,421,181,15.8,No,2013,No,No,No
Stephan Hawkins,247,16,224,103,57,41,1104.0,0,0,50.0,224,103,14.1,No,2013,No,No,No
David Appolon,381,91,322,130,142,101,1552.0,85,20,88.0,237,110,15.9,No,2013,No,No,No
Vaughn Morgan,34,3,39,15,15,4,216.0,0,0,17.0,39,15,15.2,No,2013,No,No,No
Keith Armstrong,74,4,74,32,27,10,461.0,0,0,18.0,74,32,11.6,No,2013,No,No,No
Shane Sweigart,2,1,6,1,0,0,24.0,2,0,4.0,4,1,21.5,No,2013,No,No,No
Treadwell Lewis,10,2,31,3,6,2,46.0,13,2,5.0,18,1,43.4,No,2013,No,No,No
Myles Mack,1658,425,1311,541,393,337,3931.0,648,239,278.0,663,302,23.1,No,2013,No,No,No
Eli Carter,1544,300,1384,525,375,292,3417.0,657,202,308.0,727,323,28.8,No,2013,No,No,No
Wally Judge,667,81,533,256,298,155,2073.0,2,0,169.0,531,256,20.1,No,2013,No,No,No
Jerome Seagears,987,385,850,335,225,174,3235.0,394,143,203.0,456,192,17.8,No,2013,No,No,No
Dane Miller,1042,313,898,400,326,197,3553.0,169,45,273.0,729,355,19.2,No,2013,No,No,No
Kadeem Jack,1044,62,898,409,330,209,2581.0,51,17,181.0,847,392,24.4,No,2013,No,No,No
Austin Johnson,533,62,413,214,175,105,1913.0,0,0,131.0,413,214,17.0,No,2013,No,No,No
Mike Poole,721,165,721,297,136,100,2597.0,113,27,163.0,608,270,18.8,No,2013,No,No,No
Malick Kone,267,49,255,105,78,47,1212.0,45,10,62.0,210,95,14.9,No,2013,No,No,No
Derrick Randall,251,4,185,99,102,53,1081.0,0,0,52.0,185,99,13.9,No,2013,No,No,No
Vincent Garrett,168,35,147,60,43,32,425.0,35,16,31.0,112,44,23.7,No,2013,No,No,No
Jalen Hyde,9,2,12,4,5,1,67.0,5,0,4.0,7,4,13.8,No,2013,No,No,No
Logan Kelley,0,1,0,0,0,0,3.0,0,0,0.0,0,0,0.0,No,2013,No,No,No
John Dickson,1313,96,1077,456,456,329,2933.0,241,72,199.0,836,384,26.9,No,2013,No,No,No
Mikh McKinney,1468,369,1082,508,395,320,3105.0,339,132,197.0,743,376,25.9,No,2013,No,No,No
Dylan Garrity,1406,527,965,434,378,316,3991.0,532,222,261.0,433,212,19.1,No,2013,No,No,No
Konner Veteto,715,16,529,263,319,189,1807.0,3,0,141.0,526,263,25.5,No,2013,No,No,No
Joe Eberhard,514,79,395,177,111,84,1947.0,180,76,69.0,215,101,14.1,No,2013,No,No,No
Cody Demps,914,286,695,317,344,242,3055.0,143,38,200.0,552,279,18.6,No,2013,No,No,No
Jackson Carbajal,463,50,413,172,110,62,1307.0,196,57,81.0,217,115,22.1,No,2013,No,No,No
Joey Quigley,95,17,101,33,42,24,489.0,19,5,24.0,82,28,16.1,No,2013,No,No,No
Jordan Salley,242,8,155,96,79,50,671.0,0,0,37.0,155,96,18.7,No,2013,No,No,No
Julian Demalleville,56,52,51,17,19,12,554.0,36,10,32.0,15,7,8.9,No,2013,No,No,No
Dreon Barlett,415,45,330,135,62,51,1484.0,232,94,48.0,98,41,14.5,No,2013,No,No,No
Kendall Groom,34,27,50,14,13,5,276.0,6,1,19.0,44,13,14.5,No,2013,No,No,No
Ryan Okwudibonye,11,0,8,4,3,3,28.0,0,0,4.0,8,4,26.2,No,2013,No,No,No
Shane Gibson,2079,203,1562,728,395,337,3707.0,691,286,330.0,871,442,28.4,No,2013,No,No,No
Louis Montes,1261,104,967,435,424,304,2952.0,264,87,201.0,703,348,23.3,No,2013,No,No,No
Steve Glowiak,1028,126,923,346,140,104,2868.0,672,232,100.0,251,114,18.9,No,2013,No,No,No
Phil Gaetano,661,730,558,198,150,130,3781.0,383,135,355.0,175,63,13.0,No,2013,No,No,No
Nick Greenbacker,409,79,405,171,65,35,1862.0,103,32,108.0,302,139,14.6,No,2013,No,No,No
Justin Swidowski,421,17,325,168,84,67,965.0,49,18,52.0,276,150,22.0,No,2013,No,No,No
Tevin Falzon,749,87,641,237,339,252,2273.0,103,23,129.0,538,214,19.9,No,2013,No,No,No
De'Aires Tate,101,5,85,45,18,11,325.0,0,0,27.0,85,45,18.5,No,2013,No,No,No
Femi Akinpetide,222,21,211,83,97,55,999.0,4,1,63.0,207,82,16.9,No,2013,No,No,No
Mostafa Abdel Latif,191,10,170,82,46,27,849.0,0,0,40.0,170,82,13.6,No,2013,No,No,No
Lewis Cramer,39,4,34,15,15,9,185.0,0,0,6.0,34,15,13.2,No,2013,No,No,No
Evan Kelley,1194,243,1015,435,414,268,3327.0,229,56,259.0,786,379,22.1,No,2013,No,No,No
Earl Brown,1373,171,1000,527,478,299,3409.0,68,20,292.0,932,507,24.6,No,2013,No,No,No
Umar Shannon,1307,226,1078,404,383,308,3033.0,528,191,216.0,550,213,24.8,No,2013,No,No,No
Ollie Jackson,789,145,764,269,127,89,2658.0,504,162,191.0,260,107,21.0,No,2013,No,No,No
Ben Millaud-Meunier,989,117,737,289,237,199,2243.0,548,212,130.0,189,77,23.3,No,2013,No,No,No
Dominique Major,550,72,500,177,85,49,1917.0,411,147,55.0,89,30,17.1,No,2013,No,No,No
Stephon Mosley,202,13,164,74,67,50,600.0,13,4,48.0,151,70,22.2,No,2013,No,No,No
Stephon Whyatt,574,181,493,203,150,100,2108.0,210,68,157.0,283,135,18.8,No,2013,No,No,No
Ronnie Drinnon,971,131,795,388,296,172,3005.0,77,23,144.0,718,365,19.2,No,2013,No,No,No
Anthony Ervin,798,144,715,284,178,138,2593.0,278,92,148.0,437,192,19.6,No,2013,No,No,No
Greg Brown,855,292,766,312,222,156,3221.0,234,75,187.0,532,237,17.5,No,2013,No,No,No
Tony Peters,207,51,206,89,65,28,1095.0,9,1,87.0,197,88,15.8,No,2013,No,No,No
Kameron Ritter,253,106,201,90,102,51,1460.0,68,22,87.0,133,68,12.4,No,2013,No,No,No
Stanley Storm,67,8,53,24,30,19,378.0,0,0,23.0,53,24,12.9,No,2013,No,No,No
Zachary Vigneault,4,1,4,1,2,1,16.0,4,1,2.0,0,0,23.6,No,2013,No,No,No
Aric Gresko,3,2,6,1,0,0,32.0,4,1,3.0,2,0,15.5,No,2013,No,No,No
Carl Jones,1845,341,1409,570,662,492,3928.0,605,213,266.0,804,357,26.9,No,2013,No,No,No
Langston Galloway,1991,296,1501,657,407,334,4720.0,806,343,156.0,695,314,21.0,Yes,2013,No,No,No
Ronald Roberts,1398,100,953,543,527,312,3541.0,0,0,190.0,953,543,21.1,No,2013,No,No,No
C.J. Aiken,939,89,692,346,249,180,2958.0,236,67,108.0,456,279,16.7,No,2013,No,No,No
Halil Kanacevic,1163,407,980,444,364,227,3707.0,180,48,343.0,800,396,20.9,No,2013,No,No,No
Chris Wilson,876,377,775,294,260,166,3815.0,388,122,219.0,387,172,15.6,No,2013,No,No,No
Daryus Quarles,435,75,475,164,87,53,1849.0,193,54,67.0,282,110,16.9,No,2013,No,No,No
Papa Ndao,319,71,275,107,44,33,1383.0,205,72,86.0,70,35,14.3,No,2013,No,No,No
Isaiah Miles,1097,69,810,375,250,210,2529.0,376,137,113.0,434,238,21.2,No,2013,No,No,No
Taylor Trevisan,27,3,15,9,10,6,38.0,7,3,3.0,8,6,32.2,No,2013,No,No,No
Christopher Coyne,5,2,3,2,0,0,12.0,1,1,0.0,2,1,13.5,No,2013,No,No,No
Eric Kindler,20,7,29,6,9,5,84.0,20,3,7.0,9,3,24.4,No,2013,No,No,No
Evan Maschmeyer,64,26,70,20,26,19,353.0,27,5,31.0,43,15,17.0,No,2013,No,No,No
Colin Kelly,3,0,3,1,4,1,29.0,1,0,2.0,2,1,12.7,No,2013,No,No,No
Dwayne Evans,1499,126,1081,543,547,393,3616.0,66,20,232.0,1015,523,23.2,No,2013,No,No,No
Cody Ellis,1062,99,896,329,272,210,2675.0,580,194,107.0,316,135,23.1,No,2013,No,No,No
Mike McCall Jr.,1212,339,998,413,285,225,3704.0,449,161,197.0,549,252,19.2,No,2013,No,No,No
Jordair Jett,1239,422,953,453,500,306,3497.0,109,27,295.0,844,426,22.6,No,2013,No,No,No
Kwamain Mitchell,1575,420,1257,547,405,281,3939.0,567,200,280.0,690,347,24.7,No,2013,No,No,No
Rob Loe,973,153,809,342,224,156,2822.0,408,133,174.0,401,209,20.6,No,2013,No,No,No
Cory Remekun,400,55,312,158,158,84,1847.0,0,0,121.0,312,158,15.0,No,2013,No,No,No
Jake Barnett,717,119,637,228,166,123,2537.0,403,138,158.0,234,90,19.1,No,2013,No,No,No
Grandy Glaze,670,52,521,289,154,92,1639.0,11,0,96.0,510,289,21.2,No,2013,No,No,No
John Manning,186,25,152,71,74,43,972.0,5,1,47.0,147,70,12.9,No,2013,No,No,No
Keith Carter,707,304,568,247,156,98,2146.0,293,115,140.0,275,132,18.6,No,2013,No,No,No
Sean Duff,4,0,3,1,4,2,11.0,1,0,2.0,2,1,34.1,No,2013,No,No,No
Joey Lepak,2,1,1,0,2,2,14.0,1,0,0.0,0,0,7.4,No,2013,No,No,No
Matthew Dellavedova,1933,768,1423,590,541,465,4944.0,761,288,342.0,662,302,21.2,Yes,2013,No,No,No
Beau Levesque,829,135,595,276,240,186,2132.0,241,91,124.0,354,185,20.6,No,2013,No,No,No
Stephen Holt,1370,305,924,409,496,401,3962.0,396,151,184.0,528,258,17.8,No,2013,No,No,No
Brad Waldow,1743,141,1162,683,632,377,3486.0,1,0,187.0,1161,683,25.3,No,2013,No,No,No
Mitchell Young,878,76,630,350,269,171,2251.0,28,7,138.0,602,343,20.6,No,2013,No,No,No
Jorden Page,637,175,515,211,128,104,2085.0,319,111,126.0,196,100,17.5,No,2013,No,No,No
James Walker,587,104,473,186,174,122,1905.0,250,93,100.0,223,93,18.2,No,2013,No,No,No
Jordan Giusti,197,84,173,64,63,41,1183.0,86,28,45.0,87,36,11.0,No,2013,No,No,No
Matt Hodgson,518,27,366,200,182,115,1731.0,12,3,154.0,354,197,18.1,No,2013,No,No,No
Kyle Rowley,255,34,209,102,104,51,958.0,0,0,92.0,209,102,19.3,No,2013,No,No,No
Eividas Petrulis,72,11,56,23,14,8,176.0,46,18,18.0,10,5,24.1,No,2013,No,No,No
Paul McCoy,612,161,510,220,198,128,1963.0,140,44,156.0,370,176,20.4,No,2013,No,No,No
Tim Williams,238,15,152,88,84,60,515.0,9,2,34.0,143,86,22.4,No,2013,No,No,No
Zach Sanchez,3,0,5,1,0,0,23.0,5,1,2.0,0,0,15.9,No,2013,No,No,No
Desmond Washington,1596,126,1323,514,384,325,3883.0,695,243,192.0,628,271,24.1,No,2013,No,No,No
Yvon Raymond,760,184,631,285,303,173,2558.0,62,17,200.0,569,268,20.0,No,2013,No,No,No
Darius Conley,975,76,829,383,354,209,2888.0,2,0,216.0,827,383,22.0,No,2013,No,No,No
Blaise Ffrench,405,257,419,155,161,86,2013.0,42,9,190.0,377,146,18.2,No,2013,No,No,No
Chris Burke,604,124,536,222,135,94,2540.0,205,66,139.0,331,156,15.5,No,2013,No,No,No
Markese Tucker,267,12,229,116,57,35,732.0,0,0,32.0,229,116,21.0,No,2013,No,No,No
Chris Prescott,618,97,627,206,114,83,2025.0,401,123,142.0,226,83,21.2,No,2013,No,No,No
Chazz Patterson,579,152,514,177,166,123,2898.0,323,102,151.0,191,75,13.9,No,2013,No,No,No
Patrick Jackson,232,28,236,85,95,53,1074.0,58,9,64.0,178,76,16.4,No,2013,No,No,No
Karee Ferguson,109,10,121,45,24,11,446.0,26,8,30.0,95,37,19.3,No,2013,No,No,No
Elias Desport,281,46,250,98,128,83,1638.0,8,2,99.0,242,96,13.5,No,2013,No,No,No
Jose Irizarry,2,0,1,1,0,0,9.0,0,0,0.0,1,1,6.0,No,2013,No,No,No
James Thomas,617,63,463,227,268,163,1858.0,1,0,95.0,462,227,18.8,Yes,2013,No,No,No
Darius Gatson,499,254,445,152,173,119,1983.0,220,76,138.0,225,76,17.5,No,2013,No,No,No
Paul Baxter,1103,362,905,377,339,228,3501.0,347,121,216.0,558,256,18.2,No,2013,No,No,No
Terrance Motley,504,25,424,202,155,96,1081.0,7,4,79.0,417,198,27.1,No,2013,No,No,No
Will Bond,374,58,310,120,56,43,1193.0,237,91,39.0,73,29,16.0,No,2013,No,No,No
Nathaniel Mason,351,38,273,113,135,99,906.0,78,26,63.0,195,87,22.5,No,2013,No,No,No
DeMarcus Gatlin,903,196,684,287,432,278,2322.0,179,51,173.0,505,236,23.6,No,2013,No,No,No
Marquel McKinney,353,82,319,109,117,71,1817.0,206,64,74.0,113,45,12.6,No,2013,No,No,No
Jeremy McKay,120,35,139,42,16,10,427.0,96,26,17.0,43,16,19.6,No,2013,No,No,No
Michael Holyfield,732,31,489,286,289,160,2165.0,1,0,181.0,488,286,19.0,No,2013,No,No,No
Aaron Harwell,321,214,301,108,149,89,1736.0,71,16,164.0,230,92,15.9,No,2013,No,No,No
Erik Williams,92,6,97,37,22,13,321.0,24,5,14.0,73,32,19.4,No,2013,No,No,No
Mitch McCormick,26,4,29,8,5,3,99.0,24,7,2.0,5,1,16.8,No,2013,No,No,No
Tim Williams,1939,115,1309,759,599,419,3990.0,8,2,194.0,1301,757,23.4,No,2013,No,No,No
Raijon Kelly,1064,303,889,394,192,152,2795.0,341,124,213.0,548,270,23.6,No,2013,No,No,No
Clide Geffrard,1088,105,771,372,322,230,2244.0,309,114,159.0,462,258,25.2,No,2013,No,No,No
Tyler Hood,1161,128,898,409,241,175,2988.0,473,168,131.0,425,241,20.6,No,2013,No,No,No
Connor Miller,475,168,440,155,92,58,2471.0,302,107,122.0,138,48,13.5,No,2013,No,No,No
Russell Wilson,188,139,156,69,90,48,1193.0,16,2,130.0,140,67,15.1,No,2013,No,No,No
Will Cook,372,59,321,126,110,72,1498.0,173,48,75.0,148,78,16.8,No,2013,No,No,No
Brandon Hayman,244,28,206,113,50,16,846.0,15,2,41.0,191,111,17.4,No,2013,No,No,No
Jaylen Beckham,23,12,26,7,14,8,129.0,5,1,21.0,21,6,24.0,No,2013,No,No,No
Levi Barnes,15,2,20,6,0,0,104.0,13,3,4.0,7,3,12.9,No,2013,No,No,No
Hamilton Bailey,4,1,3,0,5,4,44.0,2,0,0.0,1,0,6.5,No,2013,No,No,No
Mike Fitzpatrick,0,0,0,0,0,0,5.0,0,0,0.0,0,0,0.0,No,2013,No,No,No
Tony Thompson,0,0,2,0,0,0,7.0,0,0,1.0,2,0,23.1,No,2013,No,No,No
Gregg Wooten,242,56,209,85,105,58,763.0,55,14,75.0,154,71,25.8,No,2013,No,No,No
Jamaal Franklin,1162,162,849,362,436,340,2198.0,325,98,218.0,524,264,29.9,Yes,2013,No,No,No
Chase Tapley,1526,303,1247,573,206,157,3813.0,565,223,182.0,682,350,20.7,No,2013,No,No,No
Xavier Thames,1374,354,1080,427,488,397,3581.0,353,123,211.0,727,304,22.0,No,2013,No,No,No
J.J. O'Brien,1028,204,882,415,298,179,3686.0,77,19,189.0,805,396,17.3,No,2013,No,No,No
James Rahon,1121,116,991,401,185,131,3375.0,513,188,102.0,478,213,16.7,No,2013,No,No,No
Deshawn Stephens,383,19,270,162,130,59,1374.0,0,0,57.0,270,162,14.6,No,2013,No,No,No
Winston Shepard,1403,315,1165,467,653,428,3583.0,169,41,308.0,996,426,26.1,No,2013,No,No,No
Skylar Spencer,546,45,389,226,204,94,3104.0,0,0,93.0,389,226,9.8,No,2013,No,No,No
Dwayne Polee II,654,52,541,234,173,119,1737.0,200,67,87.0,341,167,21.5,No,2013,No,No,No
LaBradford Franklin,158,83,112,47,64,54,593.0,39,10,67.0,73,37,18.3,No,2013,No,No,No
James Johnson,240,14,178,94,91,52,813.0,0,0,79.0,178,94,19.2,Yes,2013,No,No,No
Aaron Douglass,9,0,5,3,2,1,15.0,4,2,1.0,1,1,23.9,No,2013,No,No,No
Narbeh Ebrahimian,11,4,16,4,7,3,76.0,5,0,0.0,11,4,13.1,No,2013,No,No,No
Jeremy Castleberry,7,0,9,3,0,0,20.0,7,1,2.0,2,2,28.4,No,2013,No,No,No
Ryan Staten,11,3,18,5,5,1,43.0,2,0,1.0,16,5,26.1,No,2013,No,No,No
Johnny Dee,2046,157,1542,666,419,381,4081.0,835,333,169.0,707,333,25.2,No,2013,No,No,No
Ken Rancifer,953,101,794,346,218,141,2636.0,328,120,180.0,466,226,21.9,No,2013,No,No,No
Christopher Anderson,1181,757,935,390,462,300,4108.0,271,101,365.0,664,289,19.9,No,2013,No,No,No
Chris Manresa,885,88,690,347,352,188,2621.0,12,3,139.0,678,344,20.4,No,2013,No,No,No
Cameron Miles,354,140,353,122,111,80,1586.0,104,30,123.0,249,92,17.8,No,2013,No,No,No
Mike Davis,257,55,226,98,90,51,849.0,45,10,42.0,181,88,18.6,Yes,2013,No,No,No
John Sinis,261,26,221,93,51,33,970.0,127,42,58.0,94,51,16.6,No,2013,No,No,No
Dennis Kramer,865,61,693,344,174,116,2409.0,186,61,156.0,507,283,20.8,No,2013,No,No,No
Jito Kok,645,52,475,234,312,177,2935.0,2,0,188.0,473,234,14.8,No,2013,No,No,No
Simi Fajemisin,319,19,221,109,167,101,1497.0,1,0,104.0,220,109,14.5,No,2013,No,No,No
Keith Stackhouse,25,6,28,10,5,2,131.0,15,3,12.0,13,7,17.2,No,2013,No,No,No
Trey Guidry,20,1,17,6,14,7,67.0,5,1,4.0,12,5,22.0,No,2013,No,No,No
Cole Dickerson,1253,131,966,487,310,164,2852.0,304,115,191.0,662,372,23.8,No,2013,No,No,No
Cody Doolin,1217,579,966,416,328,253,4345.0,410,132,240.0,556,284,16.3,No,2013,No,No,No
De'End Parker,347,59,279,115,125,88,825.0,66,29,35.0,213,86,24.2,No,2013,No,No,No
Tim Derksen,1434,197,1005,497,442,294,3355.0,358,146,179.0,647,351,21.2,No,2013,No,No,No
Mark Tollefsen,1253,166,885,474,240,171,3309.0,356,134,102.0,529,340,17.3,No,2013,No,No,No
Avry Holmes,1259,251,912,377,368,288,3444.0,529,217,161.0,383,160,19.0,No,2013,No,No,No
Chris Adams,419,89,391,143,16,11,1853.0,325,122,54.0,66,21,12.8,No,2013,No,No,No
Tao Xu,92,7,80,34,36,24,427.0,0,0,39.0,80,34,17.0,No,2013,No,No,No
Matt Christiansen,201,36,172,87,50,27,998.0,1,0,51.0,171,87,13.1,No,2013,No,No,No
Frank Rogers,514,65,416,187,146,92,1357.0,142,48,95.0,274,139,21.6,No,2013,No,No,No
Coltin Gelb,0,0,0,0,0,0,2.0,0,0,0.0,0,0,0.0,No,2013,No,No,No
Gavin Hoffmann,60,21,47,18,23,14,407.0,27,10,13.0,20,8,9.0,No,2013,No,No,No
Chris Cunningham,689,71,516,235,290,213,2235.0,20,6,189.0,496,229,19.2,No,2013,No,No,No
James Kinney,964,150,854,348,152,117,1863.0,416,151,158.0,438,197,29.6,No,2013,No,No,No
D.J. Brown,898,347,748,256,311,231,3213.0,468,155,183.0,280,101,17.4,No,2013,No,No,No
LaVanne Pennington,288,23,306,103,75,49,782.0,127,33,58.0,179,70,25.8,No,2013,No,No,No
Louis Garrett,172,22,170,60,42,30,512.0,76,22,34.0,94,38,21.6,No,2013,No,No,No
Xavier Jones,123,41,130,42,62,37,485.0,13,2,35.0,117,40,19.8,No,2013,No,No,No
Alex Brown,120,7,90,51,59,18,562.0,0,0,19.0,90,51,12.0,No,2013,No,No,No
Stephon Smith,197,19,195,78,67,41,906.0,0,0,50.0,195,78,15.5,No,2013,No,No,No
Chris Jones,280,54,271,109,87,59,1181.0,19,3,54.0,252,106,15.7,No,2013,No,No,No
David Andoh,613,34,561,238,177,124,1677.0,52,13,134.0,509,225,23.4,No,2013,No,No,No
Aalim Moor,75,29,73,32,3,1,359.0,24,10,21.0,49,22,13.3,No,2013,No,No,No
Nick Grieves,48,4,46,16,2,1,94.0,44,15,4.0,2,1,27.1,No,2013,No,No,No
Jaleel Williams,699,59,626,252,142,88,1971.0,337,107,97.0,289,145,21.4,No,2013,No,No,No
Mike VanKirk,12,0,9,4,7,4,65.0,0,0,3.0,9,4,11.7,No,2013,No,No,No
Kevin Foster,2423,464,1975,771,577,450,4212.0,1184,431,401.0,791,340,33.0,No,2013,No,No,No
Marc Trasolini,1699,100,1139,628,517,383,3824.0,182,60,215.0,957,568,22.9,No,2013,No,No,No
Evan Roquemore,1627,578,1258,469,600,484,4272.0,577,205,326.0,681,264,22.2,No,2013,No,No,No
Raymond Cowels,1090,113,949,363,181,145,3157.0,584,219,131.0,365,144,18.6,No,2013,No,No,No
Brandon Clark,1549,410,1225,493,474,398,3437.0,486,165,240.0,739,328,26.3,No,2013,No,No,No
Yannick Atanga,295,18,230,112,140,71,1748.0,1,0,63.0,229,112,10.6,No,2013,No,No,No
John McArthur,392,49,400,157,96,72,2059.0,29,6,75.0,371,151,12.9,No,2013,No,No,No
Denzel Johnson,609,111,608,229,127,93,2055.0,187,58,78.0,421,171,19.5,No,2013,No,No,No
Robert Garrett,145,8,114,59,65,27,773.0,0,0,32.0,114,59,11.7,No,2013,No,No,No
Julian Clarke,131,28,132,45,25,15,556.0,88,26,25.0,44,19,15.5,No,2013,No,No,No
Niyi Harrison,753,24,537,275,340,203,2192.0,0,0,165.0,537,275,19.9,No,2013,No,No,No
Kyle Perricone,23,4,21,8,2,1,69.0,15,6,3.0,6,2,18.1,No,2013,No,No,No
Rashad Hassan,1386,94,1008,561,404,253,2915.0,36,11,241.0,972,550,25.9,No,2013,No,No,No
Preston Blackmon,1250,541,1221,468,198,155,3690.0,509,159,387.0,712,309,24.4,No,2013,No,No,No
Arnold Louis,909,81,716,350,365,199,2696.0,41,10,201.0,675,340,21.2,No,2013,No,No,No
Deven Williams,531,48,468,190,79,64,1003.0,239,87,76.0,229,103,30.7,No,2013,No,No,No
Cedric Smith,503,129,444,188,255,124,2520.0,33,3,154.0,411,185,15.0,No,2013,No,No,No
Jyles Smith,641,76,499,249,258,143,2984.0,7,0,200.0,492,249,14.5,No,2013,No,No,No
Khiry White,203,69,170,70,85,53,1121.0,44,10,111.0,126,60,15.2,No,2013,No,No,No
Stephen Wilson,236,66,243,72,89,63,999.0,109,29,80.0,134,43,19.2,No,2013,No,No,No
Patrick Hendley,147,28,144,55,33,22,579.0,44,15,46.0,100,40,18.7,No,2013,No,No,No
Robert Burger,58,13,63,21,15,7,437.0,34,9,28.0,29,12,12.1,No,2013,No,No,No
Christopher Spears,138,9,121,58,40,21,799.0,1,1,52.0,120,57,12.8,No,2013,No,No,No
Marcus Hutchins,43,6,30,11,28,20,188.0,11,1,15.0,19,10,17.2,No,2013,No,No,No
Angelo Davis,39,5,26,8,32,23,122.0,1,0,13.0,25,8,23.3,No,2013,No,No,No
Clarence Trent,815,97,702,300,236,158,1952.0,212,57,196.0,490,243,24.3,No,2013,No,No,No
Chad Rasmussen,537,100,517,180,53,39,1759.0,399,138,99.0,118,42,16.9,No,2013,No,No,No
Deshaun Sunderhaus,527,43,411,213,139,94,1204.0,23,7,95.0,388,206,23.1,No,2013,No,No,No
Prince Obasi,377,203,327,131,123,81,1440.0,108,34,118.0,219,97,16.4,No,2013,No,No,No
D'Vonne Pickett,422,198,371,166,145,82,1371.0,42,8,133.0,329,158,20.1,No,2013,No,No,No
Louis Green,291,13,226,123,69,45,979.0,1,0,71.0,225,123,15.9,No,2013,No,No,No
Jarell Flora,999,104,864,363,134,99,2650.0,463,174,155.0,401,189,21.1,No,2013,No,No,No
Allen Tate,148,34,167,61,40,22,695.0,29,4,56.0,138,57,16.2,No,2013,No,No,No
Luiz Bidart,129,42,98,36,41,32,651.0,71,25,38.0,27,11,11.5,No,2013,No,No,No
Jack Crook,770,148,652,306,255,156,2739.0,11,2,212.0,641,304,18.5,No,2013,No,No,No
Sterling Carter,888,141,822,298,142,94,1982.0,553,198,170.0,269,100,24.4,No,2013,No,No,No
T.J. Diop,83,14,78,33,27,17,356.0,2,0,28.0,76,33,15.4,No,2013,No,No,No
David Trimble,19,17,20,7,12,5,123.0,1,0,10.0,19,7,14.0,No,2013,No,No,No
Fuquan Edwin,1633,182,1358,606,366,249,3847.0,472,172,235.0,886,434,24.1,No,2013,No,No,No
Aaron Cosby,1274,239,1077,395,307,239,3535.0,664,245,221.0,413,150,21.1,No,2013,No,No,No
Gene Teague,1034,101,658,388,452,258,2593.0,0,0,240.0,658,388,22.9,No,2013,No,No,No
Brian Oliver,1018,120,927,350,114,92,2687.0,617,226,152.0,310,124,21.5,Yes,2013,No,No,No
Brandon Mobley,890,77,715,313,217,171,2529.0,274,93,122.0,441,220,19.5,No,2013,No,No,No
Kyle Smyth,930,194,740,308,138,104,3191.0,552,210,89.0,188,98,14.2,No,2013,No,No,No
Haralds Karlis,336,85,293,108,83,56,1806.0,208,64,78.0,85,44,11.9,No,2013,No,No,No
Tom Maayan,82,128,83,30,29,12,864.0,35,10,115.0,48,20,13.1,No,2013,No,No,No
Kevin Johnson,52,0,38,19,31,14,165.0,0,0,7.0,38,19,19.3,Yes,2013,Yes,Yes,Yes
Patrik Auda,604,96,415,212,203,142,1970.0,111,38,103.0,304,174,16.4,No,2013,No,No,No
Aaron Geramipoor,126,6,104,55,45,16,783.0,0,0,34.0,104,55,10.7,No,2013,No,No,No
Freddie Wilson,279,90,281,98,56,35,1147.0,168,48,74.0,113,50,18.4,No,2013,No,No,No
Connor Laverty,2,0,1,1,0,0,5.0,0,0,1.0,1,1,21.3,No,2013,No,No,No
O.D. Anosike,1259,102,970,493,530,272,3621.0,2,1,231.0,968,492,20.6,No,2013,No,No,No
Rob Poole,1493,218,1208,469,441,340,4051.0,610,215,207.0,598,254,20.4,No,2013,No,No,No
Evan Hymes,1338,361,1138,422,403,314,3554.0,527,180,341.0,611,242,24.2,No,2013,No,No,No
Rakeem Brookins,477,165,475,163,134,102,1545.0,174,49,147.0,301,114,22.6,No,2013,No,No,No
Trenity Burdine,271,32,212,92,88,66,1022.0,64,21,51.0,148,71,15.4,No,2013,No,No,No
Imoh Silas,267,38,225,118,69,31,1243.0,0,0,102.0,225,118,14.7,No,2013,No,No,No
Davis Martens,163,15,166,62,70,37,647.0,17,2,44.0,149,60,19.2,No,2013,No,No,No
Rich Audu,93,14,100,30,18,16,467.0,50,17,33.0,50,13,16.0,No,2013,No,No,No
Brett Bisping,1528,151,1116,532,477,368,3750.0,274,96,235.0,842,436,20.4,No,2013,No,No,No
Ryan Oliver,684,125,583,236,112,76,2410.0,368,136,98.0,215,100,15.0,No,2013,No,No,No
Chris Leppanen,15,12,12,7,2,0,95.0,1,1,10.0,11,6,12.9,No,2013,No,No,No
Steven Cruz,11,2,7,3,7,4,27.0,3,1,7.0,4,2,32.6,No,2013,No,No,No
Marcus Hopper,10,0,18,4,3,2,93.0,6,0,5.0,12,4,13.7,No,2013,No,No,No
Lionel Gomis,28,5,33,10,17,8,261.0,0,0,13.0,33,10,10.8,No,2013,No,No,No
Augustine Rubit,1917,125,1359,673,763,550,3756.0,75,21,269.0,1284,652,26.2,No,2013,No,No,No
Mychal Ammons,901,108,724,312,319,209,2496.0,185,68,187.0,539,244,21.2,No,2013,No,No,No
Antoine Allen,652,94,613,202,177,130,1797.0,368,118,128.0,245,84,22.9,No,2013,No,No,No
Javier Carter,652,52,525,252,207,147,2294.0,4,1,125.0,521,251,16.1,No,2013,No,No,No
Freddie Goldstein,489,120,462,161,82,63,1460.0,303,104,152.0,159,57,22.0,No,2013,No,No,No
Xavier Roberson,332,54,252,109,70,51,829.0,149,63,58.0,103,46,20.9,No,2013,No,No,No
Dre Conner,307,133,204,74,177,131,1329.0,88,28,85.0,116,46,14.2,No,2013,No,No,No
Barrington Stevens III,758,300,690,259,179,130,3481.0,317,110,198.0,373,149,13.9,No,2013,No,No,No
Trey Anderson,262,119,258,88,101,69,1164.0,61,17,130.0,197,71,18.5,No,2013,No,No,No
Wendell Wright,109,55,88,39,61,31,958.0,4,0,55.0,84,39,8.6,No,2013,No,No,No
Viktor Juricek,125,8,109,40,39,27,510.0,56,18,40.0,53,22,16.9,No,2013,No,No,No
Gregoryshon Magee,6,0,6,2,2,2,17.0,0,0,7.0,6,2,40.0,No,2013,No,No,No
Matthew Hezekiah,763,37,591,326,158,111,1834.0,3,0,101.0,588,326,21.0,No,2013,No,No,No
Khalif Toombs,1143,508,1000,363,402,297,3844.0,393,120,309.0,607,243,19.3,No,2013,No,No,No
Darryl Palmer,968,122,901,391,264,159,3307.0,125,27,145.0,776,364,18.0,No,2013,No,No,No
Adama Adams,507,148,424,163,171,129,1462.0,166,52,164.0,258,111,23.0,No,2013,No,No,No
Shaquiell Mitchell,184,44,227,60,93,47,867.0,69,17,79.0,158,43,20.3,No,2013,No,No,No
Patrick Myers,144,40,171,51,40,27,759.0,62,15,51.0,109,36,16.0,No,2013,No,No,No
Luka Radovic,345,23,307,135,100,65,1609.0,46,10,105.0,261,125,14.1,No,2013,No,No,No
Devin Joint,366,94,382,150,94,45,1852.0,88,21,97.0,294,129,14.0,No,2013,No,No,No
Chasen Campbell,52,4,64,18,11,7,181.0,28,9,14.0,36,9,23.1,No,2013,No,No,No
Phillip Henry,21,2,27,7,7,4,101.0,14,3,2.0,13,4,16.1,No,2013,No,No,No
Randall Black,19,3,31,6,8,4,110.0,16,3,10.0,15,3,20.5,No,2013,No,No,No
Terrance Linton,4,1,10,1,4,1,42.0,7,1,5.0,3,0,20.3,No,2013,No,No,No
Joshua Benjamin,0,2,2,0,0,0,25.0,0,0,4.0,2,0,12.1,No,2013,No,No,No
Omari Bennett,0,0,0,0,0,0,4.0,0,0,0.0,0,0,0.0,No,2013,No,No,No
Theron Stephens,127,22,141,41,19,16,371.0,93,29,17.0,48,12,22.3,No,2013,No,No,No
Dominique Youmans,5,3,10,2,2,1,136.0,0,0,10.0,10,2,7.8,No,2013,No,No,No
Torrey Craig,2128,236,1808,747,502,337,4061.0,899,297,347.0,909,450,29.5,Yes,2013,No,No,No
Ty Greene,1884,329,1447,590,548,419,4213.0,755,285,190.0,692,305,22.5,No,2013,No,No,No
Ricardo Glenn,1255,204,858,476,484,300,3046.0,13,3,213.0,845,473,21.3,No,2013,No,No,No
Adrian Rodgers,1597,226,1406,585,346,260,3554.0,502,167,257.0,904,418,25.8,No,2013,No,No,No
Jodd Maxey,878,138,693,356,267,166,2693.0,5,0,164.0,688,356,18.1,No,2013,No,No,No
Fred Miller,889,346,836,322,207,153,2789.0,297,92,224.0,539,230,20.9,No,2013,No,No,No
Babatunde Olomuwiya,588,75,423,236,222,115,2068.0,5,1,140.0,418,235,16.1,No,2013,No,No,No
Mario Blessing,556,293,534,194,85,55,3213.0,339,113,187.0,195,81,11.8,No,2013,No,No,No
Rob Elam,51,25,61,19,23,13,513.0,1,0,19.0,60,19,8.7,No,2013,No,No,No
Bruce Haynes,20,3,15,6,4,3,44.0,14,5,1.0,1,1,20.1,No,2013,No,No,No
Jeremy Ford,3,2,3,1,2,1,25.0,1,0,1.0,2,1,9.9,No,2013,No,No,No
Brenton Williams,986,101,700,297,252,223,2005.0,410,169,97.0,290,128,23.1,No,2013,No,No,No
Michael Carrera,1143,86,860,368,462,330,2743.0,215,77,182.0,645,291,22.6,No,2013,No,No,No
Lakeem Jackson,766,227,675,343,215,75,3001.0,25,5,177.0,650,338,15.7,No,2013,No,No,No
Brian Richardson,709,118,645,238,159,112,2244.0,370,121,117.0,275,117,19.3,No,2013,No,No,No
Bruce Ellington,893,238,957,322,184,123,2435.0,411,126,211.0,546,196,25.9,No,2013,No,No,No
Eric Smith,446,195,440,151,133,87,2037.0,196,57,150.0,244,94,16.2,No,2013,No,No,No
Mindaugas Kacinas,879,82,618,328,280,188,3129.0,118,35,167.0,500,293,14.4,No,2013,No,No,No
RJ Slawson,582,51,463,208,200,137,2018.0,106,29,128.0,357,179,17.0,No,2013,No,No,No
Damien Leonard,324,30,354,110,42,28,1066.0,246,76,65.0,108,34,21.5,No,2013,No,No,No
LaShay Page,656,51,590,216,131,102,1923.0,355,122,73.0,235,94,19.2,No,2013,No,No,No
Laimonas Chatkevicius,890,71,703,361,213,150,2234.0,65,18,167.0,638,343,21.4,No,2013,No,No,No
Brian Steele,99,27,110,34,12,8,476.0,79,23,18.0,31,11,14.2,No,2013,No,No,No
Shane Phillips,5,4,8,2,2,1,33.0,5,0,4.0,3,2,18.2,No,2013,No,No,No
Austin Constable,0,0,4,0,0,0,12.0,2,0,1.0,2,0,20.8,No,2013,No,No,No
Nate Wolters,2352,668,1716,773,807,648,4204.0,462,158,280.0,1254,615,29.3,Yes,2013,No,No,No
Jordan Dykstra,1661,190,1171,568,428,332,3595.0,434,193,202.0,737,375,22.9,No,2013,No,No,No
Tony Fiegen,844,106,673,341,237,161,2691.0,1,1,119.0,672,340,17.6,No,2013,No,No,No
Brayden Carlson,1132,287,805,363,330,249,3835.0,405,157,191.0,400,206,15.8,No,2013,No,No,No
Chad White,1169,203,852,389,242,176,3445.0,526,215,169.0,326,174,17.2,No,2013,No,No,No
Marcus Heemstra,414,83,309,162,123,87,1377.0,8,3,85.0,301,159,17.3,No,2013,No,No,No
Taevaunn Prince,329,23,223,105,159,109,888.0,37,10,60.0,186,95,21.5,No,2013,No,No,No
Joshua White,240,44,227,90,36,23,757.0,122,37,32.0,105,53,18.3,No,2013,No,No,No
Jake Bittle,829,225,630,289,226,174,2674.0,223,77,180.0,407,212,17.8,No,2013,No,No,No
Zach Horstman,347,51,284,121,98,67,1198.0,121,38,41.0,163,83,16.3,No,2013,No,No,No
Cory Jacobsen,59,12,53,19,13,6,276.0,46,15,11.0,7,4,13.3,No,2013,No,No,No
Joey Feilmeier,3,1,5,1,0,0,17.0,3,1,2.0,2,0,22.5,No,2013,No,No,No
Juevol Myles,502,98,373,148,175,150,1060.0,160,56,67.0,213,92,26.1,No,2013,No,No,No
Trevor Gruis,1340,191,920,512,486,316,3491.0,0,0,259.0,920,512,20.7,No,2013,No,No,No
Brandon Bos,1200,223,959,376,355,303,2895.0,382,145,184.0,577,231,23.8,No,2013,No,No,No
Casey Kasperbauer,1163,168,891,379,163,148,3378.0,610,257,101.0,281,122,16.3,No,2013,No,No,No
Karim Rowson,396,39,287,126,189,135,1163.0,36,9,80.0,251,117,20.9,No,2013,No,No,No
Steve Tecker,495,116,393,194,96,72,1703.0,95,35,81.0,298,159,15.4,No,2013,No,No,No
Tyler Flack,952,65,711,370,238,178,2173.0,108,34,128.0,603,336,22.1,No,2013,No,No,No
Jordan Boots,536,146,485,186,51,37,1997.0,365,127,90.0,120,59,15.0,No,2013,No,No,No
Eric Robertson,566,39,490,214,159,118,1892.0,76,20,63.0,414,194,17.0,No,2013,No,No,No
Jared Bartling,6,7,14,1,14,4,162.0,2,0,14.0,12,1,10.8,No,2013,No,No,No
Jack Foley,6,1,11,1,4,3,43.0,9,1,5.0,2,0,22.0,Yes,2013,No,No,No
Victor Rudd,1254,140,1103,435,355,261,3197.0,440,123,187.0,663,312,25.1,No,2013,No,No,No
Toarlyn Fitzpatrick,869,89,778,316,191,126,3156.0,316,111,178.0,462,205,18.4,No,2013,No,No,No
Jawanza Poland,760,99,700,273,196,140,2132.0,276,74,149.0,424,199,24.5,No,2013,No,No,No
Anthony Collins,987,724,813,346,298,236,4374.0,156,59,344.0,657,287,16.2,No,2013,No,No,No
Martino Brock,1230,208,1002,445,464,276,3342.0,216,64,227.0,786,381,22.2,No,2013,No,No,No
Zach LeDay,1346,109,916,442,552,420,3029.0,134,42,152.0,782,400,22.7,No,2013,No,No,No
Javontae Hawkins,1169,107,893,406,351,274,2559.0,254,83,188.0,639,323,25.2,No,2013,No,No,No
Shaun Noriega,423,34,344,125,90,72,1175.0,274,101,49.0,70,24,20.3,No,2013,No,No,No
Kore White,558,54,520,231,136,75,1826.0,60,21,118.0,460,210,20.4,No,2013,No,No,No
Musa Abdul-Aleem,551,31,463,185,113,88,1136.0,274,93,64.0,189,92,26.6,No,2013,No,No,No
Jordan Omogbehin,23,1,23,11,16,1,189.0,0,0,13.0,23,11,12.6,No,2013,No,No,No
Mike McCloskey,11,6,11,4,2,1,65.0,7,2,5.0,4,2,14.8,No,2013,No,No,No
Mike Dakkak,0,0,0,0,0,0,1.0,0,0,0.0,0,0,0.0,No,2013,No,No,No
Tyler Stone,1568,125,1208,632,369,262,3029.0,137,42,152.0,1071,590,25.4,No,2013,No,No,No
Corey Wilford,616,90,495,217,92,68,1288.0,280,114,75.0,215,103,24.4,No,2013,No,No,No
Nino Johnson,988,117,661,369,434,248,2755.0,9,2,207.0,652,367,19.6,No,2013,No,No,No
Marland Smith,1423,248,1201,476,292,220,3671.0,697,251,198.0,504,225,21.5,No,2013,No,No,No
A.J. Jones,284,53,229,105,72,44,666.0,70,30,68.0,159,75,25.4,No,2013,No,No,No
Nick Niernczyk,541,107,474,188,68,60,1560.0,282,105,56.0,192,83,18.5,No,2013,No,No,No
Lucas Nutt,931,604,634,259,356,296,3576.0,312,117,272.0,322,142,15.2,No,2013,No,No,No
Jared White,57,22,35,17,22,19,207.0,5,4,25.0,30,13,17.4,No,2013,No,No,No
Colin Ferguson,12,0,13,6,0,0,63.0,0,0,2.0,13,6,12.2,No,2013,No,No,No
Jacob Tolbert,10,3,12,5,0,0,178.0,1,0,8.0,11,5,5.7,No,2013,No,No,No
Michael Porter,164,25,127,66,42,27,580.0,17,5,31.0,110,61,15.9,No,2013,No,No,No
Matt Floyd,2,0,3,1,0,0,7.0,0,0,0.0,3,1,21.9,No,2013,No,No,No
Brandon Fortenberry,1348,421,1057,444,407,292,3639.0,470,168,254.0,587,276,22.3,No,2013,No,No,No
Roosevelt Johnson,825,67,697,307,333,209,1930.0,9,2,195.0,688,305,28.3,No,2013,No,No,No
Dre Evans,617,165,516,212,112,79,2006.0,268,114,112.0,248,98,17.7,No,2013,No,No,No
Jeffery Ricard,444,88,401,153,142,108,1470.0,113,30,113.0,288,123,20.8,No,2013,No,No,No
Todd Nelson,331,34,290,107,65,39,967.0,221,78,52.0,69,29,20.2,No,2013,No,No,No
Onochie Ochie,743,36,532,273,249,162,1795.0,95,35,123.0,437,238,22.5,No,2013,No,No,No
Antonnio Benton,597,65,506,220,179,129,2025.0,112,28,132.0,394,192,18.8,No,2013,No,No,No
Roger Woods,846,118,588,298,366,226,2195.0,65,24,149.0,523,274,22.2,No,2013,No,No,No
Jeremy Campbell,316,55,303,115,132,78,1290.0,42,8,79.0,261,107,18.0,No,2013,No,No,No
Jamaal James,18,3,13,5,12,8,187.0,0,0,10.0,13,5,8.1,No,2013,No,No,No
Jan Petrovcic,74,23,84,30,35,13,605.0,8,1,43.0,76,29,12.4,No,2013,No,No,No
Eric Wise,1662,236,1303,587,615,450,3538.0,111,38,224.0,1192,549,26.9,No,2013,No,No,No
JT Terrell,951,99,858,317,226,171,2220.0,437,146,166.0,421,171,25.7,No,2013,No,No,No
Byron Wesley,1569,273,1273,583,516,345,4179.0,170,58,251.0,1103,525,22.4,No,2013,No,No,No
Jio Fontan,1056,415,943,350,408,267,2960.0,272,89,266.0,671,261,24.4,No,2013,No,No,No
Dewayne Dedmon,360,25,294,153,88,54,1156.0,4,0,78.0,290,153,19.5,Yes,2013,No,No,No
Omar Oraby,698,33,444,267,256,164,1644.0,0,0,132.0,444,267,21.5,No,2013,No,No,No
Aaron Fuller,741,46,593,276,253,161,2278.0,104,28,125.0,489,248,20.9,No,2013,No,No,No
Ari Stewart,542,45,541,201,75,57,1471.0,268,83,125.0,273,118,23.5,No,2013,No,No,No
Chass Bryan,101,79,105,34,49,26,666.0,25,7,48.0,80,27,13.4,No,2013,No,No,No
James Blasczyk,138,17,132,60,33,18,781.0,0,0,35.0,132,60,13.2,No,2013,No,No,No
Renaldo Woolridge,320,42,329,118,56,31,1166.0,182,53,56.0,147,65,17.5,No,2013,No,No,No
Greg Allen,133,29,143,45,17,12,604.0,106,31,23.0,37,14,16.6,No,2013,No,No,No
Brendyn Taylor,113,34,102,39,46,22,539.0,45,13,25.0,57,26,14.5,No,2013,No,No,No
Strahinja Gavrilovic,248,8,200,86,105,68,773.0,30,8,41.0,170,78,18.6,No,2013,No,No,No
Daniel Munoz,5,8,12,1,2,2,123.0,12,1,15.0,0,0,13.0,No,2013,No,No,No
Tyler Sugiyama,0,0,1,0,1,0,14.0,0,0,1.0,1,0,9.5,No,2013,No,No,No
Jerome Jones,699,44,628,261,133,88,1640.0,248,89,127.0,380,172,26.1,No,2013,No,No,No
Kris Davis,1305,278,1015,450,338,223,3493.0,418,182,263.0,597,268,21.3,No,2013,No,No,No
Mark Yelovich,1467,131,1192,526,423,309,2184.0,292,106,140.0,900,420,28.5,No,2013,No,No,No
Michael Messer,887,149,688,307,258,184,2641.0,235,89,155.0,453,218,18.9,No,2013,No,No,No
Tim Johnson,579,99,524,214,135,96,1612.0,193,55,125.0,331,159,22.6,No,2013,No,No,No
Derian Shaffer,360,24,278,141,143,78,1231.0,0,0,86.0,278,141,18.4,No,2013,No,No,No
Maurice Wiltz,462,79,347,138,143,105,1291.0,199,81,77.0,148,57,19.6,No,2013,No,No,No
Ray Lester,299,32,245,109,185,81,1216.0,2,0,103.0,243,109,18.2,No,2013,No,No,No
Reggie Reed,67,114,62,24,32,18,731.0,8,1,74.0,54,23,10.8,No,2013,No,No,No
Charles Joy,59,30,70,24,19,9,362.0,19,2,34.0,51,22,16.3,No,2013,No,No,No
Michael Birts,39,2,25,11,23,17,179.0,1,0,11.0,24,11,13.6,No,2013,No,No,No
Zeke Schneider,43,5,34,16,16,11,507.0,0,0,24.0,34,16,6.7,No,2013,No,No,No
Kyle Heck,5,2,3,1,2,2,40.0,2,1,1.0,1,0,6.5,No,2013,No,No,No
Desmar Jackson,1884,251,1442,665,625,460,3545.0,333,94,369.0,1109,571,31.1,No,2013,No,No,No
Jeff Early,656,58,533,259,186,126,1612.0,58,12,107.0,475,247,23.9,No,2013,No,No,No
Anthony Beane,1917,189,1563,679,474,366,4272.0,537,193,255.0,1026,486,25.4,No,2013,No,No,No
Dantiel Daniels,943,78,587,355,460,233,2898.0,0,0,132.0,587,355,16.6,No,2013,No,No,No
Kendal Brown-Surles,721,281,623,238,160,119,2882.0,380,126,193.0,243,112,16.5,No,2013,No,No,No
Jalen Pendleton,643,121,510,227,283,173,1771.0,63,16,113.0,447,211,23.3,No,2013,No,No,No
T.J. Lindsay,336,78,314,123,46,29,1287.0,167,61,64.0,147,62,16.3,No,2013,No,No,No
Josh Swan,174,36,160,59,97,52,771.0,27,4,52.0,133,55,17.7,No,2013,No,No,No
Davante Drinkard,232,26,224,92,100,48,1425.0,0,0,85.0,224,92,13.4,No,2013,No,No,No
Tony Bryer,32,2,29,15,2,2,161.0,1,0,7.0,28,15,12.3,No,2013,No,No,No
Colby Long,26,8,28,9,3,1,128.0,21,7,12.0,7,2,17.5,No,2013,No,No,No
Diamond Taylor,180,25,174,61,54,35,733.0,73,23,46.0,101,38,17.6,No,2013,No,No,No
Ryan Bonifield,1,0,0,0,2,1,6.0,0,0,0.0,0,0,8.6,No,2013,No,No,No
Calvin Belts,0,0,2,0,2,0,9.0,0,0,0.0,2,0,17.8,No,2013,No,No,No
Jalen Jones,1635,97,1247,568,627,434,3523.0,208,65,212.0,1039,503,26.4,Yes,2013,No,No,No
Nick Russell,951,293,852,339,251,196,2811.0,239,77,253.0,613,262,22.7,No,2013,No,No,No
Ryan Manuel,878,210,541,258,502,348,3083.0,43,14,177.0,498,244,16.8,No,2013,No,No,No
Cannen Cunningham,802,106,603,314,234,166,2425.0,41,8,187.0,562,306,20.1,No,2013,No,No,No
Shawn Williams,606,110,520,234,144,81,2354.0,182,57,87.0,338,177,15.6,No,2013,No,No,No
Brian Bernardi,1296,174,1042,410,231,197,3782.0,722,279,141.0,320,131,17.0,No,2013,No,No,No
London Giles,425,79,357,136,108,86,1534.0,196,67,105.0,161,69,18.8,No,2013,No,No,No
Uche Ofoegbu,539,84,431,189,154,103,1872.0,157,58,106.0,274,131,15.9,No,2013,No,No,No
Jordan Dickerson,226,25,168,84,99,58,1540.0,2,0,64.0,166,84,9.5,No,2013,No,No,No
Kevin Dunleavy Jr.,4,0,9,2,3,0,38.0,6,0,5.0,3,2,21.6,No,2013,No,No,No
Marcus Holyfield,0,0,0,0,0,0,2.0,0,0,0.0,0,0,0.0,No,2013,No,No,No
Garrett Wilson,0,0,2,0,0,0,8.0,1,0,1.0,1,0,20.1,No,2013,No,No,No
Dwayne Davis,545,87,395,193,127,100,1026.0,143,59,114.0,252,134,28.2,No,2013,No,No,No
Jerrold Brooks,729,172,646,251,122,91,2071.0,392,136,107.0,254,115,20.0,No,2013,No,No,No
Neil Watson,1157,473,823,329,393,335,3322.0,415,164,229.0,408,165,19.1,No,2013,No,No,No
Jonathan Mills,667,77,486,246,278,175,1862.0,0,0,125.0,486,246,20.4,No,2013,No,No,No
Daveon Boardingham,684,36,421,242,299,200,1542.0,1,0,100.0,420,242,22.0,No,2013,No,No,No
Michael Craig,582,128,388,230,180,121,1277.0,7,1,124.0,381,229,23.9,No,2013,No,No,No
Rashard McGill,378,51,348,130,131,87,1658.0,97,31,88.0,251,99,15.4,No,2013,No,No,No
Cedric Jenkins,586,96,538,213,113,79,1576.0,275,81,102.0,263,132,22.5,No,2013,No,No,No
Norville Carey,869,51,668,340,288,183,2076.0,23,6,161.0,645,334,23.4,No,2013,No,No,No
Deon Edwin,710,124,536,249,215,147,1830.0,185,65,130.0,351,184,20.1,No,2013,No,No,No
Jamie Chapman,45,22,39,14,24,11,318.0,17,6,20.0,22,8,12.0,No,2013,No,No,No
Christian Robbins,1,0,1,0,2,1,17.0,0,0,0.0,1,0,5.8,No,2013,No,No,No
Jackson Stevenett,1273,144,954,463,395,312,2959.0,108,35,165.0,846,428,22.6,No,2013,No,No,No
Damon Heuir,942,260,810,308,311,221,2591.0,318,105,226.0,492,203,23.3,No,2013,No,No,No
Jayson Cheesman,304,40,298,113,128,78,1001.0,0,0,83.0,298,113,22.5,No,2013,No,No,No
A.J. Hess,1115,115,870,353,225,192,3041.0,575,217,130.0,295,136,19.0,No,2013,No,No,No
Wade Collie,289,73,249,106,72,48,1017.0,84,29,76.0,165,77,18.1,No,2013,No,No,No
Cal Hanks,354,21,278,121,178,112,1098.0,1,0,92.0,277,121,21.6,No,2013,No,No,No
Jordan Johnson,182,70,140,64,75,47,1054.0,24,7,63.0,116,57,11.5,No,2013,No,No,No
Jaren Jeffery,356,48,276,134,144,79,1315.0,30,9,68.0,246,125,17.0,No,2013,No,No,No
Chris Nsenki,126,56,164,46,15,12,799.0,89,22,51.0,75,24,14.4,No,2013,No,No,No
Julian Scott,106,10,89,42,37,22,287.0,0,0,35.0,89,42,25.2,No,2013,No,No,No
Tyson Koehler,188,43,161,76,51,36,802.0,4,0,40.0,157,76,14.3,No,2013,No,No,No
Zach Ghormley,7,0,11,2,2,2,21.0,8,1,1.0,3,1,30.3,No,2013,No,No,No
John Renfro,4,0,2,1,3,2,9.0,1,0,0.0,1,1,18.7,No,2013,No,No,No
Drake Thomas,12,22,25,5,6,1,198.0,6,1,14.0,19,4,11.0,No,2013,No,No,No
Matt Gardner,7,1,6,3,2,1,19.0,2,0,3.0,4,3,27.6,No,2013,No,No,No
Derick Beltran,937,100,760,302,269,214,2114.0,361,119,124.0,399,183,25.8,No,2013,No,No,No
Malcolm Miller,920,68,685,326,134,98,1766.0,404,170,74.0,281,156,24.2,Yes,2013,No,No,No
Javan Mitchell,628,54,504,236,251,156,1893.0,1,0,130.0,503,236,20.7,No,2013,No,No,No
Jameel Grace,850,435,761,272,344,221,3079.0,291,85,298.0,470,187,20.9,No,2013,No,No,No
Yondarius Johnson,694,70,576,243,223,133,1879.0,233,75,109.0,343,168,21.5,No,2013,No,No,No
Brandon Moore,335,51,274,124,116,83,1769.0,17,4,94.0,257,120,12.5,No,2013,No,No,No
Cameron Monroe,336,100,331,123,131,81,1678.0,42,9,141.0,289,114,16.8,No,2013,No,No,No
Christopher Hyder,599,476,456,204,241,173,3321.0,74,18,174.0,382,186,11.5,No,2013,No,No,No
Madut Bol,392,16,316,135,137,95,1453.0,74,27,65.0,242,108,15.9,No,2013,No,No,No
Aaron Alston,21,2,14,8,13,5,99.0,1,0,8.0,13,8,15.4,No,2013,No,No,No
Thomas Marshall,50,28,38,15,27,20,402.0,2,0,30.0,36,15,10.8,No,2013,No,No,No
Demitrius Conger,1206,249,824,390,412,320,3510.0,297,106,254.0,527,284,18.9,No,2013,No,No,No
Eric Mosley,644,119,494,204,139,115,1293.0,308,121,95.0,186,83,26.2,No,2013,No,No,No
Chris Johnson,563,70,432,182,182,149,1309.0,130,50,85.0,302,132,23.9,Yes,2013,No,No,No
Youssou Ndoye,971,58,660,335,447,301,2765.0,1,0,233.0,659,335,20.4,No,2013,No,No,No
Matthew Wright,1073,292,890,352,254,213,3111.0,468,156,210.0,422,196,20.0,No,2013,No,No,No
Marquise Simmons,617,46,457,249,196,118,2019.0,3,1,105.0,454,248,16.5,No,2013,No,No,No
Charlon Kloof,751,310,550,236,303,217,2504.0,193,62,173.0,357,174,17.5,No,2013,No,No,No
Jordan Gathers,547,180,481,189,119,86,2054.0,239,83,111.0,242,106,15.9,No,2013,No,No,No
Michael Davenport,818,204,749,311,163,124,2581.0,225,72,178.0,524,239,20.4,No,2013,No,No,No
Dion Wright,1263,102,1020,509,280,214,3042.0,101,31,120.0,919,478,21.1,No,2013,No,No,No
Jean Yves Toupane,18,1,17,6,6,3,42.0,13,3,1.0,4,3,25.2,No,2013,No,No,No
Danny Farrell,3,0,7,1,2,0,12.0,4,1,4.0,3,0,50.7,No,2013,No,No,No
Jalen Cannon,1720,115,1198,629,613,416,3789.0,153,46,162.0,1045,583,21.8,No,2013,No,No,No
Ben Mockford,1077,96,927,355,137,107,2752.0,688,260,97.0,239,95,19.8,No,2013,No,No,No
Akeem Johnson,1009,81,717,377,403,255,2560.0,0,0,161.0,717,377,20.9,No,2013,No,No,No
Travis Nichols,705,17,557,250,117,99,1397.0,287,106,71.0,270,144,24.2,No,2013,No,No,No
Brent Jones,1142,616,985,380,399,286,3306.0,309,96,370.0,676,284,23.3,No,2013,No,No,No
Dre Calloway,376,200,340,137,204,99,1419.0,34,3,124.0,306,134,19.6,No,2013,No,No,No
Kevin Douglas,462,41,404,169,109,71,1488.0,173,53,97.0,231,116,18.5,No,2013,No,No,No
Aleksandar Isailovic,181,25,202,61,20,16,888.0,159,43,28.0,43,18,13.5,No,2013,No,No,No
PJ Santavenere,195,21,186,68,33,25,644.0,124,34,27.0,62,34,17.6,No,2013,No,No,No
Lowell Ulmer,264,50,239,97,109,56,1137.0,58,14,65.0,181,83,15.7,No,2013,No,No,No
Anthony White,186,66,202,73,36,30,857.0,57,10,49.0,145,63,15.8,No,2013,No,No,No
Matt Milk,215,22,176,93,47,29,1083.0,0,0,50.0,176,93,11.4,No,2013,No,No,No
Milos Trivic,40,6,34,14,22,7,186.0,11,5,14.0,23,9,15.6,No,2013,No,No,No
Mike Nierva,3,1,2,1,0,0,5.0,1,1,1.0,1,0,29.8,No,2013,No,No,No
JaKarr Sampson,915,74,816,383,244,148,1997.0,13,1,118.0,803,382,26.7,Yes,2013,No,No,No
D'Angelo Harrison,2178,253,1686,660,732,594,4311.0,743,264,231.0,943,396,26.7,No,2013,No,No,No
Phil Greene,1243,281,1262,491,175,123,4041.0,424,138,154.0,838,353,18.9,No,2013,No,No,No
Sir'Dominic Pointer,1078,299,852,406,360,245,3660.0,109,21,218.0,743,385,17.3,No,2013,No,No,No
Amir Garrett,341,51,279,124,157,86,1254.0,30,7,73.0,249,117,17.1,No,2013,No,No,No
Chris Obekpa,425,78,361,175,164,75,2318.0,1,0,112.0,360,175,12.1,No,2013,No,No,No
Jamal Branch,436,198,392,170,107,74,1722.0,75,22,119.0,317,148,16.8,No,2013,No,No,No
Marc-Antoine Bourgault,107,9,107,37,5,4,349.0,87,29,12.0,20,8,17.6,No,2013,No,No,No
Christian Jones,609,77,532,252,178,104,1893.0,4,1,118.0,528,251,18.9,No,2013,No,No,No
Felix Balamou,267,80,263,107,81,52,1085.0,7,1,70.0,256,106,16.7,No,2013,No,No,No
David Lipscomb,0,3,5,0,0,0,44.0,3,0,2.0,2,0,8.1,No,2013,No,No,No
Khadim Ndiaye,2,0,5,1,0,0,37.0,0,0,1.0,5,1,8.3,No,2013,No,No,No
Sam Sealy,0,0,0,0,2,0,9.0,0,0,0.0,0,0,5.3,No,2013,No,No,No
Jamal White,10,1,15,3,2,2,32.0,13,2,1.0,2,1,26.5,No,2013,No,No,No
Dwight Powell,1465,240,1110,515,557,402,3569.0,114,33,283.0,996,482,23.8,Yes,2013,No,No,No
Chasson Randle,2375,354,1775,760,684,551,4791.0,787,304,324.0,988,456,25.9,Yes,2013,No,No,No
Josh Huestis,1019,113,870,392,277,169,3376.0,207,66,125.0,663,326,17.0,Yes,2013,No,No,No
Aaron Bright,1241,428,1027,386,326,271,3626.0,556,198,247.0,471,188,20.4,No,2013,No,No,No
Andy Brown,216,37,176,86,58,30,802.0,40,14,38.0,136,72,15.1,No,2013,No,No,No
John Gage,513,31,415,169,72,60,1305.0,297,115,58.0,118,54,19.8,No,2013,No,No,No
Rosco Allen,811,105,641,255,283,202,2288.0,292,99,126.0,349,156,20.2,No,2013,No,No,No
Gabriel Harris,184,50,183,61,66,47,825.0,51,15,53.0,132,46,16.5,No,2013,No,No,No
Robbie Lemons,156,24,147,55,24,14,742.0,93,32,17.0,54,23,12.1,No,2013,No,No,No
Christian Sanders,290,218,256,86,126,93,1643.0,87,25,125.0,169,61,13.6,No,2013,No,No,No
Stefan Nastic,875,107,645,307,365,259,2182.0,8,2,162.0,637,305,23.3,No,2013,No,No,No
Grant Verhoeven,250,27,192,90,92,60,1156.0,22,10,39.0,170,80,12.1,No,2013,No,No,No
Anthony Brown,1562,231,1211,518,410,308,4200.0,541,218,228.0,670,300,20.1,Yes,2013,No,No,No
Wade Morgan,4,7,15,1,8,2,58.0,4,0,7.0,11,1,22.7,No,2013,No,No,No
Taylor Smith,796,65,488,340,272,116,1697.0,0,0,99.0,488,340,22.9,No,2013,No,No,No
Antonio Bostic,896,184,838,344,173,131,2755.0,251,77,166.0,587,267,21.3,No,2013,No,No,No
Desmond Haymon,1159,191,896,376,408,269,3141.0,411,138,148.0,485,238,20.8,No,2013,No,No,No
Hal Bateman,363,263,305,125,180,107,1431.0,29,6,142.0,276,119,20.2,No,2013,No,No,No
Jacob Parker,1251,201,898,439,335,267,3090.0,261,106,160.0,637,333,20.3,No,2013,No,No,No
Thomas Walkup,1744,395,1114,633,577,438,3532.0,131,40,215.0,983,593,22.9,No,2013,No,No,No
Deshaunt Walker,473,49,441,169,51,41,957.0,281,94,37.0,160,75,27.1,No,2013,No,No,No
Ice Asortse,59,3,37,23,23,13,166.0,0,0,20.0,37,23,22.2,No,2013,No,No,No
Nikola Gajic,380,71,278,133,96,67,955.0,126,47,60.0,152,86,20.7,No,2013,No,No,No
Trey Pinkney,358,422,266,97,212,141,2911.0,98,23,164.0,168,74,9.2,No,2013,No,No,No
Jared Harrison,26,11,26,6,10,8,99.0,18,6,11.0,8,0,22.9,No,2013,No,No,No
Rex Baxter,24,2,24,9,8,5,60.0,10,1,5.0,14,8,29.6,No,2013,No,No,No
Joe Bright,58,16,52,16,36,25,382.0,9,1,21.0,43,15,12.8,No,2013,No,No,No
Danilo Toskovic,10,4,10,5,0,0,33.0,3,0,1.0,7,5,18.1,No,2013,No,No,No
Adam Perez,8,3,10,3,6,2,68.0,6,0,3.0,4,3,12.6,No,2013,No,No,No
Adam Pegg,1105,93,865,441,257,183,2519.0,111,40,179.0,754,401,24.6,No,2013,No,No,No
Chris Perez,1468,188,1171,547,426,283,3514.0,264,91,240.0,907,456,22.9,No,2013,No,No,No
Aaron Graham,1125,200,937,348,284,223,3007.0,599,206,238.0,338,142,22.1,No,2013,No,No,No
Joel Naburgs,963,289,783,297,247,189,3138.0,520,180,221.0,263,117,17.9,No,2013,No,No,No
Willie Green,888,125,645,337,294,198,2282.0,65,16,136.0,580,321,20.8,Yes,2013,No,No,No
Hunter Miller,425,256,391,131,149,106,2236.0,187,57,188.0,204,74,14.8,No,2013,No,No,No
Liam McInerney,318,90,288,116,92,56,1988.0,95,30,100.0,193,86,10.9,No,2013,No,No,No
Dennis Diaz,127,41,125,44,18,12,578.0,88,27,58.0,37,17,16.3,No,2013,No,No,No
Logan Irwin,41,20,15,11,16,14,152.0,7,5,13.0,8,6,11.8,No,2013,No,No,No
Tanner Plemmons,51,4,39,18,0,0,94.0,34,15,6.0,5,3,24.7,No,2013,No,No,No
Leke Solanke,32,6,23,12,14,8,265.0,3,0,13.0,20,12,8.4,No,2013,No,No,No
Brian Pegg,1088,116,855,446,361,190,2936.0,25,6,209.0,830,440,21.3,No,2013,No,No,No
J.R. Weston,77,21,81,26,21,10,343.0,57,15,21.0,24,11,16.5,No,2013,No,No,No
Jameel Warney,2132,220,1482,884,615,364,4140.0,0,0,184.0,1482,884,24.2,Yes,2013,No,No,No
Dave Coley,1228,198,1136,418,382,289,3373.0,312,103,256.0,824,315,24.5,No,2013,No,No,No
Anthony Jackson,1048,177,876,357,185,164,2578.0,463,170,200.0,413,187,23.6,No,2013,No,No,No
Tommy Brenton,971,402,631,315,506,321,3798.0,77,20,223.0,554,295,15.5,No,2013,No,No,No
Marcus Rouse,654,105,606,243,88,73,2179.0,278,95,76.0,328,148,17.5,No,2013,No,No,No
Carson Puriefoy,1572,345,1242,494,517,398,3651.0,503,186,296.0,739,308,24.9,No,2013,No,No,No
Eric McAlister,499,47,398,200,119,85,1867.0,49,14,71.0,349,186,14.7,No,2013,No,No,No
Ron Bracey,189,12,178,68,41,31,516.0,75,22,35.0,103,46,23.8,No,2013,No,No,No
Scott King,349,43,305,125,48,34,1028.0,186,65,50.0,119,60,18.9,No,2013,No,No,No
Anthony Mayo,202,18,210,78,66,46,1069.0,0,0,42.0,210,78,14.0,No,2013,No,No,No
Leonard Hayes,347,56,342,120,41,31,1300.0,225,76,39.0,117,44,16.3,No,2013,No,No,No
Ben Resner,27,15,25,6,20,14,115.0,7,1,26.0,18,5,27.4,No,2013,No,No,No
C.J. Fair,1660,119,1367,631,466,337,4251.0,178,61,204.0,1189,570,22.0,No,2013,No,No,No
Brandon Triche,1564,438,1242,536,425,319,3938.0,520,173,303.0,722,363,22.4,No,2013,No,No,No
Michael Carter-Williams,544,345,452,180,209,142,1678.0,137,42,154.0,315,138,21.3,Yes,2013,No,No,No
James Southerland,880,68,724,325,104,77,2089.0,413,153,66.0,311,172,20.4,Yes,2013,No,No,No
Rakeem Christmas,1046,86,731,409,335,228,3126.0,1,0,162.0,730,409,17.4,Yes,2013,No,No,No
Jerami Grant,541,62,385,187,251,161,1577.0,20,6,63.0,365,181,19.1,Yes,2013,No,No,No
Baye Moussa Keita,364,25,237,142,138,80,2110.0,0,0,78.0,237,142,9.3,No,2013,No,No,No
Trevor Cooney,1437,211,1285,466,281,224,4034.0,835,281,145.0,450,185,20.2,No,2013,No,No,No
DaJuan Coleman,448,25,327,169,198,110,1388.0,1,0,98.0,326,169,19.3,No,2013,No,No,No
Albert Nassar,5,0,5,2,0,0,11.0,2,1,0.0,3,1,24.1,No,2013,No,No,No
Nolan Hart,3,3,13,1,3,1,25.0,9,0,6.0,4,1,42.0,No,2013,No,No,No
Noel Jones,2,0,2,1,0,0,8.0,0,0,0.0,2,1,12.6,No,2013,No,No,No
Matt Lyde-Cajuste,9,2,12,3,4,3,54.0,3,0,4.0,9,3,16.7,No,2013,No,No,No
Griffin Hoffman,9,1,12,3,4,1,44.0,10,2,5.0,2,1,21.7,No,2013,No,No,No
Russ DeRemer,0,0,5,0,0,0,26.0,3,0,2.0,2,0,14.0,No,2013,No,No,No
Khalif Wyatt,1576,295,1083,482,525,435,2881.0,495,177,227.0,588,305,27.8,No,2013,No,No,No
Scootie Randall,734,116,627,265,120,87,2228.0,350,117,76.0,277,148,17.7,No,2013,No,No,No
Jake O'Brien,1337,63,1102,466,278,209,3296.0,513,196,155.0,589,270,22.5,No,2013,No,No,No
Anthony Lee,925,40,717,372,286,180,2438.0,5,1,119.0,712,371,20.1,No,2013,No,No,No
Rahlir Jefferson,914,266,724,353,348,208,3588.0,3,0,187.0,721,353,15.6,No,2013,No,No,No
Will Cummings,1245,357,942,392,499,386,3144.0,270,75,193.0,672,317,22.2,No,2013,No,No,No
T.J. DiLeo,288,122,242,101,92,56,1768.0,111,30,62.0,131,71,10.0,No,2013,No,No,No
Dalton Pepper,843,122,756,305,113,94,2123.0,400,139,93.0,356,166,21.3,No,2013,No,No,No
Quenton DeCosey,1513,251,1260,499,494,349,3574.0,477,166,206.0,783,333,24.3,No,2013,No,No,No
Daniel Dingle,757,220,659,246,269,168,2657.0,311,97,151.0,348,149,18.2,No,2013,No,No,No
Devontae Watson,191,9,183,84,47,23,1009.0,0,0,32.0,183,84,12.0,No,2013,No,No,No
Jimmy McDonnell,49,15,45,15,18,12,363.0,18,7,22.0,27,8,10.4,No,2013,No,No,No
Myles Taylor,1734,96,1128,588,705,534,3186.0,81,24,222.0,1047,564,26.5,No,2013,No,No,No
Mike Liabo,1524,247,1421,529,285,220,3092.0,723,246,243.0,698,283,29.0,No,2013,No,No,No
Justin Childs,446,86,417,164,122,89,1378.0,109,29,123.0,308,135,21.2,No,2013,No,No,No
Terence Smith,1171,293,877,370,380,306,3096.0,320,125,202.0,557,245,20.0,No,2013,No,No,No
Jeremy Washington,348,102,331,138,89,69,1355.0,28,3,63.0,303,135,16.1,No,2013,No,No,No
Bobby Jones,236,15,230,76,60,37,634.0,148,47,32.0,82,29,22.4,Yes,2013,No,Yes,Yes
B.J. McLaughlin,113,22,109,43,33,22,455.0,22,5,33.0,87,38,17.0,No,2013,No,No,No
Dee Oldham,654,145,538,210,192,149,2119.0,251,85,100.0,287,125,17.1,No,2013,No,No,No
Tobias Dowdell,122,8,107,54,20,13,595.0,1,1,23.0,106,53,11.4,No,2013,No,No,No
Khristian Taylor,105,66,96,38,59,24,663.0,20,5,57.0,76,33,13.5,No,2013,No,No,No
DeMarc Richardson,58,57,57,21,27,15,566.0,8,1,42.0,49,20,9.6,No,2013,No,No,No
Omari Minor,151,136,150,52,64,43,1418.0,18,4,104.0,132,48,10.1,No,2013,No,No,No
Pierre Mopo,23,3,30,9,14,5,415.0,0,0,19.0,30,9,6.6,No,2013,No,No,No
Kellen Thornton,963,64,736,384,238,158,2239.0,119,37,145.0,617,347,22.9,No,2013,No,No,No
Patrick Miller,1900,520,1433,609,754,555,4451.0,392,127,375.0,1041,482,24.8,No,2013,No,No,No
Robert Covington,1748,145,1309,623,399,320,3536.0,431,182,275.0,878,441,25.5,Yes,2013,No,No,No
Jordan Cyphers,753,59,569,215,246,200,1786.0,351,123,102.0,218,92,22.5,No,2013,No,No,No
M.J. Rhett,866,71,637,339,274,188,2968.0,1,0,196.0,636,339,16.4,No,2013,No,No,No
Michael Green,290,23,254,108,89,67,1343.0,40,7,68.0,214,101,13.8,No,2013,No,No,No
Jay Harris,721,161,636,238,214,145,2300.0,292,100,186.0,344,138,21.0,No,2013,No,No,No
DeShawn Dockery,242,141,237,87,99,42,1494.0,95,26,122.0,142,61,13.6,No,2013,No,No,No
Tashon Fredrick,241,34,215,82,91,64,1250.0,46,13,65.0,169,69,13.0,No,2013,No,No,No
Jordan Gaither,100,25,105,34,31,16,492.0,66,16,28.0,39,18,15.2,No,2013,No,No,No
Kharon Butcher,65,24,60,20,24,13,360.0,44,12,23.0,16,8,13.3,No,2013,No,No,No
Devante McClung,11,6,11,4,8,3,104.0,2,0,10.0,9,4,11.8,No,2013,No,No,No
Chaed Wellian,83,4,60,33,4,3,265.0,34,14,13.0,26,19,14.4,No,2013,No,No,No
Abraham Millsap,4,1,4,2,0,0,30.0,0,0,6.0,4,2,16.5,No,2013,No,No,No
Jud Dillard,1729,156,1219,605,618,470,3442.0,162,49,258.0,1057,556,25.8,No,2013,No,No,No
Dennis Ogbe,859,60,534,326,234,167,2116.0,125,40,129.0,409,286,18.2,No,2013,No,No,No
Jeremiah Samarrippas,1093,531,971,375,200,164,3947.0,515,179,352.0,456,196,19.4,No,2013,No,No,No
Lanerryl Johnson,692,100,607,232,168,133,1433.0,261,95,130.0,346,137,29.4,No,2013,No,No,No
Matt Marseille,490,47,381,170,188,113,1486.0,104,37,112.0,277,133,19.4,No,2013,No,No,No
Javon McKay,513,111,378,171,199,146,2077.0,96,25,118.0,282,146,14.2,No,2013,No,No,No
Anthony Morse,418,27,299,157,182,104,1479.0,2,0,78.0,297,157,15.7,No,2013,No,No,No
Terrell Barnes,393,117,370,153,239,87,2496.0,1,0,129.0,369,153,12.2,No,2013,No,No,No
Ammanuel Diressa,85,16,90,28,18,12,375.0,67,17,21.0,23,11,16.1,No,2013,No,No,No
Mitchell Hill,59,17,57,18,15,11,350.0,38,12,16.0,19,6,11.6,No,2013,No,No,No
Ryon Riggins,37,9,37,18,4,1,189.0,1,0,13.0,36,18,14.1,No,2013,No,No,No
DeOndre Haynes,117,42,110,39,53,37,445.0,15,2,41.0,95,37,19.5,No,2013,No,No,No
Jordan McRae,1521,209,1190,496,455,350,3088.0,522,179,225.0,668,317,27.8,Yes,2013,No,No,No
Jarnell Stokes,1129,129,776,411,489,307,2587.0,3,0,180.0,773,411,24.2,Yes,2013,No,No,No
Trae Golden,1342,441,1013,402,511,408,3384.0,399,130,255.0,614,272,23.3,No,2013,No,No,No
Josh Richardson,1252,246,1005,458,314,238,3842.0,308,98,209.0,697,360,19.0,Yes,2013,No,No,No
Skylar McBee,611,78,537,182,100,86,2409.0,465,161,70.0,72,21,14.0,No,2013,No,No,No
Kenny Hall,506,30,361,198,173,110,1717.0,6,0,114.0,355,198,16.7,No,2013,No,No,No
Armani Moore,907,245,804,343,319,186,2892.0,131,35,200.0,673,308,20.5,No,2013,No,No,No
Quinton Chievous,891,93,666,335,313,173,2069.0,178,48,159.0,488,287,22.7,No,2013,No,No,No
Derek Reese,408,71,352,143,113,75,1915.0,142,47,71.0,210,96,13.0,No,2013,No,No,No
Yemi Makenjuola,111,7,86,42,45,27,457.0,0,0,23.0,86,42,15.0,No,2013,No,No,No
D'Montre Edwards,63,5,60,20,19,14,195.0,25,9,9.0,35,11,21.1,No,2013,No,No,No
Brandon Lopez,5,8,10,2,3,1,121.0,1,0,10.0,9,2,9.4,No,2013,No,No,No
Rob Murphy,33,1,12,9,17,15,54.0,0,0,9.0,12,9,26.2,No,2013,No,No,No
William Nelson,380,27,349,131,121,82,827.0,130,36,80.0,219,95,31.8,No,2013,No,No,No
Johnathan Jordan,1576,652,1145,492,827,559,4341.0,138,33,335.0,1007,459,23.1,No,2013,No,No,No
Hameed Ali,983,363,963,341,251,191,3322.0,345,110,181.0,618,231,19.7,No,2013,No,No,No
Joy Williamson,479,67,358,162,169,123,1593.0,100,32,95.0,258,130,18.0,No,2013,No,No,No
Zane Knowles,390,21,302,168,115,54,1307.0,1,0,80.0,301,168,17.8,No,2013,No,No,No
Nate Maxey,266,8,178,116,77,34,1078.0,0,0,58.0,178,116,13.5,No,2013,No,No,No
Brandon Pye,916,103,792,324,112,88,3049.0,449,180,83.0,343,144,15.9,No,2013,No,No,No
Dale Francis,197,12,197,78,14,8,1276.0,103,33,46.0,94,45,10.3,No,2013,No,No,No
Cole Martinez,414,55,304,126,83,75,1225.0,233,87,36.0,71,39,16.1,No,2013,No,No,No
James King,58,14,75,19,11,7,344.0,49,13,15.0,26,6,14.8,No,2013,No,No,No
Jelani Currie,447,79,361,151,164,107,1842.0,107,38,87.0,254,113,14.8,No,2013,No,No,No
Kennon Dvorak,44,11,38,13,18,9,238.0,28,9,11.0,10,4,12.8,No,2013,No,No,No
Ted Wang,35,2,37,13,19,9,246.0,1,0,12.0,36,13,12.3,No,2013,No,No,No
Elston Turner,1310,207,1109,456,243,188,3194.0,561,210,167.0,548,246,24.3,Yes,2013,No,No,No
Fabyon Harris,572,94,437,195,130,105,1663.0,196,77,85.0,241,118,19.3,No,2013,No,No,No
Ray Turner,776,21,561,300,289,176,2068.0,1,0,131.0,560,300,21.7,No,2013,No,No,No
Kourtney Roberson,1077,96,718,435,359,207,3011.0,0,0,153.0,718,435,18.7,No,2013,No,No,No
J-Mychal Reese,1034,279,879,363,291,217,2849.0,252,91,250.0,627,272,22.3,No,2013,No,No,No
Alex Caruso,1090,649,840,382,343,235,3933.0,268,91,346.0,572,291,18.1,Yes,2013,No,No,No
Andrew Young,91,8,90,32,38,27,419.0,1,0,24.0,89,32,17.4,No,2013,No,No,No
Jordan Green,630,184,507,224,195,135,2553.0,165,47,140.0,342,177,15.7,No,2013,No,No,No
Jarod Jahns,51,12,44,18,20,14,476.0,8,1,15.0,36,17,7.9,No,2013,No,No,No
Grant Jolly,6,0,5,2,6,2,12.0,0,0,0.0,5,2,36.0,No,2013,No,No,No
Blake McDonald,18,19,18,5,8,6,193.0,6,2,12.0,12,3,9.5,No,2013,No,No,No
Keith Davis,288,23,237,115,109,58,1472.0,0,0,101.0,237,115,13.9,No,2013,No,No,No
Kyle Dobbins,25,11,16,7,24,11,55.0,1,0,10.0,15,7,35.0,No,2013,No,No,No
Daniel Alexander,609,109,485,216,89,76,1731.0,284,101,105.0,201,115,19.4,No,2013,No,No,No
Kevin Butler,997,126,784,348,337,229,3096.0,217,72,165.0,567,276,19.0,No,2013,No,No,No
Karol Gruszecki,358,41,313,121,63,40,973.0,194,76,72.0,119,45,21.2,No,2013,No,No,No
Jordan Reves,887,85,637,332,350,223,2717.0,0,0,210.0,637,332,18.1,No,2013,No,No,No
Brandon Edwards,1078,75,705,387,341,252,3007.0,156,52,126.0,549,335,16.2,No,2013,No,No,No
Greg Gainey,456,21,366,177,101,73,1025.0,84,29,59.0,282,148,22.9,No,2013,No,No,No
Jamel Outler,890,66,746,274,235,161,2250.0,520,181,126.0,226,93,21.6,No,2013,No,No,No
Cameron Catlett,708,291,609,269,291,159,2415.0,39,11,220.0,570,258,19.4,No,2013,No,No,No
Shaquille White-Miller,514,455,476,152,226,155,2745.0,182,55,294.0,294,97,15.6,No,2013,No,No,No
Drew Charles,928,173,765,299,204,154,2664.0,465,176,142.0,300,123,18.0,No,2013,No,No,No
Deon Rodgers,11,3,9,4,6,3,84.0,0,0,9.0,9,4,12.5,No,2013,No,No,No
Luke Davis,22,4,23,8,0,0,108.0,14,6,1.0,9,2,10.9,No,2013,No,No,No
Kyle McElvain,40,3,45,14,2,2,177.0,34,10,6.0,11,4,14.4,No,2013,No,No,No
Kyan Anderson,1624,480,1232,520,479,394,4126.0,529,190,328.0,703,330,22.8,No,2013,No,No,No
Garlon Green,1138,103,951,399,285,218,3278.0,338,122,184.0,613,277,20.4,No,2013,No,No,No
Adrick McKinney,415,51,352,153,222,109,1346.0,1,0,103.0,351,153,22.1,No,2013,No,No,No
Devonta Abron,623,50,440,204,351,215,1732.0,1,0,102.0,439,204,21.1,No,2013,No,No,No
Connell Crossland,278,44,220,108,105,55,1109.0,19,7,63.0,201,101,16.2,No,2013,No,No,No
Nate Butler,240,79,247,84,83,48,1381.0,68,24,80.0,179,60,14.2,No,2013,No,No,No
Charles Hill Jr.,218,43,239,78,57,35,798.0,94,27,50.0,145,51,21.4,No,2013,No,No,No
Jarvis Ray,413,69,397,162,135,80,1428.0,64,9,103.0,333,153,21.1,No,2013,No,No,No
Clyde Smith III,31,21,44,11,13,6,282.0,13,3,22.0,31,8,14.1,No,2013,No,No,No
Amric Fields,1019,89,810,385,283,170,2496.0,241,79,134.0,569,306,22.3,No,2013,No,No,No
Chris Zurcher,26,14,22,9,4,4,190.0,12,4,11.0,10,5,9.9,No,2013,No,No,No
Thomas Montigel,36,7,37,10,16,13,312.0,19,3,7.0,18,7,8.9,No,2013,No,No,No
Kemal Dincer,5,1,11,2,2,1,28.0,5,0,1.0,6,2,25.1,No,2013,No,No,No
Julian Washburn,1526,274,1360,592,319,223,4448.0,349,119,213.0,1011,473,21.3,Yes,2013,No,No,No
John Bohannon,1204,194,800,455,444,290,3063.0,25,4,252.0,775,451,22.7,No,2013,No,No,No
Konner Tucker,649,70,547,207,139,111,1810.0,349,124,98.0,198,83,21.5,No,2013,No,No,No
Jacques Streeter,1180,600,923,368,381,280,4283.0,441,164,251.0,482,204,16.7,No,2013,No,No,No
McKenzie Moore,360,81,253,114,133,102,911.0,84,30,89.0,169,84,24.7,No,2013,No,No,No
Cedrick Lang,938,118,573,333,453,272,3037.0,1,0,164.0,572,333,17.2,No,2013,No,No,No
C.J. Cooper,844,275,692,254,221,178,3008.0,460,158,157.0,232,96,17.2,No,2013,No,No,No
Chris Washburn,602,117,474,212,330,173,2050.0,16,5,155.0,458,207,19.9,Yes,2013,No,No,No
Jalen Ragland,167,26,196,53,33,29,666.0,126,32,19.0,70,21,19.4,No,2013,No,No,No
Malcolm Moore,179,23,145,65,57,38,633.0,34,11,41.0,111,54,17.8,No,2013,No,No,No
Hooper Vint,439,43,341,181,104,64,1376.0,55,13,83.0,286,168,17.5,No,2013,No,No,No
Twymond Howard,1006,143,786,359,339,245,2378.0,124,43,140.0,662,316,24.2,No,2013,No,No,No
Brandon Provost,1252,190,856,371,345,277,3096.0,521,233,191.0,335,138,20.5,No,2013,No,No,No
Aaron Urbanus,1259,306,1039,409,272,203,3482.0,626,238,261.0,413,171,21.5,No,2013,No,No,No
Jesus M. Delgado,480,105,391,170,182,123,1589.0,74,17,107.0,317,153,19.5,No,2013,No,No,No
Justin Leathers,429,66,384,152,121,88,1499.0,109,37,98.0,275,115,18.8,No,2013,No,No,No
Ruben Cabrera,587,39,468,212,187,119,1524.0,125,44,130.0,343,168,23.6,No,2013,No,No,No
Shaquille Hines,1325,184,1112,542,310,194,3514.0,161,47,223.0,951,495,22.0,No,2013,No,No,No
Lauri Toivonen,198,54,154,74,78,49,1213.0,9,1,44.0,145,73,10.1,No,2013,No,No,No
Josh Cleveland,518,55,413,206,219,106,1809.0,0,0,112.0,413,206,18.2,No,2013,No,No,No
Jamal Dantzler,137,29,119,51,59,25,609.0,28,10,39.0,91,41,16.0,No,2013,No,No,No
Hurley Johnson,188,29,171,65,67,36,667.0,83,22,42.0,88,43,19.1,No,2013,No,No,No
DeMarko Nash,39,42,57,12,9,6,312.0,30,9,35.0,27,3,16.3,No,2013,No,No,No
Noe Espericueta,6,0,6,3,0,0,10.0,0,0,0.0,6,3,31.7,No,2013,No,No,No
Blake Provost,13,6,19,4,4,3,146.0,13,2,9.0,6,2,10.2,No,2013,No,No,No
Kannon Burrage,984,86,796,319,316,245,1909.0,284,101,132.0,512,218,29.4,No,2013,No,No,No
Michael Hale,774,214,598,239,257,193,2013.0,283,103,140.0,315,136,22.2,No,2013,No,No,No
Jeromie Hill,1674,160,1420,637,379,235,3823.0,447,165,306.0,973,472,25.4,No,2013,No,No,No
Jordan Sims,620,79,549,204,97,55,2426.0,462,157,71.0,87,47,14.0,No,2013,No,No,No
Hyjii Thomas,434,77,342,133,196,133,1444.0,111,35,124.0,231,98,19.7,No,2013,No,No,No
Larry Wilkins,272,45,196,106,125,60,1356.0,0,0,66.0,196,106,12.2,No,2013,No,No,No
Edrico McGregor,351,44,234,145,106,60,1250.0,1,1,104.0,233,144,15.8,No,2013,No,No,No
Tyler Wood,169,34,152,56,43,27,945.0,101,30,36.0,51,26,11.2,No,2013,No,No,No
A.J. Price,12,7,12,4,0,0,150.0,10,4,17.0,2,0,10.1,No,2013,No,No,No
Tank Mayberry,10,4,8,3,11,4,74.0,0,0,10.0,8,3,16.4,No,2013,No,No,No
Jeremy Hines,6,1,4,2,0,0,14.0,4,2,1.0,0,0,18.7,No,2013,No,No,No
Dante Willis,0,0,0,0,0,0,5.0,0,0,0.0,0,0,0.0,No,2013,No,No,No
Omar Strong,965,118,774,299,170,145,2114.0,591,222,136.0,183,77,24.5,No,2013,No,No,No
Ray Penn,895,364,780,284,216,167,2792.0,452,160,217.0,328,124,20.4,No,2013,No,No,No
Fred Sturdivant,645,36,458,256,268,130,1686.0,11,3,107.0,447,253,21.4,No,2013,No,No,No
Lawrence Johnson-Danner,1109,134,913,362,187,155,3391.0,617,230,169.0,296,132,17.8,No,2013,No,No,No
Aaron Clayborn,727,62,585,288,264,151,2489.0,5,0,154.0,580,288,17.8,No,2013,No,No,No
Madarious Gibbs,1186,469,904,404,474,311,3932.0,213,67,313.0,691,337,19.1,No,2013,No,No,No
Kyrie Sutton,557,28,456,233,180,91,1720.0,1,0,112.0,455,233,20.4,No,2013,No,No,No
Dexter Ellington,262,87,248,87,73,55,1066.0,118,33,87.0,130,54,18.0,No,2013,No,No,No
Billy Rosenberg,16,1,7,5,8,6,40.0,0,0,1.0,7,5,15.5,No,2013,No,No,No
Ethan Blackwell,3,3,5,1,0,0,48.0,2,1,6.0,3,0,12.1,No,2013,No,No,No
Joel Wright,1143,114,854,380,474,351,2001.0,115,32,266.0,739,348,34.3,No,2013,No,No,No
Matt Staff,895,103,724,348,165,133,1993.0,186,66,161.0,538,282,22.9,No,2013,No,No,No
Reid Koenen,684,69,550,228,172,134,2007.0,290,94,123.0,260,134,18.6,No,2013,No,No,No
Corey Stern,354,42,264,123,166,99,1112.0,33,9,62.0,231,114,18.6,No,2013,No,No,No
Phil Hawkins,427,145,379,137,135,104,1793.0,151,49,96.0,228,88,15.5,No,2013,No,No,No
Wesley Davis,877,182,789,322,238,147,3016.0,295,86,148.0,494,236,17.8,No,2013,No,No,No
Vonn Jones,406,207,342,130,135,92,1367.0,168,54,107.0,174,76,17.8,No,2013,No,No,No
Deonte' Jones,162,18,123,58,8,7,500.0,86,39,9.0,37,19,13.3,No,2013,No,No,No
Basil Brown,112,22,90,32,61,42,405.0,31,6,18.0,59,26,16.2,No,2013,No,No,No
Ray Dorsey,88,38,74,29,43,22,505.0,26,8,22.0,48,21,12.0,No,2013,No,No,No
Nick Hinton,74,7,95,30,21,7,341.0,21,7,31.0,74,23,18.8,No,2013,No,No,No
Darius Richardson,188,28,207,68,14,11,606.0,140,41,28.0,67,27,19.5,No,2013,No,No,No
Justin Tanton,3,0,3,1,1,1,7.0,2,0,1.0,1,1,31.3,No,2013,No,No,No
Jeffrey Nwankwo,0,0,0,0,0,0,4.0,0,0,2.0,0,0,24.5,No,2013,No,No,No
Jaye Crockett,1232,111,933,466,338,251,2883.0,156,49,207.0,777,417,23.5,No,2013,No,No,No
Jordan Tolbert,1354,80,934,506,499,330,3096.0,38,12,229.0,896,494,23.6,No,2013,No,No,No
Josh Gray,684,275,668,262,189,123,2094.0,171,37,228.0,497,225,23.2,Yes,2013,No,No,No
Dejan Kravic,513,63,417,213,137,86,1345.0,2,1,94.0,415,212,22.1,No,2013,No,No,No
Dusty Hannahs,1509,123,1139,487,330,293,3156.0,612,242,156.0,527,245,22.7,Yes,2013,No,No,No
"Jamal Williams,",203,66,195,63,66,48,895.0,103,29,52.0,92,34,16.0,No,2013,No,No,No
Daylen Robinson,92,58,110,31,35,24,495.0,41,6,53.0,69,25,18.2,No,2013,No,No,No
Trency Jackson,657,143,544,210,238,154,1836.0,227,83,123.0,317,127,21.5,No,2013,No,No,No
Ty Nurse,339,81,265,104,77,68,1323.0,178,63,66.0,87,41,14.9,No,2013,No,No,No
Toddrick Gotcher,952,219,732,293,310,228,3220.0,377,138,120.0,355,155,16.4,No,2013,No,No,No
Kader Tapsoba,122,8,70,44,50,34,439.0,0,0,24.0,70,44,13.9,No,2013,No,No,No
Clark Lammert,108,26,76,31,55,35,529.0,28,11,20.0,48,20,12.3,No,2013,No,No,No
Luke Adams,133,43,109,32,53,42,600.0,80,27,48.0,29,5,16.3,No,2013,No,No,No
Sheldon McClellan,1963,180,1392,634,632,517,4237.0,523,178,180.0,869,456,23.2,No,2013,No,No,No
Julien Lewis,1276,155,1202,476,248,187,3437.0,423,137,192.0,779,339,22.6,No,2013,No,No,No
Ioannis Papapetrou,281,41,222,96,96,56,826.0,92,33,59.0,130,63,20.1,No,2013,No,No,No
Javan Felix,1249,366,1159,448,232,183,3427.0,485,170,217.0,674,278,21.9,No,2013,No,No,No
Jonathan Holmes,1166,92,869,397,384,278,2931.0,299,94,179.0,570,303,21.1,No,2013,No,No,No
Myck Kabongo,487,237,345,138,249,178,1449.0,106,33,139.0,239,105,20.9,No,2013,No,No,No
Connor Lammert,763,135,639,281,144,98,3119.0,330,103,111.0,309,178,13.3,No,2013,No,No,No
Cameron Ridley,943,37,634,346,462,251,2458.0,0,0,179.0,634,346,21.1,No,2013,No,No,No
Demarcus Holland,707,212,606,257,228,137,3033.0,177,56,194.0,429,201,15.1,No,2013,No,No,No
Prince Ibeh,400,14,282,157,199,86,1769.0,1,0,105.0,281,157,13.8,No,2013,No,No,No
Jaylen Bond,756,87,723,339,166,64,2590.0,78,14,104.0,645,325,18.0,No,2013,No,No,No
Andrew Dick,8,0,5,3,4,1,35.0,2,1,2.0,3,2,12.3,No,2013,No,No,No
Dean Melchionni,3,1,9,1,0,0,34.0,7,1,2.0,2,0,15.5,No,2013,No,No,No
Danny Newsome,16,0,14,6,4,1,40.0,6,3,3.0,8,3,23.9,No,2013,No,No,No
Rian Pearson,1794,197,1444,680,565,391,3668.0,128,43,251.0,1316,637,27.7,No,2013,No,No,No
Julius Brown,1838,694,1512,635,459,369,4328.0,578,199,369.0,934,436,24.9,No,2013,No,No,No
Matt Smith,814,37,579,282,226,165,2364.0,208,85,114.0,371,197,17.6,No,2013,No,No,No
Dominique Buckley,691,209,560,219,145,122,2363.0,339,131,150.0,221,88,17.2,No,2013,No,No,No
Nathan Boothe,1494,249,1235,599,297,247,3523.0,137,49,185.0,1098,550,22.4,No,2013,No,No,No
Reese Holliday,1024,153,711,314,428,308,3134.0,244,88,212.0,467,226,19.0,No,2013,No,No,No
Josh Lemons,28,24,38,10,10,6,382.0,16,2,17.0,22,8,8.2,No,2013,No,No,No
Richard Wonnell,80,12,57,29,44,22,829.0,1,0,26.0,56,29,6.6,No,2013,No,No,No
A.J. Mathew,21,13,23,7,5,3,235.0,11,4,6.0,12,3,7.0,No,2013,No,No,No
Brendon Schwiebert,3,0,1,1,0,0,13.0,1,1,1.0,0,0,8.1,No,2013,No,No,No
James Ewing,6,1,11,2,8,2,60.0,0,0,4.0,11,2,16.4,No,2013,No,No,No
Delino Dear,508,30,373,193,211,122,1828.0,0,0,104.0,373,193,17.1,No,2013,No,No,No
Jerrelle Benimon,1287,233,848,443,532,365,3101.0,110,36,294.0,738,407,23.1,Yes,2013,No,No,No
Marcus Damas,1140,139,960,387,344,244,3140.0,378,122,210.0,582,265,21.9,No,2013,No,No,No
Jerome Hairston,333,86,316,121,70,51,1007.0,123,40,91.0,193,81,22.2,No,2013,No,No,No
Mike Burwell,747,121,642,246,224,151,2269.0,323,104,139.0,319,142,20.1,No,2013,No,No,No
Rafriel Guthrie,664,63,507,214,297,188,1557.0,143,48,108.0,364,166,24.9,No,2013,No,No,No
Bilal Dixon,780,48,602,316,255,147,2656.0,3,1,140.0,599,315,15.4,No,2013,No,No,No
Kris Walden,308,144,350,112,66,47,1617.0,151,37,174.0,199,75,17.7,No,2013,No,No,No
Timajh Parker-Rivera,751,100,536,271,382,209,3120.0,8,0,141.0,528,271,14.1,No,2013,No,No,No
Jamel Flash,38,2,42,13,26,12,399.0,0,0,15.0,42,13,9.0,No,2013,No,No,No
Barrington Alston,7,0,12,3,7,1,103.0,1,0,6.0,11,3,10.6,No,2013,No,No,No
Christian Collins,15,4,5,4,6,4,24.0,4,3,1.0,1,1,19.1,No,2013,No,No,No
Jeremy Schulkin,2,1,2,1,0,0,8.0,0,0,1.0,2,1,19.0,No,2013,No,No,No
Bryan Blackstone,2,4,3,1,0,0,29.0,1,0,11.0,2,1,24.8,No,2013,No,No,No
Emil Jones,645,154,590,251,151,108,1934.0,115,35,91.0,475,216,20.4,No,2013,No,No,No
Hunter Williams,772,208,721,265,122,82,2292.0,418,160,145.0,303,105,21.4,No,2013,No,No,No
Ray Chambers,406,15,332,168,92,70,1227.0,2,0,49.0,330,168,18.2,No,2013,No,No,No
Antoine Myers,638,167,442,212,332,213,1885.0,9,1,135.0,433,211,20.7,No,2013,No,No,No
Deonata Jethroe,188,12,193,68,30,22,570.0,108,30,21.0,85,38,21.9,No,2013,No,No,No
Tevin Calhoun,507,32,458,174,133,85,1369.0,245,74,60.0,213,100,22.5,No,2013,No,No,No
Westley Hinton,276,18,246,98,59,41,819.0,122,39,45.0,124,59,20.6,No,2013,No,No,No
R.J. Scott,376,43,378,128,47,32,1056.0,259,88,77.0,119,40,22.9,No,2013,No,No,No
Jeff Mullahey,382,72,335,116,108,83,1418.0,197,67,50.0,138,49,16.2,No,2013,No,No,No
Josh Warren,148,11,122,63,44,22,826.0,1,0,27.0,121,63,11.0,No,2013,No,No,No
Justin Wright,304,36,249,98,82,63,715.0,134,45,47.0,115,53,23.1,No,2013,No,No,No
Breon Dixon,4,0,4,2,0,0,27.0,0,0,3.0,4,2,14.2,No,2013,No,No,No
Sidki Muwallif,0,1,1,0,0,0,10.0,0,0,0.0,1,0,5.5,No,2013,No,No,No
Josh Davis,1305,176,1033,475,562,344,3675.0,30,11,229.0,1003,464,21.6,Yes,2013,No,No,No
Ricky Tarrant,1658,375,1205,468,658,525,3760.0,611,197,242.0,594,271,23.9,No,2013,No,No,No
Jordan Callahan,1269,304,1094,437,247,178,3493.0,582,217,213.0,512,220,21.3,No,2013,No,No,No
Kendall Timmons,1327,249,1019,452,570,379,3433.0,133,44,247.0,886,408,23.4,No,2013,No,No,No
Tre Drye,650,73,480,234,300,173,3072.0,36,9,153.0,444,225,13.4,No,2013,No,No,No
Ben Cherry,446,59,340,141,70,56,1629.0,245,108,60.0,95,33,13.6,No,2013,No,No,No
Kajon Mack,971,261,778,330,293,220,2848.0,287,91,168.0,491,239,18.9,No,2013,No,No,No
Louis Dabney,1471,201,1225,468,511,387,3372.0,461,148,213.0,764,320,26.2,No,2013,No,No,No
Jay Hook,955,62,724,290,229,187,2477.0,480,188,121.0,244,102,20.7,No,2013,No,No,No
Tomas Bruha,247,10,181,94,95,59,1056.0,0,0,69.0,181,94,14.7,No,2013,No,No,No
Lotanna Nwogbo,830,29,540,314,306,200,1767.0,5,2,151.0,535,312,24.0,No,2013,No,No,No
Kevin Thomas,240,10,182,99,72,42,1133.0,0,0,65.0,182,99,13.2,No,2013,No,No,No
Josh Birchfield,6,2,9,3,0,0,64.0,0,0,4.0,9,3,10.4,No,2013,No,No,No
RaAnthony Sanders,723,151,539,236,231,178,1903.0,200,73,116.0,339,163,21.3,No,2013,No,No,No
Max Keenan,11,0,6,2,8,5,59.0,4,2,6.0,2,0,14.5,No,2013,No,No,No
Marc Eddy Norelia,1084,102,804,430,343,223,2402.0,7,1,134.0,797,429,22.9,No,2013,No,No,No
James Woodard,1881,236,1410,595,579,430,4272.0,733,261,221.0,677,334,23.0,No,2013,No,No,No
Scottie Haralson,1087,136,948,363,128,106,3131.0,677,255,120.0,271,108,18.7,No,2013,No,No,No
Patrick Swilling Jr.,482,90,438,158,98,59,1387.0,297,107,97.0,141,51,21.5,No,2013,No,No,No
Kauri Black,606,119,441,232,253,142,2400.0,0,0,142.0,441,232,15.6,No,2013,No,No,No
Shaquille Harrison,1481,461,1156,513,654,422,4017.0,153,33,306.0,1003,480,22.7,Yes,2013,No,No,No
Rashad Ray,840,298,682,270,280,213,2867.0,273,87,161.0,409,183,17.6,No,2013,No,No,No
D'Andre Wright,861,62,663,303,340,236,2282.0,72,19,164.0,591,284,22.3,No,2013,No,No,No
Tim Peete,487,188,446,170,147,94,2456.0,175,53,140.0,271,117,13.8,No,2013,No,No,No
Zeldric King,77,7,47,28,31,20,341.0,1,1,39.0,46,27,15.1,No,2013,No,No,No
Brandon Swannegan,550,24,395,201,252,148,1893.0,0,0,87.0,395,201,16.3,No,2013,No,No,No
Rashad Smith,915,95,711,361,310,176,2486.0,67,17,137.0,644,344,20.7,No,2013,No,No,No
Nick Wood,27,0,21,9,5,4,42.0,13,5,3.0,8,4,32.3,No,2013,No,No,No
Jamie Booker,2,1,3,1,0,0,27.0,0,0,0.0,3,1,5.8,No,2013,No,No,No
Shabazz Muhammad,572,27,456,202,180,128,987.0,106,40,51.0,350,162,29.8,Yes,2013,No,No,No
Jordan Adams,1131,142,798,373,342,287,2081.0,296,98,94.0,502,275,25.3,Yes,2013,No,No,No
Travis Wear,1052,85,843,425,228,182,2845.0,50,20,115.0,793,405,18.8,Yes,2013,No,No,No
Kyle Anderson,865,355,670,303,303,223,2242.0,96,36,183.0,574,267,22.2,Yes,2013,No,No,No
Larry Drew II,724,632,638,263,198,119,3150.0,230,79,289.0,408,184,15.2,Yes,2013,No,No,No
David Wear,888,96,748,354,163,120,2832.0,142,60,120.0,606,294,16.8,Yes,2013,No,No,No
Norman Powell,1376,214,1090,503,347,259,3555.0,354,111,180.0,736,392,20.3,Yes,2013,No,No,No
Tony Parker,1128,41,822,456,419,216,2485.0,0,0,159.0,822,456,23.4,Yes,2013,Yes,Yes,Yes
Joshua Smith,1211,85,755,446,520,319,2283.0,1,0,210.0,754,446,27.7,No,2013,No,No,No
Tyler Lamb,987,210,878,338,241,182,2803.0,379,129,211.0,499,209,22.1,No,2013,No,No,No
David Brown,15,5,23,6,2,2,76.0,8,1,11.0,15,5,23.3,No,2013,No,No,No
Sooren Derboghosian,16,1,10,7,3,2,60.0,0,0,5.0,10,7,15.4,No,2013,No,No,No
Khalid McCaskill,13,1,15,6,1,0,42.0,5,1,3.0,10,5,23.0,No,2013,No,No,No
Aubrey Williams,1,0,2,0,2,1,21.0,0,0,1.0,2,0,9.4,No,2013,No,No,No
Jarred Shaw,865,54,693,352,220,160,1897.0,10,1,134.0,683,351,26.7,No,2013,No,No,No
Spencer Butterfield,768,158,545,261,155,129,1827.0,263,117,102.0,282,144,21.5,No,2013,No,No,No
Preston Medlin,1368,320,966,445,329,265,3172.0,511,213,173.0,455,232,22.4,No,2013,No,No,No
Marcel Davis,996,453,809,342,345,234,3223.0,234,78,252.0,575,264,19.8,No,2013,No,No,No
Kyisean Reed,554,47,342,206,211,142,1386.0,1,0,72.0,341,206,20.3,No,2013,No,No,No
TeNale Roland,367,152,314,123,76,51,1399.0,180,70,73.0,134,53,16.5,No,2013,No,No,No
Ben Clifford,380,49,264,125,136,108,1425.0,65,22,69.0,199,103,15.3,No,2013,No,No,No
Marvin Jean,148,56,139,50,24,17,684.0,92,31,44.0,47,19,15.5,No,2013,No,No,No
Jordan Stone,224,20,136,77,124,70,1017.0,0,0,55.0,136,77,13.4,No,2013,No,No,No
Matt Lopez,393,18,284,159,137,75,950.0,0,0,86.0,284,159,24.5,No,2013,No,No,No
Danny Berger,331,105,282,108,87,68,1239.0,144,47,60.0,138,61,17.0,No,2013,No,No,No
Quincy Bair,0,0,1,0,0,0,10.0,1,0,0.0,0,0,5.4,No,2013,No,No,No
Connor Garner,0,0,4,0,0,0,5.0,3,0,1.0,1,0,54.4,No,2013,No,No,No
Ben Aird,1535,162,1142,577,502,359,3766.0,65,22,175.0,1077,555,21.6,No,2013,No,No,No
Holton Hunsaker,1555,438,1220,427,531,463,4161.0,705,238,320.0,515,189,22.6,No,2013,No,No,No
Nick Thompson,391,156,329,154,91,61,1317.0,60,22,131.0,269,132,20.9,No,2013,No,No,No
Jason Johnson,302,63,251,111,78,46,889.0,95,34,47.0,156,77,20.6,No,2013,No,No,No
Alfonzo Hubbard,439,73,358,171,114,78,1124.0,62,19,72.0,296,152,22.5,No,2013,No,No,No
Antoine Hosley,179,25,185,70,28,16,536.0,74,23,38.0,111,47,23.9,No,2013,No,No,No
Zach Jones,158,21,138,65,46,28,595.0,3,0,22.0,135,65,16.2,No,2013,No,No,No
Keawe Enos,391,101,304,123,73,63,1582.0,216,82,69.0,88,41,13.9,No,2013,No,No,No
Taylor Brown,201,66,193,62,55,30,1238.0,159,47,39.0,34,15,10.4,No,2013,No,No,No
Will Sinclair,14,4,14,4,13,6,192.0,0,0,8.0,14,4,7.9,No,2013,No,No,No
Jarred DuBois,1537,332,1285,487,441,373,4002.0,506,190,299.0,779,297,23.0,No,2013,No,No,No
Jason Washburn,1073,63,780,441,236,187,2756.0,9,4,143.0,771,437,20.6,No,2013,No,No,No
Jordan Loveridge,1568,231,1264,513,399,319,3993.0,586,223,211.0,678,290,22.4,No,2013,No,No,No
Brandon Taylor,1270,428,992,419,233,188,3877.0,620,244,259.0,372,175,18.9,No,2013,No,No,No
Glen Dean,1132,373,865,339,351,279,3293.0,451,175,247.0,414,164,19.9,No,2013,No,No,No
Cedric Martin,341,119,288,105,106,64,1779.0,189,67,73.0,99,38,13.1,No,2013,No,No,No
Dallin Bachynski,550,50,358,193,229,158,1559.0,15,6,89.0,343,187,19.2,No,2013,No,No,No
Justin Seymour,637,124,543,217,125,89,1962.0,309,114,120.0,234,103,19.1,No,2013,No,No,No
Jeremy Olsen,282,15,228,123,60,36,803.0,0,0,59.0,228,123,21.2,No,2013,No,No,No
Dakarai Tucker,717,79,557,247,98,78,2234.0,372,145,72.0,185,102,16.3,No,2013,No,No,No
Renan Lenz,211,25,160,83,56,42,615.0,13,3,30.0,147,80,19.0,No,2013,No,No,No
Aaron Dotson,337,94,289,103,154,100,1464.0,112,31,107.0,177,72,16.7,No,2013,No,No,No
Alex Mortensen,11,2,13,2,13,7,87.0,2,0,13.0,11,2,21.1,No,2013,No,No,No
Ryan Osterloh,2,0,1,0,2,2,10.0,0,0,0.0,1,0,10.8,No,2013,No,No,No
Xan Ricketts,8,0,5,4,2,0,35.0,0,0,2.0,5,4,12.1,No,2013,No,No,No
Ryan Broekhoff,1591,246,1103,512,385,315,3642.0,618,252,186.0,485,260,21.5,Yes,2013,No,No,No
Kevin Van Wijk,1030,55,587,357,460,316,1963.0,7,0,185.0,580,357,27.1,No,2013,No,No,No
Matt Kenney,876,330,649,296,287,189,3137.0,293,95,212.0,356,201,16.8,No,2013,No,No,No
Erik Buggs,638,425,544,250,234,109,3428.0,132,29,316.0,412,221,14.1,No,2013,No,No,No
Will Bogan,548,147,438,175,85,68,2374.0,332,130,122.0,106,45,13.6,No,2013,No,No,No
LaVonte Dority,795,157,586,242,257,217,1880.0,242,94,145.0,344,148,24.1,No,2013,No,No,No
Ben Boggs,355,53,286,111,107,88,1336.0,142,45,80.0,144,66,16.7,No,2013,No,No,No
Bobby Capobianco,481,74,348,172,166,104,1605.0,91,33,105.0,257,139,17.4,No,2013,No,No,No
Jordan Coleman,378,45,283,118,161,118,1087.0,91,24,62.0,192,94,20.6,No,2013,No,No,No
Vashil Fernandez,612,38,442,242,264,128,2596.0,0,0,131.0,442,242,13.9,No,2013,No,No,No
Alex Rossi,24,2,15,9,0,0,62.0,12,6,5.0,3,3,17.3,No,2013,No,No,No
Kedren Johnson,758,260,628,249,225,170,2293.0,275,90,199.0,353,159,22.1,No,2013,No,No,No
Rod Odom,985,96,833,322,239,158,3165.0,492,183,143.0,341,139,18.7,No,2013,No,No,No
Kyle Fuller,706,267,629,229,270,190,2473.0,231,58,184.0,398,171,20.7,No,2013,No,No,No
Kevin Bright,228,39,188,77,34,20,966.0,133,54,50.0,55,23,14.9,No,2013,No,No,No
Sheldon Jeter,856,105,674,320,207,148,2586.0,190,68,119.0,484,252,18.3,No,2013,No,No,No
Dai-Jon Parker,499,183,437,172,104,69,2177.0,237,86,125.0,200,86,15.3,No,2013,No,No,No
Josh Henderson,416,56,341,164,148,86,1400.0,6,2,90.0,335,162,19.5,No,2013,No,No,No
Shelby Moats,158,38,154,59,45,20,957.0,76,20,52.0,78,39,13.1,No,2013,No,No,No
James Siakam,593,65,332,196,283,199,1829.0,8,2,101.0,324,194,16.9,No,2013,No,No,No
A.J. Astroth,296,33,240,107,111,69,1071.0,58,13,50.0,182,94,16.0,No,2013,No,No,No
Carter Josephs,6,46,3,2,8,2,316.0,0,0,18.0,3,2,4.1,No,2013,No,No,No
Alex Gendelman,0,0,2,0,0,0,4.0,2,0,0.0,0,0,28.3,No,2013,No,No,No
Andris Kehris,0,0,0,0,0,0,3.0,0,0,0.0,0,0,0.0,No,2013,No,No,No
Nathan Watkins,25,1,23,7,13,8,106.0,18,3,7.0,5,4,18.4,No,2013,No,No,No
Clancy Rugg,991,64,565,290,497,386,2395.0,88,25,140.0,477,265,21.4,No,2013,No,No,No
Sandro Carissimo,1141,278,946,394,270,218,3610.0,345,135,176.0,601,259,18.7,No,2013,No,No,No
Luke Apfeld,1048,53,734,358,372,290,2461.0,127,42,140.0,607,316,23.1,No,2013,No,No,No
Trey Blue,599,90,544,204,142,101,1600.0,290,90,127.0,254,114,24.9,No,2013,No,No,No
Ethan O'Day,1233,104,944,523,291,187,3098.0,1,0,181.0,943,523,21.9,No,2013,No,No,No
Candon Rusin,1071,84,894,371,203,141,3148.0,505,188,214.0,389,183,20.8,No,2013,No,No,No
Brian Voelkel,805,679,576,233,485,309,4134.0,108,30,295.0,468,203,14.3,No,2013,No,No,No
Brendan Kilpatrick,165,23,140,58,58,36,596.0,48,13,40.0,92,45,19.2,No,2013,No,No,No
Josh Elbaum,165,123,122,60,89,44,1322.0,7,1,97.0,115,59,10.7,No,2013,No,No,No
Ben Crenca,278,11,207,105,113,68,895.0,0,0,57.0,207,105,18.7,No,2013,No,No,No
Troy Davine,3,0,2,1,0,0,16.0,2,1,2.0,0,0,13.8,No,2013,No,No,No
JayVaughn Pinkston,1590,182,1063,495,780,567,3571.0,115,33,288.0,948,462,24.6,No,2013,No,No,No
Ryan Arcidiacono,1604,535,1228,487,461,369,4592.0,729,261,253.0,499,226,19.2,Yes,2013,No,No,No
Darrun Hilliard,1511,248,1125,491,428,320,3537.0,569,209,206.0,556,282,22.4,Yes,2013,No,No,No
Mouphtaou Yarou,1068,72,784,384,421,299,2946.0,2,1,163.0,782,383,19.5,No,2013,No,No,No
James Bell,1046,143,836,344,213,168,2866.0,522,190,170.0,314,154,19.6,No,2013,No,No,No
Tony Chennault,559,230,532,197,219,144,2315.0,90,21,184.0,442,176,18.4,No,2013,No,No,No
Daniel Ochefu,1015,185,673,404,333,207,3060.0,4,0,220.0,669,404,17.9,Yes,2013,No,No,No
Maurice Sutton,300,30,212,106,144,88,1189.0,1,0,81.0,211,106,15.2,No,2013,No,No,No
Ash Yacoubou,791,124,727,297,192,114,2443.0,276,83,164.0,451,214,21.3,No,2013,No,No,No
Mislav Brzoja,507,194,395,166,165,124,1648.0,154,51,138.0,241,115,19.7,No,2013,No,No,No
Patrick Farrell,11,2,10,3,5,2,73.0,10,3,4.0,0,0,11.8,No,2013,No,No,No
Henry Lowe,8,3,10,3,5,0,74.0,8,2,9.0,2,1,15.1,No,2013,No,No,No
Nick McMahon,2,1,4,1,0,0,34.0,3,0,2.0,1,1,8.9,No,2013,No,No,No
Treveon Graham,1882,199,1431,618,645,446,3558.0,565,200,191.0,866,418,26.8,Yes,2013,No,No,No
Juvonte Reddic,1438,76,1091,574,452,286,3362.0,18,4,210.0,1073,570,22.3,No,2013,No,No,No
Troy Daniels,913,48,764,297,87,68,2109.0,650,251,73.0,114,46,20.9,Yes,2013,No,No,No
Rob Brandenberg,1219,191,1089,423,281,194,3242.0,525,179,148.0,564,244,21.1,No,2013,No,No,No
Melvin Johnson,1657,218,1459,598,224,176,3482.0,774,285,171.0,685,313,24.4,No,2013,No,No,No
Darius Theus,760,460,636,277,252,166,3079.0,161,40,236.0,475,237,16.4,No,2013,No,No,No
Briante Weber,862,378,695,296,299,230,2965.0,146,40,186.0,549,256,17.0,Yes,2013,No,No,No
Jarred Guest,198,20,204,86,45,24,1005.0,9,2,58.0,195,84,13.8,No,2013,No,No,No
DJ Haley,315,17,247,135,110,45,1561.0,0,0,63.0,247,135,11.7,No,2013,No,No,No
Teddy Okereafor,833,351,659,255,306,223,2700.0,331,100,223.0,328,155,20.1,No,2013,No,No,No
Justin Tuoyo,1144,97,743,413,455,303,2837.0,55,15,151.0,688,398,19.9,No,2013,No,No,No
David Hinton,37,5,38,16,16,5,281.0,0,0,11.0,38,16,10.1,No,2013,No,No,No
Stan Okoye,2146,212,1590,788,665,441,3471.0,387,129,305.0,1203,659,28.5,No,2013,No,No,No
D.J. Covington,1516,66,1029,599,466,317,2927.0,9,1,185.0,1020,598,22.1,No,2013,No,No,No
Rodney Glasgow,1440,530,1102,489,314,259,3536.0,547,203,199.0,555,286,18.5,No,2013,No,No,No
Brian Brown,828,143,744,286,63,53,2540.0,569,203,111.0,175,83,15.6,No,2013,No,No,No
Tim Marshall,914,101,875,306,132,87,2072.0,681,215,106.0,194,91,23.1,No,2013,No,No,No
Nick Gore,592,163,514,215,151,92,2068.0,260,70,114.0,254,145,15.1,No,2013,No,No,No
Dorian Albritton,98,14,113,35,8,3,277.0,92,25,17.0,21,10,22.2,No,2013,No,No,No
Phillip Anglade,726,53,562,315,241,96,2401.0,2,0,96.0,560,315,14.9,No,2013,No,No,No
Joe Carr,122,80,111,44,40,28,669.0,38,6,65.0,73,38,12.7,No,2013,No,No,No
Gavin Stephenson,48,24,51,17,16,11,194.0,19,3,19.0,32,14,18.4,No,2013,No,No,No
Jarid Watson,193,28,153,81,71,31,901.0,0,0,34.0,153,81,11.0,No,2013,No,No,No
Christian Burton,123,30,113,40,35,20,394.0,81,23,32.0,32,17,18.1,No,2013,No,No,No
Drew Absher,54,18,47,16,17,13,176.0,32,9,15.0,15,7,18.0,No,2013,No,No,No
Erick Green,1742,326,1356,592,520,418,3648.0,414,140,178.0,942,452,25.3,Yes,2013,No,No,No
Jarell Eddie,1182,139,995,383,276,224,3176.0,526,192,183.0,469,191,21.7,Yes,2013,No,No,No
Robert Brown,1435,341,1318,511,317,225,3746.0,572,188,256.0,746,323,23.6,No,2013,No,No,No
Cadarian Raines,553,46,486,234,163,85,1947.0,0,0,90.0,486,234,17.5,No,2013,No,No,No
C.J. Barksdale,433,40,331,164,121,94,1464.0,31,11,60.0,300,153,16.1,No,2013,No,No,No
Joey van Zegeren,524,21,396,216,233,92,1711.0,2,0,117.0,394,216,19.5,No,2013,No,No,No
Marquis Rankin,159,53,154,57,37,22,877.0,66,23,60.0,88,34,13.7,No,2013,No,No,No
Marshall Wood,565,42,489,188,124,77,1937.0,321,112,95.0,168,76,17.3,No,2013,No,No,No
Will Johnston,218,36,192,68,33,20,1206.0,172,62,21.0,20,6,10.1,No,2013,No,No,No
Christian Beyer,169,25,126,69,44,26,835.0,18,5,38.0,108,64,11.9,No,2013,No,No,No
Joey Racer,10,1,13,4,3,1,46.0,6,1,4.0,7,3,21.1,No,2013,No,No,No
Marcus Patrick,6,2,11,2,4,2,43.0,4,0,6.0,7,2,22.3,No,2013,No,No,No
Greg Donlon,14,0,10,5,6,4,37.0,0,0,1.0,10,5,19.1,No,2013,No,No,No
Joe Harris,1698,254,1276,568,414,299,4084.0,646,263,213.0,630,305,23.6,Yes,2013,No,No,No
Akil Mitchell,912,147,695,361,331,189,3164.0,11,1,155.0,684,360,18.2,No,2013,No,No,No
Justin Anderson,873,180,669,288,266,200,2364.0,272,97,125.0,397,191,22.3,Yes,2013,No,No,No
Mike Tobey,945,51,749,398,203,143,2247.0,19,6,106.0,730,392,24.2,Yes,2013,No,No,No
Evan Nolte,451,79,382,149,85,61,1880.0,274,92,56.0,108,57,14.6,No,2013,No,No,No
Paul Jesperson,789,78,649,268,88,76,2848.0,459,177,96.0,190,91,16.2,No,2013,No,No,No
Darion Atkins,545,46,465,236,130,73,1857.0,1,0,89.0,464,236,19.1,No,2013,No,No,No
Jontel Evans,595,419,594,247,158,88,3096.0,42,13,224.0,552,234,16.5,No,2013,No,No,No
Teven Jones,101,42,96,31,43,28,531.0,37,11,28.0,59,20,15.5,No,2013,No,No,No
Taylor Barnette,1085,181,897,360,162,125,3130.0,682,240,98.0,215,120,17.6,No,2013,No,No,No
Doug Browman,13,18,10,4,6,2,159.0,9,3,13.0,1,1,9.4,No,2013,No,No,No
Caid Kirven,11,0,13,5,0,0,77.0,3,1,6.0,10,4,14.1,No,2013,No,No,No
Thomas Rogers,10,4,21,3,4,1,82.0,16,3,8.0,5,0,21.5,No,2013,No,No,No
Jonathon Williams,825,56,569,304,239,182,1554.0,111,35,126.0,458,269,25.9,No,2013,No,No,No
Kenneth Ortiz,1080,451,881,353,519,356,3077.0,72,18,318.0,809,335,23.3,No,2013,No,No,No
Latif Rivers,1513,244,1190,470,441,377,3314.0,547,196,259.0,643,274,25.2,No,2013,No,No,No
Marcus Burton,1137,174,962,377,290,235,2580.0,451,148,160.0,511,229,23.9,No,2013,No,No,No
Mario Moody,975,64,758,369,292,199,2289.0,117,38,166.0,641,331,22.9,No,2013,No,No,No
Orlando Parker,715,54,591,290,209,135,2417.0,6,0,113.0,585,290,16.8,No,2013,No,No,No
Eric Fanning,1412,164,923,425,603,463,2641.0,272,99,262.0,651,326,28.8,No,2013,No,No,No
Dwaun Anderson,629,98,631,247,149,99,2108.0,180,36,148.0,451,211,19.8,No,2013,No,No,No
Josh Thompson,654,149,584,234,234,165,2568.0,73,21,169.0,511,213,17.2,No,2013,No,No,No
Naofall Folahan,485,25,353,192,154,101,2118.0,0,0,102.0,353,192,12.5,No,2013,No,No,No
Langston Burnett,39,10,55,12,22,9,292.0,39,6,16.0,16,6,13.7,No,2013,No,No,No
Hugo Naurais,75,8,93,32,17,6,457.0,31,5,32.0,62,27,14.2,No,2013,No,No,No
C.J. Harris,1613,282,1063,459,639,533,3970.0,417,162,299.0,646,297,21.3,No,2013,No,No,No
Travis McKie,1687,146,1228,568,567,430,4020.0,367,121,234.0,861,447,22.2,No,2013,No,No,No
Devin Thomas,1486,212,1047,544,702,398,3533.0,1,0,336.0,1046,544,24.2,No,2013,No,No,No
Codi Miller-McIntyre,1329,441,1150,496,426,269,3607.0,245,68,255.0,905,428,22.4,No,2013,No,No,No
Arnaud William Adala Moto,1284,129,964,413,609,424,2957.0,137,34,246.0,827,379,25.3,No,2013,No,No,No
Tyler Cavanaugh,1724,155,1221,545,584,479,3502.0,417,155,257.0,804,390,25.6,Yes,2013,No,No,No
Chase Fischer,1454,210,1156,465,292,235,3420.0,758,289,157.0,398,176,20.6,No,2013,No,No,No
Madison Jones,564,359,456,199,264,150,2918.0,60,16,255.0,396,183,14.4,No,2013,No,No,No
Aaron Rountree III,390,150,322,151,139,80,1885.0,31,8,99.0,291,143,12.8,No,2013,No,No,No
Andre Washington,344,34,240,127,173,90,1237.0,1,0,69.0,239,127,16.2,No,2013,No,No,No
Spencer Jennings,9,1,6,3,7,3,15.0,3,0,2.0,3,3,38.6,No,2013,No,No,No
Duke Antonelli,2,0,3,1,0,0,6.0,0,0,0.0,3,1,25.7,No,2013,No,No,No
Doug Niedrich,0,1,7,0,0,0,16.0,0,0,0.0,7,0,21.9,No,2013,No,No,No
Grant O'Brien,11,0,16,4,3,2,76.0,8,1,0.0,8,3,11.3,No,2013,No,No,No
Brock Motum,1530,127,1089,565,433,312,3002.0,249,88,228.0,840,477,27.5,No,2013,No,No,No
Royce Woolridge,924,251,724,305,347,240,2753.0,233,74,200.0,491,231,21.6,No,2013,No,No,No
Mychal Ladd,1067,178,885,380,260,170,3226.0,380,137,145.0,505,243,19.0,No,2013,No,No,No
DaVonte Lacy,1548,217,1141,467,476,365,3516.0,693,249,202.0,448,218,24.1,No,2013,No,No,No
Dexter Kernich-Drew,665,94,559,227,117,84,2252.0,345,127,106.0,214,100,17.4,No,2013,No,No,No
D.J. Shelton,674,116,541,231,233,159,2314.0,191,53,147.0,350,178,19.0,No,2013,No,No,No
Will DiIorio,154,34,119,55,75,36,943.0,23,8,39.0,96,47,11.2,No,2013,No,No,No
Junior Longrus,236,80,205,100,96,36,1761.0,3,0,79.0,202,100,10.0,No,2013,No,No,No
Brett Boese,245,46,226,86,17,10,985.0,175,63,32.0,51,23,14.2,No,2013,No,No,No
Bryce Leavitt,13,12,8,2,10,9,113.0,1,0,7.0,7,2,9.6,No,2013,No,No,No
James Hunter,201,9,169,83,52,35,480.0,0,0,30.0,169,83,24.3,No,2013,No,No,No
Keaton Hayenga,3,1,7,1,2,1,23.0,3,0,1.0,4,1,21.5,No,2013,No,No,No
Dominic Ballard,6,11,8,2,2,2,88.0,0,0,4.0,8,2,8.1,No,2013,No,No,No
C.J. Wilcox,1880,214,1478,640,356,299,3735.0,773,301,178.0,705,339,24.1,Yes,2013,No,No,No
Scott Suggs,792,100,640,278,112,92,2089.0,359,144,118.0,281,134,19.1,No,2013,No,No,No
Abdul Gaddy,907,469,807,345,222,147,3210.0,221,70,256.0,586,275,17.7,No,2013,No,No,No
Aziz N'Diaye,721,29,538,296,312,129,2354.0,1,0,149.0,537,296,17.2,No,2013,No,No,No
Andrew Andrews,1812,387,1340,520,709,578,3929.0,552,194,264.0,788,326,23.9,No,2013,No,No,No
Shawn Kemp Jr.,620,13,455,259,163,102,1892.0,0,0,86.0,455,259,16.7,No,2013,No,No,No
Desmond Simmons,582,116,499,197,208,145,2757.0,136,43,116.0,363,154,13.2,No,2013,No,No,No
Jernard Jarreau,344,61,302,129,118,74,1307.0,29,12,90.0,273,117,17.5,No,2013,No,No,No
Hikeem Stewart,24,15,36,10,3,2,237.0,16,2,13.0,20,8,10.5,No,2013,No,No,No
Dion Overstreet,2,0,0,0,2,2,4.0,0,0,1.0,0,0,24.8,No,2013,No,No,No
Martin Breunig,1195,112,759,457,383,275,2143.0,29,6,164.0,730,451,27.8,No,2013,No,No,No
Quinn Sterling,8,1,2,1,6,5,21.0,2,1,4.0,0,0,21.3,No,2013,No,No,No
Davion Berry,1160,262,727,342,447,355,2217.0,302,121,161.0,425,221,27.0,No,2013,No,No,No
Scott Bamforth,1346,248,895,415,298,258,3026.0,578,258,159.0,317,157,21.1,No,2013,No,No,No
Kyle Tresnak,1214,64,866,489,346,236,2894.0,0,0,149.0,866,489,22.0,No,2013,No,No,No
Frank Otis,525,106,362,219,158,87,1808.0,0,0,140.0,362,219,17.0,No,2013,No,No,No
Jordan Richardson,722,300,624,231,139,108,3058.0,407,152,160.0,217,79,15.0,No,2013,No,No,No
Joel Bolomboy,1484,93,931,492,651,464,3743.0,97,36,260.0,834,456,21.4,Yes,2013,No,No,No
Gelaun Wheelwright,378,88,321,134,71,56,1287.0,166,54,98.0,155,80,18.8,No,2013,No,No,No
Royce Williams,147,37,112,52,27,18,552.0,57,25,32.0,55,27,15.4,No,2013,No,No,No
James Hajek,238,22,190,94,91,50,1049.0,0,0,51.0,190,94,14.5,No,2013,No,No,No
Byron Fulton,529,39,449,204,70,46,1463.0,169,75,65.0,280,129,20.0,No,2013,No,No,No
Wayne Bradford,14,7,12,5,7,4,55.0,3,0,6.0,9,5,20.9,No,2013,No,No,No
Logan Foster,2,0,1,0,2,2,3.0,1,0,1.0,0,0,52.9,No,2013,No,No,No
Eron Harris,1489,200,1128,487,366,296,3068.0,545,219,214.0,583,268,25.0,No,2013,No,No,No
Deniz Kilicli,899,112,727,357,339,185,2241.0,0,0,217.0,727,357,25.0,No,2013,No,No,No
Aaric Murray,1859,146,1422,679,555,405,3433.0,277,96,271.0,1145,583,27.9,No,2013,No,No,No
Terry Henderson,1006,107,755,328,231,183,2355.0,434,167,109.0,321,161,20.5,No,2013,No,No,No
Jabarie Hinds,1204,326,1111,461,225,155,3318.0,384,127,232.0,727,334,21.8,No,2013,No,No,No
Juwan Staten,1558,623,1269,542,628,443,4046.0,108,31,269.0,1161,511,22.4,No,2013,No,No,No
Gary Browne,804,241,614,236,359,259,2774.0,240,73,182.0,374,163,17.3,No,2013,No,No,No
Kevin Noreen,226,62,138,74,109,70,1391.0,27,8,53.0,111,66,8.8,No,2013,No,No,No
Matt Humphrey,648,97,605,214,165,95,1941.0,377,125,107.0,228,89,21.6,No,2013,No,No,No
Keaton Miles,220,90,225,79,103,55,1280.0,31,7,62.0,194,72,13.0,No,2013,No,No,No
Dominique Rutledge,129,23,94,45,74,39,517.0,1,0,55.0,93,45,18.0,No,2013,No,No,No
Aaron Brown,816,111,692,290,242,166,2303.0,202,70,119.0,490,220,20.6,No,2013,No,No,No
Volodymyr Gerun,392,35,318,149,132,88,1181.0,29,6,82.0,289,143,20.4,No,2013,No,No,No
Richard Romeo,15,3,12,5,4,4,55.0,3,1,4.0,9,4,15.7,No,2013,No,No,No
Aric Dickerson,194,23,191,66,18,12,711.0,147,50,42.0,44,16,17.1,No,2013,No,No,No
Trey Sumler,1996,496,1490,645,599,489,4648.0,564,217,379.0,926,428,22.9,No,2013,No,No,No
Tawaski King,1009,73,816,393,359,223,3285.0,1,0,207.0,815,393,18.0,No,2013,No,No,No
Brandon Boggs,1370,150,1304,528,300,195,3593.0,379,119,224.0,925,409,23.0,No,2013,No,No,No
Tom Tankelewicz,779,73,662,256,101,88,2020.0,484,179,101.0,178,77,19.9,No,2013,No,No,No
James Sinclair,1302,241,1162,465,323,244,3384.0,419,128,202.0,743,337,22.4,No,2013,No,No,No
Preston Ross,497,55,384,187,150,101,1574.0,71,22,77.0,313,165,16.8,No,2013,No,No,No
Mike Brown,1309,235,1065,446,421,304,3396.0,335,113,226.0,730,333,21.7,Yes,2013,No,No,No
Josh Mendenhall,76,10,70,32,17,12,394.0,0,0,26.0,70,32,13.1,No,2013,No,No,No
Rhett Harrelson,838,160,660,248,184,150,2430.0,492,192,153.0,168,56,18.4,No,2013,No,No,No
Torrion Brummitt,977,103,760,362,389,243,2243.0,66,10,206.0,694,352,25.4,No,2013,No,No,No
Kenneth Hall,231,64,178,94,76,43,1506.0,0,0,72.0,178,94,9.5,No,2013,No,No,No
Brandon Littlejohn,7,1,6,3,2,1,13.0,2,0,2.0,4,3,34.7,No,2013,No,No,No
Justin Browning,588,122,398,212,202,135,2237.0,97,29,133.0,301,183,13.8,No,2013,No,No,No
Ethan Freeman,5,3,4,1,2,2,15.0,1,1,0.0,3,0,16.3,No,2013,No,No,No
Ceola Clark,1472,464,1032,471,368,283,4186.0,575,247,217.0,457,224,20.0,No,2013,No,No,No
Terell Parks,721,92,512,302,223,116,1813.0,1,1,103.0,511,301,24.0,No,2013,No,No,No
Adam Link,583,95,400,218,219,146,1883.0,6,1,103.0,394,217,19.1,No,2013,No,No,No
Jack Houpt,667,121,546,222,83,72,2927.0,386,151,102.0,160,71,13.9,No,2013,No,No,No
Don McAvoy,296,54,272,111,83,47,1046.0,75,27,61.0,197,84,21.6,No,2013,No,No,No
Remy Roberts-Burnett,379,105,400,173,54,26,1660.0,26,7,70.0,374,166,17.6,No,2013,No,No,No
Michael Ochereobia,371,24,250,148,134,75,1031.0,0,0,75.0,250,148,21.9,No,2013,No,No,No
Jordan Foster,184,80,165,59,66,45,876.0,67,21,77.0,98,38,18.4,No,2013,No,No,No
Jason Hawthorne,78,18,67,30,13,6,355.0,36,12,22.0,31,18,15.8,No,2013,No,No,No
Jamaal Walker,7,0,8,2,3,2,20.0,4,1,1.0,4,1,31.9,No,2013,No,No,No
Isaiah Duncan,2,0,4,0,4,2,12.0,2,0,1.0,2,0,35.1,No,2013,No,No,No
T.J. Price,1782,318,1425,581,440,334,3881.0,769,286,300.0,656,295,25.1,No,2013,No,No,No
George Fant,1621,123,1171,592,723,437,3671.0,3,0,273.0,1168,592,24.5,No,2013,No,No,No
Jamal Crook,779,358,715,297,249,169,2677.0,69,16,235.0,646,281,19.9,No,2013,No,No,No
Brandon Harris,462,99,419,136,117,85,1614.0,325,105,77.0,94,31,17.3,No,2013,No,No,No
Teeng Akol,433,31,363,167,119,82,1139.0,60,17,81.0,303,150,21.9,No,2013,No,No,No
Kevin Kaspar,351,108,316,113,71,53,1396.0,210,72,81.0,106,41,15.5,No,2013,No,No,No
Aleksej Rostov,445,46,349,160,140,98,1465.0,100,27,101.0,249,133,17.8,No,2013,No,No,No
O'Karo Akamune,241,30,181,95,106,51,1058.0,1,0,61.0,180,95,13.9,No,2013,No,No,No
Stephon Drane,87,1,67,35,31,17,284.0,1,0,18.0,66,35,17.6,No,2013,No,No,No
Caden Dickerson,596,131,511,197,108,84,2927.0,335,118,127.0,176,79,11.8,No,2013,No,No,No
Kene Anyigbo,114,22,87,38,70,38,488.0,0,0,41.0,87,38,16.5,No,2013,No,No,No
Percy Blade,43,7,31,12,23,17,221.0,12,2,23.0,19,10,14.9,No,2013,No,No,No
Eddie Alcantara,16,0,16,5,8,6,64.0,7,0,9.0,9,5,22.8,No,2013,No,No,No
Marcus Vasquez,10,0,4,2,8,4,49.0,3,2,1.0,1,0,9.1,No,2013,No,No,No
Spence Sheldon,2,0,1,0,2,2,11.0,1,0,2.0,0,0,18.2,No,2013,No,No,No
Kawaun Jakes,0,0,0,0,0,0,0.0,0,0,0.0,0,0,0,No,2013,No,No,No
Shayne Whittington,1119,81,807,416,367,279,2574.0,48,8,150.0,759,408,22.9,Yes,2013,No,No,No
Darius Paul,367,58,299,140,117,77,868.0,44,10,74.0,255,130,25.7,No,2013,No,No,No
Nate Hutcheson,1090,144,896,358,355,255,3277.0,394,119,230.0,502,239,20.1,No,2013,No,No,No
Brandon Pokley,446,46,342,133,97,85,1545.0,248,95,79.0,94,38,15.6,No,2013,No,No,No
David Brown,1536,176,1136,455,562,409,3279.0,671,217,220.0,465,238,26.0,No,2013,No,No,No
Austin Richie,943,279,696,270,341,243,3605.0,426,160,173.0,270,110,15.0,No,2013,No,No,No
Connar Tava,1154,314,777,409,501,327,3407.0,55,9,322.0,722,400,20.5,No,2013,No,No,No
Jared Klein,289,67,237,96,67,52,1201.0,124,45,76.0,113,51,14.9,No,2013,No,No,No
Taylor Perry,296,119,270,100,101,65,1944.0,94,31,113.0,176,69,11.5,No,2013,No,No,No
Dan Loney,79,15,46,29,37,21,443.0,0,0,26.0,46,29,10.4,No,2013,No,No,No
A.J. Avery,384,34,300,137,161,106,1475.0,10,4,72.0,290,133,15.6,No,2013,No,No,No
Charles Harris,47,7,40,20,10,4,106.0,11,3,6.0,29,17,25.1,No,2013,No,No,No
Hayden Hoerdemann,98,22,91,30,24,17,311.0,61,21,13.0,30,9,19.1,No,2013,No,No,No
Tim Brennan,6,1,13,2,5,2,66.0,6,0,8.0,7,2,18.6,No,2013,No,No,No
Nick Stapert,9,0,6,3,5,3,20.0,0,0,1.0,6,3,23.4,No,2013,No,No,No
Cleanthony Early,1135,50,790,371,342,280,1965.0,325,113,131.0,465,258,28.6,Yes,2013,No,No,No
Malcolm Armstead,1071,462,972,411,184,137,3172.0,333,112,272.0,639,299,21.3,No,2013,No,No,No
Carl Hall,679,44,454,252,263,175,1652.0,2,0,70.0,452,252,20.2,No,2013,No,No,No
Demetric Williams,739,249,589,252,192,150,2659.0,269,85,185.0,320,167,16.9,No,2013,No,No,No
Tekele Cotton,1047,276,853,375,292,189,3403.0,319,108,151.0,534,267,17.7,No,2013,No,No,No
Nick Wiggins,358,31,296,117,112,71,1007.0,161,53,51.0,135,64,20.7,No,2013,No,No,No
Fred VanVleet,1439,637,1086,463,462,372,3775.0,365,141,207.0,721,322,21.1,Yes,2013,No,No,No
Ron Baker,1636,345,1205,522,437,350,3795.0,655,242,177.0,550,280,22.0,Yes,2013,No,No,No
Jake White,872,32,622,314,281,212,1790.0,105,32,99.0,517,282,22.7,No,2013,No,No,No
Ehimen Orukpe,154,16,125,59,84,36,887.0,0,0,81.0,125,59,14.3,No,2013,No,No,No
Chadrack Lufile,259,17,180,100,106,59,836.0,0,0,53.0,180,100,17.7,No,2013,No,No,No
Evan Wessel,362,80,356,131,52,24,2182.0,253,76,50.0,103,55,10.4,No,2013,No,No,No
Marcus Thornton,2178,308,1649,709,551,435,4328.0,809,325,324.0,840,384,28.7,Yes,2013,No,No,No
Tim Rusthoven,1205,167,831,470,389,260,2624.0,32,5,167.0,799,465,25.1,No,2013,No,No,No
Brandon Britt,1254,199,947,407,444,312,2932.0,371,128,203.0,576,279,26.0,No,2013,No,No,No
Kyle Gaillard,756,169,594,285,177,106,2934.0,222,80,109.0,372,205,15.0,No,2013,No,No,No
Matt Rum,612,227,536,197,131,108,2814.0,332,110,166.0,204,87,15.2,No,2013,No,No,No
Julian Boatner,605,135,497,196,66,52,2303.0,420,161,104.0,77,35,15.4,No,2013,No,No,No
Terry Tarpey,946,270,676,335,306,228,3141.0,171,48,179.0,505,287,17.3,No,2013,No,No,No
Fred Heldring,104,43,96,36,43,29,859.0,20,3,50.0,76,33,10.8,No,2013,No,No,No
Tom Schalk,174,41,129,70,47,32,848.0,11,2,40.0,118,68,12.6,No,2013,No,No,No
Sean Sheldon,571,150,378,235,173,101,2039.0,0,0,96.0,378,235,14.8,No,2013,No,No,No
Brett Goodloe,5,1,4,2,0,0,8.0,2,1,1.0,2,1,35.0,No,2013,No,No,No
Doug Howard,25,7,21,10,7,5,83.0,2,0,6.0,19,10,20.5,No,2013,No,No,No
Andrew Pavloff,30,10,28,9,14,11,192.0,9,1,14.0,19,8,14.2,No,2013,No,No,No
Ben Whitlatch,21,0,20,7,2,1,56.0,15,6,1.0,5,1,21.9,No,2013,No,No,No
Joab Jerome,907,216,648,291,393,276,2817.0,152,49,247.0,496,242,20.4,No,2013,No,No,No
Gideon Gamble,679,99,699,259,88,60,2068.0,337,101,122.0,362,158,22.1,No,2013,No,No,No
Derrick Henry,999,104,797,308,391,291,2234.0,323,92,129.0,474,216,24.3,No,2013,No,No,No
Andre Smith,1071,322,930,348,205,161,3258.0,581,214,185.0,349,134,19.7,No,2013,No,No,No
James Bourne,489,23,309,170,244,149,2189.0,2,0,116.0,307,170,13.2,No,2013,No,No,No
Christian Farmer,256,21,239,82,46,34,624.0,185,58,27.0,54,24,25.0,No,2013,No,No,No
Larry Brown,341,29,306,147,99,47,1401.0,4,0,89.0,302,147,16.9,No,2013,No,No,No
Steve Johnson,113,10,102,38,45,32,418.0,25,5,15.0,77,33,18.5,Yes,2013,No,No,No
Shola Diop,81,3,52,33,29,15,335.0,1,0,24.0,51,33,14.8,No,2013,No,No,No
Reggie King,76,47,68,25,33,24,593.0,12,2,32.0,56,23,10.5,Yes,2013,No,No,No
Tevin Prescott,528,22,365,214,176,100,1807.0,1,0,66.0,364,214,14.5,No,2013,No,No,No
Donovan Carter,5,3,10,2,4,1,137.0,0,0,9.0,10,2,7.9,No,2013,No,No,No
Torrell Priest,0,0,0,0,0,0,1.0,0,0,0.0,0,0,0.0,No,2013,No,No,No
Ben Brust,1148,156,952,392,156,129,3332.0,607,235,95.0,345,157,18.9,No,2013,No,No,No
Jared Berggren,852,70,688,321,194,136,2276.0,227,74,105.0,461,247,22.2,No,2013,No,No,No
Ryan Evans,961,165,923,376,335,196,2943.0,70,13,161.0,853,363,24.2,No,2013,No,No,No
Sam Dekker,1363,148,1012,499,321,223,3153.0,408,142,114.0,604,357,22.9,Yes,2013,No,No,No
Traevon Jackson,839,307,683,273,285,223,2741.0,211,70,194.0,472,203,20.7,No,2013,No,No,No
Mike Bruesewitz,601,162,514,211,145,104,2723.0,261,75,123.0,253,136,14.9,No,2013,No,No,No
George Marshall,907,172,769,300,194,144,2429.0,420,163,110.0,349,137,20.7,No,2013,No,No,No
Frank Kaminsky,1458,188,1013,529,389,297,2943.0,279,103,121.0,734,426,25.5,Yes,2013,No,No,No
Zak Showalter,678,169,494,231,155,126,2599.0,254,90,102.0,240,141,13.8,No,2013,No,No,No
Zach Bohannon,161,36,110,57,50,30,541.0,46,17,32.0,64,40,17.9,No,2013,No,No,No
Dan Fahey,13,2,8,4,6,5,51.0,1,0,3.0,7,4,15.2,No,2013,No,No,No
Evan Anderson,20,6,19,9,5,1,109.0,6,1,6.0,13,8,14.2,No,2013,No,No,No
Jordan Smith,16,1,25,6,3,2,76.0,13,2,1.0,12,4,20.2,No,2013,No,No,No
J.D. Wise,12,0,6,4,2,2,26.0,2,2,3.0,4,2,21.6,No,2013,No,No,No
Karl Cochran,1894,320,1814,701,262,180,4068.0,914,312,267.0,900,389,29.8,No,2013,No,No,No
Spencer Collins,1696,194,1385,573,471,368,3882.0,512,182,203.0,873,391,25.5,No,2013,No,No,No
Lee Skinner,1242,269,985,455,481,316,4074.0,81,16,227.0,904,439,19.4,No,2013,No,No,No
Indiana Faithfull,174,150,167,57,50,40,1097.0,66,20,87.0,101,37,13.8,No,2013,No,No,No
Jarell Byrd,187,47,165,66,54,37,798.0,62,18,47.0,103,48,16.3,No,2013,No,No,No
Aerris Smith,283,11,225,121,74,41,1632.0,0,0,62.0,225,121,10.8,No,2013,No,No,No
John Swinton,196,121,144,58,70,59,1215.0,62,21,55.0,82,37,10.5,No,2013,No,No,No
C.J. Neumann,521,82,375,197,186,124,2662.0,10,3,99.0,365,194,11.5,No,2013,No,No,No
Justin Gordon,872,146,690,344,319,176,2421.0,25,8,195.0,665,336,23.4,No,2013,No,No,No
Taylor Wagener,74,17,56,19,29,19,264.0,49,17,25.0,7,2,19.4,No,2013,No,No,No
Kevin Hickson,23,0,18,10,9,3,145.0,0,0,7.0,18,10,10.2,No,2013,No,No,No
Bryan Harris,3,0,8,1,0,0,26.0,4,1,1.0,4,0,19.0,No,2013,No,No,No
James Long,33,3,30,11,5,3,113.0,23,8,3.0,7,3,15.1,No,2013,No,No,No
Zach Korkowski,35,7,16,11,13,13,96.0,3,0,9.0,13,11,17.7,No,2013,No,No,No
Jerran Young,594,75,432,218,185,119,1421.0,109,39,122.0,323,179,25.0,No,2013,No,No,No
Miles Dixon,884,176,781,303,289,222,2564.0,187,56,177.0,594,247,22.2,No,2013,No,No,No
Reggie Arceneaux,1049,296,975,369,181,138,3556.0,472,173,244.0,503,196,20.5,No,2013,No,No,No
Cole Darling,839,81,682,283,273,209,2258.0,185,64,133.0,497,219,23.4,No,2013,No,No,No
JT Yoho,1171,182,972,426,222,162,2848.0,412,157,190.0,560,269,24.4,No,2013,No,No,No
Kendall Griffin,461,149,322,142,155,116,2077.0,180,61,122.0,142,81,13.9,No,2013,No,No,No
Matt Vest,619,206,461,226,168,101,2627.0,187,66,111.0,274,160,13.9,No,2013,No,No,No
A.J. Pacher,873,78,650,317,261,183,2127.0,182,56,172.0,468,261,24.8,No,2013,No,No,No
Tavares Sledge,292,24,283,119,96,53,1222.0,10,1,79.0,273,118,18.7,No,2013,No,No,No
Joe Bramanti,304,178,243,91,158,97,2028.0,80,25,133.0,163,66,11.7,No,2013,No,No,No
Jacoby Roddy,10,1,8,3,4,4,31.0,1,0,2.0,7,3,21.6,No,2013,No,No,No
Stephen Gossard,20,0,9,8,6,4,48.0,0,0,1.0,9,8,14.9,No,2013,No,No,No
Bobo Drummond,5,5,6,1,2,2,69.0,5,1,4.0,1,0,8.9,No,2013,No,No,No
Daniel Collie,26,13,33,10,3,2,221.0,17,4,11.0,16,6,11.2,No,2013,No,No,No
Steven Davis,637,54,472,222,176,131,1390.0,186,62,106.0,286,160,24.2,No,2013,No,No,No
Derrious Gilmore,494,127,435,160,107,83,1459.0,249,91,117.0,186,69,24.1,No,2013,No,No,No
Leonard Washington,1132,111,813,414,404,269,2790.0,153,35,197.0,660,379,25.8,No,2013,No,No,No
Larry Nance,1386,172,978,510,428,330,3631.0,117,36,193.0,861,474,22.8,Yes,2013,No,Yes,Yes
Josh Adams,1819,398,1333,579,621,472,4299.0,572,189,325.0,761,390,27.0,No,2013,No,No,No
Riley Grabau,852,239,605,232,246,217,3457.0,465,171,143.0,140,61,15.1,No,2013,No,No,No
Luke Martinez,551,65,427,170,116,95,1311.0,325,116,62.0,102,54,24.3,No,2013,No,No,No
Nathan Sobey,439,88,340,145,161,109,1434.0,128,40,64.0,212,105,20.1,No,2013,No,No,No
Derek Cooke Jr.,589,73,378,244,215,100,2109.0,3,1,96.0,375,243,16.6,No,2013,No,No,No
Jason McManamen,1034,178,799,322,250,180,3015.0,564,210,103.0,235,112,18.3,No,2013,No,No,No
Austin Haldorson,37,4,43,14,4,4,216.0,17,5,6.0,26,9,14.0,No,2013,No,No,No
Jack Bentz,35,50,44,12,23,11,414.0,7,0,16.0,37,12,10.3,No,2013,No,No,No
Matt Sellers,77,11,62,31,25,15,280.0,0,0,22.0,62,31,20.8,No,2013,No,No,No
Aaron Tyser,13,1,7,5,0,0,18.0,4,3,2.0,3,2,30.4,No,2013,No,No,No
Semaj Christon,1034,281,785,363,421,282,2227.0,77,26,198.0,708,337,28.2,Yes,2013,No,No,No
Travis Taylor,1345,138,983,521,492,303,3191.0,5,0,260.0,978,521,24.3,No,2013,No,No,No
Brad Redford,693,64,516,219,70,60,1966.0,457,195,72.0,59,24,16.0,No,2013,No,No,No
Justin Martin,769,82,589,262,215,153,2196.0,273,92,140.0,316,170,20.0,No,2013,No,No,No
Dee Davis,874,493,722,284,249,185,3417.0,350,121,249.0,372,163,16.9,No,2013,No,No,No
Isaiah Philmore,1169,69,819,412,441,321,3212.0,82,24,165.0,737,388,19.5,No,2013,No,No,No
Jeff Robinson,493,26,399,201,128,85,1798.0,40,6,89.0,359,195,16.2,No,2013,No,No,No
Erik Stenger,84,8,63,34,45,16,440.0,0,0,22.0,63,34,13.0,No,2013,No,No,No
James Farr,692,40,554,278,155,101,1740.0,111,35,103.0,443,243,21.0,No,2013,No,No,No
Landen Amos,9,3,12,1,14,7,183.0,0,0,6.0,12,1,7.3,No,2013,No,No,No
Kevin Coker,2,0,2,1,0,0,19.0,0,0,1.0,2,1,8.1,No,2013,No,No,No
Joe Schuessler,0,0,1,0,0,0,6.0,0,0,1.0,1,0,18.2,No,2013,No,No,No
Tim Whelan,1,0,4,0,2,1,18.0,0,0,4.0,4,0,26.8,No,2013,No,No,No
Austin Morgan,1173,245,840,332,361,310,3117.0,508,199,201.0,332,133,20.3,No,2013,No,No,No
Justin Sears,1700,198,1184,607,707,475,3507.0,37,11,281.0,1147,596,26.8,No,2013,No,No,No
Javier Duren,1134,312,849,333,445,352,2724.0,341,116,267.0,508,217,25.8,No,2013,No,No,No
Matt Townsend,613,102,474,240,191,132,2218.0,8,1,122.0,466,239,16.4,No,2013,No,No,No
Armani Cotton,695,95,549,214,237,180,2379.0,266,87,118.0,283,127,17.3,No,2013,No,No,No
Michael Grace,412,197,383,142,118,90,1649.0,127,38,144.0,256,104,18.3,No,2013,No,No,No
Jeremiah Kreisberg,602,87,440,218,225,162,2025.0,18,4,159.0,422,214,18.3,No,2013,No,No,No
Sam Martin,263,52,232,83,57,37,906.0,170,60,36.0,62,23,17.0,No,2013,No,No,No
Greg Kelley,396,41,347,138,69,53,1149.0,196,67,45.0,151,71,19.6,No,2013,No,No,No
Brandon Sherrod,847,93,584,294,437,259,2304.0,2,0,125.0,582,294,20.3,No,2013,No,No,No
Nick Victor,428,167,358,161,132,59,2047.0,126,47,144.0,232,114,14.1,No,2013,No,No,No
Jesse Pritchard,203,43,190,63,54,36,1215.0,129,41,39.0,61,22,10.9,No,2013,No,No,No
Will Childs-Klein,39,6,36,17,8,4,96.0,5,1,11.0,31,16,27.5,No,2013,No,No,No
Jack Montague,571,170,463,187,80,57,1864.0,322,140,135.0,141,47,17.9,No,2013,No,No,No
Khaliq Ghani,117,19,97,38,22,17,455.0,67,24,24.0,30,14,14.8,No,2013,No,No,No
Will Bartlett,10,6,7,2,6,4,44.0,2,2,4.0,5,0,15.1,No,2013,No,No,No
Kendrick Perry,1991,505,1374,643,670,504,4183.0,577,201,241.0,797,442,24.0,No,2013,No,No,No
Blake Allen,1032,273,897,362,115,76,2979.0,593,232,127.0,304,130,18.8,No,2013,No,No,No
Damian Eargle,1329,71,1148,532,481,264,3357.0,7,1,188.0,1141,531,23.5,No,2013,No,No,No
Kamren Belin,728,99,623,244,154,123,1984.0,328,117,111.0,295,127,21.0,No,2013,No,No,No
DJ Cole,803,418,619,260,299,210,3071.0,211,73,227.0,408,187,16.6,No,2013,No,No,No
Bobby Hain,1187,151,925,469,324,225,2786.0,104,24,144.0,821,445,22.4,No,2013,No,No,No
Shawn Amiker,777,91,580,289,288,186,2306.0,50,13,153.0,530,276,19.5,No,2013,No,No,No
Ryan Weber,1095,173,829,350,224,182,3090.0,562,213,173.0,267,137,18.3,No,2013,No,No,No
Josh Chojnacki,100,20,85,37,34,23,696.0,17,3,33.0,68,34,10.1,No,2013,No,No,No
Fletcher Larson,132,25,129,59,17,14,792.0,0,0,32.0,129,59,11.1,No,2013,No,No,No
Mike Podolsky,32,9,43,11,9,2,265.0,25,8,11.0,18,3,11.4,No,2013,No,No,No
Danny Reese,10,5,11,4,1,0,47.0,7,2,4.0,4,2,17.2,No,2013,No,No,No
Parker Wentz,1062,157,741,333,217,186,2852.0,480,210,132.0,261,123,17.9,No,2014,No,No,No
Julian Edmonson,340,30,258,104,121,89,587.0,109,43,54.0,149,61,32.5,No,2014,No,No,No
Austin Cooke,741,108,565,239,162,127,2391.0,338,136,95.0,227,103,16.1,No,2014,No,No,No
Jacob Lancaster,214,7,159,88,58,37,434.0,1,1,41.0,158,87,27.0,No,2014,No,No,No
Harrison Hawkins,597,97,471,197,148,121,1222.0,218,82,121.0,253,115,28.7,No,2014,No,No,No
LaDarrien Williams,500,124,451,175,135,104,1221.0,137,46,98.0,314,129,26.5,No,2014,No,No,No
Michael Grant,213,36,155,70,109,73,858.0,6,0,64.0,149,70,16.5,No,2014,No,No,No
James Pegues,157,16,125,55,56,46,445.0,6,1,46.0,119,54,22.9,No,2014,No,No,No
Rafael Farley,133,12,111,44,18,12,421.0,76,33,18.0,35,11,16.9,No,2014,No,No,No
Riley Payne,187,32,154,72,72,43,1022.0,0,0,45.0,154,72,12.0,No,2014,No,No,No
Alexsander Milosavljevic,52,4,53,24,8,4,215.0,1,0,16.0,52,24,17.7,No,2014,No,No,No
Chris Blakeley,4,19,9,2,2,0,145.0,4,0,19.0,5,2,10.3,No,2014,No,No,No
Tre' Coggins,1483,194,1205,492,307,252,3101.0,682,247,232.0,523,245,26.0,No,2014,No,No,No
Max Yon,828,164,648,280,232,174,2206.0,289,94,154.0,359,186,23.1,No,2014,No,No,No
Marek Olesinski,750,121,578,265,134,97,2234.0,326,123,103.0,252,142,18.6,No,2014,No,No,No
Kamryn Williams,554,157,465,204,159,105,1807.0,127,41,127.0,338,163,20.6,No,2014,No,No,No
Justin Hammonds,530,111,361,196,205,118,1758.0,50,20,110.0,311,176,18.1,No,2014,No,No,No
DeLovell Earls,291,121,262,108,111,58,1207.0,64,17,100.0,198,91,19.1,No,2014,No,No,No
Zach Kocur,967,212,748,328,180,124,2754.0,474,187,166.0,274,141,19.3,No,2014,No,No,No
Darrius Parker,69,13,39,24,32,19,238.0,7,2,12.0,32,22,15.0,No,2014,No,No,No
Hayden Graham,1113,181,911,432,231,153,2951.0,288,96,159.0,623,336,21.2,No,2014,No,No,No
Chase Kammerer,74,32,59,25,42,22,373.0,11,2,25.0,48,23,15.5,No,2014,No,No,No
Zach Moer,359,47,280,133,102,77,897.0,48,16,84.0,232,117,24.5,No,2014,No,No,No
Nick Jorgensen,14,5,15,5,6,2,127.0,7,2,2.0,8,3,8.4,No,2014,No,No,No
Callum Long,14,6,10,4,5,4,76.0,7,2,11.0,3,2,16.6,No,2014,No,No,No
Ethan Michael,24,16,19,6,20,11,81.0,5,1,7.0,14,5,23.9,No,2014,No,No,No
Scott Adler,8,3,6,3,5,2,32.0,3,0,0.0,3,3,14.1,No,2014,No,No,No
Joe Tuss,88,20,117,32,28,14,395.0,52,10,24.0,65,22,20.3,No,2014,No,No,No
Austin Flues,2,0,0,0,2,2,6.0,0,0,0.0,0,0,8.6,No,2014,No,No,No
Demetrius Treadwell,1101,143,875,424,454,252,2554.0,13,1,194.0,862,423,25.7,No,2014,No,No,No
Quincy Diggs,1003,222,781,338,315,215,2830.0,316,112,246.0,465,226,21.5,No,2014,No,No,No
Nick Harney,781,77,606,298,238,159,1686.0,101,26,151.0,505,272,26.3,No,2014,No,No,No
Jake Kretzer,869,145,694,278,121,100,3034.0,571,213,96.0,123,65,14.3,No,2014,No,No,No
Reggie McAdams,975,76,735,314,139,99,2514.0,610,248,49.0,125,66,17.2,No,2014,No,No,No
Nyles Evans,346,106,322,114,72,48,1379.0,215,70,66.0,107,44,15.9,No,2014,No,No,No
Pat Forsythe,815,72,615,327,267,160,2210.0,6,1,171.0,609,326,21.2,No,2014,No,No,No
Adedeji Ibitayo,598,68,453,192,209,138,1508.0,219,76,89.0,234,116,22.0,No,2014,No,No,No
Isaiah Johnson,1374,203,888,508,608,357,3004.0,7,1,202.0,881,507,23.4,No,2014,No,No,No
Carmelo Betancourt,132,125,132,48,47,27,918.0,44,9,109.0,88,39,14.7,No,2014,No,No,No
Kwan Cheatham Jr.,976,180,885,336,180,129,2825.0,498,175,175.0,387,161,20.8,No,2014,No,No,No
Mark Noble,7,0,9,3,1,0,35.0,3,1,3.0,6,2,18.2,No,2014,No,No,No
Jeremy Crutcher,1130,462,988,368,415,265,3563.0,361,129,322.0,627,239,21.3,No,2014,No,No,No
Brandon Ellis,773,77,690,275,179,124,2077.0,304,99,154.0,386,176,22.7,No,2014,No,No,No
Demarquelle Tabb,1178,120,915,443,501,292,3004.0,7,0,194.0,908,443,22.5,No,2014,No,No,No
Arthur Capers,243,33,226,94,44,28,690.0,88,27,48.0,138,67,22.2,No,2014,No,No,No
Green Hill,523,178,406,158,244,182,1896.0,89,25,145.0,317,133,17.9,No,2014,No,No,No
Nicholas West,957,92,733,307,381,274,2342.0,232,69,198.0,501,238,24.5,No,2014,No,No,No
Justin Banks,329,17,235,134,81,61,1299.0,2,0,75.0,233,134,13.6,No,2014,No,No,No
Justin Colvin,317,53,311,104,87,53,1043.0,185,56,68.0,126,48,20.8,No,2014,No,No,No
Jose Long,220,57,212,72,113,57,1255.0,74,19,45.0,138,53,12.7,No,2014,No,No,No
Tyler Davis,388,86,358,128,89,58,1861.0,237,74,97.0,121,54,13.8,Yes,2014,No,No,No
Jerome Hunter,345,44,296,139,110,66,1810.0,3,1,98.0,293,138,12.3,No,2014,No,No,No
Rakiya Battle,605,473,535,172,303,217,2641.0,174,44,238.0,361,128,18.1,No,2014,No,No,No
Baryn Houston,112,11,145,40,28,15,503.0,78,17,14.0,67,23,17.6,No,2014,No,No,No
Xavier Williams,23,3,23,9,9,5,113.0,3,0,8.0,20,9,16.0,No,2014,No,No,No
Matthew Cotton,192,56,177,56,73,49,933.0,102,31,52.0,75,25,14.8,No,2014,No,No,No
Chad Frazier,549,132,424,170,203,148,1095.0,180,61,123.0,244,109,27.4,No,2014,No,No,No
C.J. Washington,593,31,522,228,151,94,1365.0,140,43,83.0,382,185,24.2,No,2014,No,No,No
Rod Rucker,808,138,728,318,267,171,2009.0,15,1,147.0,713,317,23.6,No,2014,No,No,No
Fahro Alihodzic,719,50,652,297,183,124,2246.0,6,1,123.0,646,296,18.1,No,2014,No,No,No
Robert Williams,709,135,580,243,212,147,2717.0,220,76,157.0,360,167,15.1,No,2014,No,No,No
Jordan Swing,1011,207,811,339,251,197,2724.0,408,136,165.0,403,203,20.2,No,2014,No,No,No
Denzell Watts,604,223,487,199,146,105,2284.0,260,101,135.0,227,98,15.2,No,2014,No,No,No
Tosin Mehinti,689,97,531,271,241,147,2417.0,0,0,189.0,531,271,17.4,No,2014,No,No,No
Tyler Madison,454,82,340,156,198,133,1329.0,36,9,73.0,304,147,19.4,No,2014,No,No,No
Preston Purifoy,679,69,508,210,172,144,2086.0,307,115,89.0,201,95,16.7,No,2014,No,No,No
Thaddeus Rideau,17,2,21,6,0,0,66.0,17,5,2.0,4,1,16.3,No,2014,No,No,No
Karl Moton,19,3,12,7,2,1,49.0,8,4,1.0,4,3,14.0,No,2014,No,No,No
Jamel Waters,1527,579,1248,509,482,362,3894.0,419,147,296.0,829,362,22.3,No,2014,No,No,No
DeMarcus Robinson,676,114,590,233,149,114,1769.0,288,96,75.0,302,137,20.3,No,2014,No,No,No
Brandon Graham,432,45,338,151,137,93,1359.0,136,37,73.0,202,114,17.1,No,2014,No,No,No
Maurice Strong,525,56,452,203,213,119,1670.0,4,0,109.0,448,203,19.3,No,2014,No,No,No
Bobby Brown,925,92,888,337,205,133,2601.0,384,118,139.0,504,219,21.2,Yes,2014,No,No,No
Luther Page,660,89,502,227,381,206,2624.0,3,0,205.0,499,227,16.8,No,2014,No,No,No
Terrance LeFlore,716,233,754,256,203,124,2441.0,296,80,206.0,458,176,21.0,No,2014,No,No,No
Tony Armstrong,750,54,588,285,289,180,1820.0,0,0,102.0,588,285,22.0,No,2014,No,No,No
Billy Ingram,84,8,80,31,16,9,259.0,46,13,18.0,34,18,20.0,No,2014,No,No,No
DeAngelo Stewart,457,56,378,155,65,46,1314.0,262,101,43.0,116,54,16.8,No,2014,No,No,No
Tony Jacob,18,3,10,7,13,4,36.0,0,0,8.0,10,7,32.7,No,2014,No,No,No
Darius Scott,14,4,15,6,1,1,61.0,4,1,3.0,11,5,14.7,No,2014,No,No,No
Nick Davis,291,42,246,110,76,41,1312.0,108,30,73.0,138,80,13.4,No,2014,No,No,No
Devonte' Neal,11,1,10,3,10,5,54.0,0,0,1.0,10,3,14.6,No,2014,No,No,No
Sean Burroughs,0,0,0,0,0,0,0.0,0,0,0.0,0,0,0,No,2014,No,No,No
Princeton Davis,0,0,0,0,2,0,4.0,0,0,0,0,0,0,No,2014,No,No,No
Trevor Releford,1873,395,1319,638,537,437,4367.0,446,160,303.0,873,478,23.1,No,2014,No,No,No
Levi Randolph,1336,243,1043,455,411,307,4139.0,360,119,177.0,683,336,18.7,No,2014,No,No,No
Retin Obasohan,1176,182,877,380,479,327,2937.0,266,89,206.0,611,291,24.0,No,2014,No,No,No
Shannon Hale,892,84,716,282,318,220,2173.0,346,108,187.0,370,174,25.9,No,2014,No,No,No
Rodney Cooper,1122,161,988,401,245,182,3514.0,443,138,182.0,545,263,20.0,No,2014,No,No,No
Nick Jacobs,1057,22,895,454,229,149,2691.0,1,0,149.0,894,454,22.7,No,2014,No,No,No
Algie Key,117,45,99,40,54,36,492.0,7,1,25.0,92,39,16.4,No,2014,No,No,No
Jimmie Taylor,630,55,422,248,305,134,2649.0,0,0,134.0,422,248,14.0,No,2014,No,No,No
Carl Engstrom,108,16,90,43,37,22,773.0,0,0,45.0,90,43,10.6,No,2014,No,No,No
Dakota Slaughter,393,70,308,139,65,49,1099.0,179,66,53.0,129,73,18.5,No,2014,No,No,No
Isiah Wilson,10,1,8,3,8,4,19.0,2,0,0.0,6,3,33.8,No,2014,No,No,No
Peter Hooley,1519,337,1157,464,511,410,3905.0,555,181,257.0,602,283,22.8,No,2014,No,No,No
DJ Evans,481,110,401,155,147,113,1476.0,169,58,87.0,232,97,20.8,No,2014,No,No,No
Sam Rowley,1194,166,888,453,379,288,3202.0,6,0,268.0,882,453,23.1,No,2014,No,No,No
Gary Johnson,433,58,315,151,178,129,1309.0,10,2,82.0,305,149,20.2,No,2014,No,No,No
John Puk,548,62,471,217,162,114,2845.0,0,0,145.0,471,217,13.3,No,2014,No,No,No
Dallas Ennema,586,69,469,195,116,80,2078.0,306,116,66.0,163,79,15.2,No,2014,No,No,No
Luke Devlin,605,84,529,230,139,92,2389.0,182,53,90.0,347,177,15.5,No,2014,No,No,No
Anders Haas,62,5,53,18,13,11,134.0,44,15,8.0,9,3,27.5,No,2014,No,No,No
Mike Rowley,638,114,473,235,221,163,3039.0,23,5,144.0,450,230,12.5,No,2014,No,No,No
Dave Wiegmann,53,12,56,20,20,11,351.0,13,2,18.0,43,18,13.1,No,2014,No,No,No
Ede Egharevba,255,26,232,98,52,32,656.0,89,27,47.0,143,71,23.6,No,2014,No,No,No
Levan Shengelia,90,12,71,31,55,28,421.0,0,0,28.0,71,31,14.8,No,2014,No,No,No
Anthony Odunsi,999,208,590,273,536,429,2136.0,76,24,234.0,514,249,25.0,No,2014,No,No,No
Reece Williams,4,0,5,1,2,2,23.0,1,0,2.0,4,1,19.2,No,2014,No,No,No
LeAntwan Luckett,1533,214,1351,520,603,404,3384.0,342,89,264.0,1009,431,28.6,No,2014,No,No,No
Octavius Brown,677,42,496,243,195,134,1643.0,150,57,80.0,346,186,21.3,No,2014,No,No,No
Marquis Vance,1302,209,1144,433,543,330,3659.0,344,106,232.0,800,327,22.6,No,2014,No,No,No
Devonte Hampton,605,159,583,215,138,85,2356.0,280,90,154.0,303,125,17.4,No,2014,No,No,No
Twann Oakley,456,46,372,145,124,91,1315.0,221,75,71.0,151,70,19.9,No,2014,No,No,No
Anthony Evans,255,93,288,94,50,34,1125.0,131,33,62.0,157,61,17.0,No,2014,No,No,No
Tyrel Hunt,474,43,376,166,208,135,1516.0,20,7,79.0,356,159,18.5,No,2014,No,No,No
Shaun Smith,103,15,118,31,38,30,418.0,51,11,32.0,67,20,21.3,No,2014,No,No,No
Marius Myles,78,11,63,28,34,22,616.0,0,0,21.0,63,28,8.6,No,2014,No,No,No
Stephane Raquil,108,11,97,44,42,20,881.0,1,0,37.0,96,44,9.1,No,2014,No,No,No
Josh Nicholas,156,13,130,63,54,30,749.0,1,0,41.0,129,63,13.5,No,2014,No,No,No
George Thomas,135,19,134,43,43,27,766.0,81,22,38.0,53,21,12.7,No,2014,No,No,No
Denarius Odell,15,4,14,6,7,2,34.0,2,1,3.0,12,5,32.1,No,2014,No,No,No
Corey Young,24,2,26,9,0,0,123.0,20,6,2.0,6,3,11.4,No,2014,No,No,No
DeCarlos Holmes,0,0,0,0,0,0,0.0,0,0,0.0,0,0,0,No,2014,No,No,No
Jesse Reed,1405,171,1037,479,367,272,3927.0,448,175,207.0,589,304,21.8,No,2014,No,No,No
Tony Wroblicky,881,132,657,363,242,155,2565.0,0,0,177.0,657,363,21.5,No,2014,No,No,No
John Schoof,1154,230,909,390,185,147,4062.0,553,227,187.0,356,163,17.6,No,2014,No,No,No
Darius Gardner,999,448,761,338,298,221,3862.0,261,102,297.0,500,236,18.3,No,2014,No,No,No
Kyle Kager,218,39,172,79,60,44,755.0,53,16,56.0,119,63,20.0,No,2014,No,No,No
Marko Vasic,481,157,414,194,97,58,2081.0,135,35,96.0,279,159,16.2,No,2014,No,No,No
Charlie Jones,662,199,456,231,189,134,3113.0,170,66,116.0,286,165,12.7,No,2014,No,No,No
Austin Carroll,188,58,181,62,29,17,872.0,140,47,56.0,41,15,16.1,No,2014,No,No,No
Yilret Yiljep,168,31,108,63,72,41,602.0,1,1,55.0,107,62,17.6,No,2014,No,No,No
Jalen Rhea,288,18,234,92,48,34,970.0,189,70,24.0,45,22,17.0,No,2014,No,No,No
Zach Elcano,72,24,57,28,30,16,443.0,0,0,39.0,57,28,15.7,No,2014,No,No,No
Justice Montgomery,14,16,22,4,16,5,160.0,7,1,16.0,15,3,16.8,No,2014,No,No,No
Jordan Borucki,9,0,8,4,2,1,18.0,0,0,1.0,8,4,31.1,No,2014,No,No,No
Kade Kager,0,0,0,0,2,0,2.0,0,0,0.0,0,0,28.0,No,2014,No,No,No
Langdon Neal,0,0,0,0,0,0,4.0,0,0,0.0,0,0,0.0,No,2014,No,No,No
Tab Hamilton,913,94,865,329,150,109,2593.0,435,146,116.0,430,183,20.4,No,2014,No,No,No
Tommy Spagnolo,590,66,447,239,171,106,1813.0,17,6,130.0,430,233,18.4,No,2014,No,No,No
Michael Neal,704,259,597,226,250,170,2169.0,241,82,229.0,356,144,22.0,No,2014,No,No,No
Chris Burgess,782,271,670,265,149,120,2712.0,365,132,159.0,305,133,16.6,No,2014,No,No,No
Tevin Baskin,554,25,438,193,219,153,1274.0,46,15,75.0,392,178,24.2,No,2014,No,No,No
Michael Obacha,495,53,310,156,342,183,2361.0,0,0,118.0,310,156,12.5,No,2014,No,No,No
Ty Toney,784,207,663,269,308,213,2171.0,135,33,148.0,528,236,21.2,No,2014,No,No,No
Frank Eaves,1211,136,958,357,417,334,2388.0,466,163,160.0,492,194,27.3,No,2014,No,No,No
Jay Canty,578,109,468,212,193,134,1337.0,81,20,106.0,387,192,25.2,No,2014,No,No,No
Mike Kobani,124,2,98,54,45,16,340.0,0,0,20.0,98,54,20.6,No,2014,No,No,No
Rantavious Gilbert,79,6,69,32,23,15,262.0,0,0,15.0,69,32,18.2,No,2014,No,No,No
Aaron Scott,37,4,26,13,10,6,99.0,15,5,3.0,11,8,17.0,No,2014,No,No,No
Dustin Clarke,179,39,209,64,30,22,714.0,119,29,29.0,90,35,18.1,No,2014,No,No,No
Mitch Purgason,3,0,3,1,0,0,6.0,3,1,2.0,0,0,41.6,No,2014,No,No,No
Jahii Carson,1261,330,975,442,424,308,2471.0,195,69,240.0,780,373,29.7,No,2014,No,No,No
Jermaine Marshall,1362,171,1111,455,356,262,3176.0,534,190,200.0,577,265,24.6,No,2014,No,No,No
Jordan Bachynski,968,33,632,354,424,260,2670.0,0,0,158.0,632,354,19.6,No,2014,No,No,No
Shaquielle McKissic,710,142,528,238,255,170,1978.0,191,64,77.0,337,174,19.1,No,2014,No,No,No
Jonathan Gilling,998,272,784,323,138,94,3579.0,638,258,184.0,146,65,15.2,No,2014,No,No,No
Bo Barnes,575,64,461,182,112,83,1841.0,339,128,67.0,122,54,16.3,No,2014,No,No,No
Egor Koulechov,1740,173,1330,579,409,340,3719.0,615,242,181.0,715,337,22.6,No,2014,No,No,No
Eric Jacobsen,659,65,415,239,305,180,2258.0,2,1,125.0,413,238,15.4,No,2014,No,No,No
Chance Murray,749,223,703,252,264,177,2217.0,244,68,156.0,459,184,22.5,No,2014,No,No,No
Richie Edwards,321,20,241,115,82,65,635.0,71,26,44.0,170,89,27.7,No,2014,No,No,No
Calaen Robinson,740,248,616,248,142,113,2088.0,383,131,147.0,233,117,18.9,No,2014,No,No,No
Sai Tummala,259,33,214,91,41,26,724.0,138,51,35.0,76,40,18.3,No,2014,No,No,No
Brandan Kearney,301,99,268,109,70,46,1354.0,110,37,81.0,158,72,14.5,No,2014,No,No,No
Jarett Upchurch,7,1,4,3,0,0,12.0,2,1,1.0,2,2,21.6,No,2014,No,No,No
David Whitmore,4,1,3,1,2,2,28.0,1,0,0.0,2,1,7.7,No,2014,No,No,No
Nick Johnson,1333,304,1048,441,418,307,3339.0,401,144,197.0,647,297,22.7,Yes,2014,No,No,No
Aaron Gordon,470,75,382,189,180,76,1187.0,45,16,55.0,337,173,23.2,Yes,2014,No,No,No
Kaleb Tarczewski,1185,63,740,415,504,355,3489.0,0,0,204.0,740,415,17.4,No,2014,No,No,No
Rondae Hollis-Jefferson,774,114,522,259,356,248,2050.0,39,8,103.0,483,251,20.2,Yes,2014,No,No,No
T.J. McConnell,1414,751,1123,550,235,176,4425.0,363,138,281.0,760,412,17.4,Yes,2014,No,No,No
Gabe York,1143,191,915,379,208,156,2904.0,569,229,131.0,346,150,20.0,No,2014,No,No,No
Brandon Ashley,979,71,678,352,344,249,2383.0,68,26,146.0,610,326,21.5,No,2014,No,No,No
Jordin Mayes,464,129,421,161,96,64,1664.0,222,78,97.0,199,83,17.7,No,2014,No,No,No
Elliott Pitts,192,36,170,65,34,22,915.0,118,40,29.0,52,25,12.1,No,2014,No,No,No
Matt Korcheck,50,5,26,18,18,14,178.0,0,0,7.0,26,18,12.2,No,2014,No,No,No
Jacob Hazzard,40,7,43,15,2,2,93.0,23,8,12.0,20,7,31.0,No,2014,No,No,No
Trey Mason,8,3,6,3,0,0,34.0,2,2,3.0,4,1,13.8,No,2014,No,No,No
Eric Conklin,4,0,2,2,0,0,17.0,0,0,0.0,2,2,6.2,No,2014,No,No,No
Chris Johnson,4,0,1,1,2,1,6.0,1,1,0.0,0,0,17.1,Yes,2014,No,No,No
Drew Mellon,1,3,8,0,2,1,46.0,3,0,1.0,5,0,11.2,No,2014,No,No,No
Zach Peters,0,0,6,0,0,0,31.0,6,0,2.0,0,0,13.6,No,2014,No,No,No
Will Neighbour,1054,97,788,354,340,257,2458.0,240,89,214.0,548,265,24.1,No,2014,No,No,No
Josh Hagins,1475,468,1224,525,306,250,3495.0,497,175,241.0,727,350,24.0,No,2014,No,No,No
James White,863,78,706,357,240,146,2188.0,15,3,157.0,691,354,22.6,Yes,2014,No,No,No
Leroy Isler,451,72,363,143,188,136,1644.0,93,29,109.0,270,114,17.1,No,2014,No,No,No
Ben Dillard,801,119,584,223,307,253,2555.0,288,102,111.0,296,121,17.0,No,2014,No,No,No
DeVonte Smith,220,135,187,76,80,49,1355.0,61,19,50.0,126,57,10.3,No,2014,No,No,No
Mareik Isom,576,33,456,187,137,101,1619.0,268,101,53.0,188,86,18.6,No,2014,No,No,No
Gus Leeper,367,19,322,141,111,82,1502.0,4,3,89.0,318,138,15.9,No,2014,No,No,No
Kemy Osse,741,92,648,247,147,109,2156.0,396,138,89.0,252,109,19.5,No,2014,No,No,No
Maurius Hill,632,109,544,238,192,129,2032.0,87,27,146.0,457,211,20.3,No,2014,No,No,No
Stetson Billings,199,51,207,65,73,54,1095.0,47,15,51.0,160,50,13.8,No,2014,No,No,No
J.T. Thomas,304,112,280,95,122,75,1366.0,124,39,75.0,156,56,16.1,No,2014,No,No,No
Andrew Poulter,28,0,27,14,2,0,56.0,0,0,1.0,27,14,25.8,No,2014,No,No,No
Tevin Hammond,892,365,755,255,354,257,3063.0,388,125,307.0,367,130,20.8,No,2014,No,No,No
DaVon Haynes,754,62,572,284,281,173,1812.0,51,13,137.0,521,271,23.7,No,2014,No,No,No
Marcel Mosley,1019,221,804,320,314,245,2664.0,368,134,259.0,436,186,23.8,No,2014,No,No,No
Daniel Broughton,988,78,884,379,315,197,2543.0,89,33,224.0,795,346,25.5,No,2014,No,No,No
Ghiavonni Robinson,1071,167,1059,363,224,150,3407.0,637,195,223.0,422,168,21.4,No,2014,No,No,No
Trent Whiting,444,92,385,174,133,74,1860.0,78,22,105.0,307,152,15.7,No,2014,No,No,No
DeAndre McIntyre,162,23,148,60,47,29,769.0,50,13,56.0,98,47,15.5,No,2014,No,No,No
Chandler Savage,72,34,63,26,33,20,550.0,10,0,33.0,53,26,10.4,No,2014,No,No,No
Sean Tingle,62,2,49,18,45,26,183.0,1,0,31.0,48,18,28.7,No,2014,No,No,No
Jaylon Floyd,170,14,138,67,65,34,1085.0,9,2,60.0,129,65,10.9,No,2014,No,No,No
Jordan Brown,56,6,50,24,21,8,288.0,0,0,5.0,50,24,12.0,No,2014,No,No,No
Roy Jackson,5,0,3,1,6,2,17.0,2,1,0.0,1,0,17.8,No,2014,No,No,No
Trent Jeffries,5,2,7,1,5,3,64.0,1,0,7.0,6,1,13.2,No,2014,No,No,No
Jared Young,8,0,5,3,3,1,23.0,2,1,3.0,3,2,21.2,No,2014,No,No,No
David Tillman,51,10,43,22,25,7,499.0,0,0,36.0,43,22,9.6,No,2014,No,No,No
Melvin Johnson III,1598,104,1199,527,319,262,2927.0,665,282,200.0,534,245,27.2,No,2014,No,No,No
Kirk Van Slyke,922,59,708,325,222,180,2043.0,253,92,112.0,455,233,23.1,No,2014,No,No,No
Edward Townsel,1177,240,1027,392,299,217,3366.0,496,176,247.0,531,216,21.8,No,2014,No,No,No
Brandon Reed,1168,216,1062,400,287,204,3121.0,493,164,191.0,569,236,23.0,No,2014,No,No,No
Kendrick Washington,808,112,614,295,341,213,2620.0,24,5,170.0,590,290,18.4,No,2014,No,No,No
Cameron Golden,870,224,809,288,215,146,2406.0,475,148,175.0,334,140,23.2,No,2014,No,No,No
Rakeem Dickerson,400,179,298,110,210,153,1708.0,88,27,116.0,210,83,15.6,No,2014,No,No,No
Kelvin Downs,325,28,283,126,110,72,1419.0,6,1,106.0,277,125,15.8,No,2014,No,No,No
Raeford Worsham,952,131,716,342,414,248,2340.0,91,20,155.0,625,322,22.8,No,2014,No,No,No
Seth Kisler,37,2,24,13,11,7,123.0,9,4,7.0,15,9,15.2,No,2014,No,No,No
Josh Pierre,40,4,52,10,16,11,337.0,46,9,6.0,6,1,9.6,No,2014,No,No,No
Rashad Madden,1106,369,782,336,390,314,2997.0,353,120,246.0,429,216,19.5,No,2014,No,No,No
Bobby Portis,1047,92,782,411,274,202,1994.0,63,23,97.0,719,388,24.2,Yes,2014,No,No,No
Michael Qualls,1100,147,851,364,372,269,2379.0,312,103,133.0,539,261,23.4,No,2014,No,No,No
Coty Clarke,556,116,386,181,206,160,1384.0,77,34,83.0,309,147,19.6,Yes,2014,No,No,No
Alandise Harris,1215,149,888,429,480,321,2884.0,105,36,223.0,783,393,23.0,No,2014,No,No,No
Anthlon Bell,1144,121,1012,394,149,119,2360.0,642,237,96.0,370,157,24.0,No,2014,No,No,No
Fred Gulley III,265,140,270,90,99,55,1816.0,110,30,81.0,160,60,10.9,No,2014,No,No,No
Moses Kingsley,1200,106,835,424,508,344,2701.0,18,8,172.0,817,416,22.3,No,2014,No,No,No
Mardracus Wade,797,153,569,235,253,198,2662.0,341,129,121.0,228,106,14.9,No,2014,No,No,No
Kikko Haydar,230,64,192,71,42,30,952.0,153,58,32.0,39,13,12.4,No,2014,No,No,No
Jacorey Williams,989,127,856,412,248,158,2208.0,37,7,139.0,819,405,25.5,No,2014,No,No,No
Rickey Scott,532,163,487,195,204,117,1628.0,112,25,94.0,375,170,20.4,No,2014,No,No,No
DeQuavious Wagner,37,30,41,11,10,9,163.0,23,6,9.0,18,5,16.2,No,2014,No,No,No
Manuale Watkins,477,172,381,202,102,60,1960.0,36,13,74.0,345,189,12.4,No,2014,No,No,No
Kyle Wilson,2001,211,1676,686,446,355,3781.0,754,274,257.0,922,412,28.2,No,2014,No,No,No
Dylan Cox,1030,479,716,381,361,231,3135.0,113,37,266.0,603,344,18.3,No,2014,No,No,No
Kevin Ferguson,1059,139,691,433,297,193,2802.0,0,0,196.0,691,433,18.1,No,2014,No,No,No
Tanner Plomb,1359,130,1098,468,316,239,2449.0,515,184,151.0,583,284,28.1,No,2014,No,No,No
Tanner Omlid,220,61,200,85,35,23,634.0,98,27,36.0,102,58,20.1,No,2014,No,No,No
Josh Herbeck,777,99,708,266,64,48,2144.0,521,197,101.0,187,69,20.0,No,2014,No,No,No
Larry Toomey,666,197,587,225,187,128,2554.0,280,88,156.0,307,137,16.2,No,2014,No,No,No
Matt Gramling,184,75,196,69,58,36,797.0,62,10,38.0,134,59,16.6,No,2014,No,No,No
Mo Williams,368,93,314,110,144,101,2002.0,163,47,103.0,151,63,12.3,Yes,2014,No,Yes,Yes
Travis Rollo,48,21,48,21,17,6,572.0,1,0,21.0,47,21,6.7,No,2014,No,No,No
Maxwell Lenox,290,175,218,102,123,76,1180.0,43,10,126.0,175,92,17.5,No,2014,No,No,No
Mac Hoffman,270,46,209,100,96,63,1199.0,27,7,65.0,182,93,13.0,No,2014,No,No,No
Kieffer Jordan,17,7,19,6,9,4,152.0,6,1,7.0,13,5,10.0,No,2014,No,No,No
Scott Mammel,164,46,140,53,23,19,629.0,99,39,32.0,41,14,14.3,No,2014,No,No,No
Richard Brown,13,9,21,5,4,2,155.0,12,1,11.0,9,4,10.8,No,2014,No,No,No
Milton Washington,161,57,115,58,58,41,473.0,8,4,57.0,107,54,21.5,No,2014,No,No,No
Kyle Weldon,4,0,5,2,0,0,29.0,1,0,3.0,4,2,14.0,No,2014,No,No,No
Austin Williamson,0,0,0,0,0,0,0.0,0,0,0.0,0,0,0,No,2014,No,No,No
Chris Denson,1190,156,873,401,527,341,2496.0,171,47,129.0,702,354,25.9,No,2014,No,No,No
K.T. Harrell,1497,152,1099,476,440,353,3032.0,488,192,212.0,611,284,26.3,No,2014,No,No,No
Tahj Shamsid-Deen,437,129,389,150,101,74,1472.0,201,63,58.0,188,87,17.1,No,2014,No,No,No
Allen Payne,734,135,635,266,231,163,2765.0,154,39,193.0,481,227,17.5,No,2014,No,No,No
Asauhn Dixon-Tatum,299,17,220,115,104,69,1123.0,0,0,64.0,220,115,15.2,No,2014,No,No,No
Dion Wade,307,54,299,98,68,46,1338.0,221,65,44.0,78,33,14.4,No,2014,No,No,No
Malcolm Canada,285,98,233,85,145,105,1130.0,54,10,73.0,179,75,16.9,No,2014,No,No,No
Chris Griffin,83,9,82,27,26,20,309.0,34,9,25.0,48,18,20.1,No,2014,No,No,No
Matthew Atewe,268,18,204,105,113,58,1072.0,0,0,69.0,204,105,15.4,No,2014,No,No,No
Jordon Granger,366,58,288,128,86,56,1815.0,158,54,76.0,130,74,11.2,No,2014,No,No,No
Benas Griciunas,364,27,330,154,78,45,1009.0,45,11,57.0,285,143,21.2,No,2014,No,No,No
Alex Thompson,852,59,709,300,173,128,2090.0,357,124,87.0,352,176,21.2,No,2014,No,No,No
C.J. Holmes,8,0,3,3,0,0,14.0,2,2,1.0,1,1,14.6,No,2014,No,No,No
Devin Waddell,29,10,38,10,11,5,452.0,19,4,14.0,19,6,6.2,No,2014,No,No,No
Travis Betran,1008,152,789,325,231,199,2069.0,416,159,155.0,373,166,25.3,No,2014,No,No,No
Chris Horton,1719,144,1200,662,633,395,3932.0,1,0,270.0,1199,662,22.2,No,2014,No,No,No
Will Triggs,1139,154,779,412,519,315,2964.0,3,0,197.0,776,412,20.5,No,2014,No,No,No
Ed Dyson,551,89,416,183,189,125,1556.0,173,60,92.0,243,123,18.9,No,2014,No,No,No
Zavion Williams,591,185,522,207,191,137,1565.0,155,40,175.0,367,167,24.5,No,2014,No,No,No
Demarius Smith,259,180,206,90,117,66,1060.0,51,13,147.0,155,77,18.9,No,2014,No,No,No
Chris Freeman,612,46,439,246,177,120,1740.0,1,0,117.0,438,246,18.3,No,2014,No,No,No
Corey Arentsen,201,46,168,65,24,18,666.0,136,53,29.0,32,12,15.5,No,2014,No,No,No
Serigne Mboup,69,9,46,19,52,31,302.0,0,0,29.0,46,19,16.2,No,2014,No,No,No
Preston Herring,111,11,68,40,46,25,369.0,8,6,19.0,60,34,14.7,No,2014,No,No,No
Fred Garmon,40,27,44,15,14,6,309.0,18,4,24.0,26,11,11.8,No,2014,No,No,No
Thomas Greer,64,21,47,18,35,20,339.0,20,8,29.0,27,10,13.6,No,2014,No,No,No
Chris Bond,1050,143,785,392,365,245,3105.0,79,21,205.0,706,371,19.5,No,2014,No,No,No
Zavier Turner,1404,435,1017,396,503,420,3595.0,494,192,381.0,523,204,23.1,No,2014,No,No,No
Jesse Berry,1257,181,999,377,379,279,3089.0,661,224,233.0,338,153,23.9,No,2014,No,No,No
Majok Majok,645,52,442,229,338,187,1799.0,0,0,143.0,442,229,21.1,No,2014,No,No,No
Franko House,1371,261,962,493,497,352,3368.0,121,33,245.0,841,460,22.0,No,2014,No,No,No
Mark Alstork,1395,277,1087,422,507,389,3298.0,462,162,292.0,625,260,24.8,No,2014,No,No,No
Bo Calhoun,772,70,636,301,159,118,2207.0,153,52,140.0,483,249,20.4,No,2014,No,No,No
Quinten Payne,61,24,73,23,9,6,408.0,48,9,24.0,25,14,12.5,No,2014,No,No,No
Tyler Koch,267,69,240,94,58,27,1211.0,155,52,70.0,85,42,14.8,No,2014,No,No,No
Kindon Crowder,35,11,36,13,4,1,141.0,30,8,8.0,6,5,16.4,No,2014,No,No,No
Mading Thok,49,4,29,20,19,9,120.0,0,0,7.0,29,20,19.3,No,2014,No,No,No
Kaleb Mallory,19,18,24,7,10,4,142.0,8,1,9.0,16,6,14.1,No,2014,No,No,No
Chase Brogna,15,7,26,5,2,1,140.0,22,4,3.0,4,1,11.0,No,2014,No,No,No
Matt Kamieniecki,431,71,300,156,228,118,1649.0,3,1,96.0,297,155,16.2,No,2014,No,No,No
Cory Jefferson,1159,51,794,431,424,280,2589.0,50,17,101.0,744,414,21.4,Yes,2014,No,No,No
Brady Heslip,1140,102,829,359,147,121,3015.0,689,301,42.0,140,58,15.8,No,2014,No,No,No
Isaiah Austin,883,91,744,338,241,159,2111.0,155,48,135.0,589,290,23.8,No,2014,No,No,No
Kenny Chery,754,293,619,250,190,163,2008.0,258,91,152.0,361,159,22.1,No,2014,No,No,No
Royce O'Neale,1268,400,862,411,401,301,4057.0,363,145,258.0,499,266,18.1,Yes,2014,No,No,No
Rico Gathers,1208,46,879,430,583,347,3127.0,1,1,136.0,878,429,20.9,No,2014,No,No,No
Taurean Prince,1321,145,1017,468,355,255,2604.0,346,130,221.0,671,338,27.3,Yes,2014,No,No,No
Gary Franklin,513,185,483,163,101,68,2105.0,362,119,116.0,121,44,15.6,No,2014,No,No,No
Ishmail Wainright,498,259,419,175,135,89,2458.0,178,59,142.0,241,116,12.8,No,2014,No,No,No
Logan Lowery,228,27,199,86,47,34,673.0,58,22,53.0,141,64,20.5,No,2014,No,No,No
Josh Clemons,0,0,0,0,0,0,2.0,0,0,1.0,0,0,25.7,No,2014,No,No,No
John Heard,9,1,17,3,3,1,51.0,13,2,2.0,4,1,20.2,No,2014,No,No,No
J.J. Mann,1509,272,1212,524,265,227,3570.0,644,234,184.0,568,290,21.6,No,2014,No,No,No
Craig Bradshaw,1698,328,1235,591,350,267,3370.0,632,249,279.0,603,342,25.4,No,2014,No,No,No
Drew Windler,998,120,691,333,215,158,2152.0,397,174,160.0,294,159,24.1,No,2014,No,No,No
Reece Chamberlain,789,454,559,251,304,211,2787.0,211,76,219.0,348,175,17.1,No,2014,No,No,No
Evan Bradds,1921,214,1109,740,612,429,3606.0,37,12,283.0,1072,728,23.8,No,2014,No,No,No
Blake Jenkins,918,110,602,337,336,213,2381.0,99,31,156.0,503,306,19.5,No,2014,No,No,No
Caleb Chowbay,178,67,158,62,33,28,735.0,78,26,60.0,80,36,16.4,No,2014,No,No,No
Nick Smith,781,32,591,262,77,64,1546.0,485,193,51.0,106,69,22.5,No,2014,No,No,No
Chad Lang,287,1,220,121,94,45,626.0,0,0,61.0,220,121,26.2,No,2014,No,No,No
Spencer Turner,158,33,143,53,12,7,463.0,128,45,20.0,15,8,18.8,No,2014,No,No,No
Jeff Laidig,72,37,84,18,27,23,689.0,62,13,27.0,22,5,9.2,No,2014,No,No,No
Holden Mobley,77,40,56,23,29,19,683.0,33,12,35.0,23,11,7.9,No,2014,No,No,No
Clemmye Owens,985,142,888,354,147,109,2603.0,480,168,129.0,408,186,21.4,No,2014,No,No,No
Mikel Trapp,833,105,745,278,137,95,2874.0,536,182,140.0,209,96,17.8,No,2014,No,No,No
Malik Jackson,501,33,451,174,91,73,1279.0,241,80,60.0,210,94,22.7,No,2014,No,No,No
Maurice Taylor,262,19,193,75,135,99,773.0,33,13,51.0,160,62,21.4,Yes,2014,No,No,No
Tony Kynard,219,129,244,76,77,63,845.0,43,4,84.0,201,72,23.2,No,2014,No,No,No
Travis Elliott,395,39,354,150,183,95,2198.0,0,0,115.0,354,150,13.4,No,2014,No,No,No
Allan Dempster,153,4,124,62,52,29,502.0,0,0,23.0,124,62,18.0,No,2014,No,No,No
Barry Smith,169,20,147,58,71,48,581.0,18,5,38.0,129,53,20.0,No,2014,No,No,No
Daquan Brown,135,8,119,54,47,27,450.0,0,0,30.0,119,54,20.0,No,2014,No,No,No
Troy Simmons,114,105,113,34,51,39,1073.0,28,7,85.0,85,27,11.2,No,2014,No,No,No
Ricky Johnson,1161,295,959,322,467,379,3574.0,464,138,242.0,495,184,20.6,No,2014,No,No,No
Jordan Reed,1175,105,958,387,533,371,2743.0,123,30,227.0,835,357,27.2,No,2014,No,No,No
Yosef Yacob,667,145,557,198,227,167,2126.0,312,104,174.0,245,94,21.1,No,2014,No,No,No
Marlon Beck II,1034,276,946,331,251,164,3583.0,640,208,187.0,306,123,18.6,No,2014,No,No,No
Nick Madray,434,20,367,151,111,82,1429.0,150,50,77.0,217,101,18.1,No,2014,No,No,No
Roland Brown,320,22,285,125,111,70,1021.0,2,0,87.0,283,125,21.8,No,2014,No,No,No
Rayner Moquete,357,73,357,124,70,45,1479.0,200,64,75.0,157,60,16.1,No,2014,No,No,No
Karon Waller,200,32,172,59,78,56,856.0,84,26,51.0,88,33,16.1,No,2014,No,No,No
Magnus Richards,142,25,143,52,64,38,830.0,1,0,76.0,142,52,16.1,No,2014,No,No,No
Alex Ogundadegbe,234,31,216,91,85,52,1244.0,2,0,60.0,214,91,13.6,No,2014,No,No,No
Robert Mansell,526,62,462,169,207,151,1476.0,123,37,112.0,339,132,24.8,No,2014,No,No,No
John Rinaldi,88,55,69,33,40,22,808.0,5,0,39.0,64,33,8.3,No,2014,No,No,No
Matt Smith,3,2,2,1,1,1,36.0,1,0,0.0,1,1,3.6,No,2014,No,No,No
Chris Rice,18,7,26,4,11,7,172.0,18,3,13.0,8,1,13.6,No,2014,No,No,No
Jabrille Williams,92,9,86,39,14,6,589.0,31,8,28.0,55,31,11.0,No,2014,No,No,No
Anthony Drmic,1942,244,1463,634,529,399,4117.0,786,275,223.0,677,359,24.5,No,2014,No,No,No
Derrick Marks,1912,370,1417,669,580,458,3538.0,293,116,332.0,1124,553,30.6,No,2014,No,No,No
Ryan Watkins,1070,72,745,409,346,251,2651.0,3,1,122.0,742,408,20.2,No,2014,No,No,No
Mikey Thompson,1138,298,864,363,436,336,3394.0,214,76,211.0,650,287,19.8,No,2014,No,No,No
Thomas Bropleh,715,84,567,238,175,125,2038.0,302,114,91.0,265,124,18.9,No,2014,No,No,No
Jeff Elorriaga,792,177,607,255,78,61,3111.0,518,221,70.0,89,34,12.0,No,2014,No,No,No
Nick Duncan,1141,155,894,362,224,167,3587.0,683,250,147.0,211,112,16.6,No,2014,No,No,No
Igor Hadziomerovic,511,219,456,184,161,100,2365.0,140,43,150.0,316,141,15.5,No,2014,No,No,No
Dezmyn Trent,91,4,85,32,25,13,215.0,41,14,16.0,44,18,28.4,No,2014,No,No,No
Edmunds Dukulis,13,1,12,6,6,1,47.0,0,0,2.0,12,6,18.8,No,2014,No,No,No
Joe Hanstad,145,42,118,47,33,25,727.0,82,26,30.0,36,21,12.1,No,2014,No,No,No
Joey Nebeker,11,2,14,3,6,4,28.0,8,1,4.0,6,2,38.9,No,2014,No,No,No
Jake Ness,12,3,9,2,10,8,188.0,2,0,5.0,7,2,5.4,No,2014,No,No,No
Olivier Hanlan,1727,303,1247,565,541,421,3493.0,487,176,236.0,760,389,27.9,No,2014,No,No,No
Ryan Anderson,1787,151,1295,630,706,495,3906.0,120,32,235.0,1175,598,25.9,Yes,2014,No,No,No
Joe Rahon,1277,607,1086,454,285,194,4773.0,491,175,248.0,595,279,17.3,No,2014,No,No,No
Lonnie Jackson,960,214,751,293,186,145,3203.0,598,229,167.0,153,64,17.2,No,2014,No,No,No
Patrick Heckmann,903,197,632,290,281,214,2691.0,320,109,194.0,312,181,19.9,No,2014,No,No,No
Eddie Odio,351,70,288,131,92,57,1856.0,109,32,75.0,179,99,12.3,No,2014,No,No,No
Garland Owens,427,94,355,168,104,63,1984.0,92,28,93.0,263,140,13.6,No,2014,No,No,No
Alex Dragicevich,362,66,295,116,90,64,1272.0,193,66,51.0,102,50,17.1,No,2014,No,No,No
Will Magarity,586,72,468,228,108,74,2013.0,186,56,112.0,282,172,16.9,No,2014,No,No,No
Kyle Caudill,277,45,200,99,111,78,858.0,10,1,81.0,190,98,20.3,No,2014,No,No,No
Danny Rubin,176,26,159,58,15,10,832.0,128,50,27.0,31,8,12.7,No,2014,No,No,No
Dennis Clifford,889,118,669,336,320,209,2934.0,31,8,212.0,638,328,19.4,No,2014,No,No,No
Sam Donahue,5,2,14,2,0,0,21.0,12,1,0.0,2,1,37.8,No,2014,No,No,No
John Cain Carney,17,5,22,8,3,0,240.0,4,1,8.0,18,7,7.3,No,2014,No,No,No
Steve Perpiglia,9,7,15,4,1,0,66.0,8,1,8.0,7,3,19.5,No,2014,No,No,No
Drew Jacobs,2,0,3,1,0,0,24.0,1,0,3.0,2,1,13.9,No,2014,No,No,No
Maurice Watson Jr.,1537,800,1220,590,387,270,3643.0,255,87,378.0,965,503,25.2,No,2014,No,No,No
D.J. Irving,1456,469,1146,458,475,370,4126.0,472,170,287.0,674,288,21.5,No,2014,No,No,No
Dom Morris,1139,94,856,439,312,220,3410.0,114,41,182.0,742,398,18.6,No,2014,No,No,No
John Papale,1289,249,1058,447,138,108,4315.0,712,287,106.0,346,160,15.2,No,2014,No,No,No
Cedric Hankerson,1299,162,990,387,449,290,3079.0,649,235,162.0,341,152,23.4,No,2014,No,No,No
Malik Thomas,838,152,739,312,195,129,2610.0,267,85,160.0,472,227,20.2,No,2014,No,No,No
Travis Robinson,592,91,520,202,102,66,2269.0,344,122,107.0,176,80,15.9,No,2014,No,No,No
Nathan Dieudonne,863,136,651,312,299,196,2888.0,155,43,199.0,496,269,18.3,No,2014,No,No,No
Justin Alston,811,67,594,333,205,145,2075.0,2,0,133.0,592,333,20.8,No,2014,No,No,No
Dylan Haines,133,20,136,54,22,11,563.0,51,14,44.0,85,40,17.4,No,2014,No,No,No
Cameron Curry,22,22,24,6,6,6,188.0,19,4,9.0,5,2,10.2,No,2014,No,No,No
Dylan Brossman,12,4,15,3,4,4,84.0,12,2,4.0,3,1,20.5,No,2014,No,No,No
Braiten Madrigal,3,0,5,1,0,0,22.0,5,1,0.0,0,0,12.3,No,2014,No,No,No
James Kennedy,31,4,35,15,7,1,241.0,2,0,15.0,33,15,11.9,No,2014,No,No,No
Richaun Holmes,1089,62,728,403,363,253,2518.0,85,30,143.0,643,373,21.8,Yes,2014,No,No,No
Spencer Parker,1160,135,882,395,438,312,3015.0,193,58,233.0,689,337,22.6,No,2014,No,No,No
Jehvon Clarke,888,261,854,328,179,134,2423.0,313,98,227.0,541,230,25.2,No,2014,No,No,No
Anthony Henderson,736,123,630,261,167,104,2451.0,304,110,83.0,326,151,17.0,No,2014,No,No,No
Cameron Black,590,86,516,266,121,58,2690.0,0,0,118.0,516,266,13.4,No,2014,No,No,No
J.D. Tisdale,175,67,174,60,98,52,980.0,29,3,95.0,145,57,16.5,No,2014,No,No,No
Craig Sealey,321,25,297,125,128,68,1068.0,13,3,70.0,284,122,21.0,No,2014,No,No,No
Damarkeo Lyshe,62,14,59,19,20,13,241.0,36,11,11.0,23,8,17.1,No,2014,No,No,No
Josh Gomez,95,7,89,40,23,12,409.0,9,3,28.0,80,37,16.2,No,2014,No,No,No
Chauncey Orr,305,63,233,104,83,65,1108.0,90,32,58.0,143,72,15.9,No,2014,No,No,No
Zack Denny,1070,94,918,378,220,169,2699.0,399,145,124.0,519,233,21.4,No,2014,No,No,No
Shaun Joplin,0,0,0,0,0,0,0.0,0,0,0.0,0,0,0,No,2014,No,No,No
Walt Lemon,1721,367,1422,628,502,361,3935.0,324,104,404.0,1098,524,27.6,No,2014,No,No,No
Tyshon Pickett,773,75,631,300,208,157,1985.0,51,16,103.0,580,284,22.1,No,2014,No,No,No
Omari Grier,964,94,796,302,237,195,2533.0,466,165,106.0,330,137,21.1,No,2014,No,No,No
Auston Barnes,607,69,498,205,143,120,2239.0,221,77,93.0,277,128,16.0,No,2014,No,No,No
Ka'Darryl Bell,478,128,441,155,176,120,2060.0,154,48,172.0,287,107,18.2,No,2014,No,No,No
Xzavier Taylor,622,52,463,239,238,139,1954.0,13,5,127.0,450,234,17.9,No,2014,No,No,No
Jordan Prosser,684,37,566,279,213,126,2598.0,0,0,113.0,566,279,15.8,No,2014,No,No,No
Jordan Swopshire,1078,110,815,342,240,180,2622.0,542,214,158.0,273,128,22.1,No,2014,No,No,No
Chris Blake,31,3,24,10,23,11,303.0,0,0,14.0,24,10,8.6,No,2014,No,No,No
Mason Alwan,33,5,24,12,7,5,163.0,9,4,9.0,15,8,11.9,No,2014,No,No,No
Stefan Zecevic,12,2,12,5,10,2,78.0,1,0,8.0,11,5,16.9,No,2014,No,No,No
Anthony Fields,222,127,209,83,62,41,1229.0,56,15,90.0,153,68,14.8,No,2014,No,No,No
Darrion Harris,9,3,7,3,4,2,35.0,1,1,2.0,6,2,16.5,No,2014,No,No,No
Nate Wells,136,16,128,56,40,21,633.0,14,3,27.0,114,53,14.9,No,2014,No,No,No
Tyler Haws,2720,257,1916,917,820,724,4427.0,427,162,244.0,1489,755,27.6,No,2014,No,No,No
Matt Carlino,1620,525,1397,557,359,266,3604.0,666,240,307.0,731,317,25.4,No,2014,No,No,No
Kyle Collinsworth,1707,703,1293,617,690,443,4330.0,107,30,367.0,1186,587,21.7,Yes,2014,No,No,No
Eric Mika,1080,88,705,372,475,336,1816.0,1,0,133.0,704,372,27.1,No,2014,No,No,No
Skyler Halford,545,113,389,178,125,108,1152.0,201,81,80.0,188,97,21.8,No,2014,No,No,No
Anson Winder,808,170,582,267,248,174,2126.0,283,100,91.0,299,167,17.8,No,2014,No,No,No
Nate Austin,529,100,388,205,178,106,2780.0,49,13,99.0,339,192,9.7,No,2014,No,No,No
Frank Bartley,1304,214,962,409,426,312,2758.0,477,174,163.0,485,235,22.5,No,2014,No,No,No
Josh Sharp,250,63,168,93,90,59,1379.0,17,5,45.0,151,88,8.9,No,2014,No,No,No
Luke Worthington,331,36,258,123,146,85,1516.0,0,0,61.0,258,123,13.0,No,2014,No,No,No
Andrew Johnston,4,1,3,1,4,1,17.0,3,1,2.0,0,0,18.8,No,2014,No,No,No
Graham Pingree,0,0,1,0,0,0,10.0,0,0,0.0,1,0,4.6,No,2014,No,No,No
Sean McGonagill,1618,522,1363,538,387,293,4110.0,683,249,327.0,680,289,23.8,No,2014,No,No,No
Leland King,1135,120,956,439,223,155,2281.0,298,102,141.0,658,337,26.6,No,2014,No,No,No
Cedric Kuakumensah,1181,119,1007,439,368,245,3135.0,150,58,229.0,857,381,22.9,No,2014,No,No,No
Steven Spieth,1367,337,901,406,527,447,3835.0,313,108,280.0,588,298,18.6,No,2014,No,No,No
Rafael Maia,865,131,622,313,425,228,2661.0,37,11,184.0,585,302,19.6,No,2014,No,No,No
Tavon Blackmon,1166,465,957,388,400,297,3468.0,247,93,310.0,710,295,21.0,No,2014,No,No,No
Dockery Walker,568,35,459,234,202,99,1493.0,5,1,114.0,454,233,23.1,No,2014,No,No,No
JR Hobbie,907,53,653,275,111,100,2425.0,599,257,70.0,54,18,16.0,No,2014,No,No,No
Matty Madigan,30,19,33,9,13,8,296.0,15,4,14.0,18,5,8.9,No,2014,No,No,No
Josh Biber,41,13,37,13,32,15,253.0,3,0,11.0,34,13,13.2,No,2014,No,No,No
Aram Martin,33,7,46,13,8,6,186.0,16,1,15.0,30,12,17.3,No,2014,No,No,No
Longi Yiljep,45,10,41,15,20,11,306.0,16,4,20.0,25,11,12.3,No,2014,No,No,No
Alex Francis,2085,172,1457,791,815,490,4141.0,53,13,457.0,1404,778,28.9,No,2014,No,No,No
Dyami Starks,1779,162,1464,600,319,279,3545.0,807,300,204.0,657,300,27.0,No,2014,No,No,No
Corey Maynard,1050,379,854,370,224,172,3406.0,417,138,211.0,437,232,17.9,No,2014,No,No,No
Joe O'Shea,865,161,602,273,294,225,2846.0,274,94,109.0,328,179,15.7,No,2014,No,No,No
Dan Garvin,895,96,749,373,245,142,2684.0,38,7,169.0,711,366,20.1,No,2014,No,No,No
Shane McLaughlin,627,436,526,216,207,136,3313.0,165,59,249.0,361,157,13.8,No,2014,No,No,No
Curtis Oakley,352,49,342,127,71,44,1140.0,184,54,56.0,158,73,19.7,No,2014,No,No,No
Bosko Kostur,890,75,646,294,237,188,2217.0,287,114,146.0,359,180,20.7,No,2014,No,No,No
Claybrin McMath,278,35,304,114,41,23,1252.0,122,27,60.0,182,87,16.3,No,2014,No,No,No
Declan Soukup,23,11,21,6,11,9,98.0,10,2,8.0,11,4,18.0,No,2014,No,No,No
Justin Brickman,40,30,39,13,15,11,221.0,10,3,24.0,29,10,16.2,No,2014,No,No,No
Ellis Williams,8,3,8,3,5,2,121.0,0,0,7.0,8,3,7.5,No,2014,No,No,No
Tim McKinney,7,0,6,2,4,3,31.0,2,0,2.0,4,2,16.5,No,2014,No,No,No
Andrew Scocca,84,25,64,27,45,30,547.0,1,0,26.0,63,27,10.9,No,2014,No,No,No
Cameron Ayers,1526,220,1205,530,319,265,3985.0,488,201,144.0,717,329,20.7,No,2014,No,No,No
Chris Hass,1402,104,1076,460,351,292,2753.0,511,190,146.0,565,270,26.4,No,2014,No,No,No
Brian Fitzpatrick,530,49,373,206,152,111,1589.0,16,7,98.0,357,199,18.7,No,2014,No,No,No
Steven Kaspar,532,413,442,181,252,144,2610.0,90,26,205.0,352,155,16.1,No,2014,No,No,No
Ben Brackney,342,28,268,109,59,52,1065.0,163,72,40.0,105,37,17.3,No,2014,No,No,No
Dom Hoffman,543,97,475,220,110,80,1731.0,63,23,88.0,412,197,18.8,No,2014,No,No,No
Ryan Frazier,656,174,520,190,266,202,2677.0,234,74,111.0,286,116,14.9,No,2014,No,No,No
John Azzinaro,459,77,439,155,68,46,1485.0,273,103,70.0,166,52,19.2,No,2014,No,No,No
Ryan Hill,250,166,209,77,130,84,1729.0,38,12,126.0,171,65,12.6,No,2014,No,No,No
Cory Starkey,179,46,150,74,50,31,828.0,0,0,52.0,150,74,14.8,No,2014,No,No,No
D.J. MacLeay,388,48,291,149,126,80,1150.0,34,10,92.0,257,139,19.8,No,2014,No,No,No
Joshea Singleton,223,26,184,71,100,65,670.0,58,16,59.0,126,55,22.6,No,2014,No,No,No
Ben Oberfeld,68,2,54,26,26,16,264.0,0,0,10.0,54,26,15.2,No,2014,No,No,No
Matt Banas,12,2,12,5,5,2,68.0,1,0,2.0,11,5,12.0,No,2014,No,No,No
Javon McCrea,2004,249,1386,798,653,407,3473.0,4,1,309.0,1382,797,29.4,No,2014,No,No,No
Josh Freelove,948,79,818,364,117,88,2243.0,363,132,110.0,455,232,22.6,No,2014,No,No,No
Will Regan,907,73,683,305,243,186,2669.0,304,111,107.0,379,194,17.3,No,2014,No,No,No
Shannon Evans,1777,504,1408,553,494,406,4201.0,738,265,259.0,670,288,22.3,No,2014,No,No,No
Jarod Oldham,562,409,497,182,234,156,2558.0,168,42,235.0,329,140,16.6,No,2014,No,No,No
Jarryn Skeete,912,247,858,292,192,143,3320.0,549,185,170.0,309,107,16.8,No,2014,No,No,No
Xavier Ford,533,42,428,190,217,134,1474.0,56,19,113.0,372,171,21.9,No,2014,No,No,No
Justin Moss,688,24,462,244,290,200,1255.0,4,0,92.0,458,244,27.2,No,2014,No,No,No
Deyshonee Much,1008,185,829,345,142,109,2579.0,521,209,143.0,308,136,19.8,No,2014,No,No,No
Auraum Nuiriankh,325,98,313,101,102,74,1525.0,186,49,104.0,127,52,15.7,No,2014,No,No,No
Corey Raley-Ross,85,33,93,33,30,16,398.0,19,3,41.0,74,30,19.0,No,2014,No,No,No
Kellen Dunham,1946,173,1457,598,537,451,4280.0,776,299,203.0,681,299,23.3,No,2014,No,No,No
Khyle Marshall,1373,52,1055,572,437,227,3001.0,19,2,123.0,1036,570,24.4,No,2014,No,No,No
Kameron Woods,804,148,623,289,329,214,3315.0,65,12,188.0,558,277,15.4,No,2014,No,No,No
Alex Barlow,596,274,497,194,132,105,2931.0,290,103,146.0,207,91,12.7,No,2014,No,No,No
Elijah Brown,1969,322,1469,585,609,520,3685.0,793,279,308.0,676,306,28.1,No,2014,No,No,No
Andrew Chrabascz,1271,254,934,441,429,312,3568.0,212,77,149.0,722,364,18.8,No,2014,No,No,No
Erik Fromm,455,20,428,163,117,73,1547.0,196,56,77.0,232,107,19.1,No,2014,No,No,No
Jackson Aldridge,213,63,203,63,92,63,912.0,94,24,78.0,109,39,18.6,No,2014,No,No,No
Rene Castro,715,184,585,253,178,127,1809.0,250,82,109.0,335,171,21.6,No,2014,No,No,No
Nolan Berry,126,8,81,39,46,38,265.0,29,10,18.0,52,29,24.3,No,2014,No,No,No
Devontae Morgan,83,25,65,30,52,21,317.0,8,2,14.0,57,28,17.1,No,2014,No,No,No
Michael Volovic,11,1,6,4,3,2,10.0,3,1,0.0,3,3,39.8,No,2014,No,No,No
Steven Bennett,29,8,28,10,1,0,112.0,24,9,6.0,4,1,15.9,No,2014,No,No,No
Elliott Kampen,6,1,6,1,4,3,72.0,5,1,3.0,1,0,7.9,No,2014,No,No,No
Chris Eversley,1218,143,1037,444,348,244,2761.0,290,86,139.0,747,358,27.1,No,2014,No,No,No
David Nwaba,1047,180,788,373,457,297,2291.0,24,4,141.0,764,369,26.9,Yes,2014,No,No,No
Kyle Odister,764,128,691,266,75,56,2059.0,454,176,97.0,237,90,21.7,No,2014,No,No,No
Brian Bennett,1108,91,973,491,208,126,2849.0,5,0,110.0,968,491,22.8,No,2014,No,No,No
Jamal Johnson,444,300,390,134,186,129,2372.0,144,47,145.0,246,87,14.7,No,2014,No,No,No
Ridge Shipley,861,287,756,280,219,154,2840.0,442,147,152.0,314,133,19.1,No,2014,No,No,No
Joel Awich,673,66,625,248,164,120,2280.0,191,57,118.0,434,191,19.5,No,2014,No,No,No
Maliik Love,511,210,445,188,203,120,2567.0,49,15,133.0,396,173,14.6,No,2014,No,No,No
Anthony Silvestri,111,4,132,37,14,8,504.0,117,29,11.0,15,8,16.6,No,2014,No,No,No
Michael Bolden,203,32,204,69,27,18,1012.0,141,47,17.0,63,22,12.9,No,2014,No,No,No
Taylor Sutlive,251,47,207,88,12,9,848.0,165,66,24.0,42,22,14.5,No,2014,No,No,No
Zach Gordon,327,17,240,110,179,107,1529.0,2,0,74.0,238,110,13.9,No,2014,No,No,No
Reese Morgan,814,119,577,206,286,248,2017.0,426,154,65.0,151,52,20.9,No,2014,No,No,No
Max Betkowski,0,0,1,0,2,0,12.0,1,0,1.0,0,0,13.7,No,2014,No,No,No
Markel Leonard,0,0,4,0,0,0,11.0,3,0,1.0,1,0,25.3,No,2014,No,No,No
Issiah Grayson,869,307,596,276,262,209,2071.0,248,108,212.0,348,168,23.2,No,2014,No,No,No
Brandon Barnes,856,105,705,311,291,180,2273.0,168,54,173.0,537,257,22.4,No,2014,No,No,No
Javonte Maynor,1065,107,904,343,163,108,3330.0,720,271,111.0,184,72,17.2,No,2014,No,No,No
Aly Ahmed,1075,94,852,409,364,254,2411.0,9,3,193.0,843,406,26.3,No,2014,No,No,No
Stefon Johnson,857,105,754,360,211,124,2968.0,43,13,166.0,711,347,17.4,No,2014,No,No,No
Tyrell Corbin,529,229,430,151,241,189,1883.0,131,38,204.0,299,113,21.2,No,2014,No,No,No
Erik Kinney,164,30,139,49,100,66,765.0,9,0,58.0,130,49,16.4,No,2014,No,No,No
Corey Hall,224,15,175,80,82,52,830.0,36,12,60.0,139,68,16.8,No,2014,No,No,No
Abdul Ahmed,202,32,205,72,42,29,792.0,93,29,48.0,112,43,18.4,No,2014,No,No,No
Zach Lamb,424,70,344,156,94,70,1021.0,111,42,81.0,233,114,23.7,No,2014,No,No,No
Kregg Jones,157,5,124,65,63,27,690.0,0,0,40.0,124,65,14.6,No,2014,No,No,No
Zech Smith,173,4,134,72,63,29,817.0,0,0,38.0,134,72,12.4,No,2014,No,No,No
Matt Ratto,62,8,48,18,11,10,179.0,43,16,9.0,5,2,17.7,No,2014,No,No,No
Dee Wallace,9,0,12,3,0,0,27.0,12,3,0.0,0,0,23.2,No,2014,No,No,No
Michael Williams,1526,219,1270,528,340,243,3558.0,616,227,204.0,654,301,23.4,No,2014,No,No,No
Alex Harris,1387,307,1120,457,465,318,3519.0,500,155,211.0,620,302,23.1,No,2014,No,No,No
Marquis Horne,282,31,255,107,61,42,779.0,78,26,50.0,177,81,22.1,No,2014,No,No,No
Josh Gentry,425,73,318,140,142,113,1442.0,107,32,81.0,211,108,16.9,No,2014,No,No,No
Steve McClellan,721,68,544,288,211,141,2552.0,7,4,150.0,537,284,16.5,No,2014,No,No,No
Sheldon Blackwell,230,110,213,85,97,52,1366.0,37,8,67.0,176,77,12.4,No,2014,No,No,No
Jared Brandon,310,69,269,125,78,51,1247.0,43,9,61.0,226,116,15.1,No,2014,No,No,No
Chris Collins,120,41,107,41,74,38,602.0,5,0,40.0,102,41,15.5,No,2014,No,No,No
Joe Boyd,141,15,128,51,49,39,860.0,2,0,41.0,126,51,11.7,No,2014,No,No,No
James Johnson,306,10,206,123,98,60,1186.0,0,0,47.0,206,123,12.8,Yes,2014,No,No,No
Floris Versteeg,20,0,21,6,6,4,106.0,17,4,5.0,4,2,14.1,No,2014,No,No,No
Ian Spruce,9,0,7,3,0,0,9.0,7,3,0.0,0,0,40.2,No,2014,No,No,No
Stephen Maxwell,1748,67,1199,635,657,478,3704.0,0,0,219.0,1199,635,23.3,No,2014,No,No,No
Stephan Hicks,1959,137,1338,651,737,599,3938.0,185,58,227.0,1153,593,24.1,No,2014,No,No,No
Josh Greene,1549,360,1167,455,472,411,3594.0,590,228,240.0,577,227,22.1,No,2014,No,No,No
Tre Hale-Edmerson,813,303,682,325,177,128,3522.0,128,35,232.0,554,290,14.1,No,2014,No,No,No
Aaron Parks,1100,205,875,327,556,418,2889.0,111,28,202.0,764,299,23.2,No,2014,No,No,No
Landon Drew,585,393,545,208,109,79,2525.0,249,90,193.0,296,118,15.6,No,2014,No,No,No
Ben Vozzola,99,33,99,36,8,8,326.0,53,19,31.0,46,17,20.7,No,2014,No,No,No
Trevone Williams,269,54,273,110,34,25,918.0,92,24,50.0,181,86,17.7,No,2014,No,No,No
J.J. Thomas,568,62,461,200,207,142,1437.0,76,26,130.0,385,174,23.4,No,2014,No,No,No
Dominique Youmans,5,3,10,2,2,1,136.0,0,0,10.0,10,2,7.8,No,2014,No,No,No
Robert Cid,10,0,9,2,6,5,24.0,4,1,2.0,5,1,30.1,No,2014,No,No,No
Kevin Rutledge,0,0,1,0,0,0,1.0,0,0,0.0,1,0,50.4,No,2014,No,No,No
Corey Hawkins,1743,297,1200,561,555,445,3095.0,434,176,226.0,766,385,29.7,No,2014,No,No,No
Ryan Sypkens,1275,203,1038,435,117,90,3240.0,750,315,202.0,288,120,21.1,No,2014,No,No,No
Georgi Funtarov,269,26,246,103,57,28,825.0,122,35,47.0,124,68,20.5,No,2014,No,No,No
Darius Graham,923,418,758,299,281,200,3834.0,339,125,315.0,419,174,16.7,No,2014,No,No,No
Brynton Lemar,1170,214,957,380,356,262,3147.0,394,148,190.0,563,232,21.8,No,2014,No,No,No
Iggy Nujic,391,50,331,133,120,88,1222.0,116,37,84.0,215,96,20.2,No,2014,No,No,No
Josh Ritchart,1333,116,1003,473,224,153,3014.0,568,234,168.0,435,239,22.9,No,2014,No,No,No
Clint Bozner,193,17,136,74,76,45,655.0,1,0,60.0,135,74,18.9,No,2014,No,No,No
Avery Johnson,427,127,356,142,107,80,2297.0,182,63,105.0,174,79,12.0,Yes,2014,No,No,No
Justin Dueck,20,4,16,8,12,4,272.0,0,0,10.0,16,8,6.3,No,2014,No,No,No
Olivier-Paul Betu,38,30,32,13,19,10,376.0,14,2,30.0,18,11,10.1,No,2014,No,No,No
Carlos Mancasola,0,1,3,0,0,0,6.0,3,0,0.0,0,0,26.8,No,2014,No,No,No
Luke Nelson,1531,414,1242,514,322,245,3480.0,709,258,264.0,533,256,25.0,No,2014,No,No,No
Chris McNealy,1207,277,1062,439,278,198,3480.0,355,131,177.0,707,308,19.9,Yes,2014,No,No,No
Will Davis II,1384,90,1083,593,306,198,3406.0,2,0,206.0,1081,593,21.9,No,2014,No,No,No
Alex Young,1324,576,1143,466,355,262,4060.0,396,130,233.0,747,336,19.9,No,2014,No,No,No
Mamadou Ndiaye,878,33,509,344,348,190,1869.0,1,0,163.0,508,344,23.5,No,2014,No,No,No
John Ryan,357,76,269,146,117,65,1240.0,0,0,91.0,269,146,17.7,No,2014,No,No,No
Aaron Wright,508,235,397,154,254,159,2151.0,122,41,193.0,275,113,17.2,No,2014,No,No,No
Dominique Dunning,369,84,293,132,144,88,1456.0,48,17,66.0,245,115,15.5,No,2014,No,No,No
Travis Souza,540,122,398,163,89,72,1945.0,342,142,61.0,56,21,13.6,No,2014,No,No,No
Mike Best,760,59,687,314,165,120,2090.0,51,12,117.0,636,302,21.9,No,2014,No,No,No
Ioannis Dimakopoulos,766,84,642,312,150,100,1795.0,122,42,117.0,520,270,24.1,No,2014,No,No,No
Jaron Martin,1062,226,890,370,165,132,2540.0,454,190,138.0,436,180,22.7,No,2014,No,No,No
Ege Mala,14,3,13,5,4,3,45.0,3,1,2.0,10,4,19.6,No,2014,No,No,No
Reed McConnell,28,7,29,10,4,3,110.0,15,5,3.0,14,5,16.3,No,2014,No,No,No
Chris Patton,783,81,602,319,217,145,1605.0,2,0,149.0,600,319,27.7,No,2014,No,No,No
Sam Finley,460,32,359,141,196,149,883.0,113,29,64.0,246,112,29.6,No,2014,No,No,No
Taylor Johns,1383,163,1043,509,538,344,3229.0,86,21,299.0,957,488,25.7,No,2014,No,No,No
Steven Thornton,580,63,452,183,182,136,1864.0,233,78,78.0,219,105,17.2,No,2014,No,No,No
Nick Gruninger,373,176,296,118,103,92,1371.0,128,45,92.0,168,73,16.6,No,2014,No,No,No
Austin Quick,478,202,440,158,121,83,2074.0,260,79,162.0,180,79,16.7,No,2014,No,No,No
Steven Jones,376,184,393,144,92,49,1970.0,143,39,112.0,250,105,14.4,No,2014,No,No,No
Lucas Devenny,213,48,169,86,89,41,1348.0,0,0,51.0,169,86,10.2,No,2014,No,No,No
Chris Harriel,916,141,859,307,305,193,2614.0,383,109,164.0,476,198,22.9,No,2014,No,No,No
Colin Gruber,155,22,175,53,29,26,649.0,85,23,34.0,90,30,17.7,No,2014,No,No,No
Tre Owens,59,8,71,19,6,4,239.0,60,17,6.0,11,2,17.6,No,2014,No,No,No
Kristopher Acevedo,4,0,5,2,0,0,8.0,2,0,0.0,3,2,32.6,No,2014,No,No,No
Alan Williams,1732,117,1295,637,649,458,3026.0,3,0,196.0,1292,637,32.0,Yes,2014,No,No,No
Michael Bryson,1620,219,1243,561,316,257,3758.0,651,241,253.0,592,320,23.2,No,2014,No,No,No
Kyle Boswell,975,181,679,297,223,165,2633.0,505,216,118.0,174,81,18.4,No,2014,No,No,No
Zalmico Harmon,427,261,341,124,168,131,1906.0,135,48,82.0,206,76,14.4,No,2014,No,No,No
Taran Brown,561,105,524,203,81,59,1721.0,307,96,97.0,217,107,20.6,No,2014,No,No,No
Eric Childress,734,407,637,253,186,133,3020.0,258,95,236.0,379,158,16.6,No,2014,No,No,No
Mitch Brewe,458,52,353,170,136,97,1684.0,58,21,61.0,295,149,15.1,No,2014,No,No,No
Sam Beeler,454,29,315,193,146,68,1572.0,0,0,92.0,315,193,16.0,No,2014,No,No,No
Shawn Moore,88,27,67,40,12,6,520.0,9,2,21.0,58,38,9.7,No,2014,No,No,No
Aamahd Walker,22,2,21,8,9,5,73.0,5,1,5.0,16,7,22.5,No,2014,No,No,No
John Green,663,89,573,252,153,104,1441.0,155,55,103.0,418,197,27.5,No,2014,No,No,No
Hunter Ford,34,7,21,12,2,1,77.0,18,9,2.0,3,3,17.0,No,2014,No,No,No
Logan Louks,4,0,3,2,0,0,4.0,0,0,0.0,3,2,41.0,No,2014,No,No,No
Duke DaRe,27,30,47,9,7,5,316.0,32,4,27.0,15,5,13.0,No,2014,No,No,No
Justin Cobbs,1539,575,1157,524,491,404,3839.0,256,87,278.0,901,437,22.6,No,2014,No,No,No
David Kravish,1266,127,1065,554,213,152,3943.0,22,6,158.0,1043,548,17.6,No,2014,No,No,No
Tyrone Wallace,1623,436,1417,588,537,329,4074.0,404,118,279.0,1013,470,24.9,Yes,2014,No,No,No
Richard Solomon,885,81,642,329,385,220,2457.0,28,7,143.0,614,322,20.4,No,2014,No,No,No
Jordan Mathews,1617,170,1226,513,395,305,3799.0,699,286,145.0,527,227,21.0,No,2014,No,No,No
Jabari Bird,1227,132,1018,450,186,140,3013.0,504,187,137.0,514,263,21.3,Yes,2014,No,No,No
Rick Kreklow,467,124,386,146,124,87,1819.0,258,88,106.0,128,58,15.8,No,2014,No,No,No
Jeff Powers,169,19,141,56,28,20,498.0,94,37,20.0,47,19,18.1,No,2014,No,No,No
Sam Singer,469,292,439,184,124,63,2451.0,138,38,147.0,301,146,13.6,No,2014,No,No,No
Kameron Rooks,354,31,243,134,152,86,1468.0,0,0,56.0,243,134,12.8,No,2014,No,No,No
Christian Behrens,176,13,145,69,72,38,772.0,0,0,28.0,145,69,14.2,No,2014,No,No,No
Garrett Galvin,4,0,4,2,2,0,26.0,0,0,2.0,4,2,13.9,No,2014,No,No,No
Roger Moute a Bidias,161,29,147,45,79,54,914.0,60,17,41.0,87,28,12.8,No,2014,No,No,No
Reco McCarter,953,183,744,335,320,206,2461.0,287,77,239.0,457,258,24.5,No,2014,No,No,No
Darius Leonard,752,70,674,306,111,67,2177.0,214,73,83.0,460,233,19.2,No,2014,No,No,No
Andrew Ryan,1041,227,834,361,164,120,3333.0,512,199,134.0,322,162,16.6,No,2014,No,No,No
Kyre' Hamer,937,217,649,325,291,212,2933.0,205,75,222.0,444,250,18.3,No,2014,No,No,No
D.J. Mason,932,148,755,371,254,145,2091.0,131,45,136.0,624,326,25.7,No,2014,No,No,No
Leek Leek,345,50,292,116,73,57,1250.0,139,56,58.0,153,60,16.1,No,2014,No,No,No
Luke Moyer,237,46,174,76,32,23,641.0,135,62,45.0,39,14,19.7,No,2014,No,No,No
Antwon Oliver,236,48,219,91,49,30,958.0,104,24,53.0,115,67,16.1,No,2014,No,No,No
Quinton Ray,205,199,231,74,63,41,2069.0,91,16,120.0,140,58,9.8,No,2014,No,No,No
Marvelle Harris,650,77,539,266,215,117,2443.0,5,1,147.0,534,265,16.5,No,2014,No,No,No
Jordan Faciane,23,12,22,8,5,4,66.0,13,3,4.0,9,5,22.9,No,2014,No,No,No
Casey Perrin,40,6,33,12,6,6,77.0,28,10,5.0,5,2,27.6,No,2014,No,No,No
Antonio Kalpic,63,6,45,25,18,13,306.0,0,0,21.0,45,25,12.3,No,2014,No,No,No
Lance Brown,4,2,7,0,6,4,25.0,3,0,3.0,4,0,28.0,No,2014,No,No,No
Jacob Talbert,15,6,20,6,4,3,52.0,10,0,6.0,10,6,28.4,No,2014,No,No,No
Billy Baron,1716,416,1214,533,513,436,3342.0,558,214,246.0,656,319,25.8,No,2014,No,No,No
Chris Perez,1468,188,1171,547,426,283,3514.0,264,91,240.0,907,456,22.9,No,2014,No,No,No
Jordan Heath,642,53,456,243,167,83,1779.0,184,73,63.0,272,170,17.1,No,2014,No,No,No
Zach Lewis,1292,273,1168,426,276,212,3600.0,687,228,161.0,481,198,20.5,No,2014,No,No,No
Chris Manhertz,758,61,545,268,309,222,2694.0,2,0,152.0,543,268,15.8,No,2014,No,No,No
Dominique Raney,188,21,168,71,41,30,529.0,58,16,27.0,110,55,20.5,No,2014,No,No,No
Phil Valenti,1353,236,1047,502,334,253,3288.0,273,96,201.0,774,406,21.3,No,2014,No,No,No
Josiah Heath,638,80,520,252,218,134,2442.0,6,0,97.0,514,252,15.2,No,2014,No,No,No
Jeremiah Williams,305,76,261,102,64,53,917.0,131,48,71.0,130,54,20.6,No,2014,No,No,No
Kevin Bleeker,475,81,410,178,112,81,1854.0,124,38,105.0,286,140,15.5,No,2014,No,No,No
Kassius Robertson,1773,255,1278,563,418,329,4074.0,771,318,232.0,507,245,21.1,No,2014,No,No,No
LaQuentin Miles,1354,226,1127,512,562,311,2412.0,68,19,270.0,1059,493,32.0,No,2014,No,No,No
DeShone McClure,549,131,473,207,105,60,1499.0,219,75,84.0,254,132,18.8,No,2014,No,No,No
Jalen Jackson,841,130,663,322,199,141,1826.0,122,56,155.0,541,266,25.8,No,2014,No,No,No
Aubrey Ball,152,19,127,48,34,23,347.0,79,33,18.0,48,15,21.7,No,2014,No,No,No
Phabian Glasco,152,20,111,64,53,24,608.0,1,0,21.0,110,64,12.1,No,2014,No,No,No
Daouda Berete,255,92,230,85,95,71,1050.0,42,14,75.0,188,71,15.5,No,2014,No,No,No
Ethan Lee,415,57,325,154,190,107,1602.0,7,0,93.0,318,154,15.2,No,2014,No,No,No
Terrell Brown,190,24,145,85,29,20,605.0,0,0,46.0,145,85,15.7,No,2014,No,No,No
DuShaun Rice,121,44,108,37,40,29,476.0,58,18,28.0,50,19,15.2,No,2014,No,No,No
Lenell Brown,198,67,198,75,41,20,958.0,98,28,78.0,100,47,14.3,No,2014,No,No,No
Oliver Wells,181,78,167,67,45,30,908.0,49,17,55.0,118,50,12.3,No,2014,No,No,No
Ryan Williams,423,142,466,145,115,80,1536.0,182,53,138.0,284,92,19.9,No,2014,No,No,No
Chasen Wiilliamson,21,6,24,6,13,8,106.0,9,1,4.0,15,5,15.1,No,2014,No,No,No
Jeff Drew,15,2,21,7,0,0,105.0,1,1,11.0,20,6,14.3,No,2014,No,No,No
Terry Tidwell,168,10,125,70,60,28,565.0,1,0,52.0,124,70,17.0,No,2014,No,No,No
Sean Young,6,0,10,3,0,0,22.0,1,0,2.0,9,3,25.2,No,2014,No,No,No
Taylor Johnson,0,0,1,0,0,0,0.0,1,0,0.0,0,0,0,No,2014,No,No,No
Faronte Drakeford,790,78,692,313,211,157,1741.0,31,7,171.0,661,306,28.4,No,2014,No,No,No
Kyle Vinales,1514,296,1300,518,334,271,2802.0,544,207,249.0,756,311,30.1,No,2014,No,No,No
Malcolm McMillan,1133,462,842,348,457,343,4051.0,281,94,227.0,561,254,15.7,No,2014,No,No,No
Brandon Peel,958,126,815,390,247,174,3126.0,15,4,184.0,800,386,18.1,No,2014,No,No,No
Matt Mobley,1946,272,1478,602,537,447,4382.0,819,295,285.0,659,307,23.4,No,2014,No,No,No
Khalen Cumberlander,1138,242,1020,432,283,154,3386.0,381,120,251.0,639,312,21.2,No,2014,No,No,No
Terrell Allen,435,48,371,156,146,97,1699.0,89,26,75.0,282,130,15.0,No,2014,No,No,No
Juwan Newmen,107,4,87,38,46,31,338.0,1,0,31.0,86,38,20.3,No,2014,No,No,No
De'Angelo Speech,217,100,204,71,88,57,1274.0,44,18,113.0,160,53,14.0,No,2014,No,No,No
Matt Hunter,565,91,517,207,154,110,1405.0,133,41,128.0,384,166,25.2,No,2014,No,No,No
Andrew Hurd,16,6,19,5,4,3,116.0,16,3,7.0,3,2,11.8,No,2014,No,No,No
Greg Andrade,93,19,84,30,34,21,578.0,38,12,17.0,46,18,10.8,No,2014,No,No,No
Isaiah Sykes,1545,336,1194,588,599,335,3574.0,103,34,344.0,1091,554,25.8,No,2014,No,No,No
Tristan Spurlock,928,111,759,305,267,196,2638.0,371,122,118.0,388,183,19.3,No,2014,No,No,No
Calvin Newell,754,204,653,261,217,140,2135.0,310,92,175.0,343,169,22.0,No,2014,No,No,No
Kasey Wilson,892,64,688,308,248,160,2487.0,296,116,135.0,392,192,19.3,No,2014,No,No,No
Matt Williams,1105,138,950,363,136,105,3115.0,740,274,126.0,210,89,18.7,No,2014,No,No,No
Staphon Blair,525,9,368,214,177,97,1776.0,1,0,91.0,367,214,15.7,No,2014,No,No,No
Eugene McCrory,130,8,90,46,61,38,371.0,0,0,13.0,90,46,17.3,No,2014,No,No,No
Daiquan Walker,711,268,657,250,128,97,2619.0,310,114,184.0,347,136,17.7,No,2014,No,No,No
Brandon Goodwin,1651,477,1212,575,535,383,3633.0,392,118,290.0,820,457,24.1,Yes,2014,No,No,No
Justin McBride,431,10,301,170,149,91,882.0,0,0,95.0,301,170,27.4,No,2014,No,No,No
Steven Haney,961,102,830,319,144,112,2464.0,567,211,91.0,263,108,20.1,No,2014,No,No,No
Isaac Lang,16,0,14,6,1,0,49.0,11,4,3.0,3,2,17.6,No,2014,No,No,No
Dylan Karell,59,16,43,24,35,11,487.0,0,0,25.0,43,24,9.1,No,2014,No,No,No
Chris Fowler,1736,686,1209,593,680,475,3927.0,226,75,327.0,983,518,24.7,No,2014,No,No,No
John Simons,1279,111,893,398,294,227,3928.0,653,256,111.0,240,142,15.2,No,2014,No,No,No
Braylon Rayson,1885,232,1551,625,448,364,3681.0,768,271,237.0,783,354,26.9,No,2014,No,No,No
Blake Hibbitts,727,48,617,231,120,89,2407.0,501,176,74.0,116,55,16.1,No,2014,No,No,No
Austin Stewart,592,54,411,204,200,147,1857.0,111,37,105.0,300,167,17.2,No,2014,No,No,No
Austin Keel,571,71,522,199,123,90,1687.0,305,83,84.0,217,116,20.7,No,2014,No,No,No
Rayshawn Simmons,833,360,679,289,293,205,2648.0,166,50,174.0,513,239,19.5,No,2014,No,No,No
DeAndray Buckley,121,28,94,33,87,50,508.0,25,5,21.0,69,28,16.5,No,2014,No,No,No
Spencer Krannitz,93,3,108,33,13,10,299.0,74,17,9.0,34,16,21.6,No,2014,No,No,No
Nick Carlos,33,3,42,13,0,0,108.0,28,7,6.0,14,6,23.2,No,2014,No,No,No
Josh Kozinski,1000,65,915,323,63,48,3244.0,877,306,27.0,38,17,14.9,No,2014,No,No,No
Zach Saylor,107,13,125,46,34,15,681.0,1,0,37.0,124,46,13.3,No,2014,No,No,No
Derrick Richardson,141,25,116,46,67,39,687.0,37,10,45.0,79,36,14.7,No,2014,No,No,No
Sheldon Lowman,10,1,5,4,3,2,20.0,0,0,1.0,5,4,19.4,No,2014,No,No,No
Tanner Beachnau,4,3,5,1,2,1,19.0,3,1,1.0,2,0,19.1,No,2014,No,No,No
Matt Kennedy,501,70,358,173,103,92,1390.0,136,63,66.0,222,110,16.9,No,2014,No,No,No
Arlon Harper,1633,256,1287,557,435,324,3464.0,535,195,214.0,752,362,24.3,No,2014,No,No,No
Sheldon Strickland,907,231,813,319,170,124,2487.0,390,145,160.0,423,174,20.8,No,2014,No,No,No
Will Saunders,714,54,532,220,141,105,1498.0,416,169,72.0,116,51,22.5,No,2014,No,No,No
Saah Nimley,1866,511,1484,544,633,490,3717.0,838,288,302.0,646,256,27.7,No,2014,No,No,No
Cedrick Bowen,754,51,523,312,203,129,2129.0,7,1,83.0,516,311,16.3,No,2014,No,No,No
Paul Gombwer,620,88,515,229,177,116,2770.0,135,46,157.0,380,183,13.5,No,2014,No,No,No
Alhaji Fullah,264,15,184,115,62,34,931.0,2,0,35.0,182,115,13.2,No,2014,No,No,No
Malcolm Bernard,814,232,624,254,368,235,2687.0,213,71,196.0,411,183,18.4,No,2014,No,No,No
Ty'Quan Bitting,233,14,148,98,78,37,583.0,0,0,39.0,148,98,18.6,No,2014,No,No,No
Bakari Copeland,980,106,689,313,381,290,1948.0,181,64,148.0,508,249,26.4,No,2014,No,No,No
Mitchell Deter,54,12,48,18,4,3,188.0,42,15,7.0,6,3,14.9,No,2014,No,No,No
Greg Dorleus,31,1,22,11,15,9,104.0,1,0,8.0,21,11,17.6,No,2014,No,No,No
Thomas Odom,25,1,24,8,3,2,80.0,20,7,3.0,4,1,17.4,No,2014,No,No,No
Pierria Henry,1238,566,997,413,481,335,3947.0,273,77,339.0,724,336,19.7,No,2014,No,No,No
Shawn Lester,369,48,300,126,90,68,757.0,158,49,76.0,142,77,27.0,No,2014,No,No,No
Willie Clayton,1049,63,715,424,462,201,3088.0,0,0,243.0,715,424,18.9,No,2014,No,No,No
Terrence Williams,972,228,857,326,372,265,2930.0,195,55,244.0,662,271,21.6,Yes,2014,No,No,No
Mike Thorne,857,47,685,355,276,147,2199.0,2,0,133.0,683,355,21.7,No,2014,No,No,No
Denzel Ingram,1332,399,1170,453,238,177,3784.0,677,249,198.0,493,204,18.9,No,2014,No,No,No
Ben Cherry,446,59,340,141,70,56,1629.0,245,108,60.0,95,33,13.6,No,2014,No,No,No
Marcus Bryan,513,62,443,200,197,112,2092.0,1,1,84.0,442,199,14.1,No,2014,No,No,No
Cameron Blakley,52,5,59,16,13,9,232.0,43,11,14.0,16,5,17.0,No,2014,No,No,No
Reid Aube,43,3,27,14,16,15,349.0,0,0,14.0,27,14,6.8,No,2014,No,No,No
Gavin Wilson,3,0,11,1,0,0,17.0,8,1,3.0,3,0,40.8,No,2014,No,No,No
Z Mason,1177,55,883,420,385,272,2206.0,199,65,146.0,684,355,26.6,No,2014,No,No,No
Casey Jones,1321,215,995,508,400,283,3187.0,78,22,278.0,917,486,22.9,No,2014,No,No,No
Gee McGhee,1189,277,879,354,575,378,3527.0,337,103,187.0,542,251,18.7,No,2014,No,No,No
Martynas Bareika,500,57,430,165,133,90,1323.0,243,80,105.0,187,85,22.0,No,2014,No,No,No
Ronrico White,1100,285,822,304,429,336,2910.0,447,156,176.0,375,148,20.4,No,2014,No,No,No
Greg Pryor,1203,343,879,356,446,346,3366.0,435,145,246.0,444,211,20.0,No,2014,No,No,No
Eric Robertson,851,153,686,283,136,94,2560.0,467,191,104.0,219,92,16.7,No,2014,No,No,No
Lance Stokes,285,50,193,93,171,99,1609.0,2,0,86.0,191,93,11.0,No,2014,No,No,No
Alex Bran,211,27,181,76,21,16,542.0,118,43,47.0,63,33,21.6,No,2014,No,No,No
T.J. Williams,37,0,28,16,10,5,182.0,0,0,14.0,28,16,12.3,No,2014,No,No,No
Anthanee Doyle,23,6,21,8,5,3,72.0,9,4,4.0,12,4,18.2,No,2014,No,No,No
Andrew Houts,18,5,13,6,6,5,35.0,5,1,5.0,8,5,28.5,No,2014,No,No,No
Jay Wimbley,2,0,0,0,2,2,1.0,0,0,0.0,0,0,45.5,No,2014,No,No,No
Quinton Pippen,802,147,698,274,119,96,1876.0,438,158,119.0,260,116,23.5,No,2014,No,No,No
Clarke Rosenberg,1241,237,1041,428,411,298,3252.0,292,87,258.0,749,341,23.3,No,2014,No,No,No
Matt Ross,714,58,612,266,112,89,2044.0,272,93,96.0,340,173,18.8,No,2014,No,No,No
Nate Duhon,556,80,463,200,182,137,1488.0,76,19,102.0,387,181,22.1,No,2014,No,No,No
Eddie Denard,346,44,309,138,151,70,1165.0,6,0,79.0,303,138,19.5,No,2014,No,No,No
Corey Gray,448,137,422,151,109,69,1881.0,239,77,119.0,183,74,16.0,No,2014,No,No,No
Rahjan Muhammad,105,13,95,36,22,17,350.0,52,16,20.0,43,20,18.4,No,2014,No,No,No
Jared Dimakos,209,26,163,77,59,34,689.0,68,21,45.0,95,56,17.6,No,2014,No,No,No
Johnny Griffin,166,20,130,61,76,43,916.0,14,1,25.0,116,60,10.8,No,2014,No,No,No
Kurt Karis,79,53,85,28,39,23,595.0,13,0,45.0,72,28,12.8,No,2014,No,No,No
Jamere Dismukes,312,114,284,104,91,71,849.0,111,33,84.0,173,71,24.4,No,2014,No,No,No
Markus Starks,77,6,89,30,26,15,560.0,5,2,31.0,84,28,11.9,No,2014,No,No,No
Willie Rosenthal,5,0,5,2,2,1,22.0,0,0,2.0,5,2,18.3,No,2014,No,No,No
Quron Davis,167,17,142,63,76,41,762.0,0,0,46.0,142,63,14.3,No,2014,No,No,No
Joshua Batson,198,120,270,66,95,50,1407.0,86,16,92.0,184,50,14.3,No,2014,No,No,No
Arthur Gage,11,1,8,3,8,5,115.0,0,0,5.0,8,3,7.4,No,2014,No,No,No
Sean Kilpatrick,2145,279,1687,707,536,418,4315.0,901,313,236.0,786,394,26.0,Yes,2014,No,No,No
Justin Jackson,770,166,633,322,267,124,2740.0,21,2,212.0,612,320,18.3,Yes,2014,No,No,No
Titus Rubles,449,134,400,149,205,147,1725.0,46,4,114.0,354,145,18.1,No,2014,No,No,No
Shaq Thomas,723,106,635,283,220,132,2473.0,80,25,138.0,555,258,18.8,No,2014,No,No,No
Jermaine Sanders,505,103,449,176,127,74,2114.0,249,79,69.0,200,97,14.5,No,2014,No,No,No
Troy Caupain,1317,515,1092,433,390,297,3981.0,455,154,222.0,637,279,19.8,Yes,2014,No,No,No
Ge'Lawn Guyn,963,135,831,333,213,153,2488.0,394,144,141.0,437,189,21.6,No,2014,No,No,No
Kevin Johnson,829,167,761,284,148,113,2797.0,463,148,148.0,298,136,18.5,Yes,2014,Yes,Yes,Yes
Jermaine Lawrence,173,15,183,69,68,33,667.0,16,2,57.0,167,67,21.0,No,2014,No,No,No
David Nyarsuk,117,9,87,51,23,15,521.0,0,0,30.0,87,51,12.5,No,2014,No,No,No
Jeremiah Davis,375,138,360,134,90,67,1249.0,143,40,110.0,217,94,21.8,No,2014,No,No,No
Derek Cox,0,0,1,0,0,0,2.0,0,0,0.0,1,0,26.0,No,2014,No,No,No
Zack Tobler,29,2,27,7,23,13,69.0,9,2,5.0,18,5,32.7,No,2014,No,No,No
Matt Van Scyoc,1331,101,1020,423,329,243,3450.0,661,242,195.0,359,181,20.7,No,2014,No,No,No
Ashton Moore,1399,321,1197,462,337,268,3497.0,542,207,269.0,655,255,25.6,No,2014,No,No,No
Brian White,1059,47,731,380,304,246,2467.0,154,53,127.0,577,327,19.9,No,2014,No,No,No
Marshall Harris III,668,438,472,186,266,207,2895.0,253,89,257.0,219,97,16.0,No,2014,No,No,No
Quinton Marshall,824,133,715,313,224,132,2574.0,207,66,185.0,508,247,19.6,No,2014,No,No,No
Tom Koopman,261,30,234,112,50,33,1071.0,17,4,57.0,217,108,14.1,No,2014,No,No,No
C.J. Bray,371,36,330,141,84,54,1382.0,108,35,64.0,222,106,17.2,No,2014,No,No,No
Raemond Robinson,628,153,539,205,69,49,2003.0,427,169,117.0,112,36,17.5,No,2014,No,No,No
Warren Sledge,730,320,597,229,193,150,2812.0,341,122,153.0,256,107,13.7,No,2014,No,No,No
P.J. Horgan,653,54,467,248,232,155,2027.0,2,2,107.0,465,246,20.3,No,2014,No,No,No
Dylen Setzekorn,182,12,154,63,45,32,463.0,66,24,33.0,88,39,24.1,No,2014,No,No,No
Nate Bowser,9,0,13,3,5,3,82.0,0,0,5.0,13,3,13.2,No,2014,No,No,No
K.J. McDaniels,1035,85,804,362,300,230,2287.0,259,81,140.0,545,281,26.5,No,2014,No,No,No
Rod Hall,924,393,731,311,361,255,3697.0,141,47,224.0,590,264,16.8,No,2014,No,No,No
Damarcus Harrison,784,134,744,276,173,128,2468.0,334,104,130.0,410,172,20.9,No,2014,No,No,No
Jordan Roper,971,238,897,337,207,156,2974.0,409,141,143.0,488,196,21.0,No,2014,No,No,No
Landry Nnoko,744,65,573,300,229,144,2632.0,0,0,146.0,573,300,17.2,No,2014,No,No,No
Jaron Blossomgame,1733,141,1286,627,529,383,3925.0,304,96,190.0,982,531,23.4,Yes,2014,No,No,No
Adonis Filer,989,219,837,315,348,264,2709.0,318,95,203.0,519,220,23.4,No,2014,No,No,No
Ibrahim Djambo,60,4,66,21,12,8,294.0,42,10,14.0,24,11,16.5,No,2014,No,No,No
Austin Ajukwa,641,56,543,219,168,132,1919.0,198,71,127.0,345,148,19.8,No,2014,No,No,No
Devin Coleman,511,64,498,185,72,47,1488.0,266,94,58.0,232,91,20.9,No,2014,No,No,No
Josh Smith,172,11,154,65,64,39,882.0,11,3,48.0,143,62,14.5,Yes,2014,No,No,No
Sidy Djitte,474,36,327,174,203,125,1854.0,2,1,105.0,325,173,15.1,No,2014,No,No,No
Carson Fields,11,4,19,5,4,1,72.0,10,0,3.0,9,5,18.4,No,2014,No,No,No
Bryn Forbes,1742,182,1258,565,351,288,4010.0,745,324,164.0,513,241,20.9,Yes,2014,No,No,No
Trey Lewis,1448,297,1153,482,342,259,3480.0,587,225,229.0,566,257,22.7,No,2014,No,No,No
Jon Harris,895,126,694,318,145,106,2851.0,412,153,108.0,282,165,16.7,No,2014,No,No,No
Anton Grady,1414,169,1124,559,458,288,3171.0,38,8,237.0,1086,551,25.4,No,2014,No,No,No
Charlie Lee,1147,458,889,359,299,262,3594.0,418,167,286.0,471,192,19.9,No,2014,No,No,No
Sebastian Douglas,464,97,380,194,114,68,1692.0,44,8,134.0,336,186,17.8,No,2014,No,No,No
Marlin Mason,773,98,594,283,188,137,2413.0,184,70,171.0,410,213,19.1,No,2014,No,No,No
Devon Long,307,22,232,134,77,39,1098.0,0,0,55.0,232,134,15.6,No,2014,No,No,No
Demonte Flannigan,722,48,622,304,165,101,1703.0,44,13,123.0,578,291,26.3,No,2014,No,No,No
Ismaila Dauda,34,1,27,11,17,12,178.0,0,0,15.0,27,11,14.5,No,2014,No,No,No
Ludovic Ndaye,167,11,161,67,54,29,880.0,18,4,32.0,143,63,13.1,No,2014,No,No,No
Raphael Veira,6,0,14,2,4,2,41.0,10,0,6.0,4,2,28.2,No,2014,No,No,No
Khyler Fields,2,1,5,1,0,0,22.0,1,0,4.0,4,1,17.8,No,2014,No,No,No
Elijah Wilson,1885,132,1681,659,385,274,4232.0,852,293,213.0,829,366,24.2,No,2014,No,No,No
Warren Gillis,1352,286,1081,484,363,305,3416.0,251,79,271.0,830,405,22.4,No,2014,No,No,No
Josh Cameron,891,136,702,284,256,193,1665.0,346,130,141.0,356,154,28.9,No,2014,No,No,No
Badou Diagne,1071,97,843,386,313,201,3102.0,290,98,206.0,553,288,19.4,No,2014,No,No,No
Michel Enanga,545,111,467,192,213,119,2289.0,156,42,158.0,311,150,15.8,No,2014,No,No,No
El Hadji Ndieguene,314,37,275,123,110,68,1563.0,0,0,84.0,275,123,13.1,No,2014,No,No,No
Colton Ray-St Cyr,740,170,613,266,193,122,2227.0,261,86,144.0,352,180,18.7,No,2014,No,No,No
Uros Ljeskovic,248,13,188,98,123,52,959.0,0,0,82.0,188,98,17.0,No,2014,No,No,No
Eric Smith,446,195,440,151,133,87,2037.0,196,57,150.0,244,94,16.2,No,2014,No,No,No
Tristian Curtis,456,35,312,181,185,92,2069.0,6,2,87.0,306,179,11.8,No,2014,No,No,No
Ron Trapps,394,51,372,136,59,43,1028.0,250,79,58.0,122,57,22.2,No,2014,No,No,No
Kyle Buffkin,6,1,13,2,9,2,111.0,0,0,8.0,13,2,11.5,No,2014,No,No,No
Murphy Burnatowski,1356,140,1157,484,268,200,3106.0,529,188,177.0,628,296,25.6,No,2014,No,No,No
Austin Tillotson,1393,484,1023,502,338,244,3871.0,368,145,251.0,655,357,20.6,No,2014,No,No,No
Ethan Jacobs,780,57,595,293,136,103,1671.0,241,91,99.0,354,202,26.5,No,2014,No,No,No
Damon Sherman-Newsome,1030,147,807,357,232,176,2601.0,380,140,154.0,427,217,23.7,No,2014,No,No,No
Luke Roh,770,337,579,308,252,152,3516.0,7,2,224.0,572,306,14.9,No,2014,No,No,No
Matt McMullen,564,134,448,193,134,102,2169.0,191,76,115.0,257,117,16.6,No,2014,No,No,No
Clayton Graham,168,45,105,66,53,36,768.0,0,0,33.0,105,66,11.8,No,2014,No,No,No
Pat Moore,923,144,753,313,142,109,2771.0,463,188,148.0,290,125,18.8,No,2014,No,No,No
Chad Johnson,200,52,195,80,49,26,933.0,61,14,73.0,134,66,16.8,No,2014,No,No,No
Nathan Harries,159,38,142,61,27,18,616.0,53,19,25.0,89,42,16.0,No,2014,No,No,No
Alex Ramon,314,77,230,110,73,51,1217.0,109,43,78.0,121,67,15.6,No,2014,No,No,No
John Fenton,53,1,54,22,25,9,335.0,0,0,14.0,54,22,14.1,No,2014,No,No,No
Andrew Bargmann,58,12,42,19,14,11,249.0,27,9,12.0,15,10,13.3,No,2014,No,No,No
Jack Fleming,5,1,4,2,0,0,15.0,2,1,1.0,2,1,19.1,No,2014,No,No,No
Anthony DeRiggs,5,0,4,2,0,0,13.0,3,1,0.0,1,1,18.4,No,2014,No,No,No
Wyatt Hagerty,0,0,5,0,2,0,33.0,0,0,1.0,5,0,12.5,No,2014,No,No,No
Nic Lane,2,1,2,1,0,0,10.0,1,0,2.0,1,1,23.4,No,2014,No,No,No
Willis Hall,1152,119,914,453,196,149,3482.0,271,97,184.0,643,356,18.0,No,2014,No,No,No
Anthony Stitt,1091,309,1004,381,263,163,3570.0,460,166,240.0,544,215,20.6,No,2014,No,No,No
Adjehi Baru,1094,98,797,393,521,308,3606.0,0,0,200.0,797,393,18.5,No,2014,No,No,No
Anthony Thomas,533,84,479,217,142,79,1868.0,84,20,134.0,395,197,19.5,No,2014,No,No,No
Canyon Barry,1292,125,1093,423,354,286,2882.0,468,160,180.0,625,263,26.6,No,2014,No,No,No
Nori Johnson,549,60,450,178,103,74,1754.0,315,119,82.0,135,59,17.4,No,2014,No,No,No
Joe Chealey,1827,397,1320,533,723,582,4018.0,516,179,244.0,804,354,25.8,Yes,2014,No,No,No
David Wishon,210,8,166,81,93,48,771.0,0,0,75.0,166,81,18.9,No,2014,No,No,No
Theo Johnson,464,75,346,144,219,154,1434.0,90,22,98.0,256,122,20.0,No,2014,No,No,No
Johnathan Burroughs-Cook,536,86,440,177,204,137,1436.0,158,45,88.0,282,132,22.2,No,2014,No,No,No
Terrance O'Donohue,182,8,151,66,70,41,872.0,23,9,49.0,128,57,14.6,No,2014,No,No,No
Pat Branin,34,5,31,11,11,5,155.0,22,7,6.0,9,4,14.9,No,2014,No,No,No
Judson Hall,5,1,4,2,0,0,18.0,3,1,0.0,1,1,11.9,No,2014,No,No,No
Glen Pierre Jr.,49,3,45,15,25,19,360.0,0,0,19.0,45,15,11.5,No,2014,No,No,No
Harrison Bowne,6,1,7,2,5,1,47.0,3,1,0.0,4,1,10.7,No,2014,No,No,No
Chad Cooke,2,1,2,1,0,0,10.0,1,0,5.0,1,1,37.4,No,2014,No,No,No
J.J. Avila,1741,329,1345,639,477,356,3619.0,353,107,299.0,992,532,26.7,No,2014,No,No,No
Daniel Bejarano,1125,231,1025,374,290,218,2902.0,481,159,140.0,544,215,23.0,No,2014,No,No,No
Jon Octeus,913,207,667,282,398,299,2739.0,159,50,126.0,508,232,18.4,No,2014,No,No,No
Joe De Ciman,917,157,749,301,226,165,2987.0,402,150,119.0,347,151,16.4,No,2014,No,No,No
Gerson Santo,242,16,165,89,93,64,958.0,0,0,30.0,165,89,12.7,No,2014,No,No,No
Carlton Hurst,583,83,385,194,241,169,2240.0,67,26,84.0,318,168,12.8,No,2014,No,No,No
David Cohn,1049,519,723,332,321,269,3402.0,298,116,198.0,425,216,16.2,No,2014,No,No,No
Marcus Holt,105,0,68,39,60,27,457.0,3,0,14.0,65,39,12.4,No,2014,No,No,No
Dwight Smith,260,62,186,85,114,75,1026.0,55,15,55.0,131,70,15.4,No,2014,No,No,No
Josh Morgan,21,2,17,8,4,2,49.0,10,3,4.0,7,5,23.8,No,2014,No,No,No
Mike Burnett,8,0,6,2,4,4,26.0,0,0,1.0,6,2,17.6,No,2014,No,No,No
Enrico Bueno,1,1,3,0,4,1,16.0,3,0,1.0,0,0,18.8,No,2014,No,No,No
Josh Scott,1711,128,1157,600,657,506,3761.0,16,5,151.0,1141,595,21.7,No,2014,No,No,No
Askia Booker,1740,335,1551,595,480,380,3810.0,538,170,287.0,1013,425,28.1,No,2014,No,No,No
Xavier Johnson,1461,91,1068,510,497,311,3387.0,340,130,215.0,728,380,22.9,No,2014,No,No,No
Spencer Dinwiddie,1115,227,690,290,506,420,2590.0,298,115,153.0,392,175,21.8,Yes,2014,No,No,No
Wesley Gordon,870,176,638,309,357,236,3406.0,46,16,169.0,592,293,14.3,No,2014,No,No,No
Xavier Talton,525,190,475,171,134,101,2417.0,230,82,152.0,245,89,14.4,No,2014,No,No,No
Jaron Hopkins,1073,274,916,430,290,162,3005.0,166,51,253.0,750,379,22.2,No,2014,No,No,No
Dustin Thomas,589,112,463,215,227,145,2210.0,59,14,148.0,404,201,16.3,No,2014,No,No,No
Tre'Shaun Fletcher,1078,219,825,365,322,237,2568.0,316,111,174.0,509,254,22.5,No,2014,No,No,No
Eli Stalzer,105,27,92,35,30,18,584.0,56,17,38.0,36,18,12.7,No,2014,No,No,No
George King,1294,88,1001,444,308,225,2866.0,451,181,196.0,550,263,23.1,Yes,2014,No,No,No
Ben Mills,71,5,62,29,21,12,235.0,1,1,17.0,61,28,19.2,No,2014,No,No,No
Beau Gamble,24,11,21,8,4,2,41.0,16,6,5.0,5,2,34.7,No,2014,No,No,No
Brett Brady,15,2,11,5,2,1,43.0,9,4,3.0,2,1,17.1,No,2014,No,No,No
Kevin Nelson,3,0,2,1,0,0,17.0,2,1,0.0,0,0,6.0,No,2014,No,No,No
Alex Rosenberg,1430,204,992,409,628,478,3352.0,371,134,207.0,621,275,24.7,No,2014,No,No,No
Maodo Lo,1756,264,1329,623,304,233,3678.0,692,277,235.0,637,346,25.7,No,2014,No,No,No
Grant Mullins,1316,277,938,407,334,284,3535.0,538,218,164.0,400,189,19.3,No,2014,No,No,No
Cory Osetkowski,613,145,498,229,211,132,2142.0,79,23,124.0,419,206,19.1,No,2014,No,No,No
Meiko Lyles,586,44,467,201,94,69,1950.0,278,115,74.0,189,86,16.5,No,2014,No,No,No
Luke Petrasek,1040,150,796,372,231,175,2580.0,333,121,162.0,463,251,21.9,No,2014,No,No,No
Isaac Cohen,371,303,276,159,97,42,2592.0,28,11,132.0,248,148,9.8,No,2014,No,No,No
Steve Frankoski,702,57,622,247,48,40,1953.0,421,168,73.0,201,79,20.1,No,2014,No,No,No
Jeff Coby,560,56,448,193,208,150,1617.0,81,24,98.0,367,169,21.3,No,2014,No,No,No
Zach En'Wezoh,80,16,73,38,17,4,334.0,1,0,30.0,72,38,19.0,No,2014,No,No,No
Kendall Jackson,107,32,93,35,24,18,508.0,62,19,30.0,31,16,14.6,No,2014,No,No,No
Noah Springwater,143,27,122,40,34,29,714.0,105,34,24.0,17,6,12.7,No,2014,No,No,No
Paddy Quinn,11,1,4,3,6,5,36.0,1,0,1.0,3,3,12.5,No,2014,No,No,No
Chris McComber,205,30,189,71,27,14,961.0,153,49,21.0,36,22,12.6,No,2014,No,No,No
Conor Voss,81,17,57,29,39,23,345.0,0,0,27.0,57,29,15.5,No,2014,No,No,No
Shabazz Napier,1959,646,1447,595,626,509,4614.0,693,260,350.0,754,335,24.0,Yes,2014,No,No,No
DeAndre Daniels,953,52,791,359,202,152,2356.0,238,83,128.0,553,276,23.1,No,2014,No,No,No
Ryan Boatright,1786,491,1362,566,573,455,4322.0,524,199,302.0,838,367,24.3,No,2014,No,No,No
Niels Giffey,640,79,454,216,152,120,2328.0,209,88,102.0,245,128,14.3,No,2014,No,No,No
Lasan Kromah,1256,240,1092,481,293,183,3303.0,347,111,254.0,745,370,22.8,No,2014,No,No,No
Amida Brimah,895,28,545,347,312,201,2909.0,0,0,134.0,545,347,15.4,No,2014,No,No,No
Phillip Nolan,269,24,215,108,82,53,1670.0,0,0,66.0,215,108,10.4,No,2014,No,No,No
Omar Calhoun,750,100,641,243,193,148,2355.0,361,116,131.0,280,127,19.9,No,2014,No,No,No
Terrence Samuel,516,221,393,162,226,173,2362.0,68,19,157.0,325,143,14.8,No,2014,No,No,No
Tyler Olander,383,91,353,154,105,72,1876.0,17,3,79.0,336,151,13.5,No,2014,No,No,No
Kentan Facey,560,46,431,222,162,113,2173.0,6,3,99.0,425,219,15.0,No,2014,No,No,No
Leon Tolksdorf,118,33,133,42,20,11,605.0,94,23,21.0,39,19,15.2,No,2014,No,No,No
Pat Lenehan,4,1,7,1,2,1,30.0,3,1,1.0,4,0,16.0,No,2014,No,No,No
Nnamdi Amilo,6,0,3,1,4,4,22.0,0,0,0.0,3,1,11.8,No,2014,No,No,No
Tor Watts,2,0,4,1,0,0,16.0,1,0,1.0,3,1,16.7,No,2014,No,No,No
Michael Murray,1030,96,957,389,301,191,2982.0,268,61,169.0,689,328,21.1,No,2014,No,No,No
Sterling Smith,1082,166,850,367,197,153,3166.0,498,195,126.0,352,172,16.6,No,2014,No,No,No
Andre Armstrong,702,35,541,181,256,210,1451.0,390,130,74.0,151,51,25.2,No,2014,No,No,No
Taariq Cephas,1084,451,921,366,280,200,3460.0,420,152,290.0,501,214,19.0,No,2014,No,No,No
Arnold Fripp,579,30,505,214,112,79,1443.0,193,72,66.0,312,142,21.0,No,2014,No,No,No
Daquan Brickhouse,336,112,280,99,119,101,1002.0,105,37,51.0,175,62,18.9,No,2014,No,No,No
Dallas Gary,405,41,311,124,192,135,1033.0,89,22,85.0,222,102,22.9,No,2014,No,No,No
Charles Ieans,195,25,191,74,51,28,772.0,56,19,43.0,135,55,16.6,No,2014,No,No,No
Brandon St. Louis,124,17,130,48,54,28,967.0,1,0,41.0,129,48,10.1,No,2014,No,No,No
Jerimyjah Batts,135,13,132,52,55,31,775.0,0,0,35.0,132,52,12.1,No,2014,No,No,No
Christian Kessee,837,138,717,274,173,138,2081.0,408,151,142.0,309,123,21.6,No,2014,No,No,No
Zach Burnham,109,6,125,44,33,21,573.0,1,0,29.0,124,44,14.6,No,2014,No,No,No
Van Rolle,36,12,46,11,18,8,139.0,21,6,14.0,25,5,23.9,No,2014,No,No,No
Michael Oyefusi,10,1,7,3,3,2,19.0,6,2,3.0,1,1,29.0,No,2014,No,No,No
Jahvari Josiah,130,11,120,42,65,40,389.0,41,6,41.0,79,36,23.5,No,2014,No,No,No
Nolan Cressler,1172,153,976,432,184,134,2827.0,464,174,156.0,512,258,22.6,No,2014,No,No,No
Devin Cherry,851,240,745,295,278,194,2512.0,230,67,252.0,515,228,24.0,No,2014,No,No,No
Dwight Tarwater,437,59,419,159,71,48,1870.0,231,71,60.0,188,88,14.5,No,2014,No,No,No
Robert Hatter,1241,200,1068,432,327,234,2577.0,472,143,223.0,596,289,28.9,No,2014,No,No,No
Darryl Smith,541,90,400,209,105,74,2030.0,117,49,91.0,283,160,13.7,No,2014,No,No,No
Jake Matthews,136,29,121,42,34,25,618.0,83,27,28.0,38,15,14.1,No,2014,No,No,No
Nenad Tomic,139,5,112,52,49,35,400.0,1,0,18.0,111,52,20.4,No,2014,No,No,No
David Onuorah,323,32,260,130,147,62,2128.0,3,1,131.0,257,129,11.2,No,2014,No,No,No
Dominick Scelfo,222,54,224,72,51,28,818.0,172,50,36.0,52,22,18.2,No,2014,No,No,No
Deion Giddens,81,4,62,33,23,15,508.0,0,0,11.0,62,33,8.8,No,2014,No,No,No
Dave LaMore,114,11,93,46,41,22,634.0,1,0,27.0,92,46,11.7,No,2014,No,No,No
Robert Mischler,67,11,42,22,10,6,267.0,34,17,10.0,8,5,10.9,No,2014,No,No,No
JoJo Fallas,345,86,326,115,37,28,1486.0,242,87,63.0,84,28,14.1,No,2014,No,No,No
Desmond Fleming,41,21,29,18,8,5,279.0,4,0,12.0,25,18,8.1,No,2014,No,No,No
Braxston Bunce,3,0,4,1,2,1,42.0,0,0,3.0,4,1,10.1,No,2014,No,No,No
Montez Blair,26,3,28,8,6,4,70.0,22,6,8.0,6,2,27.4,No,2014,No,No,No
Doug McDermott,3150,194,2075,1141,715,594,4569.0,598,274,321.0,1477,867,32.3,Yes,2014,No,No,No
Ethan Wragge,1155,72,816,360,116,101,2732.0,761,334,69.0,55,26,18.4,No,2014,No,No,No
Austin Chatman,1013,493,832,323,313,246,3739.0,334,121,244.0,498,202,17.7,No,2014,No,No,No
Jahenns Manigat,900,298,679,296,129,102,3592.0,508,206,139.0,171,90,13.2,No,2014,No,No,No
Devin Brooks,478,196,406,158,190,136,1324.0,102,26,138.0,304,132,26.0,No,2014,No,No,No
Grant Gibbs,811,519,555,287,255,173,3136.0,165,64,221.0,390,223,15.3,No,2014,No,No,No
Will Artino,620,47,416,256,193,108,1498.0,0,0,81.0,416,256,21.2,No,2014,No,No,No
Avery Dingman,462,84,378,152,102,70,1800.0,244,88,75.0,134,64,15.0,No,2014,No,No,No
Isaiah Zierden,769,153,569,229,161,140,2545.0,441,171,68.0,128,58,14.3,No,2014,No,No,No
Zach Hanson,525,15,347,218,146,89,1190.0,2,0,80.0,345,218,21.3,No,2014,No,No,No
Geoffrey Groselle,593,27,339,232,191,129,1220.0,0,0,83.0,339,232,21.4,No,2014,No,No,No
Steven Ferrarini,7,2,6,2,3,3,18.0,3,0,0.0,3,2,22.4,No,2014,No,No,No
Mogboluwaga Oginni,15,1,14,6,7,3,62.0,0,0,3.0,14,6,17.8,No,2014,No,No,No
Alex Olsen,18,2,9,6,11,6,60.0,1,0,1.0,8,6,13.9,No,2014,No,No,No
Alex Mitola,1207,276,979,375,253,217,3390.0,625,240,172.0,354,135,20.0,No,2014,No,No,No
Connor Boehm,1127,137,906,457,256,163,3007.0,139,50,193.0,767,407,21.4,No,2014,No,No,No
John Golden,780,153,662,266,241,157,3044.0,287,91,136.0,375,175,16.2,No,2014,No,No,No
Tyler Melville,804,148,658,266,258,201,2153.0,198,71,184.0,460,195,24.0,No,2014,No,No,No
Gabas Maldunas,1084,153,908,431,373,221,2761.0,9,1,225.0,899,430,25.8,No,2014,No,No,No
Kevin Crescenzi,412,97,417,144,87,60,1736.0,197,64,84.0,220,80,16.5,No,2014,No,No,No
Brandon McDonnell,248,31,202,95,65,51,857.0,32,7,46.0,170,88,16.9,No,2014,No,No,No
Eli Harrison,101,5,83,34,9,5,202.0,63,28,10.0,20,6,25.4,No,2014,No,No,No
Malik Gill,491,252,410,146,208,148,1659.0,163,51,176.0,247,95,21.9,No,2014,No,No,No
Matt Rennie,60,15,53,19,41,22,395.0,1,0,18.0,52,19,12.1,No,2014,No,No,No
Wesley Dickinson,238,16,159,92,92,54,884.0,0,0,54.0,159,92,15.2,No,2014,No,No,No
Mike Fleming,210,98,165,66,59,50,1132.0,93,28,53.0,72,38,11.2,No,2014,No,No,No
Tommy Carpenter,224,86,181,95,59,32,978.0,14,2,78.0,167,93,15.6,No,2014,No,No,No
Cole Harrison,132,13,119,56,37,20,454.0,0,0,36.0,119,56,19.9,No,2014,No,No,No
Ike Ngwudo,77,20,71,29,21,10,405.0,24,9,25.0,47,20,13.5,No,2014,No,No,No
De'Mon Brooks,1777,113,1209,647,590,430,2971.0,154,53,232.0,1055,594,29.7,No,2014,No,No,No
Brian Sullivan,1565,335,1304,517,227,180,4053.0,890,351,176.0,414,166,20.5,No,2014,No,No,No
Tyler Kalinoski,1311,336,1026,450,221,168,3570.0,623,243,141.0,403,207,18.4,No,2014,No,No,No
Tom Droney,746,315,585,254,252,182,3208.0,200,56,197.0,385,198,14.3,No,2014,No,No,No
Chris Czerapowicz,1004,70,891,371,126,90,2732.0,506,172,89.0,385,199,19.5,No,2014,No,No,No
Jack Gibbs,2036,466,1494,647,594,487,3618.0,690,255,284.0,804,392,28.8,No,2014,No,No,No
Jordan Barham,866,67,590,340,289,175,1643.0,31,11,75.0,559,329,25.0,No,2014,No,No,No
Jake Belford,247,32,173,88,62,46,710.0,63,25,54.0,110,63,18.6,No,2014,No,No,No
Andrew McAuliffe,318,50,262,147,72,23,1323.0,9,1,77.0,253,146,14.3,No,2014,No,No,No
Joe Aase,20,4,24,8,2,1,152.0,11,3,4.0,13,5,9.8,No,2014,No,No,No
Ali Mackay,38,9,24,15,11,6,194.0,7,2,5.0,17,13,9.1,No,2014,No,No,No
Connor Perkey,15,0,5,4,6,6,46.0,1,1,1.0,4,3,10.0,No,2014,No,No,No
Ryan Ansel,3,1,1,1,0,0,9.0,1,1,1.0,0,0,11.4,No,2014,No,No,No
Will Thoni,1,1,7,0,2,1,16.0,5,0,2.0,2,0,32.0,No,2014,No,No,No
Manu Giamoukis,4,1,7,1,2,1,34.0,5,1,2.0,2,0,14.8,No,2014,No,No,No
Clay Tormey,11,5,13,4,5,2,76.0,4,1,8.0,9,3,15.8,No,2014,No,No,No
Jordan Sibert,1153,158,852,366,321,237,2660.0,506,184,138.0,346,182,23.2,Yes,2014,No,No,No
Devin Oliver,923,188,723,328,283,200,2971.0,211,67,179.0,512,261,18.1,No,2014,No,No,No
Dyshawn Pierre,1423,276,1041,501,435,307,3772.0,297,114,220.0,744,387,20.7,No,2014,No,No,No
Vee Sanford,834,155,673,305,203,156,2005.0,198,68,138.0,475,237,23.6,No,2014,No,No,No
Khari Price,619,251,478,185,167,142,2288.0,294,107,134.0,184,78,16.2,No,2014,No,No,No
Matt Kavanaugh,558,59,407,213,183,132,1685.0,0,0,127.0,407,213,19.1,No,2014,No,No,No
Jalen Robinson,373,30,312,138,151,91,1175.0,17,6,73.0,295,132,20.4,No,2014,No,No,No
Scoochie Smith,1289,498,983,422,400,286,3851.0,432,159,247.0,551,263,19.4,No,2014,No,No,No
Devon Scott,256,27,159,91,124,74,930.0,0,0,66.0,159,91,16.3,No,2014,No,No,No
Kendall Pollard,1171,122,797,421,555,317,2714.0,48,12,206.0,749,409,24.8,No,2014,No,No,No
Kyle Davis,830,257,560,278,305,209,2980.0,217,65,131.0,343,213,14.8,No,2014,No,No,No
Alex Gavrilovic,360,21,287,139,88,58,1187.0,75,24,63.0,212,115,17.2,No,2014,No,No,No
Brian Vonderhaar,5,4,2,2,0,0,34.0,1,1,1.0,1,1,4.5,No,2014,No,No,No
Bobby Wehrli,86,15,67,32,15,8,529.0,35,14,18.0,32,18,9.5,No,2014,No,No,No
Casey Walker,1449,101,1324,496,263,191,3980.0,835,266,140.0,489,230,22.3,No,2014,No,No,No
Tyshawn Bell,1207,90,996,414,207,173,3154.0,544,206,103.0,452,208,20.3,No,2014,No,No,No
Kendall Gray,1020,77,696,377,415,266,3224.0,3,0,182.0,693,377,17.8,No,2014,No,No,No
Kendal Williams,525,177,477,188,108,81,1634.0,179,68,95.0,298,120,20.1,No,2014,No,No,No
DeAndre Haywood,1087,207,872,378,418,261,2709.0,235,70,222.0,637,308,24.5,No,2014,No,No,No
Albert Thomas,253,154,205,89,99,66,1395.0,29,9,92.0,176,80,13.7,No,2014,No,No,No
Nick Doyle,81,33,95,33,14,8,368.0,34,7,26.0,61,26,19.4,No,2014,No,No,No
Jason Owens,134,18,154,56,39,21,631.0,4,1,41.0,150,55,18.0,No,2014,No,No,No
Charles Burley,101,157,82,23,73,49,1014.0,23,6,108.0,59,17,11.5,No,2014,No,No,No
Jordan Lawson,112,10,83,39,49,34,563.0,1,0,27.0,82,39,13.2,No,2014,No,No,No
Mrdjan Gasevic,259,39,224,101,101,57,988.0,1,0,69.0,223,101,17.6,No,2014,No,No,No
Ashwell Boyd,13,1,10,5,5,3,32.0,0,0,2.0,10,5,25.3,No,2014,No,No,No
Chris Lewis,34,16,24,11,13,8,111.0,10,4,9.0,14,7,19.5,No,2014,No,No,No
Larry Haley,28,3,30,9,4,4,74.0,21,6,1.0,9,3,23.2,No,2014,No,No,No
Cahli Thomas,67,35,63,20,25,18,410.0,38,9,29.0,25,11,13.4,No,2014,No,No,No
Rakeen Brown,3,3,7,1,2,1,31.0,3,0,5.0,4,1,23.5,No,2014,No,No,No
J. Walter Lawson,0,0,0,0,0,0,0.0,0,0,1.0,0,0,0,No,2014,No,No,No
Scott Sill,114,6,139,45,9,2,458.0,86,22,21.0,53,23,18.4,No,2014,No,No,No
Davon Usher,1205,102,858,374,409,311,2197.0,388,146,134.0,470,228,26.2,No,2014,No,No,No
Devon Saddler,2222,336,1750,748,713,534,4449.0,569,192,368.0,1181,556,28.5,No,2014,No,No,No
Jarvis Threatt,1191,308,868,338,613,462,2714.0,189,53,190.0,679,285,25.1,No,2014,No,No,No
Carl Baptiste,607,31,451,250,158,105,1989.0,11,2,110.0,440,248,15.9,No,2014,No,No,No
Kyle Anderson,1292,138,1152,435,198,153,4048.0,780,269,149.0,372,166,17.6,Yes,2014,No,No,No
Marvin King-Davis,849,52,661,309,330,231,2152.0,2,0,92.0,659,309,21.6,No,2014,No,No,No
Devonne Pinkard,525,77,519,174,111,74,2389.0,337,103,79.0,182,71,14.1,No,2014,No,No,No
Cazmon Hayes,1019,132,919,341,301,200,3055.0,474,137,130.0,445,204,20.2,No,2014,No,No,No
Maurice Jeffers,545,59,424,211,217,123,2101.0,0,0,152.0,424,211,16.5,No,2014,No,No,No
Barnett Harris,101,40,68,27,79,47,871.0,0,0,42.0,68,27,8.8,No,2014,No,No,No
Sean Locke,9,1,13,2,5,3,39.0,13,2,2.0,0,0,22.5,No,2014,No,No,No
Thomas Allshouse,0,0,0,0,0,0,11.0,0,0,0.0,0,0,0.0,No,2014,No,No,No
Dylan Miller,248,25,205,109,38,26,818.0,16,4,32.0,189,105,16.4,No,2014,No,No,No
Tommy Williams,1,0,2,0,2,1,19.0,0,0,2.0,2,0,13.0,No,2014,No,No,No
Brett Olson,1468,336,1018,489,254,225,4296.0,607,265,212.0,411,224,19.2,No,2014,No,No,No
Chris Udofia,1501,349,1074,551,515,334,3661.0,225,65,228.0,849,486,25.6,No,2014,No,No,No
Jalen Love,678,169,565,246,125,85,2530.0,283,101,97.0,282,145,17.5,No,2014,No,No,No
Cam Griffin,784,191,526,269,319,230,2552.0,63,16,158.0,463,253,20.2,No,2014,No,No,No
Marcus Byrd,893,152,667,318,120,94,2679.0,389,163,119.0,278,155,19.1,No,2014,No,No,No
Bryant Rucker,521,126,367,180,121,90,1752.0,172,71,97.0,195,109,18.1,No,2014,No,No,No
Nate Engesser,849,145,590,302,117,98,2014.0,344,147,87.0,246,155,22.2,No,2014,No,No,No
Dom Samac,64,10,50,25,10,7,235.0,20,7,6.0,30,18,15.6,No,2014,No,No,No
Drick Bernstine,803,241,693,345,215,111,2859.0,17,2,223.0,676,343,17.9,No,2014,No,No,No
Griffin McKenzie,24,5,24,9,1,1,92.0,10,5,5.0,14,4,17.8,No,2014,No,No,No
Charles Webb,6,1,10,2,4,2,26.0,0,0,3.0,10,2,34.6,No,2014,No,No,No
Josiah Dunn,4,1,2,2,1,0,11.0,0,0,1.0,2,2,17.0,No,2014,No,No,No
Brandon Young,1899,521,1530,660,624,449,4007.0,445,130,352.0,1085,530,26.6,No,2014,No,No,No
Billy Garrett,1632,432,1199,463,672,565,3649.0,437,141,321.0,762,322,25.6,Yes,2014,No,No,No
Cleveland Melvin,1792,87,1509,719,444,290,3349.0,192,64,217.0,1317,655,28.2,No,2014,No,No,No
Tommy Hamilton IV,1005,110,791,355,286,197,2798.0,238,98,225.0,553,257,21.0,No,2014,No,No,No
Durrell McDonald,410,133,382,155,64,42,1766.0,159,58,112.0,223,97,15.0,No,2014,No,No,No
Sandi Marcius,316,17,219,120,126,76,1200.0,0,0,89.0,219,120,15.6,No,2014,No,No,No
Charles McKinney,398,116,311,155,133,76,1608.0,52,12,117.0,259,143,14.8,No,2014,No,No,No
Forrest Robinson,310,22,268,109,28,23,1000.0,188,69,44.0,80,40,16.7,No,2014,No,No,No
Jamee Crockett,965,125,834,343,224,157,2483.0,378,122,133.0,456,221,21.4,No,2014,No,No,No
R.J. Curington,254,26,214,89,55,43,649.0,107,33,47.0,107,56,22.5,No,2014,No,No,No
Greg Sequele,43,4,35,20,11,3,339.0,0,0,14.0,35,20,8.1,No,2014,No,No,No
Peter Ryckbosch,123,7,92,49,53,25,599.0,0,0,35.0,92,49,12.2,No,2014,No,No,No
DeJuan Marrero,687,94,630,277,229,133,1882.0,0,0,158.0,630,277,22.9,No,2014,No,No,No
Edwind McGhee,57,21,52,15,29,20,350.0,27,7,16.0,25,8,11.4,No,2014,No,No,No
Cory Dolins,10,4,9,4,5,2,48.0,0,0,3.0,9,4,15.1,No,2014,No,No,No
Juwan Howard Jr.,1720,248,1501,620,365,302,3733.0,494,178,219.0,1007,442,25.4,No,2014,No,No,No
Evan Bruinsma,760,111,543,260,264,194,2338.0,163,46,148.0,380,214,17.4,No,2014,No,No,No
Matthew Grant,447,122,414,136,134,108,1840.0,228,67,70.0,186,69,14.7,No,2014,No,No,No
Jarod Williams,773,215,622,264,280,195,2427.0,165,50,213.0,457,214,19.5,No,2014,No,No,No
Carlton Brundidge,658,153,534,230,240,165,1726.0,118,33,117.0,416,197,21.4,No,2014,No,No,No
Anton Wilson,1005,183,748,325,174,150,2755.0,499,205,140.0,249,120,17.0,No,2014,No,No,No
Patrick Onwenu,460,47,326,142,242,172,1474.0,35,4,114.0,291,138,19.0,No,2014,No,No,No
Ugochukwu Njoku,155,18,130,63,74,29,867.0,1,0,36.0,129,63,11.5,No,2014,No,No,No
Jermaine Lippert,90,20,60,36,29,16,408.0,6,2,32.0,54,34,12.9,No,2014,No,No,No
Olumide Solanke,7,1,6,1,6,5,31.0,0,0,2.0,6,1,17.3,No,2014,No,No,No
Richard Carter,808,227,609,252,324,240,1790.0,194,64,146.0,415,188,27.4,No,2014,No,No,No
Aaron Hawley,864,66,758,308,137,94,2436.0,383,154,117.0,375,154,21.2,No,2014,No,No,No
Chris Caird,478,72,363,157,79,68,1385.0,237,96,78.0,126,61,20.1,No,2014,No,No,No
Jordan Daniels,650,181,562,227,116,97,1987.0,258,99,135.0,304,128,21.7,No,2014,No,No,No
Jacob Enevold,606,40,405,229,211,148,2148.0,0,0,162.0,405,229,17.8,No,2014,No,No,No
Seth VanDeest,987,138,651,346,418,291,2802.0,16,4,148.0,635,342,19.5,No,2014,No,No,No
Trevor Berkeley,305,34,211,113,73,56,1197.0,55,23,63.0,156,90,15.1,No,2014,No,No,No
Daddy Ugbede,147,5,94,52,63,43,400.0,0,0,27.0,94,52,20.5,No,2014,No,No,No
Gary Ricks,501,118,415,174,58,46,1526.0,266,107,53.0,149,67,18.9,No,2014,No,No,No
Karl Madison,326,258,311,101,147,100,2238.0,87,24,170.0,224,77,13.7,No,2014,No,No,No
Blake Danielak,63,11,67,23,6,3,261.0,41,14,12.0,26,9,17.4,No,2014,No,No,No
Robert Puleikis,12,0,6,5,5,2,23.0,0,0,0.0,6,5,19.9,No,2014,No,No,No
Mitch McLaughlin,1,1,1,0,4,1,20.0,0,0,4.0,1,0,18.6,No,2014,No,No,No
Addison Joseph,0,0,0,0,0,0,0.0,0,0,0.0,0,0,0,No,2014,No,No,No
A.J. Rutter,11,0,10,4,0,0,18.0,8,3,2.0,2,1,33.8,No,2014,No,No,No
Chris Fouch,1744,178,1464,568,426,333,3449.0,780,275,151.0,684,293,28.2,No,2014,No,No,No
Frantz Massenat,1646,548,1261,505,649,484,4381.0,419,152,264.0,842,353,23.0,No,2014,No,No,No
Tavon Allen,1249,220,1206,434,291,221,3146.0,490,160,188.0,716,274,26.7,No,2014,No,No,No
Rodney Williams,1158,125,860,420,479,315,3055.0,14,3,182.0,846,417,21.5,No,2014,No,No,No
Dartaye Ruffin,809,58,632,322,269,165,3255.0,0,0,148.0,632,322,15.2,No,2014,No,No,No
Kazembe Abif,552,42,422,201,226,148,2087.0,15,2,86.0,407,199,15.9,No,2014,No,No,No
Damion Lee,2016,244,1468,636,578,487,4104.0,710,257,217.0,758,379,26.0,Yes,2014,No,No,No
Major Canady,93,56,99,30,47,25,669.0,36,8,28.0,63,22,11.7,No,2014,No,No,No
Freddie Wilson,279,90,281,98,56,35,1147.0,168,48,74.0,113,50,18.4,No,2014,No,No,No
Mohamed Bah,328,32,230,125,126,78,1578.0,4,0,61.0,226,125,11.8,No,2014,No,No,No
Goran Pantovic,40,6,37,17,9,6,384.0,0,0,14.0,37,17,7.9,No,2014,No,No,No
Stevan Manojlovic,5,3,7,2,0,0,35.0,5,1,2.0,2,1,13.9,No,2014,No,No,No
Jake Lerner,2,2,7,1,2,0,27.0,4,0,1.0,3,1,17.8,No,2014,No,No,No
Khris Lane,1027,78,780,416,202,133,2355.0,176,62,153.0,604,354,21.9,No,2014,No,No,No
Jabari Parker,670,41,499,236,214,160,1074.0,106,38,81.0,393,198,32.7,Yes,2014,No,No,No
Rodney Hood,890,139,699,318,176,136,2200.0,298,118,84.0,401,200,20.5,Yes,2014,No,No,No
Quinn Cook,1571,509,1235,534,313,267,4033.0,629,236,201.0,606,298,20.2,Yes,2014,No,No,No
Rasheed Sulaimon,1307,309,991,425,373,285,3491.0,429,172,173.0,562,253,19.9,No,2014,No,No,No
Andre Dawkins,1014,66,763,330,160,123,2468.0,568,231,88.0,195,99,18.7,Yes,2014,No,No,No
Amile Jefferson,1079,142,687,426,395,227,3344.0,0,0,140.0,687,426,15.4,Yes,2014,No,No,No
Tyler Thornton,433,264,308,125,121,94,2590.0,231,89,118.0,77,36,9.5,No,2014,No,No,No
Matt Jones,912,195,798,318,155,106,3411.0,459,170,113.0,339,148,14.6,No,2014,No,No,No
Josh Hairston,250,27,220,97,87,56,1139.0,3,0,52.0,217,97,13.9,No,2014,No,No,No
Marshall Plumlee,427,59,233,155,209,116,1777.0,1,1,68.0,232,154,11.4,Yes,2014,No,No,No
Semi Ojeleye,711,56,463,222,237,186,1338.0,195,81,55.0,268,141,24.9,Yes,2014,No,No,No
Alex Murphy,602,61,470,226,166,89,1520.0,192,61,98.0,278,165,22.5,No,2014,No,No,No
Nick Pagliuca,4,3,9,1,2,1,41.0,7,1,1.0,2,0,13.7,No,2014,No,No,No
Todd Zafirovski,5,1,7,2,4,1,41.0,0,0,1.0,7,2,12.3,No,2014,No,No,No
Ovie Soko,1115,124,806,379,523,338,2891.0,80,19,210.0,726,360,23.0,No,2014,No,No,No
Dominique McKoy,618,78,477,264,178,90,2008.0,12,0,98.0,465,264,16.5,No,2014,No,No,No
Derrick Colter,1695,526,1383,550,472,356,3948.0,675,239,326.0,708,311,24.2,No,2014,No,No,No
Micah Mason,1431,376,1001,487,174,146,3366.0,671,311,162.0,330,176,18.4,No,2014,No,No,No
Tra'Vaughn White,569,104,516,194,148,116,1353.0,200,65,69.0,316,129,24.2,No,2014,No,No,No
Jeremiah Jones,761,209,661,260,247,164,2755.0,243,77,139.0,418,183,16.7,No,2014,No,No,No
Desmond Ridenour,461,152,457,178,121,68,1759.0,155,37,109.0,302,141,17.4,No,2014,No,No,No
Jerry Jones,560,117,483,207,106,68,1915.0,233,78,94.0,250,129,16.3,No,2014,No,No,No
L.G. Gill,778,79,666,279,156,106,2413.0,339,114,90.0,327,165,17.1,No,2014,No,No,No
Isaiah Watkins,22,1,24,7,11,8,96.0,2,0,7.0,22,7,18.6,No,2014,No,No,No
Darius Lewis,434,49,302,167,183,100,1613.0,0,0,126.0,302,167,15.7,No,2014,No,No,No
Brandon Cartmill,0,0,0,0,0,0,1.0,0,0,0.0,0,0,0.0,No,2014,No,No,No
Nick Foschia,6,1,15,3,2,0,47.0,5,0,2.0,10,3,18.8,No,2014,No,No,No
Christian Johnston,2,0,7,1,0,0,17.0,1,0,1.0,6,1,24.0,No,2014,No,No,No
Akeem Richmond,1622,146,1338,514,216,178,3514.0,1082,416,128.0,256,98,22.6,No,2014,No,No,No
Caleb White,1578,216,1244,539,317,244,4083.0,676,256,188.0,568,283,20.4,No,2014,No,No,No
Paris Roberts-Campbell,872,212,734,275,222,162,3073.0,480,160,128.0,254,115,16.3,No,2014,No,No,No
Prince Williams,704,280,533,232,264,193,2147.0,136,47,180.0,397,185,20.4,No,2014,No,No,No
Michael Zangari,580,51,465,211,212,143,2045.0,71,15,99.0,394,196,17.0,No,2014,No,No,No
Antonio Robinson,304,213,292,111,97,66,1538.0,50,16,102.0,242,95,15.3,No,2014,No,No,No
Brandan Stith,1027,105,765,402,397,223,3097.0,2,0,149.0,763,402,18.5,No,2014,No,No,No
Petar Torlak,119,32,95,41,23,14,379.0,57,23,29.0,38,18,18.5,No,2014,No,No,No
Marshall Guilmette,295,49,244,111,93,62,935.0,37,11,67.0,207,100,19.9,No,2014,No,No,No
Greg Alexander,625,39,498,214,71,49,1848.0,392,148,43.0,106,66,16.6,No,2014,No,No,No
Francis Edosomwan,14,3,10,5,10,4,61.0,1,0,4.0,9,5,15.7,No,2014,No,No,No
Peyton Robbins,3,1,5,1,2,1,20.0,0,0,1.0,5,1,17.8,No,2014,No,No,No
Rashawn Rembert,1326,147,1019,425,268,216,3210.0,658,260,155.0,361,165,20.4,No,2014,No,No,No
Jalen Riley,1056,141,769,290,416,346,1533.0,369,130,135.0,400,160,35.8,No,2014,No,No,No
Kinard Gadsden-Gilliard,530,145,464,185,174,128,1810.0,99,32,144.0,365,153,19.2,No,2014,No,No,No
Lester Wilson,1388,60,1194,487,197,142,3234.0,753,272,117.0,441,215,21.9,No,2014,No,No,No
A.J. Merriweather,1084,151,778,384,344,247,2935.0,160,69,217.0,618,315,19.5,No,2014,No,No,No
Hunter Harris,561,35,403,206,231,144,1688.0,27,5,84.0,376,201,18.0,No,2014,No,No,No
Petey McClain,332,412,282,107,157,101,2579.0,74,17,187.0,208,90,10.6,No,2014,No,No,No
Lukas Poderis,300,21,240,112,139,75,1492.0,6,1,51.0,234,111,11.9,No,2014,No,No,No
Devin Harris,818,257,629,286,319,225,2413.0,75,21,198.0,554,265,20.1,Yes,2014,No,Yes,Yes
Isaac Banks,451,57,324,190,147,70,2048.0,3,1,93.0,321,189,11.7,No,2014,No,No,No
Todd Halvorsen,27,9,24,9,5,4,111.0,15,5,10.0,9,4,16.8,No,2014,No,No,No
Ron Giplaye,111,12,91,42,71,27,476.0,0,0,25.0,91,42,15.4,No,2014,No,No,No
Tyler Ailshie,5,2,6,2,0,0,28.0,4,1,0.0,2,1,10.7,No,2014,No,No,No
Adam Denison,0,0,0,0,0,0,0.0,0,0,0.0,0,0,0,No,2014,No,No,No
Sherman Blanford,771,119,575,277,318,217,1639.0,4,0,114.0,571,277,27.9,No,2014,No,No,No
Reggie Smith,655,155,500,197,272,193,1670.0,210,68,150.0,290,129,24.9,Yes,2014,No,No,No
Chris Olivier,831,47,625,327,295,177,1566.0,1,0,105.0,624,327,30.2,No,2014,No,No,No
Dylan Chatman,406,114,339,131,76,51,1650.0,249,93,77.0,90,38,14.8,No,2014,No,No,No
Alex Austin,530,84,422,176,137,102,1684.0,234,76,69.0,188,100,18.1,No,2014,No,No,No
Josh Piper,721,121,606,268,102,85,2400.0,278,100,109.0,328,168,17.6,No,2014,No,No,No
Luke Piotrowski,292,30,238,115,89,62,1027.0,3,0,60.0,235,115,17.8,No,2014,No,No,No
Dennis Green,87,15,67,25,53,36,219.0,9,1,20.0,58,24,26.6,No,2014,No,No,No
Keenen Anderson,173,18,118,67,86,39,815.0,0,0,49.0,118,67,14.0,No,2014,No,No,No
Zach Dickerson,90,45,80,33,20,15,609.0,33,9,33.0,47,24,10.4,No,2014,No,No,No
Jake Verhagen,75,11,72,27,0,0,342.0,61,21,4.0,11,6,11.8,No,2014,No,No,No
Mat Piotrowski,42,8,57,17,5,4,281.0,23,4,12.0,34,13,13.6,No,2014,No,No,No
Anthony Johnson,89,17,75,32,27,17,399.0,25,8,23.0,50,24,14.8,Yes,2014,No,No,No
Donald Moore,16,2,17,4,9,6,75.0,7,2,6.0,10,2,18.9,No,2014,No,No,No
Aaron Siler,11,4,9,3,3,2,43.0,7,3,2.0,2,0,15.0,No,2014,No,No,No
Julian Robertson,0,0,0,0,0,0,2.0,0,0,1.0,0,0,26.0,No,2014,No,No,No
Glenn Cosey,1077,235,765,328,272,226,2260.0,468,195,102.0,297,133,23.6,No,2014,No,No,No
Corey Walden,1807,366,1164,585,562,471,3978.0,477,166,274.0,687,419,23.0,No,2014,No,No,No
Marcus Lewis,542,79,424,213,136,82,1672.0,134,34,71.0,290,179,18.0,No,2014,No,No,No
Tarius Johnson,560,79,414,193,183,119,1646.0,147,55,76.0,267,138,18.8,No,2014,No,No,No
Orlando Williams,824,138,637,278,183,131,2246.0,346,137,134.0,291,141,20.8,No,2014,No,No,No
Eric Stutz,1338,204,825,502,388,303,3392.0,76,31,217.0,749,471,19.8,No,2014,No,No,No
Timmy Knipp,641,93,519,213,101,77,1896.0,383,138,93.0,136,75,19.1,No,2014,No,No,No
Isaac McGlone,637,238,523,209,101,75,3098.0,393,144,110.0,130,65,11.4,No,2014,No,No,No
Jeff Johnson,489,159,415,178,89,63,2101.0,211,70,113.0,204,108,15.0,No,2014,No,No,No
Deverin Muff,159,14,123,60,65,39,814.0,0,0,37.0,123,60,12.8,No,2014,No,No,No
Tommy Matthews,33,15,37,9,20,11,238.0,17,4,13.0,20,5,13.3,No,2014,No,No,No
Herb Harrison,22,3,17,10,2,2,90.0,0,0,7.0,17,10,15.2,No,2014,No,No,No
Ryan Parsons,38,2,35,12,6,3,101.0,33,11,2.0,2,1,21.4,No,2014,No,No,No
Monte Burney,0,0,2,0,0,0,3.0,2,0,1.0,0,0,53.6,No,2014,No,No,No
Robbie Stenzel,27,13,25,8,6,5,99.0,22,6,4.0,3,2,17.4,No,2014,No,No,No
Karrington Ward,899,48,714,306,274,184,2178.0,298,103,67.0,416,203,21.7,No,2014,No,No,No
Ray Lee,1873,242,1426,595,591,470,3270.0,600,213,336.0,826,382,31.3,No,2014,No,No,No
Mike Talley,1268,414,975,378,577,394,3471.0,375,118,239.0,600,260,21.8,No,2014,No,No,No
Glenn Bryant,899,42,739,356,260,169,2364.0,95,18,104.0,644,338,21.7,No,2014,No,No,No
Darell Combs,1313,210,1076,436,377,284,2521.0,433,157,238.0,643,279,29.6,No,2014,No,No,No
Daylen Harrison,683,129,597,239,180,144,2524.0,192,61,146.0,405,178,17.4,No,2014,No,No,No
DaShonte Riley,392,76,331,154,148,84,2336.0,4,0,172.0,327,154,13.3,No,2014,No,No,No
J.R. Sims,503,96,493,165,145,107,1949.0,236,66,113.0,257,99,18.9,No,2014,No,No,No
Mo Hughley,234,57,165,80,119,74,879.0,2,0,62.0,163,80,16.7,No,2014,No,No,No
Jalen Ross,1112,233,921,345,380,287,2920.0,390,135,219.0,531,210,23.5,No,2014,No,No,No
Anthony Strickland,157,28,135,56,67,45,934.0,2,0,40.0,133,56,12.3,No,2014,No,No,No
Olalekan Ajayi,183,19,140,63,100,57,1328.0,0,0,65.0,140,63,9.5,No,2014,No,No,No
Ali Farhat,12,2,17,5,2,1,29.0,7,1,0.0,10,4,32.4,No,2014,No,No,No
Trent Perry,68,10,81,24,7,3,286.0,63,17,6.0,18,7,15.5,No,2014,No,No,No
Tyler Harvey,1564,197,1066,494,373,316,2635.0,602,260,151.0,464,234,26.7,No,2014,No,No,No
Venky Jois,1803,276,1232,718,660,363,3927.0,22,4,302.0,1210,714,23.7,No,2014,No,No,No
Drew Brandon,641,312,546,215,200,158,2141.0,185,53,136.0,361,162,18.3,No,2014,No,No,No
Parker Kelly,1006,119,744,309,213,178,3466.0,515,210,90.0,229,99,13.6,No,2014,No,No,No
Martin Seiferth,487,17,324,206,169,75,1429.0,0,0,72.0,324,206,16.7,No,2014,No,No,No
Ognjen Miljkovic,541,46,448,186,118,88,1277.0,219,81,95.0,229,105,23.7,No,2014,No,No,No
Felix Von Hofe,1058,88,842,345,143,106,2963.0,657,262,77.0,185,83,17.0,No,2014,No,No,No
Thomas Reuter,230,69,228,81,89,49,1010.0,79,19,75.0,149,62,17.2,No,2014,No,No,No
Garrett Moon,71,6,66,32,15,5,361.0,6,2,20.0,60,30,13.0,No,2014,No,No,No
Daniel Hill,67,47,62,17,41,28,421.0,28,5,38.0,34,12,14.3,No,2014,No,No,No
Danny Powell,30,0,28,10,6,5,49.0,17,5,4.0,11,5,35.7,No,2014,No,No,No
Nate Galgalo,3,0,3,1,0,0,11.0,2,1,0.0,1,0,13.8,No,2014,No,No,No
Lucas Troutman,1626,80,1219,636,533,353,3168.0,4,1,218.0,1215,635,27.3,No,2014,No,No,No
Sebastian Koch,1128,262,873,371,187,144,3502.0,599,242,177.0,274,129,16.6,No,2014,No,No,No
Ryley Beaumont,1093,175,969,436,231,148,3354.0,242,73,191.0,727,363,19.4,No,2014,No,No,No
Tanner Samson,1320,220,1008,390,262,216,3616.0,862,324,116.0,146,66,17.4,No,2014,No,No,No
Jack Isenbarger,1438,290,1147,446,335,282,3361.0,721,264,206.0,426,182,23.0,No,2014,No,No,No
Austin Hamilton,833,303,695,295,239,157,2390.0,268,86,182.0,427,209,21.0,No,2014,No,No,No
Kevin Blake,504,89,371,168,230,138,1756.0,101,30,88.0,270,138,16.4,No,2014,No,No,No
Luke Eddy,782,296,594,252,266,199,2029.0,241,79,195.0,353,173,22.5,No,2014,No,No,No
Ryan Winters,285,47,216,106,104,73,1230.0,0,0,59.0,216,106,13.5,No,2014,No,No,No
Brian Dawkins,962,80,776,391,156,91,2212.0,247,89,116.0,529,302,22.4,No,2014,No,No,No
Christian Hairston,586,75,422,240,176,105,1785.0,8,1,126.0,414,239,17.6,No,2014,No,No,No
Tony Sabato,199,51,207,84,60,31,1067.0,1,0,66.0,206,84,14.4,No,2014,No,No,No
Ryder Bowline,15,3,12,6,4,0,34.0,9,3,4.0,3,3,26.8,No,2014,No,No,No
Wes Brewer,12,1,9,6,2,0,33.0,0,0,8.0,9,6,27.3,No,2014,No,No,No
Sam Hershberger,19,6,11,4,11,10,49.0,7,1,1.0,4,3,17.6,No,2014,No,No,No
Patrick Ryan,16,2,14,6,4,3,32.0,8,1,5.0,6,5,32.8,No,2014,No,No,No
D.J. Balentine,2464,472,1910,824,698,553,4644.0,702,263,295.0,1208,561,29.0,No,2014,No,No,No
Egidijus Mockevicius,1504,43,893,551,548,402,3497.0,0,0,178.0,893,551,20.2,No,2014,No,No,No
Blake Simmons,1088,326,879,379,239,185,4198.0,404,145,201.0,475,234,15.3,No,2014,No,No,No
Adam Wing,804,240,632,293,216,169,3328.0,124,49,186.0,508,244,14.7,No,2014,No,No,No
Duane Gibson,756,396,584,277,291,202,2861.0,3,0,283.0,581,277,18.8,No,2014,No,No,No
Jaylon Moore,430,17,287,177,141,76,1349.0,0,0,53.0,287,177,16.1,No,2014,No,No,No
Jaylon Brown,1369,339,970,464,484,376,3512.0,176,65,229.0,794,399,21.5,No,2014,No,No,No
David Howard,412,21,285,151,202,110,1206.0,2,0,56.0,283,151,19.2,No,2014,No,No,No
Ryan Sawvell,812,103,593,329,178,123,2581.0,80,31,100.0,513,298,15.8,No,2014,No,No,No
Tyler Ptacek,39,4,36,11,6,6,152.0,27,11,9.0,9,0,16.8,No,2014,No,No,No
Christian Benzon,322,72,240,109,187,98,1403.0,16,6,71.0,224,103,15.1,No,2014,No,No,No
Rokas Cesnulevicius,29,7,23,11,19,7,200.0,0,0,11.0,23,11,11.1,No,2014,No,No,No
Mike Leazer,0,1,2,0,0,0,10.0,0,0,2.0,2,0,21.4,No,2014,No,No,No
Maurice Barrow,1309,193,1041,484,429,298,3839.0,142,43,256.0,899,441,20.5,No,2014,No,No,No
Marcus Gilbert,1661,154,1246,531,468,357,3820.0,675,242,271.0,571,289,23.9,No,2014,No,No,No
K.J. Rose,371,188,337,130,158,87,1584.0,87,24,149.0,250,106,18.8,No,2014,No,No,No
Amadou Sidibe,752,97,587,302,227,148,2701.0,0,0,155.0,587,302,16.6,No,2014,No,No,No
Coleman Johnson,452,72,440,183,131,86,1972.0,2,0,101.0,438,183,16.2,No,2014,No,No,No
Justin Jenkins,439,77,401,139,144,99,1485.0,213,62,104.0,188,77,20.2,No,2014,No,No,No
Doug Chappell,95,14,93,27,41,23,342.0,55,18,31.0,38,9,21.8,No,2014,No,No,No
Sean Grennan,134,53,118,39,39,31,655.0,79,25,45.0,39,14,14.0,No,2014,No,No,No
Steve Johnston,236,37,209,65,72,50,973.0,182,56,41.0,27,9,15.9,No,2014,No,No,No
Steve Smith,138,15,144,45,9,7,528.0,134,41,18.0,10,4,16.5,No,2014,No,Yes,Yes
Malcolm Gilbert,102,13,103,44,30,14,636.0,0,0,28.0,103,44,12.1,No,2014,No,No,No
Lincoln Davis,389,84,312,120,164,107,1187.0,126,42,76.0,186,78,18.6,No,2014,No,No,No
Andrew Leone,13,4,10,1,12,10,39.0,9,1,2.0,1,0,22.8,No,2014,No,No,No
Sidney Sanders Jr.,716,273,603,242,262,193,1675.0,119,39,128.0,484,203,26.3,No,2014,No,No,No
Mustafaa Jones,877,135,763,278,142,126,2700.0,537,195,140.0,226,83,18.5,No,2014,No,No,No
Mathias Seilund,661,71,574,234,135,112,2331.0,211,81,132.0,363,153,16.9,No,2014,No,No,No
Matt MacDonald,627,95,505,198,165,124,2353.0,320,107,85.0,185,91,14.6,No,2014,No,No,No
Scooter Gillette,600,33,395,220,245,160,2122.0,2,0,112.0,393,220,14.7,No,2014,No,No,No
Xavier Harris,411,37,337,171,128,69,1382.0,0,0,100.0,337,171,18.5,No,2014,No,No,No
Malachi Nix,223,82,182,54,130,95,904.0,67,20,91.0,115,34,19.0,No,2014,No,No,No
Scott Kingsley,119,8,119,40,29,22,373.0,59,17,18.0,60,23,20.8,No,2014,No,No,No
Jayde Dawson,74,15,79,26,26,15,219.0,34,7,23.0,45,19,26.9,No,2014,No,No,No
Kyle Pearson,124,6,104,49,32,16,367.0,29,10,19.0,75,39,19.3,No,2014,No,No,No
Mike Owona,63,7,58,28,18,7,514.0,0,0,29.0,58,28,9.6,No,2014,No,No,No
Myles Mann,34,2,38,15,13,4,211.0,0,0,11.0,38,15,13.3,No,2014,No,No,No
Jamie Adams,970,211,795,293,321,251,1886.0,401,133,207.0,394,160,28.8,No,2014,No,No,No
Reggie Lewis,1176,167,1139,432,172,124,3169.0,517,188,143.0,622,244,20.3,Yes,2014,No,Yes,Yes
Jamari Bradshaw,589,66,509,216,164,91,1231.0,193,66,101.0,316,150,26.3,No,2014,No,No,No
Trey Kellum,1050,70,803,400,385,250,2698.0,2,0,207.0,801,400,21.4,No,2014,No,No,No
Bobby King,222,23,169,94,68,34,847.0,0,0,59.0,169,94,14.5,No,2014,No,No,No
D'Andre Bullard,307,138,362,117,69,45,1539.0,91,28,127.0,271,89,16.0,No,2014,No,No,No
Muhammad Abdul-Aleem,365,49,344,127,133,84,883.0,96,27,96.0,248,100,27.1,No,2014,No,No,No
Pierre Crawford,112,7,107,48,38,16,349.0,0,0,31.0,107,48,21.2,No,2014,No,No,No
Christopher Rozier,78,3,106,28,20,14,227.0,38,8,10.0,68,20,25.4,No,2014,No,No,No
Willie Conner,900,86,676,282,307,221,2303.0,339,115,129.0,337,167,19.4,No,2014,No,No,No
Richie Spiller,72,33,73,22,30,18,331.0,28,10,37.0,45,12,17.3,No,2014,No,No,No
Walter Davis,134,42,111,57,57,20,1112.0,2,0,40.0,109,57,7.6,Yes,2014,Yes,Yes,Yes
Greg Nelson,37,2,29,9,14,12,128.0,23,7,8.0,6,2,15.7,No,2014,No,No,No
Onyekachukwu Odi,91,6,100,34,67,23,636.0,0,0,51.0,100,34,13.6,No,2014,No,No,No
Pablo Bertone,1153,173,954,422,278,198,2625.0,316,111,211.0,638,311,25.6,No,2014,No,No,No
Marquan Botley,1018,272,868,319,270,214,2552.0,456,166,131.0,412,153,23.3,No,2014,No,No,No
Justin Raffington,602,58,481,227,256,143,1957.0,26,5,167.0,455,222,20.5,No,2014,No,No,No
Jackson Trapp,926,168,804,313,167,127,3323.0,479,173,161.0,325,140,16.5,No,2014,No,No,No
D'Andre Johnson,284,89,245,94,80,58,1010.0,119,38,79.0,126,56,18.7,No,2014,No,No,No
Kelvin Penn,382,57,309,168,109,46,2804.0,0,0,115.0,309,168,8.9,No,2014,No,No,No
Dragan Sekelja,246,73,208,91,104,61,981.0,9,3,102.0,199,88,18.9,No,2014,No,No,No
Richard Morrow,136,23,117,50,60,34,580.0,6,2,47.0,111,48,17.1,No,2014,No,No,No
Javier Lacunza,175,9,157,58,39,30,698.0,94,29,32.0,63,29,15.8,No,2014,No,No,No
Grant Pelchen,21,10,19,9,10,3,131.0,0,0,2.0,19,9,10.1,No,2014,No,No,No
Tyler Pate,16,4,19,5,5,3,75.0,15,3,4.0,4,2,17.4,No,2014,No,No,No
Brian Hornstein,40,2,47,19,8,2,180.0,1,0,11.0,46,19,17.8,No,2014,No,No,No
Bernard Thompson,1835,246,1466,636,487,344,4031.0,601,219,278.0,865,417,24.8,Yes,2014,No,No,No
Chase Fieler,1306,203,971,487,317,229,3458.0,327,103,201.0,644,384,19.2,No,2014,No,No,No
Brett Comer,1477,845,1247,536,459,304,4047.0,324,101,460.0,923,435,24.2,No,2014,No,No,No
Jamail Jones,645,78,596,240,160,102,2050.0,215,63,120.0,381,177,19.7,No,2014,No,No,No
Filip Cvjeticanin,699,43,617,235,71,47,2129.0,496,182,85.0,121,53,17.3,No,2014,No,No,No
Dajuan Graf,971,417,751,347,301,224,3338.0,162,53,230.0,589,294,16.8,No,2014,No,No,No
Eric McKnight,506,24,343,210,175,86,1780.0,1,0,116.0,342,210,15.4,No,2014,No,No,No
Nate Hicks,323,22,231,131,105,61,1424.0,1,0,56.0,230,131,12.2,No,2014,No,No,No
Marcus Blake,45,10,43,14,28,17,284.0,1,0,18.0,42,14,13.3,No,2014,No,No,No
Kevin Boyle,21,8,19,4,10,9,106.0,15,4,7.0,4,0,14.8,No,2014,No,No,No
Armand Shoon,6,4,13,2,6,2,80.0,5,0,3.0,8,2,12.1,No,2014,No,No,No
TeJai Allen,5,0,5,1,4,3,33.0,0,0,5.0,5,1,18.5,No,2014,No,No,No
Tymell Murphy,984,132,680,394,258,171,2040.0,84,25,172.0,596,369,24.0,No,2014,No,No,No
Rakeem Buckles,699,65,538,250,227,158,1745.0,122,41,146.0,416,209,22.9,No,2014,No,No,No
Dennis Mavin,1242,201,1008,412,578,356,3002.0,210,62,266.0,798,350,27.1,No,2014,No,No,No
Jerome Frink,1623,159,1296,619,455,297,3910.0,270,88,286.0,1026,531,22.5,No,2014,No,No,No
Marco Porcher Jimenez,464,42,416,161,62,47,1383.0,278,95,57.0,138,66,18.5,No,2014,No,No,No
Cody Mann,127,52,112,42,39,26,566.0,44,17,28.0,68,25,14.5,No,2014,No,No,No
Jason Boswell,290,129,264,99,81,61,1703.0,106,31,114.0,158,68,12.7,No,2014,No,No,No
Dominique Williams,438,46,399,171,106,73,1605.0,85,23,72.0,314,148,17.0,No,2014,No,No,No
Raymond Taylor,1110,462,1031,375,266,189,2941.0,507,171,245.0,524,204,24.4,No,2014,No,No,No
Ivan Jurkovic,55,3,55,21,18,13,326.0,4,0,23.0,51,21,13.3,No,2014,No,No,No
Joey De La Rosa,58,4,61,24,28,10,350.0,0,0,22.0,61,24,14.2,No,2014,No,No,No
Steven Miro,81,21,70,27,28,21,401.0,17,6,20.0,53,21,12.9,No,2014,No,No,No
Jonas Page,13,0,10,4,2,2,30.0,8,3,1.0,2,1,20.9,No,2014,No,No,No
George Naldjieff,4,0,5,2,0,0,25.0,0,0,2.0,5,2,14.3,No,2014,No,No,No
Aaron Thomas,815,116,628,277,271,209,1938.0,163,52,152.0,465,225,24.5,No,2014,No,No,No
Okaro White,1402,95,944,466,502,401,3417.0,211,69,217.0,733,397,21.0,Yes,2014,No,No,No
Ian Miller,977,193,802,324,227,183,2349.0,408,146,193.0,394,178,24.1,No,2014,No,No,No
Devon Bookert,1120,347,856,359,270,214,3567.0,449,188,246.0,407,171,17.7,No,2014,No,No,No
Montay Brandon,899,196,669,311,409,252,3509.0,95,25,221.0,574,286,16.0,No,2014,No,No,No
Boris Bojanovsky,683,60,423,244,282,195,2257.0,4,0,127.0,419,244,15.5,No,2014,No,No,No
Robert Gilchrist,154,10,153,68,39,14,683.0,17,4,48.0,136,64,16.8,No,2014,No,No,No
Michael Ojo,351,25,240,126,174,99,1282.0,0,0,96.0,240,126,16.5,No,2014,No,No,No
Jarquez Smith,612,39,468,239,172,117,1879.0,70,17,130.0,398,222,18.1,No,2014,No,No,No
Brandon Allen,90,16,73,33,6,6,323.0,46,18,22.0,27,15,14.9,No,2014,No,No,No
Joell Hopkins,227,9,160,84,107,59,625.0,5,0,37.0,155,84,19.1,No,2014,No,No,No
Marquez White,3,0,2,1,0,0,10.0,2,1,1.0,0,0,15.6,No,2014,No,No,No
Casey Prather,787,109,541,308,254,161,2019.0,32,10,149.0,509,298,21.5,No,2014,No,No,No
Michael Frazier,998,114,718,318,158,135,2593.0,526,227,122.0,192,91,19.1,Yes,2014,No,No,No
Scottie Wilbekin,953,419,769,320,246,175,3462.0,367,138,182.0,402,182,16.6,No,2014,No,No,No
Patric Young,1307,115,929,536,413,235,3638.0,0,0,187.0,929,536,19.3,No,2014,No,No,No
Dorian Finney-Smith,1429,256,1168,480,432,284,3834.0,511,185,240.0,657,295,21.9,Yes,2014,No,No,No
Will Yeguete,515,110,383,189,238,132,2347.0,25,5,124.0,358,184,14.2,No,2014,No,No,No
Kasey Hill,1087,530,988,390,446,266,3600.0,172,41,304.0,816,349,21.3,No,2014,No,No,No
DeVon Walker,434,89,374,144,179,118,1797.0,110,28,83.0,264,116,15.2,No,2014,No,No,No
Jacob Kurtz,188,41,120,73,63,41,877.0,3,1,44.0,117,72,12.0,No,2014,No,No,No
Chris Walker,179,3,146,80,51,19,540.0,3,0,34.0,143,80,20.6,No,2014,No,No,No
Billy Donovan,4,3,9,0,4,4,44.0,8,0,3.0,1,0,17.0,Yes,2014,No,No,No
Eli Carter,1544,300,1384,525,375,292,3417.0,657,202,308.0,727,323,28.8,No,2014,No,No,No
Lexx Edwards,4,2,7,1,2,1,53.0,5,1,1.0,2,0,8.5,No,2014,No,No,No
Dillon Graham,11,5,22,5,0,0,92.0,12,1,4.0,10,4,15.4,No,2014,No,No,No
Branden Frazier,1642,495,1447,539,479,378,4138.0,634,186,317.0,813,353,23.4,No,2014,No,No,No
Jon Severe,1305,218,1130,431,324,259,2885.0,516,184,241.0,614,247,26.0,No,2014,No,No,No
Mandell Thomas,1385,274,1227,483,363,255,3607.0,460,164,212.0,767,319,22.2,No,2014,No,No,No
Bryan Smith,902,183,901,311,173,124,3053.0,535,156,173.0,366,155,18.6,No,2014,No,No,No
Ryan Rhoomes,953,94,631,389,308,175,3178.0,0,0,138.0,631,389,14.4,No,2014,No,No,No
Travion Leonard,335,19,300,141,97,53,1019.0,2,0,82.0,298,141,20.3,No,2014,No,No,No
Ryan Canty,323,15,259,138,108,47,1267.0,0,0,59.0,259,138,14.2,No,2014,No,No,No
Chris Whitehead,72,29,55,28,28,16,343.0,1,0,19.0,54,28,12.2,No,2014,No,No,No
Jermaine Myers,154,96,136,47,55,42,914.0,68,18,64.0,68,29,12.0,No,2014,No,No,No
Jake Fay,24,3,41,7,4,3,124.0,31,7,8.0,10,0,20.2,No,2014,No,No,No
Jared Fay,11,0,9,4,2,0,32.0,6,3,2.0,3,1,18.1,No,2014,No,No,No
Matt Massimino,2,1,4,1,0,0,23.0,0,0,1.0,4,1,11.0,No,2014,No,No,No
Leo Walsh,4,1,4,2,0,0,16.0,0,0,2.0,4,2,18.1,No,2014,No,No,No
DC Gaitley,2,0,1,1,0,0,12.0,0,0,0.0,1,1,4.1,No,2014,No,No,No
Khalid Robinson,13,2,13,3,12,7,162.0,2,0,15.0,11,3,10.1,No,2014,No,No,No
Marvelle Harris,2031,396,1595,667,678,506,4524.0,568,191,264.0,1027,476,25.3,No,2014,No,No,No
Tyler Johnson,1350,303,1077,491,348,249,3538.0,320,119,176.0,757,372,21.5,Yes,2014,No,No,No
Cezar Guerrero,1147,309,938,373,287,232,3004.0,478,169,197.0,460,204,22.3,No,2014,No,No,No
Paul Watson,1361,116,1121,465,354,250,4014.0,500,181,202.0,621,284,19.4,Yes,2014,No,No,No
Allen Huddleston,1163,170,889,341,467,307,2996.0,521,174,166.0,368,167,23.4,No,2014,No,No,No
Alex Davis,344,39,254,121,159,100,1551.0,11,2,95.0,243,119,14.7,No,2014,No,No,No
Karachi Edo,863,41,615,327,334,204,2470.0,20,5,77.0,595,322,17.8,No,2014,No,No,No
Tanner Giddings,112,12,116,49,21,12,813.0,6,2,25.0,110,47,10.1,No,2014,No,No,No
Emmanuel Owootoah,159,83,136,47,55,39,991.0,83,26,61.0,53,21,12.2,No,2014,No,No,No
Blake Williams,12,1,9,5,2,0,30.0,6,2,3.0,3,3,23.0,No,2014,No,No,No
Broderick Newbill,532,38,406,199,165,108,1396.0,83,26,92.0,323,173,20.4,No,2014,No,No,No
Kyle Jackson,0,1,1,0,0,0,17.0,0,0,0.0,1,0,3.1,No,2014,No,No,No
Michael Salazar,0,0,2,0,0,0,10.0,2,0,0.0,0,0,10.7,No,2014,No,No,No
Stephen Croone,1936,385,1294,573,872,651,3744.0,463,139,365.0,831,434,29.6,No,2014,No,No,No
Kendrec Ferrara,893,83,756,357,227,129,2998.0,163,50,204.0,593,307,19.2,No,2014,No,No,No
Larry Wideman,723,115,679,246,154,105,2686.0,389,126,162.0,290,120,18.3,No,2014,No,No,No
William Gates,481,48,434,189,121,61,1660.0,132,42,95.0,302,147,17.5,No,2014,No,No,No
Charlie Reddick,746,132,609,250,181,131,2209.0,330,115,144.0,279,135,20.2,No,2014,No,No,No
Keith Belfield,186,26,159,58,54,38,681.0,81,32,41.0,78,26,17.8,No,2014,No,No,No
Adonis Rwabigwi,276,20,202,98,138,80,1306.0,1,0,88.0,201,98,13.7,No,2014,No,No,No
Kris Acox,1051,85,731,448,297,155,3027.0,1,0,175.0,730,448,18.3,No,2014,No,No,No
Dominic Early,147,17,147,50,42,27,488.0,82,20,15.0,65,30,19.7,No,2014,No,No,No
Aaron O'Neill,52,17,46,17,6,4,396.0,39,14,9.0,7,3,7.9,No,2014,No,No,No
Kevin Chuisseu,63,7,59,22,51,19,445.0,1,0,28.0,58,22,13.6,No,2014,No,No,No
T.K. Hayes,14,3,17,4,8,5,61.0,10,1,6.0,7,3,23.4,No,2014,No,No,No
Jerome Hill,1292,122,907,440,643,406,2703.0,40,6,200.0,867,434,26.5,No,2014,No,No,No
Naji Hibbert,706,168,657,242,175,117,2572.0,316,105,113.0,341,137,17.2,No,2014,No,No,No
Tyler Strange,927,651,825,319,180,117,3921.0,499,172,269.0,326,147,15.4,No,2014,No,No,No
Donta Harper,902,149,729,332,331,236,2231.0,30,2,225.0,699,330,25.7,No,2014,No,No,No
Tyrell Nelson,1664,139,1167,653,550,345,3412.0,39,13,253.0,1128,640,24.2,No,2014,No,No,No
Onzie Branch,292,51,233,111,104,70,1013.0,12,0,64.0,221,111,17.6,No,2014,No,No,No
Josh Castellanos,619,369,541,173,280,204,2814.0,230,69,258.0,311,104,17.4,No,2014,No,No,No
Isaiah Ivey,572,85,485,183,152,122,1889.0,239,84,66.0,246,99,16.2,No,2014,No,No,No
Michael Byron,457,25,322,173,180,111,1797.0,0,0,110.0,322,173,14.8,No,2014,No,No,No
Jarvis Davis,522,74,397,165,131,113,1449.0,222,79,96.0,175,86,19.5,No,2014,No,No,No
Logan Stumpf,29,2,20,10,6,5,66.0,14,4,4.0,6,6,20.6,No,2014,No,No,No
Donell Tuff,12,0,11,6,6,0,40.0,1,0,1.0,10,6,18.8,No,2014,No,No,No
Corey Hensley,135,8,121,60,27,15,573.0,0,0,29.0,121,60,14.7,No,2014,No,No,No
Adam Sweeney,13,4,23,5,2,2,62.0,10,1,3.0,13,4,22.1,No,2014,No,No,No
Sherrod Wright,1593,138,1132,529,566,428,3530.0,316,107,263.0,816,422,24.1,No,2014,No,No,No
Bryon Allen,1048,380,871,380,283,220,3082.0,216,68,239.0,655,312,20.7,No,2014,No,No,No
Patrick Holloway,786,62,746,286,97,72,1912.0,395,142,91.0,351,144,23.7,No,2014,No,No,No
Jalen Jenkins,1106,163,786,413,424,279,3028.0,5,1,250.0,781,412,20.6,No,2014,No,No,No
Marko Gujanicic,715,130,622,258,200,140,2326.0,205,59,162.0,417,199,19.2,No,2014,No,No,No
Johnny Williams,468,44,426,190,152,88,1693.0,6,0,99.0,420,190,18.2,No,2014,No,No,No
Erik Copes,420,29,353,175,138,70,1836.0,0,0,101.0,353,175,14.5,No,2014,No,No,No
Marquise Moore,1270,363,987,440,518,373,3554.0,69,17,259.0,918,423,21.1,No,2014,No,No,No
Corey Edwards,480,284,395,149,147,108,2316.0,206,74,207.0,189,75,14.9,No,2014,No,No,No
Vaughn Gray,289,23,288,100,77,40,1074.0,148,49,42.0,140,51,17.5,No,2014,No,No,No
Anali Okoloji,355,37,308,115,152,106,1185.0,82,19,73.0,226,96,19.6,No,2014,No,No,No
Jonathan Arledge,821,68,662,296,273,198,1991.0,103,31,135.0,559,265,24.5,No,2014,No,No,No
Maurice Creek,841,108,664,280,178,135,1791.0,382,146,119.0,282,134,24.5,No,2014,No,No,No
Isaiah Armwood,923,118,670,331,387,256,2859.0,25,5,181.0,645,326,18.0,No,2014,No,No,No
Kevin Larsen,1470,282,1093,559,497,328,4209.0,59,24,226.0,1034,535,18.8,No,2014,No,No,No
Patricio Garino,1550,221,1116,567,468,314,3877.0,280,102,289.0,836,465,21.3,Yes,2014,No,No,No
Joe McDonald,1154,447,930,378,465,305,3965.0,270,93,273.0,660,285,18.3,No,2014,No,No,No
Kethan Savage,982,191,736,322,404,290,2488.0,171,48,178.0,565,274,23.1,No,2014,No,No,No
Nemanja Mikic,742,70,690,258,70,37,2438.0,497,189,109.0,193,69,17.4,No,2014,No,No,No
John Kopriva,430,45,351,163,149,85,1909.0,43,19,79.0,308,144,13.6,No,2014,No,No,No
Nick Griffin,868,69,754,303,97,76,2302.0,476,186,87.0,278,117,21.0,No,2014,No,No,No
Miguel Cartagena,33,32,49,11,13,7,206.0,24,4,23.0,25,7,19.0,No,2014,No,No,No
Paris Maragkos,268,31,231,111,54,36,611.0,26,10,68.0,205,101,30.0,No,2014,No,No,No
Skyler White,33,7,33,12,7,4,71.0,17,5,2.0,16,7,27.3,No,2014,No,No,No
D'Vauntes Smith-Rivera,1919,386,1419,600,565,469,4257.0,691,250,215.0,728,350,23.6,No,2014,No,No,No
Markel Starks,1246,300,1026,438,252,205,3361.0,459,165,201.0,567,273,21.7,No,2014,No,No,No
Jabril Trawick,851,205,579,270,334,237,2884.0,221,74,176.0,358,196,17.1,No,2014,No,No,No
Mikael Hopkins,629,129,503,213,313,200,2268.0,12,3,196.0,491,210,20.2,No,2014,No,No,No
Aaron Bowen,451,66,375,181,124,61,1410.0,110,28,91.0,265,153,19.9,No,2014,No,No,No
Nate Lubick,640,252,460,260,196,113,3009.0,32,7,169.0,428,253,13.1,No,2014,No,No,No
Joshua Smith,1211,85,755,446,520,319,2283.0,1,0,210.0,754,446,27.7,No,2014,No,No,No
Reggie Cameron,357,64,310,116,71,53,1225.0,221,72,56.0,89,44,16.9,No,2014,No,No,No
Moses Abraham,141,25,99,52,79,37,919.0,0,0,62.0,99,52,11.8,No,2014,No,No,No
John Caprio,29,15,30,10,22,9,154.0,3,0,17.0,27,10,20.2,No,2014,No,No,No
Bradley Hayes,372,56,290,155,118,62,1066.0,0,0,81.0,290,155,20.4,No,2014,No,No,No
Stephen Domingo,153,46,202,52,54,22,935.0,134,27,21.0,68,25,13.8,No,2014,No,No,No
David Allen,8,1,8,2,5,2,42.0,7,2,2.0,1,0,15.8,No,2014,No,No,No
Riyan Williams,8,4,10,2,9,4,56.0,4,0,4.0,6,2,16.7,No,2014,No,No,No
Jelani Hewitt,1810,340,1488,573,490,394,4042.0,768,270,343.0,720,303,26.3,No,2014,No,No,No
Tre Bussey,1206,138,1038,429,285,193,3303.0,426,155,176.0,612,274,21.4,No,2014,No,No,No
Brian Holmes,435,132,353,140,133,94,1603.0,171,61,112.0,182,79,17.2,No,2014,No,No,No
Angel Matias,484,69,387,194,156,87,1543.0,51,9,97.0,336,185,18.6,No,2014,No,No,No
Curtis Diamond,459,59,465,159,107,66,1500.0,270,75,69.0,195,84,20.1,No,2014,No,No,No
Marvin Baynham,580,49,396,221,249,138,2611.0,0,0,173.0,396,221,13.8,No,2014,No,No,No
Kyle Doyle,241,22,217,100,97,37,986.0,15,4,71.0,202,96,17.4,No,2014,No,No,No
Torloft Thomas,545,144,458,157,187,142,1924.0,265,89,137.0,193,68,17.2,No,2014,No,No,No
Sam Mike,110,3,87,45,40,20,781.0,0,0,41.0,87,45,9.8,No,2014,No,No,No
Kameron Dunnican,84,13,67,36,28,12,594.0,0,0,44.0,67,36,11.2,No,2014,No,No,No
Grayson Clark,20,1,18,7,4,2,52.0,8,4,3.0,10,3,22.7,No,2014,No,No,No
Scott Kelly,5,1,3,2,4,1,47.0,0,0,3.0,3,2,8.7,No,2014,No,No,No
Zach Altany,3,0,16,1,0,0,26.0,11,1,1.0,5,0,33.7,No,2014,No,No,No
Cole Rives,8,1,11,2,4,2,36.0,8,2,1.0,3,0,20.4,No,2014,No,No,No
D.J. Suter,12,1,11,5,0,0,31.0,7,2,0.0,4,3,18.1,No,2014,No,No,No
Ryan Harrow,1692,426,1423,636,396,314,3528.0,338,106,211.0,1085,530,27.3,No,2014,No,No,No
R.J. Hunter,1819,240,1321,559,525,448,3438.0,715,253,168.0,606,306,27.5,No,2014,No,No,No
Manny Atkins,1140,138,841,375,290,234,2885.0,381,156,141.0,460,219,20.8,No,2014,No,No,No
Devonta White,1393,415,1120,465,431,336,3721.0,388,127,255.0,732,338,22.6,No,2014,No,No,No
Curtis Washington,431,12,285,175,116,81,1360.0,0,0,49.0,285,175,15.5,No,2014,No,No,No
Markus Crider,824,132,598,330,249,164,3069.0,7,0,158.0,591,330,15.5,No,2014,No,No,No
Rashaad Richardson,497,53,473,186,37,24,1687.0,295,101,52.0,178,85,17.1,No,2014,No,No,No
Jaylen Hinton,41,23,32,13,27,15,210.0,2,0,4.0,30,13,12.5,No,2014,No,No,No
T.J. Shipes,355,18,247,144,142,67,1809.0,0,0,71.0,247,144,11.6,No,2014,No,No,No
LaRon Smith,314,25,242,137,107,40,1220.0,0,0,61.0,242,137,14.2,No,2014,No,No,No
Denny Burguillos,40,2,33,16,17,8,339.0,0,0,13.0,33,16,8.6,No,2014,No,No,No
Kevin Shaw,23,4,24,7,4,2,56.0,22,7,4.0,2,0,28.4,No,2014,No,No,No
Ryann Green,141,60,119,43,50,36,931.0,74,19,34.0,45,24,10.4,No,2014,No,No,No
Isaiah Dennis,347,136,244,141,123,61,1282.0,7,4,88.0,237,137,16.0,No,2014,No,No,No
Darius Sharpe,3,0,2,1,0,0,7.0,2,1,1.0,0,0,23.1,No,2014,No,No,No
Trae Golden,1342,441,1013,402,511,408,3384.0,399,130,255.0,614,272,23.3,No,2014,No,No,No
Marcus Georges-Hunt,1728,287,1314,569,625,468,4017.0,371,122,220.0,943,447,23.3,Yes,2014,No,No,No
Daniel Miller,1007,183,803,423,257,161,3627.0,1,0,186.0,802,423,15.9,No,2014,No,No,No
Robert Carter,1012,123,792,391,252,172,2383.0,195,58,170.0,597,333,23.6,No,2014,No,No,No
Kammeon Holsey,912,95,677,373,282,166,2473.0,0,0,207.0,677,373,21.4,No,2014,No,No,No
Chris Bolden,560,102,591,209,67,45,1997.0,312,97,100.0,279,112,18.7,No,2014,No,No,No
Quinton Stephens,857,157,827,303,158,113,2931.0,442,138,145.0,385,165,18.2,No,2014,No,No,No
Solomon Poole,591,140,622,220,90,54,1608.0,313,97,184.0,309,123,28.0,No,2014,No,No,No
Stacey Poole,113,17,113,39,46,29,373.0,28,6,22.0,85,33,21.9,No,2014,No,No,No
Corey Heyward,134,93,136,41,58,33,1394.0,60,19,54.0,76,22,8.0,No,2014,No,No,No
Jason Morris,515,60,507,185,115,79,1651.0,196,66,123.0,311,119,21.5,No,2014,No,No,No
Travis Jorgenson,180,168,209,67,30,20,1059.0,91,26,81.0,118,41,14.7,No,2014,No,No,No
Brooks Doyle,12,3,15,4,4,2,72.0,10,2,3.0,5,2,14.3,No,2014,No,No,No
Ron Wamer,6,2,4,2,3,2,33.0,2,0,3.0,2,2,13.4,No,2014,No,No,No
Aaron Peek,2,0,6,1,0,0,27.0,2,0,2.0,4,1,15.5,No,2014,No,No,No
Colin Gurry,0,0,0,0,0,0,7.0,0,0,1.0,0,0,7.5,No,2014,No,No,No
Charles Mann,1411,400,925,365,895,618,3645.0,192,63,399.0,733,302,25.1,No,2014,No,No,No
Kenny Gaines,1324,125,1091,444,302,223,3138.0,569,213,154.0,522,231,23.0,No,2014,No,No,No
Nemanja Djurisic,1123,147,910,399,312,219,3188.0,291,106,238.0,619,293,21.9,No,2014,No,No,No
Marcus Thornton,829,91,687,289,361,230,2885.0,72,21,165.0,615,268,18.9,Yes,2014,No,No,No
Brandon Morris,398,67,270,124,220,140,1309.0,33,10,89.0,237,114,18.8,No,2014,No,No,No
Donte Williams,588,44,476,225,243,137,2409.0,2,1,86.0,474,224,15.3,No,2014,No,No,No
Juwan Parker,793,148,702,259,274,227,2604.0,191,48,142.0,511,211,19.2,No,2014,No,No,No
Cameron Forte,831,128,599,347,256,136,1600.0,4,1,149.0,595,346,26.7,No,2014,No,No,No
J.J. Frazier,1628,422,1212,487,535,450,3528.0,576,204,201.0,636,283,24.1,No,2014,No,No,No
Taylor Echols,68,12,65,22,8,2,288.0,62,22,21.0,3,0,16.4,No,2014,No,No,No
Tim Dixon,91,21,89,38,24,15,728.0,0,0,34.0,89,38,10.0,No,2014,No,No,No
John Cannon,172,7,140,73,34,26,480.0,2,0,30.0,138,73,20.5,No,2014,No,No,No
Kenny Paul Geno,191,74,172,70,42,26,1240.0,80,25,32.0,92,45,9.2,No,2014,No,No,No
Houston Kessler,113,10,130,45,30,17,925.0,38,6,36.0,92,39,9.9,No,2014,No,No,No
Dusan Langura,29,0,34,10,0,0,88.0,30,9,2.0,4,1,20.1,No,2014,No,No,No
Brandon Young,1,1,11,0,2,1,33.0,3,0,3.0,8,0,23.2,No,2014,No,No,No
Kevin Pangos,1824,536,1306,566,439,370,4689.0,776,322,222.0,530,244,19.3,No,2014,No,No,No
Sam Dower,1271,79,872,490,340,271,2552.0,61,20,152.0,811,470,23.9,No,2014,No,No,No
Przemek Karnowski,1495,165,1033,615,511,264,3212.0,3,1,245.0,1030,614,24.3,No,2014,No,No,No
Gary Bell Jr.,1291,265,968,433,274,206,3823.0,536,219,162.0,432,214,17.2,No,2014,No,No,No
David Stockton,661,423,526,223,207,145,2741.0,229,70,202.0,297,153,15.5,Yes,2014,No,No,No
Drew Barham,410,38,328,136,52,32,1161.0,257,106,39.0,71,30,17.2,No,2014,No,No,No
Kyle Dranginis,703,298,548,255,153,98,2960.0,267,95,141.0,281,160,13.3,No,2014,No,No,No
Gerard Coleman,917,134,799,349,322,197,2325.0,97,22,164.0,702,327,23.6,No,2014,No,No,No
Angel Nunez,501,50,430,180,152,106,1365.0,136,35,106.0,294,145,22.6,No,2014,No,No,No
Ryan Edwards,460,25,362,176,139,97,985.0,36,11,73.0,326,165,23.4,No,2014,No,No,No
Luke Meikle,774,77,745,280,158,120,2212.0,294,94,91.0,451,186,21.4,No,2014,No,No,No
Brian Bhaskar,9,1,8,3,4,1,32.0,3,2,1.0,5,1,17.6,No,2014,No,No,No
Connor Griffin,13,2,9,4,10,5,88.0,0,0,3.0,9,4,10.0,No,2014,No,No,No
A'Torri Shine,769,59,641,260,230,172,1852.0,241,77,127.0,400,183,24.5,No,2014,No,No,No
Antwan Scott,939,168,693,298,254,199,1879.0,356,144,152.0,337,154,25.4,No,2014,No,No,No
Chandler Thomas,412,20,343,155,145,89,1190.0,34,13,73.0,309,142,20.3,No,2014,No,No,No
Terry Rose,619,46,546,217,63,48,1601.0,376,140,93.0,170,77,21.8,No,2014,No,No,No
Remond Brown,976,155,868,373,261,167,2833.0,207,63,202.0,661,310,21.3,No,2014,No,No,No
Steven Danridge,309,30,255,126,126,57,1746.0,1,0,111.0,254,126,12.6,No,2014,No,No,No
Chase Cormier,354,274,346,93,237,136,2467.0,121,32,194.0,225,61,13.5,No,2014,No,No,No
Windale Glinton,85,5,77,36,19,13,385.0,2,0,20.0,75,36,13.8,No,2014,No,No,No
Richard Freeman,270,33,269,90,141,80,1036.0,50,10,87.0,219,80,21.3,No,2014,No,No,No
Tyron Bain,59,13,52,17,34,24,225.0,11,1,25.0,41,16,20.8,No,2014,No,No,No
Dion Watson,12,1,23,4,4,3,46.0,12,1,1.0,11,3,28.2,No,2014,No,No,No
Valerio Altheimer,99,14,92,39,40,19,445.0,17,2,21.0,75,37,15.6,No,2014,No,No,No
Floyddell Wilson,3,0,1,0,4,3,8.0,0,0,0.0,1,0,18.2,No,2014,No,No,No
Brauhnye' Turner,33,5,52,14,16,5,195.0,2,0,9.0,50,14,18.7,No,2014,No,No,No
Travis Hawkins,0,0,0,0,0,0,0.0,0,0,0.0,0,0,0,No,2014,No,No,No
Isiah Patterson,42,8,42,13,10,7,175.0,27,9,10.0,15,4,16.6,No,2014,No,No,No
Reginald Smith,3,0,3,1,2,1,10.0,0,0,0.0,3,1,21.1,No,2014,No,No,No
Killian Larson,516,24,333,180,210,155,980.0,3,1,76.0,330,179,26.9,No,2014,No,No,No
Jerome Garrison,745,104,488,215,326,244,1982.0,195,71,92.0,293,144,19.5,No,2014,No,No,No
Daniel Alexander,609,109,485,216,89,76,1731.0,284,101,105.0,201,115,19.4,No,2014,No,No,No
Blake Davis,238,54,206,78,45,36,943.0,134,46,41.0,72,32,14.8,No,2014,No,No,No
Demetrius Walker,616,115,479,181,244,180,1461.0,212,74,126.0,267,107,26.2,No,2014,No,No,No
Justin Foreman,432,61,326,136,190,111,1292.0,135,49,76.0,191,87,18.3,No,2014,No,No,No
Akachi Okugo,107,63,111,29,50,35,602.0,58,14,39.0,53,15,15.0,No,2014,No,No,No
Jeremy Adams,241,24,207,70,134,87,935.0,52,14,58.0,155,56,18.4,No,2014,No,No,No
Sam Daly,141,91,110,49,62,37,664.0,28,6,70.0,82,43,16.6,No,2014,No,No,No
Jake Zuilhof,481,50,336,180,204,121,1729.0,0,0,135.0,336,180,16.0,No,2014,No,No,No
Jeff Lowery,406,181,342,141,145,103,1465.0,54,21,121.0,288,120,17.3,No,2014,No,No,No
Jevon Estelle,23,6,24,8,9,6,109.0,9,1,7.0,15,7,16.3,No,2014,No,No,No
Ben Sanders,10,2,8,4,2,1,25.0,2,1,3.0,6,3,24.8,No,2014,No,No,No
Keifer Sykes,2096,522,1570,713,712,557,4236.0,346,113,286.0,1224,600,27.0,No,2014,No,No,No
Alec Brown,1678,111,1299,604,524,392,3693.0,195,78,263.0,1104,526,25.5,No,2014,No,No,No
Greg Mays,989,69,735,387,308,198,2608.0,63,17,158.0,672,370,20.7,No,2014,No,No,No
Carrington Love,1289,356,1052,421,444,287,3575.0,502,160,205.0,550,261,20.0,No,2014,No,No,No
Jordan Fouse,1136,397,924,421,396,242,4171.0,187,52,248.0,737,369,16.1,No,2014,No,No,No
Vincent Garrett,168,35,147,60,43,32,425.0,35,16,31.0,112,44,23.7,No,2014,No,No,No
Kenneth Lowe,720,139,563,309,229,102,2606.0,1,0,161.0,562,309,15.0,No,2014,No,No,No
Lamin Fulton,342,72,328,118,49,35,1228.0,213,71,82.0,115,47,18.4,No,2014,No,No,No
Tevin Findlay,359,144,330,133,119,74,1255.0,70,19,100.0,260,114,17.8,No,2014,No,No,No
Alfonzo McKinnie,689,23,536,271,193,120,1811.0,77,27,121.0,459,244,21.9,Yes,2014,No,No,No
Turner Botz,477,70,407,145,118,88,1808.0,277,99,56.0,130,46,13.1,No,2014,No,No,No
Josh Humphrey,35,20,50,11,29,13,434.0,3,0,23.0,47,11,10.3,No,2014,No,No,No
Du'Vaughn Maxwell,965,87,741,379,384,202,2481.0,24,5,165.0,717,374,21.3,No,2014,No,No,No
Deron Powers,1497,561,1196,469,517,425,4199.0,426,134,331.0,770,335,20.6,No,2014,No,No,No
Brian Darden,1152,140,947,330,315,261,2762.0,672,231,157.0,275,99,21.8,No,2014,No,No,No
Emmanuel Okoroba,565,33,452,188,313,189,1736.0,0,0,150.0,452,188,21.0,No,2014,No,No,No
Dwight Meikle,738,56,585,288,197,138,1836.0,82,24,184.0,503,264,22.9,No,2014,No,No,No
Ramon Mercado,402,49,378,131,82,63,1161.0,258,77,69.0,120,54,20.3,No,2014,No,No,No
Ke'Ron Brown,454,128,448,151,234,131,2155.0,128,21,156.0,320,130,16.1,No,2014,No,No,No
Jervon Pressley,632,62,535,229,322,174,2207.0,2,0,210.0,533,229,19.8,No,2014,No,No,No
Lawrence Cooks,743,150,597,229,202,164,2282.0,338,121,131.0,259,108,17.3,No,2014,No,No,No
Breon Key,198,49,139,63,81,56,722.0,61,16,38.0,78,47,14.6,No,2014,No,No,No
Reggie Price,55,3,69,21,4,1,198.0,44,12,11.0,25,9,20.0,No,2014,No,No,No
Miles Jackson,30,7,20,11,7,4,127.0,8,4,7.0,12,7,11.4,No,2014,No,No,No
Dionte Adams,226,29,191,86,85,54,1027.0,3,0,48.0,188,86,12.9,No,2014,No,No,No
Gregory Hayden,25,7,18,6,21,11,57.0,6,2,15.0,12,4,36.2,No,2014,No,No,No
Phillip Reed,24,5,24,8,15,8,242.0,0,0,12.0,24,8,8.7,No,2014,No,No,No
Mark Nwakamma,1550,203,1174,598,477,315,3235.0,120,39,342.0,1054,559,29.9,No,2014,No,No,No
Yolonzo Moore II,1078,289,846,349,340,250,3945.0,403,130,255.0,443,219,17.8,No,2014,No,No,No
Wes Cole,845,85,789,284,77,58,2300.0,612,219,108.0,177,65,22.6,No,2014,No,No,No
Taylor Dyson,773,56,670,244,144,118,1968.0,460,167,90.0,210,77,23.1,No,2014,No,No,No
Evan Cooper,634,135,486,199,162,125,2020.0,297,111,116.0,189,88,18.4,No,2014,No,No,No
Corban Wroe,641,181,475,228,137,103,2772.0,221,82,153.0,254,146,13.9,No,2014,No,No,No
Nate Sikma,752,228,703,265,148,103,2663.0,409,119,205.0,294,146,20.3,No,2014,No,No,No
Oren Faulk,220,58,180,84,99,52,945.0,6,0,82.0,174,84,18.2,No,2014,No,No,No
Yasin Kolo,71,4,48,23,31,21,162.0,13,4,14.0,35,19,25.6,No,2014,No,No,No
Jamie Schneck,250,48,200,104,95,42,1321.0,0,0,76.0,200,104,13.5,No,2014,No,No,No
Justin Graham,442,119,377,139,158,112,1761.0,162,52,112.0,215,87,17.2,No,2014,No,No,No
Jeremiah Aska,2,1,3,0,3,2,24.0,3,0,1.0,0,0,12.7,No,2014,No,No,No
Dougal Weir,22,7,23,10,2,2,246.0,1,0,8.0,22,10,7.0,No,2014,No,No,No
Adam Oresky,0,0,0,0,0,0,7.0,0,0,0.0,0,0,0.0,No,2014,No,No,No
Wesley Saunders,1511,383,1032,496,620,468,3580.0,127,51,273.0,905,445,24.7,No,2014,No,No,No
Siyani Chambers,1287,601,1016,393,430,342,4140.0,432,159,300.0,584,234,20.0,No,2014,No,No,No
Steve Moundou-Missi,1010,67,732,372,361,260,2749.0,18,6,151.0,714,366,21.3,No,2014,No,No,No
Laurent Rivard,1270,95,872,377,276,229,3694.0,700,287,106.0,172,90,16.7,No,2014,No,No,No
Kyle Casey,1242,124,881,439,426,320,2828.0,142,44,207.0,739,395,24.9,No,2014,No,No,No
Brandyn Curry,953,488,735,316,280,204,3266.0,322,117,228.0,413,199,18.4,No,2014,No,No,No
Jonah Travis,529,42,319,175,249,179,1492.0,1,0,85.0,318,175,19.5,No,2014,No,No,No
Evan Cummins,323,88,232,137,86,49,1269.0,0,0,77.0,232,137,14.5,No,2014,No,No,No
Agunwa Okolie,530,101,392,208,187,107,1997.0,26,7,109.0,366,201,15.7,No,2014,No,No,No
Zena Edosomwan,743,68,598,296,291,151,1684.0,0,0,128.0,598,296,27.0,No,2014,No,No,No
Dee Giger,151,16,142,51,37,28,449.0,75,21,41.0,67,30,23.4,No,2014,No,No,No
Matt Fraschilla,15,5,11,5,5,2,94.0,4,3,11.0,7,2,14.0,No,2014,No,No,No
Matt Brown,41,8,37,13,12,8,271.0,23,7,11.0,14,6,11.0,No,2014,No,No,No
Alex Nesbitt,11,8,11,3,9,5,126.0,3,0,5.0,8,3,8.9,No,2014,No,No,No
Hunter Myers,3,0,1,1,0,0,4.0,1,1,1.0,0,0,26.6,No,2014,No,No,No
Charlie Anastasi,4,2,5,1,2,2,30.0,0,0,2.0,5,1,14.5,No,2014,No,No,No
Michael Hall,7,1,6,3,4,1,24.0,0,0,5.0,6,3,30.2,No,2014,No,No,No
Kenyatta Smith,264,12,188,107,75,50,719.0,0,0,65.0,188,107,22.6,No,2014,No,No,No
Christian Standhardinger,1250,106,866,417,527,382,2304.0,113,34,170.0,753,383,27.7,No,2014,No,No,No
Isaac Fotu,785,53,514,308,239,168,1757.0,11,1,102.0,503,307,20.3,No,2014,No,No,No
Garrett Nevels,754,97,653,287,95,73,1969.0,282,107,65.0,371,180,18.9,No,2014,No,No,No
Brandon Spearman,667,91,562,233,181,116,1925.0,246,85,86.0,316,148,18.7,No,2014,No,No,No
Keith Shamburger,1371,525,1125,399,475,382,4183.0,609,191,227.0,516,208,19.3,No,2014,No,No,No
Quincy Smith,585,199,461,202,281,153,2013.0,99,28,135.0,362,174,17.7,No,2014,No,No,No
Davis Rozitis,262,21,178,105,84,52,905.0,0,0,44.0,178,105,14.1,No,2014,No,No,No
Aaron Valdes,975,122,728,349,304,199,2137.0,231,78,113.0,497,271,22.5,No,2014,No,No,No
Dyrbe Enos,49,7,59,16,6,2,190.0,51,15,11.0,8,1,18.7,No,2014,No,No,No
Mike Thomas,899,82,626,324,357,236,2112.0,76,15,128.0,550,309,21.8,No,2014,No,No,No
Stefan Jovanovic,628,47,493,250,175,128,1763.0,9,0,111.0,484,250,19.2,No,2014,No,No,No
Brandon Jawato,178,16,153,59,28,14,542.0,119,46,24.0,34,13,17.1,No,2014,No,No,No
Michael Harper,12,1,11,4,2,1,70.0,7,3,5.0,4,1,11.8,No,2014,No,No,No
Jack Hackman,3,0,2,1,0,0,11.0,1,1,1.0,1,0,13.3,No,2014,No,No,No
John Brown,2229,180,1550,858,712,512,3535.0,12,1,187.0,1538,857,30.8,Yes,2014,No,No,No
Devante Wallace,973,137,779,334,158,121,2599.0,434,184,120.0,345,150,20.0,No,2014,No,No,No
Adam Weary,1258,297,940,449,386,289,2987.0,212,71,221.0,728,378,23.5,No,2014,No,No,No
Lorenzo Cugini,1045,140,838,390,117,92,3137.0,420,173,112.0,418,217,16.8,No,2014,No,No,No
Anthony Lindauer,843,200,682,277,137,122,2427.0,398,167,169.0,284,110,19.8,No,2014,No,No,No
Jorge Perez-Laham,248,196,235,92,46,30,1315.0,88,34,95.0,147,58,14.2,No,2014,No,No,No
Derrell Edwards,263,108,266,91,75,54,1432.0,106,27,72.0,160,64,13.3,No,2014,No,No,No
Dejuan McGaughy,299,117,285,115,55,38,1105.0,78,31,77.0,207,84,17.9,No,2014,No,No,No
Haiishen McIntyre,401,226,324,130,176,128,1735.0,53,13,100.0,271,117,15.4,No,2014,No,No,No
Allan Chaney,581,54,425,221,164,129,1135.0,47,10,83.0,378,211,27.5,No,2014,No,No,No
Cliff Cornish,144,21,142,54,56,36,634.0,1,0,42.0,141,54,17.0,No,2014,No,No,No
Tarique Thompson,640,63,498,259,150,112,1774.0,28,10,88.0,470,249,19.6,No,2014,No,No,No
Matteo Bellusci,2,0,1,0,2,2,9.0,0,0,0.0,1,0,11.5,No,2014,No,No,No
Quincy Drye,29,2,32,12,9,5,79.0,4,0,3.0,28,12,26.3,No,2014,No,No,No
Tre Duncan,21,5,20,8,10,4,71.0,7,1,8.0,13,7,23.9,No,2014,No,No,No
Zeke Upshaw,755,78,588,230,250,187,1583.0,327,108,112.0,261,122,26.7,No,2014,No,No,No
Dion Nesmith,1308,330,1110,451,315,238,3587.0,478,168,230.0,632,283,20.8,No,2014,No,No,No
Jamall Robinson,693,109,676,241,155,100,2839.0,348,111,90.0,328,130,14.8,No,2014,No,No,No
Moussa Kone,773,47,561,327,219,119,2475.0,0,0,110.0,561,327,15.9,No,2014,No,No,No
Stephen Nwaukoni,576,35,409,186,314,204,2284.0,0,0,140.0,409,186,15.8,No,2014,No,No,No
Jordan Allen,935,171,666,360,425,214,3018.0,6,1,193.0,660,359,17.4,No,2014,No,No,No
Chris Jenkins,565,45,534,192,28,17,1714.0,464,164,48.0,70,28,17.3,No,2014,No,No,No
Darren Payen,607,23,430,248,165,107,1591.0,24,4,102.0,406,244,19.9,No,2014,No,No,No
Adam Savion,25,9,21,8,19,9,226.0,0,0,19.0,21,8,11.2,No,2014,No,No,No
Dan Steinberg,2,0,1,1,0,0,5.0,0,0,0.0,1,1,10.3,No,2014,No,No,No
Dave Dudzinski,1366,66,1029,498,397,311,3048.0,182,59,162.0,847,439,24.5,No,2014,No,No,No
Malcolm Miller,1013,164,746,332,319,244,2917.0,284,105,175.0,462,227,20.1,Yes,2014,No,No,No
Anthony Thompson,857,278,730,236,332,245,3561.0,451,140,137.0,279,96,16.1,No,2014,No,No,No
Justin Burrell,1143,414,1017,380,292,243,3439.0,406,140,253.0,611,240,22.3,No,2014,No,No,No
Eric Green,553,108,518,234,131,76,2047.0,42,9,99.0,476,225,18.1,No,2014,No,No,No
Malachi Alexander,1303,224,984,433,456,303,3743.0,336,134,230.0,648,299,21.5,No,2014,No,No,No
Cullen Hamilton,827,125,784,289,167,128,2677.0,378,121,109.0,406,168,20.0,No,2014,No,No,No
Taylor Abt,271,13,231,111,70,30,1359.0,65,19,66.0,166,92,13.2,No,2014,No,No,No
Robert Champion,1057,111,870,368,255,168,2629.0,454,153,149.0,416,215,24.6,No,2014,No,No,No
De'Vaughn Reid,55,26,54,17,24,17,293.0,13,4,23.0,41,13,16.5,No,2014,No,No,No
Christopher Morgan,102,2,68,43,24,16,454.0,0,0,21.0,68,43,12.1,No,2014,No,No,No
Chris Jayne,3,1,3,1,4,1,22.0,1,0,2.0,2,1,17.3,No,2014,No,No,No
Isaiah Baker,7,2,8,2,10,3,72.0,0,0,5.0,8,2,13.5,No,2014,No,No,No
Matt Husek,478,70,417,184,73,47,1422.0,180,63,63.0,237,121,20.5,No,2014,No,No,No
Patrick Kerrigan,3,0,1,1,0,0,25.0,1,1,1.0,0,0,4.3,No,2014,No,No,No
Rob Lewis,622,126,473,199,253,183,1363.0,122,41,136.0,351,158,26.4,No,2014,No,No,No
Cody Joyce,1048,71,778,400,392,248,2756.0,1,0,164.0,777,400,21.3,No,2014,No,No,No
Tyler Russell,914,162,844,342,222,175,2322.0,180,55,188.0,664,287,23.4,No,2014,No,No,No
Caleb Crayton,635,102,546,225,204,136,2082.0,183,49,172.0,363,176,19.2,No,2014,No,No,No
Ricmonds Vilde,397,41,295,159,105,68,1090.0,30,11,114.0,265,148,20.9,No,2014,No,No,No
Marcel Smith,762,276,603,248,178,148,2739.0,311,118,168.0,292,130,15.1,No,2014,No,No,No
Colter Lasher,1246,214,1042,471,228,165,2796.0,390,139,193.0,652,332,23.0,No,2014,No,No,No
Dauson Womack,277,46,230,96,135,83,1167.0,9,2,86.0,221,94,16.1,No,2014,No,No,No
Jimmy Barton,100,61,108,36,18,12,562.0,58,16,48.0,50,20,14.5,No,2014,No,No,No
Reveal Chukwujekwu,911,165,705,319,337,251,2697.0,79,22,208.0,626,297,19.0,No,2014,No,No,No
Alex Fountain,535,81,423,180,167,131,1678.0,120,44,71.0,303,136,16.3,No,2014,No,No,No
Cody Stetler,318,50,273,119,120,77,1029.0,13,3,67.0,260,116,18.6,No,2014,No,No,No
Mike Turner,87,7,70,29,11,7,189.0,54,22,13.0,16,7,22.9,No,2014,No,No,No
Jacob Gonzalez,7,1,6,3,0,0,13.0,3,1,1.0,3,2,26.5,No,2014,No,No,No
TaShawn Thomas,1793,226,1318,737,510,317,4001.0,20,2,258.0,1298,735,22.8,No,2014,No,No,No
Jherrod Stiggers,1077,142,928,351,183,132,2571.0,679,243,167.0,249,108,23.5,No,2014,No,No,No
Danuel House,1683,238,1315,547,554,387,3587.0,598,202,228.0,717,345,25.4,No,2014,No,No,No
L.J. Rose,608,415,516,192,210,155,2374.0,213,69,189.0,303,123,17.0,No,2014,No,No,No
Danrad Knowles,962,72,771,353,326,204,2751.0,169,52,142.0,602,301,20.0,No,2014,No,No,No
Brandon Morris,293,81,234,98,53,45,1055.0,126,52,50.0,108,46,14.8,No,2014,No,No,No
Tione Womack,207,150,186,79,48,30,1240.0,54,19,75.0,132,60,11.5,No,2014,No,No,No
J.J. Richardson,216,18,167,86,76,44,696.0,1,0,58.0,166,86,19.0,No,2014,No,No,No
LeRon Barnes,553,96,472,202,130,85,2411.0,181,64,83.0,291,138,13.1,No,2014,No,No,No
Mikhail McLean,245,25,183,87,130,71,1125.0,3,0,58.0,180,87,13.7,No,2014,No,No,No
Jaaron Simmons,1149,547,879,386,403,301,3009.0,211,76,308.0,668,310,23.1,No,2014,No,No,No
Jimmie Jones,28,28,21,11,6,3,223.0,11,3,20.0,10,8,9.9,No,2014,No,No,No
Tyus Bowser,0,0,3,0,0,0,4.0,2,0,1.0,1,0,51.2,No,2014,No,No,No
Valentine Izundu,202,13,130,84,84,34,1034.0,0,0,39.0,130,84,10.3,No,2014,No,No,No
Lawrence Paye,3,0,6,1,1,1,11.0,4,0,1.0,2,1,33.9,No,2014,No,No,No
James Daniel,2128,314,1613,591,803,656,3740.0,852,290,379.0,761,301,31.7,No,2014,No,No,No
Prince Okoroh,936,89,853,332,378,247,2745.0,98,25,214.0,755,307,23.3,No,2014,No,No,No
Solomon Mangham,675,40,687,240,147,92,2249.0,329,103,95.0,358,137,18.8,No,2014,No,No,No
Tyler Stone,556,39,434,181,270,182,2204.0,55,12,117.0,379,169,15.1,No,2014,No,No,No
James Miller,930,101,734,333,278,192,2082.0,234,72,189.0,500,261,25.6,No,2014,No,No,No
Marcel Boyd,657,63,487,226,365,205,2767.0,1,0,207.0,486,226,15.4,No,2014,No,No,No
Damon Collins,807,210,703,267,361,248,3497.0,109,25,313.0,594,242,16.8,No,2014,No,No,No
Oliver Ellison,265,23,184,104,116,57,1861.0,0,0,75.0,184,104,8.6,No,2014,No,No,No
Keon Hill,248,129,288,88,51,32,1146.0,134,40,105.0,154,48,18.2,No,2014,No,No,No
Kofi Andoh,328,60,247,90,192,139,1561.0,39,9,94.0,208,81,13.5,No,2014,No,No,No
Ausar Madison,57,56,54,17,37,20,485.0,15,3,49.0,39,14,12.5,No,2014,No,No,No
Jared Norsworthy,143,14,113,45,74,42,598.0,38,11,38.0,75,34,16.3,No,2014,No,No,No
Emmanuel Okoro,3,0,6,1,5,1,78.0,1,0,3.0,5,1,7.8,No,2014,No,No,No
James Carlton,546,39,445,199,172,128,1379.0,89,20,108.0,356,179,24.1,No,2014,No,No,No
Chris Hansen,1355,157,1027,411,376,304,2962.0,595,229,141.0,432,182,24.9,No,2014,No,No,No
Tomas Sanchez,743,237,539,219,256,213,2069.0,255,92,170.0,284,127,22.1,No,2014,No,No,No
Andre Hatchett,930,173,777,321,451,263,2866.0,101,25,162.0,676,296,21.8,No,2014,No,No,No
Jeffrey Solarin,669,54,507,292,148,85,1795.0,1,0,96.0,506,292,20.0,No,2014,No,No,No
Evann Hall,351,45,315,123,145,89,1095.0,56,16,92.0,259,107,23.0,No,2014,No,No,No
Avibakuro Preh,155,19,93,64,48,27,1183.0,0,0,40.0,93,64,7.2,No,2014,No,No,No
Scotty Tyler,61,10,52,26,10,7,303.0,5,2,14.0,47,24,12.2,No,2014,No,No,No
Ajak Magot,143,10,123,58,46,27,744.0,1,0,27.0,122,58,12.4,No,2014,No,No,No
Justin Smith,80,7,72,27,30,19,390.0,23,7,19.0,49,20,13.8,No,2014,No,No,No
Clint Thomas,16,2,11,6,2,1,48.0,6,3,1.0,5,3,14.1,No,2014,No,No,No
Andre Slavik,22,1,14,10,7,2,196.0,0,0,10.0,14,10,7.5,No,2014,No,No,No
Stephen Madison,1626,238,1173,544,537,403,3418.0,400,135,258.0,773,409,26.3,No,2014,No,No,No
Connor Hill,1506,111,1152,503,201,160,3305.0,800,340,110.0,352,163,21.6,No,2014,No,No,No
Sekou Wiggs,652,122,445,205,330,229,1514.0,41,13,110.0,404,192,24.2,No,2014,No,No,No
Mike Scott,715,235,605,264,146,109,1663.0,226,78,87.0,379,186,23.5,Yes,2014,No,No,No
Glen Dean,1132,373,865,339,351,279,3293.0,451,175,247.0,414,164,19.9,No,2014,No,No,No
Bira Seck,375,57,306,162,90,50,1383.0,1,1,95.0,305,161,16.5,No,2014,No,No,No
Joe Kammerer,156,19,144,71,27,14,1095.0,2,0,48.0,142,71,9.9,No,2014,No,No,No
Perrion Callandret,900,208,721,291,252,187,2571.0,356,131,182.0,365,160,20.3,No,2014,No,No,No
Ty Egbert,405,32,282,150,167,105,1423.0,0,0,72.0,282,150,15.6,No,2014,No,No,No
Paulin Mpawe,142,11,123,52,78,38,782.0,0,0,43.0,123,52,13.3,No,2014,No,No,No
Allen Jiles IV,98,21,80,39,44,20,486.0,2,0,39.0,78,39,14.1,No,2014,No,No,No
Kelsey Barlow,957,273,787,326,366,247,2788.0,200,58,206.0,587,268,21.8,No,2014,No,No,No
Marc Brown,1022,158,842,300,415,323,3427.0,311,99,188.0,531,201,18.9,No,2014,No,No,No
Jordan Harks,691,67,520,289,207,112,1691.0,4,1,83.0,516,288,19.8,No,2014,No,No,No
Jake Wiegand,687,27,535,239,278,200,1871.0,47,9,115.0,488,230,21.4,No,2014,No,No,No
Hayden Humes,970,131,774,338,216,162,3608.0,347,132,161.0,427,206,15.4,No,2014,No,No,No
Pat Birt,848,98,758,271,199,152,2371.0,442,154,98.0,316,117,20.6,No,2014,No,No,No
Markese McGuire,283,48,284,88,110,71,1145.0,107,36,62.0,177,52,17.7,No,2014,No,No,No
Gabe Snider,289,38,271,102,13,7,890.0,200,78,32.0,71,24,17.5,No,2014,No,No,No
Jay Parker,133,99,133,37,69,53,674.0,40,6,73.0,93,31,18.7,No,2014,No,No,No
Ahman Fells,331,22,272,134,54,30,1126.0,95,33,42.0,177,101,15.9,No,2014,No,No,No
Will Simonton,182,25,183,75,59,31,977.0,3,1,54.0,180,74,14.1,No,2014,No,No,No
Joey Miller,445,115,397,130,162,127,1345.0,190,58,109.0,207,72,23.3,No,2014,No,No,No
Lance Whitaker,266,140,250,86,121,67,1545.0,92,27,68.0,158,59,11.8,No,2014,No,No,No
Hans Christian Lauer,21,0,14,4,16,13,84.0,4,0,2.0,10,4,14.5,No,2014,No,No,No
Marcus White,18,15,26,5,9,5,157.0,17,3,5.0,9,2,11.7,No,2014,No,No,No
Frank Dounis,2,0,0,0,2,2,12.0,0,0,1.0,0,0,8.4,No,2014,No,No,No
Daishon Knight,951,159,793,320,267,218,2013.0,287,93,140.0,506,227,27.2,No,2014,No,No,No
Bobby Hunter,562,123,386,179,179,135,1527.0,184,69,82.0,202,110,18.7,No,2014,No,No,No
Zach Lofton,1599,188,1238,511,524,407,2906.0,528,170,198.0,710,341,28.7,Yes,2014,No,No,No
Reggie Lynch,1036,52,717,393,391,250,2606.0,0,0,181.0,717,393,21.1,No,2014,No,No,No
Nick Zeisloft,801,101,613,259,80,67,2620.0,532,216,59.0,81,43,13.7,No,2014,No,No,No
Paris Lee,1268,495,1042,417,335,254,4000.0,497,180,275.0,545,237,19.1,No,2014,No,No,No
John Jones,241,11,187,97,88,47,854.0,1,0,47.0,186,97,16.7,No,2014,No,No,No
Tony Wills,649,162,549,224,170,123,2897.0,253,78,111.0,296,146,13.2,No,2014,No,No,No
Kaza Keane,311,233,304,111,112,61,1701.0,100,28,142.0,204,83,16.4,No,2014,No,No,No
Jamaal Samuel,652,40,615,268,75,43,1891.0,226,73,85.0,389,195,20.5,No,2014,No,No,No
Michael Middlebrooks,22,4,14,10,3,2,99.0,1,0,4.0,13,10,10.1,No,2014,No,No,No
Matt Stacho,4,1,11,2,0,0,21.0,5,0,3.0,6,2,34.0,No,2014,No,No,No
Rayvonte Rice,1934,200,1515,655,642,468,3902.0,501,156,230.0,1014,499,28.3,No,2014,No,No,No
Tracy Abrams,1191,374,1041,399,369,272,3605.0,387,121,255.0,654,278,21.4,No,2014,No,No,No
Joseph Bertrand,778,94,622,314,153,110,2366.0,116,40,140.0,506,274,18.7,No,2014,No,No,No
Jon Ekey,925,131,777,336,108,82,3359.0,468,171,89.0,309,165,14.7,No,2014,No,No,No
Nnanna Egwu,750,73,722,316,144,102,3246.0,62,16,134.0,660,300,15.1,No,2014,No,No,No
Kendrick Nunn,1795,262,1473,631,291,239,3796.0,762,294,213.0,711,337,24.7,Yes,2014,No,No,No
Malcolm Hill,1846,281,1347,583,655,521,3864.0,453,159,220.0,894,424,25.5,No,2014,No,No,No
Jaylon Tate,293,304,248,84,161,119,1986.0,57,6,131.0,191,78,12.1,No,2014,No,No,No
Maverick Morgan,760,55,587,318,177,124,2136.0,0,0,125.0,587,318,19.4,No,2014,No,No,No
Austin Colbert,179,18,163,67,52,35,776.0,45,10,37.0,118,57,14.2,No,2014,No,No,No
Mike La Tulip,279,50,200,78,75,64,963.0,155,59,28.0,45,19,13.6,No,2014,No,No,No
Denzel Livingston,1172,187,767,364,435,344,1959.0,271,100,153.0,496,264,28.4,No,2014,No,No,No
Kyle Hittle,1339,173,903,453,334,242,2904.0,461,191,134.0,442,262,20.4,No,2014,No,No,No
Anthony Horton,483,51,379,186,98,63,1234.0,139,48,83.0,240,138,20.1,No,2014,No,No,No
Sam Burmeister,835,143,686,276,232,157,2718.0,340,126,169.0,346,150,17.3,No,2014,No,No,No
Mitchell Badillo,737,390,510,245,226,174,2471.0,184,73,175.0,326,172,15.9,No,2014,No,No,No
Ian Markolf,146,41,135,61,59,24,498.0,0,0,51.0,135,61,20.4,No,2014,No,No,No
Justin Philippe,113,22,79,41,42,31,329.0,0,0,29.0,79,41,18.4,No,2014,No,No,No
Winslo Barry,79,3,74,34,40,11,296.0,0,0,10.0,74,34,16.7,No,2014,No,No,No
John Baker,71,0,53,25,31,21,256.0,0,0,6.0,53,25,14.0,No,2014,No,No,No
Phillip Johnson,73,15,68,28,23,14,537.0,13,3,23.0,55,25,9.5,No,2014,No,No,No
Joseph Louwagie,10,3,9,3,8,4,45.0,0,0,2.0,9,3,15.6,No,2014,No,No,No
Chris Starkes,6,4,7,2,2,1,24.0,5,1,4.0,2,1,23.6,No,2014,No,No,No
Marcus Brock,9,2,5,2,5,4,33.0,4,1,1.0,1,1,12.4,No,2014,No,No,No
Jake Odum,1568,603,1008,452,781,590,4199.0,230,74,326.0,778,378,21.9,No,2014,No,No,No
Manny Arop,977,104,805,355,227,165,2674.0,305,102,164.0,500,253,21.3,No,2014,No,No,No
Khristian Smith,1172,172,1014,415,376,266,3402.0,276,76,174.0,738,339,21.0,No,2014,No,No,No
Justin Gant,951,88,794,354,254,175,2797.0,187,68,149.0,607,286,20.4,No,2014,No,No,No
Dawon Cummings,546,138,458,185,129,95,1613.0,255,81,91.0,203,104,20.2,No,2014,No,No,No
Devonte Brown,1170,281,824,339,623,431,3309.0,214,61,312.0,610,278,22.5,No,2014,No,No,No
Demetrius Moore,116,10,88,50,24,15,402.0,2,1,26.0,86,49,16.5,No,2014,No,No,No
Jake Kitchell,452,76,314,166,145,94,1766.0,66,26,95.0,248,140,14.5,No,2014,No,No,No
Lucas Eitel,327,86,264,109,46,25,1489.0,209,84,54.0,55,25,12.3,No,2014,No,No,No
Brandon Burnett,149,22,139,48,49,38,619.0,70,15,44.0,69,33,17.3,No,2014,No,No,No
T.J. Bell,278,24,211,112,80,54,878.0,0,0,66.0,211,112,18.7,No,2014,No,No,No
Yogi Ferrell,1986,633,1475,637,530,440,4496.0,681,272,312.0,794,365,22.7,Yes,2014,No,No,No
Will Sheehey,1120,149,873,424,275,186,2875.0,251,86,171.0,622,338,20.7,No,2014,No,No,No
Noah Vonleh,338,18,216,113,134,96,794.0,33,16,64.0,183,97,21.4,Yes,2014,No,No,No
Troy Williams,1115,163,789,412,359,253,2486.0,117,38,221.0,672,374,23.7,Yes,2014,No,No,No
Stanford Robinson,817,189,692,299,286,172,2457.0,157,47,161.0,535,252,20.1,No,2014,No,No,No
Evan Gordon,1363,249,1116,456,345,260,3778.0,556,191,254.0,560,265,20.5,No,2014,No,No,No
Jeremy Hollowell,1202,145,988,411,353,270,2825.0,349,110,213.0,639,301,24.9,No,2014,No,No,No
Hanner Mosquera-Perea,556,39,341,197,278,162,1611.0,1,0,99.0,340,197,17.6,No,2014,No,No,No
Devin Davis,616,65,517,250,177,114,1580.0,11,2,89.0,506,248,22.1,No,2014,No,No,No
Austin Etherington,280,50,205,88,86,64,1200.0,120,40,66.0,85,48,13.2,No,2014,No,No,No
Luke Fischer,1051,96,693,429,307,193,2533.0,1,0,145.0,692,429,19.7,No,2014,No,No,No
Jeff Howard,27,7,19,7,23,13,206.0,0,0,10.0,19,7,9.8,No,2014,No,No,No
Collin Hartman,437,110,352,156,72,51,1822.0,211,74,70.0,141,82,12.6,No,2014,No,No,No
Jonny Marlin,132,107,119,37,36,32,858.0,74,26,52.0,45,11,11.0,No,2014,No,No,No
Andrew Calomeris,2,0,2,1,0,0,5.0,0,0,0.0,2,1,19.8,No,2014,No,No,No
Peter Jurkin,462,7,312,170,145,115,1112.0,20,7,81.0,292,163,20.6,No,2014,No,No,No
Joe Fagan,0,0,0,0,0,0,6.0,0,0,1.0,0,0,8.2,No,2014,No,No,No
Taylor Wayer,3,0,8,1,2,0,36.0,6,1,0.0,2,0,12.7,No,2014,No,No,No
Sean Armand,1694,294,1244,566,279,214,3447.0,807,348,192.0,437,218,22.4,No,2014,No,No,No
A.J. English,2004,510,1447,612,590,467,3855.0,836,313,330.0,611,299,26.3,Yes,2014,No,No,No
David Laury,1465,222,1050,534,581,370,2930.0,72,27,213.0,978,507,26.0,No,2014,No,No,No
Tre Bowman,708,66,483,244,143,120,1757.0,250,100,55.0,233,144,17.1,No,2014,No,No,No
Isaiah Williams,1044,161,783,376,103,77,2664.0,541,215,94.0,242,161,17.1,No,2014,No,No,No
Mike Poole,721,165,721,297,136,100,2597.0,113,27,163.0,608,270,18.8,No,2014,No,No,No
Tavon Sledge,284,143,221,111,84,53,1150.0,28,9,70.0,193,102,14.2,No,2014,No,No,No
Da'Shawn Gomez,117,85,107,36,23,16,589.0,84,29,27.0,23,7,12.1,No,2014,No,No,No
Ryden Hines,155,23,110,56,36,20,756.0,58,23,18.0,52,33,9.5,No,2014,No,No,No
Daniel Robinson,15,0,14,7,3,1,78.0,0,0,2.0,14,7,11.2,No,2014,No,No,No
Grant Ellis,21,3,24,8,0,0,82.0,18,5,4.0,6,3,17.0,No,2014,No,No,No
Kristian Duravcevic,3,0,4,1,5,1,29.0,1,0,1.0,3,1,12.6,No,2014,No,No,No
Britton Williams,109,97,93,38,44,31,655.0,13,2,44.0,80,36,12.2,No,2014,No,No,No
DeAndre Kane,2110,645,1694,732,817,492,4511.0,511,154,438.0,1183,578,27.4,No,2014,No,No,No
Melvin Ejim,1643,188,1198,596,491,359,3752.0,302,92,246.0,896,504,22.0,No,2014,No,No,No
Georges Niang,2228,421,1697,849,448,342,4110.0,502,188,318.0,1195,661,26.9,Yes,2014,No,No,No
Dustin Hogue,734,74,472,267,243,150,1969.0,129,50,89.0,343,217,17.0,No,2014,No,No,No
Nazareth Mitrou-Long,1250,235,954,430,173,130,3206.0,685,260,154.0,269,170,18.6,No,2014,No,No,No
Monte Morris,1708,768,1336,636,364,284,4734.0,399,152,165.0,937,484,17.7,Yes,2014,No,No,No
Matt Thomas,1170,181,923,394,157,128,3510.0,634,254,114.0,289,140,15.8,Yes,2014,No,No,No
Sherron Dorsey-Walker,716,188,572,215,245,179,2119.0,299,107,135.0,273,108,18.3,No,2014,No,No,No
Daniel Edozie,75,8,43,25,39,25,286.0,0,0,9.0,43,25,12.3,No,2014,No,No,No
K.J. Bluford,108,10,101,36,10,5,216.0,92,31,9.0,9,5,25.8,No,2014,No,No,No
Percy Gibson,689,32,522,283,187,122,1545.0,5,1,78.0,517,282,21.4,No,2014,No,No,No
Tyler Ellerman,9,0,10,4,4,1,43.0,0,0,1.0,10,4,14.6,No,2014,No,No,No
Roy Devyn Marble,1694,397,1359,564,595,432,3749.0,396,134,232.0,963,430,24.8,No,2014,No,No,No
Aaron White,1859,190,1142,590,800,618,3939.0,217,61,211.0,925,529,22.1,No,2014,No,No,No
Mike Gesell,1072,557,973,384,290,210,3490.0,302,94,227.0,671,290,19.2,No,2014,No,No,No
Jarrod Uthoff,1298,121,1018,458,308,245,2648.0,358,137,104.0,660,321,24.0,Yes,2014,No,No,No
Melsahn Basabe,1119,48,807,431,378,256,2731.0,2,1,180.0,805,430,21.3,No,2014,No,No,No
Gabriel Olaseni,612,40,407,208,269,196,1672.0,0,0,89.0,407,208,18.8,No,2014,No,No,No
Zach McCabe,871,149,736,298,223,170,2472.0,312,105,174.0,424,193,20.5,No,2014,No,No,No
Adam Woodbury,851,108,651,332,295,187,2718.0,0,0,173.0,651,332,17.8,No,2014,No,No,No
Josh Oglesby,633,154,615,211,84,65,2289.0,450,146,65.0,165,65,15.8,No,2014,No,No,No
Peter Jok,1508,193,1191,491,352,310,2801.0,571,216,183.0,620,275,27.0,No,2014,No,No,No
Anthony Clemmons,701,344,567,235,237,159,2654.0,209,72,180.0,358,163,16.2,No,2014,No,No,No
Kyle Denning,31,8,24,12,2,2,100.0,17,5,5.0,7,7,15.0,No,2014,No,No,No
Kyle Meyer,157,37,141,60,55,33,1024.0,29,4,47.0,112,56,10.7,No,2014,No,No,No
Darius Stokes,105,8,100,46,38,13,665.0,3,0,22.0,97,46,10.7,No,2014,No,No,No
Okey Ukah,13,1,13,6,4,1,71.0,0,0,3.0,13,6,12.5,No,2014,No,No,No
Luis Jacobo,1167,120,935,413,221,170,2806.0,452,171,174.0,483,242,22.4,No,2014,No,No,No
Steve Forbes,1073,62,686,393,407,286,2037.0,1,1,181.0,685,392,27.3,No,2014,No,No,No
Pierre Bland,452,251,328,163,154,101,1907.0,61,25,124.0,267,138,14.3,No,2014,No,No,No
Mo Evans,1522,466,1141,520,263,216,3365.0,649,266,256.0,492,254,22.7,No,2014,No,No,No
Joseph Edwards,1020,218,771,386,264,156,3051.0,238,92,198.0,533,294,18.9,No,2014,No,No,No
Joe Reed,1037,150,700,379,383,245,3241.0,113,34,136.0,587,345,16.3,No,2014,No,No,No
Michael Kibiloski,671,73,538,234,85,63,1967.0,358,140,88.0,180,94,17.5,No,2014,No,No,No
Isaiah McCray,697,247,596,222,328,162,2672.0,268,91,161.0,328,131,18.0,No,2014,No,No,No
Herbert Graham,84,9,65,29,11,7,195.0,51,19,13.0,14,10,22.5,No,2014,No,No,No
Kevin Harden,108,30,127,41,21,10,493.0,50,16,32.0,77,25,18.0,No,2014,No,No,No
Brent Calhoun,517,62,426,225,107,66,1396.0,2,1,135.0,424,224,21.4,No,2014,No,No,No
Will Dunn,13,0,10,5,10,3,51.0,2,0,2.0,8,5,16.9,No,2014,No,No,No
Jared Bloom,4,1,4,2,1,0,18.0,1,0,0.0,3,2,12.8,No,2014,No,No,No
Trevor Osborn,14,5,17,3,9,7,53.0,11,1,4.0,6,2,23.7,No,2014,No,No,No
Ian Chiles,773,108,645,272,219,161,1911.0,196,68,115.0,449,204,23.7,No,2014,No,No,No
Mitchell Patton,938,55,744,376,260,181,2150.0,21,5,112.0,723,371,24.3,No,2014,No,No,No
Khufu Najee,479,88,421,184,110,89,1569.0,77,22,97.0,344,162,19.5,No,2014,No,No,No
Marcellus Barksdale,950,275,758,308,408,295,3544.0,161,39,228.0,597,269,17.4,No,2014,No,No,No
Donovan Gibbs,735,91,584,307,145,92,2680.0,79,29,126.0,505,278,15.5,No,2014,No,No,No
Ja'Rob McCallum,712,77,618,245,130,96,1883.0,337,126,121.0,281,119,22.1,No,2014,No,No,No
P.J. Hubert,293,49,259,97,31,25,919.0,200,74,41.0,59,23,18.4,No,2014,No,No,No
Justus Stanback,178,16,185,80,22,13,758.0,22,5,52.0,163,75,17.5,No,2014,No,No,No
Elijah Ray,214,12,165,77,60,45,561.0,48,15,47.0,117,62,23.0,No,2014,No,No,No
Josh James,190,16,143,73,60,44,761.0,0,0,43.0,143,73,14.9,No,2014,No,No,No
Cortell Busby,19,8,18,5,11,9,94.0,3,0,9.0,15,5,18.3,No,2014,No,No,No
"Linwood Ross,",18,0,19,6,8,5,39.0,5,1,1.0,14,5,32.5,No,2014,No,No,No
Jalen McCallum,30,8,19,11,3,2,65.0,11,6,8.0,8,5,23.6,No,2014,No,No,No
Julysses Nobles,1136,376,928,360,435,298,3286.0,343,118,283.0,585,242,21.5,No,2014,No,No,No
B.J. West,435,30,327,169,135,96,1074.0,8,1,81.0,319,168,22.0,No,2014,No,No,No
Javares Brent,789,84,811,259,69,52,2590.0,664,219,103.0,147,40,18.3,No,2014,No,No,No
Derrell Taylor,672,67,461,236,274,200,2464.0,2,0,135.0,459,236,15.0,No,2014,No,No,No
Jeff Stubbs,422,76,335,132,163,136,1174.0,82,22,127.0,253,110,23.1,No,2014,No,No,No
Treshawn Bolden,604,131,584,228,242,139,2236.0,32,9,246.0,552,219,21.1,No,2014,No,No,No
Janarius Middleton,803,102,717,345,144,89,2696.0,84,24,135.0,633,321,17.1,No,2014,No,No,No
Dontaveon Robinson,306,65,336,127,85,52,1713.0,6,0,87.0,330,127,13.6,No,2014,No,No,No
Marcus Love,118,29,125,40,46,28,547.0,53,10,30.0,72,30,16.3,No,2014,No,No,No
Chester Victor,3,0,4,1,0,0,6.0,3,1,1.0,1,0,41.7,No,2014,No,No,No
Kenneth Taylor,4,1,8,2,0,0,74.0,0,0,4.0,8,2,8.1,No,2014,No,No,No
Kenneth Wachira,2,0,3,1,0,0,45.0,1,0,5.0,2,1,8.9,No,2014,No,No,No
Rasheed James,0,0,0,0,0,0,6.0,0,0,0.0,0,0,0.0,No,2014,No,No,No
O'Barcus Taylor,0,0,0,0,0,0,0.0,0,0,0.0,0,0,0,No,2014,No,No,No
Marquis Todd,0,0,0,0,0,0,1.0,0,0,0.0,0,0,0.0,No,2014,No,No,No
Darion Rackley,1326,201,945,361,646,480,2943.0,428,124,231.0,517,237,26.7,No,2014,No,No,No
Brian Williams,1267,368,1182,466,305,187,3645.0,461,148,209.0,721,318,22.5,No,2014,No,No,No
D.J. Felder,561,40,479,222,148,105,1340.0,38,12,76.0,441,210,24.7,No,2014,No,No,No
Undra Mitchem,256,57,247,86,46,31,865.0,146,53,51.0,101,33,19.7,No,2014,No,No,No
Avery Moore,1096,175,1027,363,153,125,2783.0,750,245,178.0,277,118,23.0,No,2014,No,No,No
Nick Cook,579,111,448,219,294,141,2396.0,3,0,130.0,445,219,16.0,No,2014,No,No,No
Jamal Hunter,303,39,223,124,86,55,1317.0,0,0,64.0,223,124,13.2,No,2014,No,No,No
Grant White,259,65,226,85,105,64,965.0,92,25,90.0,134,60,19.9,No,2014,No,No,No
Teraes Clemmons,100,18,82,36,26,22,313.0,19,6,17.0,63,30,19.1,No,2014,No,No,No
Rico Sanders,169,20,176,60,18,14,557.0,113,35,21.0,63,25,19.0,No,2014,No,No,No
Giovanni Smith,52,9,47,15,10,8,255.0,39,14,5.0,8,1,11.9,No,2014,No,No,No
Mike Louder,48,0,39,19,8,7,137.0,5,3,4.0,34,16,18.3,No,2014,No,No,No
Joe Kuligoski,174,50,159,63,47,29,933.0,75,19,35.0,84,44,11.8,No,2014,No,No,No
Rod McReynolds,10,7,12,4,1,1,36.0,5,1,8.0,7,3,30.3,No,2014,No,No,No
Jarvis Haywood,787,110,579,276,254,192,1582.0,114,43,157.0,465,233,26.4,No,2014,No,No,No
Keith McDougald,1192,158,1022,405,302,230,2548.0,461,152,217.0,561,253,26.6,No,2014,No,No,No
Vince Martin,311,145,249,93,112,83,1037.0,118,42,58.0,131,51,16.8,No,2014,No,No,No
RJ Slawson,582,51,463,208,200,137,2018.0,106,29,128.0,357,179,17.0,No,2014,No,No,No
Javon Dawson,538,68,468,207,161,109,1813.0,46,15,119.0,422,192,18.4,No,2014,No,No,No
J.R. Holder,1368,161,995,464,501,344,3188.0,295,96,230.0,700,368,23.2,No,2014,No,No,No
Marcel White,1003,75,759,320,297,204,2441.0,402,159,106.0,357,161,20.5,No,2014,No,No,No
Sam Hunt,1157,152,899,352,270,245,2942.0,574,208,178.0,325,144,20.7,No,2014,No,No,No
Tyler Alderman,115,15,102,45,39,25,493.0,1,0,25.0,101,45,14.4,No,2014,No,No,No
Marcellous Bell,337,40,314,104,68,56,876.0,225,73,26.0,89,31,21.6,No,2014,No,No,No
Kordario Fleming,281,65,239,109,121,63,1068.0,3,0,85.0,236,109,17.6,No,2014,No,No,No
Jeremy Bogus,113,10,128,38,14,11,406.0,96,26,14.0,32,12,18.2,No,2014,No,No,No
Josh Murray,30,4,34,11,9,8,278.0,0,0,9.0,34,11,8.7,No,2014,No,No,No
Omar El Manasterly,248,30,186,92,103,64,1188.0,0,0,54.0,186,92,12.3,No,2014,No,No,No
Charles Cooke,1570,221,1166,506,568,399,3725.0,436,159,208.0,730,347,23.1,Yes,2014,No,No,No
Ron Curry,1550,417,1222,493,518,373,4205.0,564,191,209.0,658,302,21.3,No,2014,No,No,No
Andrey Semenov,1203,170,945,393,319,249,3321.0,441,168,182.0,504,225,20.3,No,2014,No,No,No
Andre Nation,648,98,517,222,236,157,1756.0,177,47,89.0,340,175,22.1,No,2014,No,No,No
Taylor Bessick,462,32,398,193,125,76,1858.0,0,0,99.0,398,193,15.5,No,2014,No,No,No
Jackson Kent,1228,216,990,398,317,251,3771.0,504,181,194.0,486,217,18.9,No,2014,No,No,No
Tom Vodanovich,655,86,520,250,195,122,2674.0,138,33,181.0,382,217,15.8,No,2014,No,No,No
Yohanny Dalembert,885,73,603,331,365,222,2152.0,1,1,202.0,602,330,24.2,No,2014,No,No,No
Ivan Lukic,271,31,216,100,90,60,1078.0,51,11,48.0,165,89,15.2,No,2014,No,No,No
Paulius Satkus,552,89,358,194,215,154,1765.0,29,10,144.0,329,184,18.2,No,2014,No,No,No
Tom Rivard,551,71,459,215,116,68,1489.0,160,53,105.0,299,162,22.3,No,2014,No,No,No
Dimitrije Cabarkapa,449,12,371,168,56,47,917.0,176,66,56.0,195,102,26.0,No,2014,No,No,No
Christian Pierce,5,0,8,2,0,0,28.0,4,1,3.0,4,1,20.9,No,2014,No,No,No
Marcus Foster,2167,312,1758,784,407,293,3901.0,814,306,284.0,944,478,29.1,No,2014,No,No,No
Thomas Gipson,1232,70,844,450,497,332,2972.0,0,0,214.0,844,450,22.6,No,2014,No,No,No
Shane Southwell,741,271,669,269,156,108,2605.0,270,95,167.0,399,174,17.7,No,2014,No,No,No
Will Spradling,1027,331,810,309,281,227,3698.0,524,182,162.0,286,127,15.0,No,2014,No,No,No
Wesley Iwundu,1249,366,917,425,506,348,3728.0,151,51,280.0,766,374,19.9,No,2014,No,No,No
Nino Williams,712,73,560,267,225,172,1835.0,23,6,92.0,537,261,21.8,No,2014,No,No,No
Nigel Johnson,802,217,715,273,237,160,2336.0,292,96,127.0,423,177,21.3,No,2014,No,No,No
D.J. Johnson,864,30,551,327,323,210,2271.0,1,0,139.0,550,327,19.0,No,2014,No,No,No
Omari Lawrence,235,59,225,87,88,50,938.0,51,11,60.0,174,76,17.9,No,2014,No,No,No
Jevon Thomas,200,165,199,64,138,61,1233.0,43,11,107.0,156,53,16.0,No,2014,No,No,No
Ryan Schultz,17,5,23,5,8,5,61.0,14,2,6.0,9,3,27.7,No,2014,No,No,No
Shawn Meyer,11,2,12,4,11,3,43.0,1,0,3.0,11,4,24.3,No,2014,No,No,No
Jack Karapetyan,2,0,4,1,0,0,20.0,0,0,0.0,4,1,10.3,No,2014,No,No,No
Brian Rohleder,16,11,20,7,10,2,173.0,5,0,7.0,15,7,9.4,No,2014,No,No,No
Andrew Wiggins,597,54,422,189,227,176,1148.0,126,43,80.0,296,146,26.3,Yes,2014,No,No,No
Perry Ellis,1798,148,1286,653,576,436,3604.0,130,56,174.0,1156,597,24.2,No,2014,No,No,No
Wayne Selden Jr.,1202,282,969,422,310,196,3217.0,443,162,211.0,526,260,20.7,No,2014,No,No,No
Joel Embiid,313,38,171,107,143,98,647.0,5,1,66.0,166,106,23.4,Yes,2014,Yes,Yes,Yes
Naadir Tharpe,521,304,457,175,104,87,1892.0,242,84,143.0,215,91,17.3,No,2014,No,No,No
Frank Mason,1885,576,1340,609,633,482,4345.0,440,185,270.0,900,424,21.8,Yes,2014,No,No,No
Tarik Black,1130,41,722,443,440,244,2797.0,1,0,158.0,721,443,19.5,Yes,2014,No,No,No
Jamari Traylor,516,88,370,197,193,122,2122.0,0,0,159.0,370,197,14.7,No,2014,No,No,No
Conner Frankamp,889,209,738,309,105,92,2307.0,468,179,44.0,270,130,17.9,No,2014,No,No,No
Brannen Greene,425,62,271,121,117,102,1079.0,192,81,73.0,79,40,18.6,No,2014,No,No,No
Andrew White III,1291,63,944,427,280,220,2514.0,550,217,127.0,394,210,24.4,Yes,2014,No,No,No
Landen Lucas,632,70,392,240,239,152,2151.0,1,0,136.0,391,240,14.7,No,2014,No,No,No
Evan Manning,26,5,22,9,2,1,108.0,18,7,9.0,4,2,14.9,No,2014,No,No,No
Niko Roberts,8,7,20,2,10,4,84.0,11,0,8.0,9,2,19.6,No,2014,No,No,No
Justin Wesley,81,12,61,25,57,30,654.0,7,1,32.0,54,24,9.1,No,2014,No,No,No
Christian Garrett,2,4,9,1,2,0,67.0,1,0,11.0,8,1,15.8,No,2014,No,No,No
Delbert Love,1369,337,1208,463,316,226,4080.0,633,217,285.0,575,246,21.1,No,2014,No,No,No
Orlando Coleman,703,97,649,288,96,61,2415.0,221,66,151.0,428,222,17.7,No,2014,No,No,No
Nigel Pruitt,950,106,794,306,252,188,2448.0,445,150,166.0,349,156,22.5,No,2014,No,No,No
Bernard Morena,564,76,463,209,208,125,1705.0,62,21,161.0,401,188,21.3,No,2014,No,No,No
Nate Rucker,417,21,293,150,205,117,1126.0,2,0,82.0,291,150,21.0,No,2014,No,No,No
Yonel Brown,1344,277,1107,433,366,303,3749.0,502,175,256.0,605,258,20.8,No,2014,No,No,No
Myles Hamilton,348,149,331,121,107,78,1304.0,103,28,119.0,228,93,19.9,No,2014,No,No,No
Willy Kouassi,368,14,282,144,168,80,1576.0,0,0,102.0,282,144,15.0,No,2014,No,No,No
Tanner Wozniak,148,16,153,47,27,21,597.0,115,33,37.0,38,14,17.3,No,2014,No,No,No
Andrew Osemhen,248,21,216,87,125,74,1475.0,0,0,83.0,216,87,12.6,No,2014,No,No,No
Charlie Byers,31,12,34,14,4,2,177.0,3,1,9.0,31,13,12.8,No,2014,No,No,No
Jordan Montgomery,115,22,91,34,45,25,361.0,61,22,24.0,30,12,19.8,No,2014,No,No,No
Kris Drees,27,3,21,11,10,5,221.0,0,0,8.0,21,11,7.7,No,2014,No,No,No
Kris Brewer,1128,304,897,354,402,293,3291.0,362,127,226.0,535,227,21.0,No,2014,No,No,No
Derek Jackson,1305,293,1100,447,296,210,4092.0,541,201,195.0,559,246,18.5,No,2014,No,No,No
Devareaux Manley,970,55,753,300,170,133,2341.0,598,237,74.0,155,63,20.6,No,2014,No,No,No
Darren Goodson,577,126,518,216,163,102,1381.0,144,43,111.0,374,173,26.4,No,2014,No,No,No
Mark Henniger,510,32,327,179,219,152,1858.0,4,0,91.0,323,179,14.4,No,2014,No,No,No
Kellon Thomas,1043,277,862,321,382,298,3176.0,316,103,174.0,546,218,19.2,No,2014,No,No,No
Khaliq Spicer,568,33,398,227,224,114,2120.0,0,0,80.0,398,227,14.3,No,2014,No,No,No
K.K. Simmons,310,76,262,97,87,66,907.0,144,50,66.0,118,47,20.8,No,2014,No,No,No
Chris Ortiz,633,54,534,215,236,155,2274.0,175,48,117.0,359,167,17.4,No,2014,No,No,No
Melvin Tabb,217,17,165,74,114,68,769.0,3,1,52.0,162,73,18.1,No,2014,No,No,No
Devin Carter,1087,89,838,368,225,160,2259.0,475,191,102.0,363,177,22.8,No,2014,No,No,No
Marquiez Lawrence,45,6,37,18,20,9,340.0,0,0,24.0,37,18,11.2,No,2014,No,No,No
Tyler Scott,1,1,2,0,2,1,8.0,0,0,0.0,2,0,19.1,No,2014,No,No,No
Jon Fleming,9,4,8,2,6,4,47.0,7,1,4.0,1,1,15.7,No,2014,No,No,No
Julius Randle,599,57,391,196,289,204,1233.0,18,3,101.0,373,193,25.4,Yes,2014,No,Yes,Yes
James Young,573,67,450,183,177,125,1296.0,235,82,75.0,215,101,23.4,Yes,2014,No,No,No
Aaron Harrison,979,129,781,320,277,218,2307.0,361,121,100.0,420,199,22.4,Yes,2014,No,No,No
Andrew Harrison,798,298,597,222,367,285,2261.0,188,69,173.0,409,153,21.3,Yes,2014,No,No,No
Willie Cauley-Stein,843,90,583,346,297,151,2575.0,0,0,127.0,583,346,16.9,Yes,2014,No,No,No
Alex Poythress,966,51,646,356,328,225,2480.0,96,29,149.0,550,327,19.3,Yes,2014,No,No,No
Dakari Johnson,450,40,300,161,229,128,1185.0,0,0,67.0,300,161,20.6,Yes,2014,No,No,No
Marcus Lee,755,67,533,326,206,103,2254.0,0,0,142.0,533,326,16.8,No,2014,No,No,No
Jarrod Polson,140,53,113,48,43,29,800.0,48,15,42.0,65,33,11.1,No,2014,No,No,No
Dominique Hawkins,293,103,251,92,101,72,1426.0,130,37,35.0,121,55,11.3,No,2014,No,No,No
Derek Willis,555,51,400,189,86,69,1543.0,271,108,60.0,129,81,15.6,No,2014,No,No,No
Jon Hood,95,17,95,32,19,15,425.0,55,16,13.0,40,16,13.8,No,2014,No,No,No
EJ Floreal,3,0,3,1,4,1,40.0,0,0,5.0,3,1,12.7,No,2014,No,No,No
Brian Long,2,0,6,0,4,2,40.0,3,0,0.0,3,0,10.1,No,2014,No,No,No
Sam Malone,7,1,7,3,2,1,30.0,0,0,7.0,7,3,25.5,No,2014,No,No,No
Tyreek Duren,1726,500,1267,568,543,430,4600.0,414,160,295.0,853,408,20.2,No,2014,No,No,No
Jerrell Wright,1512,123,1053,591,540,330,3196.0,0,0,242.0,1053,591,25.5,No,2014,No,No,No
Tyrone Garland,859,159,782,295,271,199,1861.0,271,70,118.0,511,225,28.9,No,2014,No,No,No
Steve Zack,774,131,647,304,243,165,2875.0,8,1,177.0,639,303,17.2,No,2014,No,No,No
Sam Mills,1020,276,897,366,130,92,4132.0,480,196,169.0,417,170,13.9,No,2014,No,No,No
D.J. Peterson,451,174,373,148,84,65,2920.0,255,90,83.0,118,58,8.9,No,2014,No,No,No
Khalid Lewis,573,277,579,205,178,120,2988.0,158,43,189.0,421,162,15.0,No,2014,No,No,No
Rohan Brown,226,29,178,86,70,41,1175.0,49,13,52.0,129,73,11.8,No,2014,No,No,No
Taylor Dunn,98,14,95,30,21,11,462.0,83,27,10.0,12,3,12.9,No,2014,No,No,No
Jermaine Davis,22,2,14,5,17,11,101.0,2,1,12.0,12,4,17.1,No,2014,No,No,No
O.J. Lewis,23,3,22,7,12,5,62.0,7,4,5.0,15,3,27.8,No,2014,No,No,No
Hank Davis,14,3,9,4,8,6,29.0,2,0,3.0,7,4,28.3,No,2014,No,No,No
Dan Trist,1491,141,1128,608,382,274,2825.0,5,1,271.0,1123,607,30.4,No,2014,No,No,No
Joey Ptasinski,1105,199,839,384,109,88,3419.0,581,249,119.0,258,135,16.0,No,2014,No,No,No
Bryce Scott,1240,270,944,419,231,189,3606.0,523,213,139.0,421,206,17.7,No,2014,No,No,No
Seth Hinrichs,1535,205,1075,520,352,286,3268.0,485,209,238.0,590,311,24.6,No,2014,No,No,No
Nick Lindner,1509,520,1113,471,504,401,3878.0,454,166,272.0,659,305,22.2,No,2014,No,No,No
Michael Hoffman,567,59,469,213,87,66,1743.0,194,75,64.0,275,138,15.8,No,2014,No,No,No
Zach Rufer,464,141,406,152,96,60,1974.0,273,100,86.0,133,52,14.5,No,2014,No,No,No
Alan Flannigan,178,38,164,65,56,41,928.0,24,7,50.0,140,58,14.1,No,2014,No,No,No
Monty Boykins,568,92,522,188,170,99,1461.0,275,93,119.0,247,95,26.1,No,2014,No,No,No
Nathaniel Musters,99,27,86,46,21,7,930.0,0,0,43.0,86,46,7.9,No,2014,No,No,No
Ben Freeland,137,13,118,61,26,15,718.0,0,0,52.0,118,61,13.5,No,2014,No,No,No
Jake Newman,18,9,13,6,10,4,126.0,5,2,7.0,8,4,10.6,No,2014,No,No,No
Billy Murphy,26,3,28,11,1,0,67.0,16,4,2.0,12,7,24.5,No,2014,No,No,No
Jack Detmer,7,5,20,2,4,3,133.0,12,0,11.0,8,2,13.4,No,2014,No,No,No
Les Smith,130,31,126,38,42,34,647.0,66,20,46.0,60,18,15.9,No,2014,No,No,No
Nimrod Hilliard,844,377,642,287,238,191,2396.0,212,79,189.0,430,208,20.9,No,2014,No,No,No
Amos Wilson,582,46,507,228,165,126,1574.0,3,0,115.0,504,228,22.2,No,2014,No,No,No
Donovan Ross,603,49,412,221,201,160,1617.0,9,1,109.0,403,220,19.1,No,2014,No,No,No
Rhon Mitchell,612,70,606,245,156,120,1594.0,22,2,149.0,584,243,25.9,No,2014,No,No,No
Anthony Holliday,602,145,392,191,249,191,1437.0,85,29,132.0,307,162,22.2,No,2014,No,No,No
Marcus Owens,691,76,618,230,140,100,2183.0,379,131,88.0,239,99,17.1,No,2014,No,No,No
Octavious Green,98,10,82,35,20,9,325.0,54,19,18.0,28,16,17.2,No,2014,No,No,No
Donnell Minton,248,80,256,96,81,55,1116.0,8,1,114.0,248,95,18.1,No,2014,No,No,No
Keilan Blanks,213,72,193,68,69,54,743.0,64,23,77.0,129,45,20.1,No,2014,No,No,No
Sebastian Norman,87,4,74,29,44,29,479.0,1,0,19.0,73,29,11.8,No,2014,No,No,No
Preston Mattingly,275,67,205,94,131,80,1213.0,29,7,39.0,176,87,12.0,No,2014,No,No,No
Matt Hancock,50,17,63,20,4,2,425.0,36,8,21.0,27,12,10.0,No,2014,No,No,No
Mackey McKnight,1327,578,1040,419,472,366,3914.0,379,123,284.0,661,296,20.6,No,2014,No,No,No
Tim Kempton,2043,131,1404,744,719,526,3586.0,73,29,349.0,1331,715,30.6,Yes,2014,No,No,No
Jesse Chuku,754,80,652,268,135,94,2481.0,331,124,93.0,321,144,17.2,No,2014,No,No,No
Austin Price,1453,214,1173,499,288,215,3745.0,612,240,187.0,561,259,20.9,No,2014,No,No,No
Corey Schaefer,638,228,528,224,136,112,2825.0,211,78,110.0,317,146,13.2,No,2014,No,No,No
Justin Goldsborough,568,42,407,233,171,102,2034.0,0,0,127.0,407,233,16.0,No,2014,No,No,No
Stefan Cvrkalj,363,44,335,124,34,25,1201.0,250,90,52.0,85,34,17.7,No,2014,No,No,No
Shane Whitfield,977,225,641,308,509,359,3333.0,15,2,228.0,626,306,17.6,No,2014,No,No,No
Miles Simelton,170,60,167,63,31,23,747.0,68,21,49.0,99,42,16.4,No,2014,No,No,No
Conroy Baltimore,136,10,110,52,46,32,545.0,0,0,32.0,110,52,15.7,No,2014,No,No,No
Devon Carter,156,35,154,56,33,24,712.0,66,20,27.0,88,36,14.4,No,2014,No,No,No
Georgios Pilitsis,8,3,5,2,2,2,22.0,4,2,1.0,1,0,16.7,No,2014,No,No,No
Cole Renninger,7,2,9,2,5,3,32.0,1,0,0.0,8,2,18.7,No,2014,No,No,No
Antwan Burrus,1170,60,936,475,299,217,2980.0,8,3,176.0,928,472,21.4,No,2014,No,No,No
John Caleb Sanders,1384,335,1098,457,388,290,3306.0,506,180,245.0,592,277,23.8,No,2014,No,No,No
Tomasz Gielo,1041,143,878,370,214,168,3109.0,368,133,176.0,510,237,18.8,No,2014,No,No,No
Davon Marshall,803,173,646,253,150,124,2097.0,442,173,120.0,204,80,20.6,No,2014,No,No,No
Andrew Smith,730,75,538,298,211,133,2161.0,8,1,130.0,530,297,18.3,No,2014,No,No,No
JR Coronado,328,34,244,130,132,68,1437.0,0,0,66.0,244,130,13.4,No,2014,No,No,No
Joe Retic,281,180,223,85,126,96,1150.0,48,15,139.0,175,70,18.9,No,2014,No,No,No
Joel Vander Pol,472,24,311,165,229,142,1645.0,0,0,110.0,311,165,16.5,No,2014,No,No,No
Casey Roberts,249,44,213,82,49,33,753.0,133,52,25.0,80,30,18.0,No,2014,No,No,No
Ethan Layer,202,40,161,58,49,35,669.0,147,51,30.0,14,7,16.5,No,2014,No,No,No
Wesley Alcegaire,746,67,637,269,163,109,1824.0,287,99,112.0,350,170,22.2,No,2014,No,No,No
Chad Donley,146,25,137,47,26,16,453.0,111,36,18.0,26,11,19.0,No,2014,No,No,No
Sommy Ogukwe,71,6,56,28,36,15,487.0,1,0,37.0,55,28,11.5,No,2014,No,No,No
Devon Pekas,4,0,4,2,1,0,12.0,1,0,3.0,3,2,31.9,No,2014,No,No,No
Martin Smith,1095,177,856,344,337,265,2873.0,422,142,172.0,434,202,20.1,No,2014,No,No,No
J.C. Hampton,1409,331,1170,455,343,270,3652.0,643,229,229.0,527,226,21.0,No,2014,No,No,No
Malcolm Smith,1360,114,882,415,761,515,2594.0,58,15,216.0,824,400,27.5,No,2014,No,No,No
Josh Williams,1506,177,1089,513,348,268,2919.0,550,212,215.0,539,301,24.4,No,2014,No,No,No
Khion Sankey,443,140,342,155,165,89,1553.0,126,44,107.0,216,111,16.5,No,2014,No,No,No
Talbott Denny,391,66,287,119,243,137,1736.0,46,16,91.0,241,103,14.0,No,2014,No,No,No
Carter Sanderson,352,65,315,112,121,72,1010.0,174,56,85.0,141,56,21.9,No,2014,No,No,No
J.J. Butler,128,109,130,49,40,19,986.0,50,11,86.0,80,38,11.6,No,2014,No,No,No
Chad Johnson,89,50,82,23,34,27,727.0,59,16,39.0,23,7,9.2,No,2014,No,No,No
Cam Miller,281,100,205,103,81,54,1235.0,57,21,49.0,148,82,11.2,No,2014,No,No,No
Charles Smith,29,1,20,8,21,13,146.0,0,0,4.0,20,8,11.4,Yes,2014,No,No,No
Dylan Greene,8,5,14,2,8,3,76.0,7,1,4.0,7,1,14.1,No,2014,No,No,No
Mike Caffey,1649,457,1429,595,422,282,4001.0,532,177,320.0,897,418,24.7,No,2014,No,No,No
Tyler Lamb,987,210,878,338,241,182,2803.0,379,129,211.0,499,209,22.1,No,2014,No,No,No
Dan Jennings,649,42,476,265,259,119,1876.0,0,0,122.0,476,265,19.3,No,2014,No,No,No
A.J. Spencer,573,105,509,229,100,71,1796.0,143,44,68.0,366,185,17.3,No,2014,No,No,No
David Samuels,550,63,458,213,178,112,1648.0,51,12,109.0,407,201,20.3,No,2014,No,No,No
Branford Jones,560,173,479,187,158,120,1984.0,198,66,120.0,281,121,17.2,No,2014,No,No,No
Travis Hammonds,611,75,462,206,155,113,1534.0,220,86,97.0,242,120,20.7,No,2014,No,No,No
Kris Gulley,368,55,346,128,67,45,1610.0,224,67,89.0,122,61,14.9,No,2014,No,No,No
McKay LaSalle,280,33,248,93,19,15,1065.0,221,79,27.0,27,14,13.7,No,2014,No,No,No
Christian Griggs-Williams,151,10,128,57,44,24,651.0,27,13,33.0,101,44,13.9,No,2014,No,No,No
Nick Shepherd,162,12,123,57,81,48,1052.0,0,0,35.0,123,57,9.7,No,2014,No,No,No
Desmond Ross,13,2,17,5,3,2,69.0,7,1,3.0,10,4,15.6,No,2014,No,No,No
Anson Moye,31,13,38,12,10,2,299.0,21,5,15.0,17,7,9.5,No,2014,No,No,No
Javion Watson,4,5,6,1,2,1,45.0,4,1,4.0,2,0,12.2,No,2014,No,No,No
E.J. Reed,619,23,446,208,272,175,1410.0,94,28,115.0,352,180,24.3,No,2014,No,No,No
Jason Brickman,1180,1007,792,348,337,281,4241.0,491,203,432.0,301,145,15.6,No,2014,No,No,No
Gerrell Martin,834,59,660,277,158,133,2089.0,349,147,100.0,311,130,19.8,No,2014,No,No,No
Landon Atterberry,518,20,444,209,110,66,1236.0,103,34,65.0,341,175,22.7,No,2014,No,No,No
Troy Joseph,294,26,254,97,70,51,1127.0,149,49,48.0,105,48,14.8,No,2014,No,No,No
Gilbert Parga,143,15,104,37,74,55,349.0,48,14,23.0,56,23,23.3,No,2014,No,No,No
Glenn Feidanga,266,12,213,88,131,90,1054.0,3,0,34.0,210,88,14.4,No,2014,No,No,No
Iverson Fleming,839,148,777,287,230,165,2442.0,308,100,165.0,469,187,21.1,No,2014,No,No,No
D.J. Griggs,110,19,104,30,43,35,437.0,50,15,20.0,54,15,16.4,No,2014,No,No,No
Joel Hernandez,1429,157,1178,523,470,287,3025.0,290,96,216.0,888,427,25.8,No,2014,No,No,No
Chris Carter,38,0,29,15,9,6,89.0,5,2,7.0,24,13,22.7,No,2014,No,No,No
Darien Best,0,0,0,0,0,0,4.0,0,0,0.0,0,0,0.0,No,2014,No,No,No
Kaleb Marquis,0,0,0,0,0,0,1.0,0,0,0.0,0,0,0.0,No,2014,No,No,No
T.T. Carey,1544,194,1322,571,228,165,3273.0,644,237,185.0,678,334,24.3,No,2014,No,No,No
Karl Ziegler,618,74,445,222,230,173,1711.0,8,1,113.0,437,221,19.4,No,2014,No,No,No
Lucas Woodhouse,1215,662,924,400,278,235,3731.0,444,180,285.0,480,220,18.1,No,2014,No,No,No
Jeylani Dublin,789,27,647,344,167,101,1797.0,0,0,122.0,647,344,23.3,No,2014,No,No,No
Leron Fisher,695,202,570,207,273,200,2126.0,222,81,163.0,348,126,20.7,No,2014,No,No,No
Darrion Allen,1117,146,949,377,283,232,3405.0,384,131,192.0,565,246,19.0,No,2014,No,No,No
Isaac Belton,327,46,310,105,107,80,1073.0,161,37,61.0,149,68,20.0,No,2014,No,No,No
Damarion Geter,541,179,407,217,180,94,3253.0,36,13,162.0,371,204,10.4,No,2014,No,No,No
Jeff Havenstein,126,24,118,48,47,30,1238.0,1,0,52.0,117,48,7.6,No,2014,No,No,No
Tyler Akers,17,2,11,4,10,7,49.0,9,2,4.0,2,2,20.7,No,2014,No,No,No
Eric Shaw,0,0,1,0,0,0,0.0,0,0,0.0,1,0,0,No,2014,No,No,No
Elfrid Payton,1426,486,1032,501,645,394,3155.0,112,30,336.0,920,471,25.6,Yes,2014,No,No,No
Shawn Long,2342,148,1732,871,722,488,4017.0,328,112,328.0,1404,759,28.4,Yes,2014,No,No,No
Xavian Rimmer,710,129,525,211,231,187,2311.0,274,101,145.0,251,110,16.5,No,2014,No,No,No
Bryant Mbamalu,1077,119,878,385,286,205,2949.0,297,102,183.0,581,283,19.6,No,2014,No,No,No
Kevin Brown,523,86,457,164,148,105,1588.0,260,90,103.0,197,74,19.1,No,2014,No,No,No
J.J. Davenport,185,16,140,64,78,57,509.0,3,0,31.0,137,64,19.3,No,2014,No,No,No
Kasey Shepherd,1013,192,789,331,222,189,2190.0,441,162,177.0,348,169,23.1,No,2014,No,No,No
Steven Wronkoski,579,86,469,186,147,110,2448.0,281,97,137.0,188,89,13.2,No,2014,No,No,No
Elridge Moore,337,103,311,129,143,78,1936.0,13,1,132.0,298,128,13.1,No,2014,No,No,No
Hayward Register,466,24,464,155,38,27,1040.0,377,129,25.0,87,26,22.9,No,2014,No,No,No
Vieux Kande,49,2,28,19,24,11,185.0,0,0,11.0,28,19,12.9,No,2014,No,No,No
Braylon Lazare,40,7,41,16,11,8,181.0,0,0,9.0,41,16,14.7,No,2014,No,No,No
Donovan Williams,59,10,50,19,16,11,136.0,30,10,9.0,20,9,23.5,No,2014,No,No,No
Luka Kamber,316,50,313,106,39,27,1245.0,247,77,69.0,66,29,16.1,No,2014,No,No,No
Aaron Leblanc,28,3,26,13,6,1,141.0,2,1,9.0,24,12,12.9,No,2014,No,No,No
Tylor Ongwae,984,149,844,349,292,234,2210.0,203,52,144.0,641,297,27.1,No,2014,No,No,No
Jayon James,519,267,460,199,233,117,1814.0,42,4,213.0,418,195,22.8,No,2014,No,No,No
Marvin Williams,493,24,413,205,132,81,1372.0,9,2,95.0,404,203,21.6,Yes,2014,No,No,No
Nick Coppola,1231,555,1087,430,269,182,4768.0,523,189,253.0,564,241,16.2,No,2014,No,No,No
Amos Olatayo,652,40,517,238,198,120,1312.0,183,56,100.0,334,182,28.7,No,2014,No,No,No
Daniel Grieves,394,51,330,136,92,59,1267.0,193,63,74.0,137,73,18.2,No,2014,No,No,No
R.J. McCray,437,133,372,157,127,82,1951.0,116,41,133.0,256,116,15.4,No,2014,No,No,No
Chinedu Amajoyi,106,25,91,31,38,28,515.0,50,16,26.0,41,15,13.9,No,2014,No,No,No
DeMondre Harvey,474,67,306,175,197,124,1765.0,0,0,80.0,306,175,14.3,No,2014,No,No,No
Kyle Koszuta,141,55,129,46,24,15,606.0,89,34,50.0,40,12,16.6,No,2014,No,No,No
Millaun Brown,191,15,150,84,59,23,905.0,0,0,55.0,150,84,13.6,No,2014,No,No,No
Evan Sims,9,2,13,4,4,1,91.0,1,0,6.0,12,4,12.1,No,2014,No,No,No
Leon Carswell II,2,0,0,0,2,2,5.0,0,0,2.0,0,0,31.2,No,2014,No,No,No
Colton Ponder,0,0,1,0,0,0,3.0,0,0,0.0,1,0,17.6,No,2014,No,No,No
Johnny O'Bryant,1155,115,956,446,415,257,2465.0,27,6,267.0,929,440,28.2,No,2014,No,No,No
Jordan Mickey,913,76,701,363,278,186,2197.0,14,1,179.0,687,362,22.4,Yes,2014,No,No,No
Andre Stringer,1365,314,1122,421,357,281,3709.0,680,242,229.0,442,179,20.4,No,2014,No,No,No
Jarell Martin,889,88,654,323,293,202,1996.0,133,41,144.0,521,282,22.8,Yes,2014,No,No,No
Shavon Coleman,636,90,517,224,181,131,1730.0,166,57,108.0,351,167,19.9,No,2014,No,No,No
Anthony Hickey,1219,469,1165,456,161,81,4007.0,652,226,209.0,513,230,18.3,No,2014,No,No,No
Malik Morgan,983,278,853,345,248,164,2964.0,394,129,215.0,459,216,19.7,No,2014,No,No,No
Tim Quarterman,830,302,683,271,288,190,2461.0,316,98,168.0,367,173,19.4,Yes,2014,No,No,No
John Odo,48,2,32,19,17,10,259.0,0,0,12.0,32,19,9.7,No,2014,No,No,No
Darcy Malone,161,31,120,55,69,43,852.0,31,8,55.0,89,47,11.9,No,2014,No,No,No
Shane Hammink,883,166,633,309,256,197,2215.0,221,68,184.0,412,241,21.0,No,2014,No,No,No
Brandon Eddlestone,25,2,26,10,4,2,133.0,8,3,5.0,18,7,11.8,No,2014,No,No,No
Henry Shortess,8,2,8,3,0,0,28.0,5,2,3.0,3,1,18.9,No,2014,No,No,No
Alex Hamilton,1986,501,1387,636,834,604,3895.0,391,110,316.0,996,526,26.1,No,2014,No,No,No
Chris Anderson,594,55,501,220,178,116,1365.0,129,38,99.0,372,182,23.7,No,2014,No,No,No
Kenyon McNeaill,1147,223,927,351,293,221,3049.0,613,224,203.0,314,127,20.3,No,2014,No,No,No
Jaron Johnson,494,36,349,167,159,116,1308.0,143,44,53.0,206,123,17.2,No,2014,No,No,No
Raheem Appleby,1770,188,1583,672,320,240,3476.0,560,186,170.0,1023,486,27.0,No,2014,No,No,No
Speedy Smith,865,858,718,279,280,193,4109.0,320,114,340.0,398,165,14.2,No,2014,No,No,No
Cordarius Johnson,1003,107,919,347,226,144,2750.0,533,165,164.0,386,182,21.1,No,2014,No,No,No
Michale Kyser,858,56,644,350,283,158,2963.0,1,0,92.0,643,350,14.4,No,2014,No,No,No
Isaiah Massey,223,16,165,83,80,56,759.0,2,1,30.0,163,82,14.6,No,2014,No,No,No
Gilbert Talbot,101,4,78,42,37,17,246.0,0,0,18.0,78,42,21.8,No,2014,No,No,No
Stojan Gjuroski,45,8,61,16,8,3,193.0,44,10,12.0,17,6,19.0,No,2014,No,No,No
Josh Butler,0,0,0,0,0,0,1.0,0,0,0.0,0,0,0.0,No,2014,No,No,No
Russ Smith,1908,378,1501,620,642,488,3228.0,521,180,316.0,980,440,32.6,Yes,2014,No,No,No
Montrezl Harrell,1294,102,910,533,407,217,2961.0,40,11,145.0,870,522,21.0,Yes,2014,No,No,No
Luke Hancock,1370,373,950,430,439,345,3439.0,453,165,239.0,497,265,20.6,No,2014,No,No,No
Chris Jones,694,190,597,231,201,150,1651.0,229,82,107.0,368,149,24.1,No,2014,No,No,No
Wayne Blackshear,1046,95,838,342,278,206,2723.0,454,156,89.0,384,186,19.5,No,2014,No,No,No
Terry Rozier,874,175,753,307,228,176,1959.0,254,84,101.0,499,223,24.7,Yes,2014,No,No,No
Mangok Mathiang,551,60,413,209,222,133,2054.0,0,0,99.0,413,209,14.9,Yes,2014,No,No,No
Stephan Van Treese,279,48,181,119,80,40,1719.0,2,1,62.0,179,118,8.1,No,2014,No,No,No
Chane Behanan,852,86,641,333,324,179,2280.0,48,7,150.0,593,326,20.7,No,2014,No,No,No
Tim Henderson,115,32,106,41,14,8,444.0,75,25,19.0,31,16,14.6,No,2014,No,No,No
Anton Gill,405,62,381,138,80,50,1397.0,240,79,57.0,141,59,17.2,No,2014,No,No,No
Akoy Agau,327,49,205,101,158,117,1131.0,31,8,100.0,174,93,17.3,No,2014,No,No,No
David Levitch,141,47,104,41,49,31,571.0,64,28,20.0,40,13,12.8,No,2014,No,No,No
Kevin Ware,816,220,674,287,267,191,2839.0,154,51,195.0,520,236,18.7,No,2014,No,No,No
Milton Doyle,1606,459,1229,538,543,390,3677.0,407,140,380.0,822,398,28.3,Yes,2014,No,No,No
Christian Thomas,1353,120,917,508,460,302,3593.0,87,35,186.0,830,473,20.8,No,2014,No,No,No
Jeff White,656,312,579,242,168,127,2954.0,135,45,202.0,444,197,16.3,No,2014,No,No,No
Devon Turk,1205,96,973,413,143,117,3046.0,650,262,147.0,323,151,21.9,No,2014,No,No,No
Joe Crisman,617,192,536,226,158,103,3044.0,192,62,144.0,344,164,14.0,No,2014,No,No,No
Nick Osborne,478,38,421,194,97,68,1437.0,64,22,83.0,357,172,20.3,No,2014,No,No,No
Matt O'Leary,1018,238,809,380,219,140,2916.0,346,118,190.0,463,262,19.4,No,2014,No,No,No
Cody Johnson,61,5,52,25,6,4,193.0,19,7,10.0,33,18,18.8,No,2014,No,No,No
Tony Nixon,468,52,452,162,101,61,1597.0,260,83,71.0,192,79,18.2,No,2014,No,No,No
Jeremy King,27,1,14,12,9,3,77.0,0,0,7.0,14,12,18.4,No,2014,No,No,No
Bill Clark,18,13,30,7,4,2,136.0,13,2,12.0,17,5,18.1,No,2014,No,No,No
Jordan Pickett,248,50,220,83,72,59,717.0,77,23,39.0,143,60,20.6,No,2014,No,No,No
London Dokubo,23,39,25,8,10,4,538.0,12,3,30.0,13,5,6.3,No,2014,No,No,No
Derrick Boone,1,0,5,0,2,1,15.0,3,0,0.0,2,0,22.4,No,2014,No,No,No
Anthony Ireland,2172,557,1774,736,633,504,4633.0,568,196,363.0,1206,540,26.2,No,2014,No,No,No
Evan Payne,1436,129,1108,477,424,351,2595.0,371,131,210.0,737,346,29.3,No,2014,No,No,No
Gabe Levin,1413,142,1062,484,520,394,3165.0,166,51,239.0,896,433,23.6,No,2014,No,No,No
Alex Osborne,536,45,428,218,200,100,2119.0,0,0,104.0,428,218,14.7,No,2014,No,No,No
C.J. Blackwell,412,43,409,158,51,34,1188.0,188,62,57.0,221,96,20.4,No,2014,No,No,No
Ben Dickinson,610,104,548,239,182,121,1504.0,57,11,126.0,491,228,26.6,No,2014,No,No,No
Nick Stover,892,140,741,310,256,181,2568.0,286,91,163.0,455,219,19.7,No,2014,No,No,No
Marin Mornar,662,60,504,245,162,118,2176.0,158,54,93.0,346,191,16.0,No,2014,No,No,No
Chase Flint,264,227,264,97,42,28,1730.0,145,42,91.0,119,55,11.1,No,2014,No,No,No
Ayodeji Egbeyemi,849,143,764,305,223,149,2932.0,285,90,148.0,479,215,17.8,No,2014,No,No,No
Nino Jackson,11,4,18,4,3,2,41.0,7,1,3.0,11,3,26.2,No,2014,No,No,No
Max Heller,7,20,14,2,3,2,162.0,5,1,14.0,9,1,9.4,No,2014,No,No,No
Alozie Erondu,4,0,4,2,0,0,21.0,0,0,0.0,4,2,9.1,No,2014,No,No,No
Dylon Cormier,1659,210,1280,552,662,459,3662.0,340,96,182.0,940,456,25.1,No,2014,No,No,No
Jarred Jones,1188,140,909,433,424,311,2853.0,46,11,234.0,863,422,24.2,No,2014,No,No,No
Eric Laster,892,121,845,330,217,126,2706.0,316,106,134.0,529,224,21.1,No,2014,No,No,No
Jordan Latham,414,55,386,159,148,94,1604.0,7,2,103.0,379,157,18.2,No,2014,No,No,No
R.J. Williams,438,261,367,133,191,140,2183.0,104,32,154.0,263,101,14.6,No,2014,No,No,No
Tyler Hubbard,879,84,776,273,194,144,2655.0,553,189,92.0,223,84,19.0,No,2014,No,No,No
Franz Rassman,745,71,626,299,178,122,2375.0,79,25,132.0,547,274,18.7,No,2014,No,No,No
Denzel Brito,501,248,487,152,196,144,2489.0,206,53,178.0,281,99,16.7,No,2014,No,No,No
Nick Gorski,158,20,159,60,45,33,784.0,23,5,48.0,136,55,15.3,No,2014,No,No,No
Damion Rashford,18,2,33,7,8,2,115.0,10,2,8.0,23,5,20.4,No,2014,No,No,No
Jevon Patton,9,17,12,2,7,5,101.0,3,0,9.0,9,2,12.6,No,2014,No,No,No
Josh Forney,18,0,9,7,16,4,115.0,0,0,10.0,9,7,12.3,No,2014,No,No,No
Sean Tuohy Jr.,10,3,16,3,5,3,78.0,11,1,4.0,5,2,15.1,No,2014,No,No,No
Chido Onyiuke,5,1,4,1,4,3,46.0,0,0,3.0,4,1,10.1,No,2014,No,No,No
Xavier Pollard,989,302,829,373,307,196,2452.0,190,47,221.0,639,326,24.1,No,2014,No,No,No
Zarko Valjarevic,781,90,670,261,104,77,2213.0,488,182,89.0,182,79,18.6,No,2014,No,No,No
Dimitry Akanda-Coronel,318,43,290,113,93,57,704.0,113,35,64.0,177,78,27.3,No,2014,No,No,No
Shaun Lawton,787,303,624,255,309,221,2647.0,185,56,259.0,439,199,19.3,No,2014,No,No,No
Till Gloger,911,37,699,376,222,159,2256.0,3,0,137.0,696,376,20.8,No,2014,No,No,No
Troy Reid-Knight,438,132,368,141,125,87,1517.0,198,69,134.0,170,72,18.0,No,2014,No,No,No
Ethan Mackey,190,15,148,86,38,18,604.0,0,0,28.0,148,86,15.9,No,2014,No,No,No
Garet Beal,272,62,239,85,90,67,959.0,131,35,77.0,108,50,18.5,No,2014,No,No,No
Kilian Cato,225,21,209,79,23,18,798.0,142,49,33.0,67,30,15.8,No,2014,No,No,No
Marko Pirovic,350,56,294,117,133,83,1189.0,133,33,68.0,161,84,17.8,No,2014,No,No,No
Christian Ejiga,104,8,91,39,39,26,443.0,1,0,29.0,90,39,15.8,No,2014,No,No,No
Erik Nissen,53,4,49,21,14,10,182.0,2,1,13.0,47,20,19.6,No,2014,No,No,No
Stefan Micovic,28,1,26,10,14,8,175.0,2,0,15.0,24,10,13.2,No,2014,No,No,No
George Beamon,1843,136,1367,608,645,504,3414.0,342,123,226.0,1025,485,28.0,No,2014,No,No,No
Michael Alvarado,1170,364,884,346,565,420,3175.0,193,58,299.0,691,288,23.4,No,2014,No,No,No
Rhamel Brown,1172,79,867,478,463,216,3155.0,4,0,202.0,863,478,21.1,No,2014,No,No,No
Emmy Andujar,1345,367,1004,492,465,324,3505.0,116,37,369.0,888,455,23.2,No,2014,No,No,No
Shane Richards,1472,149,1103,443,330,274,3569.0,801,312,158.0,302,131,20.5,No,2014,No,No,No
Ashton Pankey,827,51,542,284,421,259,2145.0,0,0,139.0,542,284,20.6,No,2014,No,No,No
RaShawn Stores,768,314,592,223,258,179,3127.0,364,143,173.0,228,80,14.7,No,2014,No,No,No
Rich Williams,1187,160,989,434,238,180,2693.0,372,139,228.0,617,295,25.4,No,2014,No,No,No
Donovan Kates,570,105,475,146,251,201,2601.0,276,77,147.0,199,69,14.7,No,2014,No,No,No
Tyler Wilson,369,364,275,99,273,164,2666.0,24,7,238.0,251,92,12.2,No,2014,No,No,No
CJ Jones,68,36,96,24,26,15,427.0,30,5,39.0,66,19,18.5,No,2014,No,No,No
Carlton Allen,48,2,35,17,22,14,357.0,0,0,17.0,35,17,8.9,No,2014,No,No,No
Trevor Glassman,7,1,20,2,2,1,42.0,18,2,4.0,2,0,29.8,No,2014,No,No,No
Adam Lacey,2,0,3,1,0,0,23.0,0,0,3.0,3,1,14.3,No,2014,No,No,No
Chavaughn Lewis,2119,308,1756,728,810,543,4140.0,386,120,407.0,1370,608,32.0,No,2014,No,No,No
Khallid Hart,1879,240,1321,584,607,496,3851.0,589,215,225.0,732,369,24.8,No,2014,No,No,No
Jay Bowie,988,116,762,341,201,163,2962.0,344,143,155.0,418,198,17.6,No,2014,No,No,No
Adam Kemp,973,61,718,356,432,261,3055.0,0,0,185.0,718,356,18.6,No,2014,No,No,No
T.J. Curry,461,162,385,142,123,89,2001.0,242,88,109.0,143,54,14.4,No,2014,No,No,No
Manny Thomas,611,133,519,188,185,137,2570.0,269,98,150.0,250,90,15.3,No,2014,No,No,No
Pieter Prinsolo,149,6,141,54,39,26,932.0,47,15,39.0,94,39,10.9,No,2014,No,No,No
Phillip Lawrence-Ricks,417,51,345,150,115,74,1533.0,137,43,60.0,208,107,15.9,No,2014,No,No,No
Kentrall Brooks,307,69,244,112,114,83,1327.0,8,0,118.0,236,112,16.3,No,2014,No,No,No
Isaiah Morton,505,224,462,159,158,102,2007.0,281,85,179.0,181,74,18.2,No,2014,No,No,No
Eric Truog,298,114,283,127,75,33,1643.0,39,11,88.0,244,116,13.1,No,2014,No,No,No
Patrick Ramsey,14,0,10,5,1,0,31.0,8,4,0.0,2,1,17.4,No,2014,No,No,No
Tourron Whitfield,11,3,10,2,6,5,53.0,8,2,2.0,2,0,14.8,No,2014,No,No,No
Nick Colletta,46,3,59,17,1,1,210.0,46,11,6.0,13,6,16.8,No,2014,No,No,No
Davante Gardner,1287,103,767,427,544,430,2410.0,23,3,144.0,744,424,24.8,No,2014,No,No,No
Jamil Wilson,1077,205,908,397,277,196,3067.0,259,87,175.0,649,310,20.3,Yes,2014,No,No,No
Todd Mayo,738,119,544,231,256,203,1777.0,229,73,140.0,315,158,22.9,No,2014,No,No,No
Jake Thomas,1143,201,859,327,291,237,3224.0,658,252,145.0,201,75,17.2,No,2014,No,No,No
Deonte Burton,1052,108,845,404,265,176,2053.0,168,68,150.0,677,336,27.7,Yes,2014,No,No,No
Chris Otule,615,19,409,240,256,135,2075.0,0,0,128.0,409,240,16.2,No,2014,No,No,No
Derrick Wilson,400,366,387,150,195,89,2789.0,63,11,127.0,324,139,11.4,No,2014,No,No,No
Juan Anderson,464,120,406,171,150,89,1864.0,114,33,131.0,292,138,17.3,No,2014,No,No,No
JaJuan Johnson,1013,222,834,379,221,173,2519.0,253,82,179.0,581,297,22.6,Yes,2014,No,No,No
Steve Taylor Jr.,854,154,715,355,236,121,2303.0,106,23,175.0,609,332,22.6,No,2014,No,No,No
John Dawson,629,189,531,217,127,96,1923.0,285,99,155.0,246,118,21.9,No,2014,No,No,No
Dylan Flood,2,0,3,1,0,0,11.0,1,0,0.0,2,1,14.0,No,2014,No,No,No
Kareem Canty,922,291,816,313,221,162,1932.0,405,134,183.0,411,179,27.5,No,2014,No,No,No
Chris Thomas,1351,257,1062,502,515,288,3011.0,224,59,288.0,838,443,26.7,No,2014,No,No,No
Ryan Taylor,1778,292,1263,616,683,458,3519.0,303,88,302.0,960,528,25.3,No,2014,No,No,No
Shawn Smith,310,24,246,108,99,65,839.0,95,29,43.0,151,79,19.4,No,2014,No,No,No
TyQuane Goard,242,30,172,91,91,60,995.0,4,0,40.0,168,91,12.5,No,2014,No,No,No
Elijah Pittman,709,54,484,234,233,148,1281.0,250,93,90.0,234,141,25.8,No,2014,No,No,No
Tamron Manning,280,125,270,88,111,75,1539.0,114,29,93.0,156,59,13.1,No,2014,No,No,No
DeVince Boykins,343,99,317,132,119,34,1701.0,125,45,119.0,192,87,14.0,No,2014,No,No,No
Cheikh Sane,251,34,203,89,132,72,1123.0,6,1,72.0,197,88,14.6,No,2014,No,No,No
Austin Loop,1096,105,793,337,149,129,3155.0,714,293,65.0,79,44,13.8,No,2014,No,No,No
Youssoupha Mbao,30,9,28,9,28,12,491.0,0,0,39.0,28,9,8.1,No,2014,No,No,No
Kevin McNair,6,0,2,1,5,4,9.0,1,0,0.0,1,1,23.5,No,2014,No,No,No
Rodney Elliott,1034,251,726,316,385,284,2303.0,341,118,217.0,385,198,24.6,No,2014,No,No,No
Chase Plummer,1307,144,1140,457,538,332,2708.0,202,61,302.0,938,396,31.6,No,2014,No,No,No
Quentin Jones,337,123,301,111,92,64,1522.0,131,51,100.0,170,60,14.7,No,2014,No,No,No
Malik Garner,274,57,243,105,78,44,1244.0,72,20,60.0,171,85,13.8,No,2014,No,No,No
Brett Roseboro,419,24,376,171,122,73,1320.0,15,4,109.0,361,167,21.0,No,2014,No,No,No
Charles Taylor Jr.,217,29,220,80,86,53,820.0,30,4,63.0,190,76,20.4,No,2014,No,No,No
Devarick Houston,326,85,293,124,88,51,1710.0,109,27,114.0,184,97,14.0,No,2014,No,No,No
David Kadiri,396,14,284,164,124,68,1240.0,1,0,49.0,283,164,15.2,No,2014,No,No,No
Bryan Harris,99,7,81,29,35,29,0,44,12,0,37,17,0,No,2014,No,No,No
Aaron Morgan,255,110,251,73,97,67,1274.0,151,42,125.0,100,31,17.1,No,2014,No,No,No
Will Darley,1095,155,798,378,217,181,2746.0,384,158,172.0,414,220,19.9,No,2014,No,No,No
Joey Getz,302,96,282,111,81,58,1210.0,64,22,90.0,218,89,17.1,No,2014,No,No,No
Ben Grace,152,31,116,45,26,22,647.0,101,40,27.0,15,5,12.8,No,2014,No,No,No
Troy Snyder,777,104,645,279,251,166,2108.0,181,53,144.0,464,226,22.1,No,2014,No,No,No
Hakeem Baxter,1085,224,794,321,499,382,3352.0,204,61,208.0,590,260,18.9,No,2014,No,No,No
Kyree Jones,501,88,437,145,151,132,1231.0,253,79,71.0,184,66,24.1,No,2014,No,No,No
Devon Walker,476,53,391,165,48,38,1317.0,276,108,52.0,115,57,18.3,No,2014,No,No,No
Ishaq Pitt,672,306,543,230,366,208,2686.0,25,4,245.0,518,226,18.2,No,2014,No,No,No
Issac Smith,186,100,211,57,75,51,913.0,79,21,81.0,132,36,18.5,No,2014,No,No,No
Louis Bell,643,120,646,219,82,56,2329.0,459,149,118.0,187,70,17.3,No,2014,No,No,No
Francis Ezeiru,158,3,136,63,78,32,664.0,0,0,41.0,136,63,16.5,No,2014,No,No,No
Shane Randall,161,15,121,52,67,55,779.0,9,2,55.0,112,50,13.7,No,2014,No,No,No
Mark Blackmon,188,36,148,58,73,51,714.0,61,21,37.0,87,37,15.9,No,2014,No,No,No
Pina Guillaume,190,17,190,80,44,25,985.0,17,5,55.0,173,75,13.8,No,2014,No,No,No
Travis Trim,79,68,92,31,30,13,689.0,14,4,50.0,78,27,11.8,No,2014,No,No,No
Iman Johnson,277,74,240,108,93,53,1316.0,31,8,82.0,209,100,14.2,No,2014,No,No,No
Maceio Choice,2,0,2,1,0,0,8.0,1,0,0.0,1,1,12.8,No,2014,No,No,No
Anfernee Robinson,0,0,1,0,0,0,4.0,0,0,1.0,1,0,25.5,No,2014,No,No,No
Brandon Turner,0,0,0,0,0,0,4.0,0,0,0.0,0,0,0.0,No,2014,No,No,No
Dez Wells,1710,294,1238,612,524,401,3756.0,227,85,321.0,1011,527,24.8,No,2014,No,No,No
Jake Layman,1436,156,1083,482,361,274,3938.0,547,198,204.0,536,284,19.3,Yes,2014,No,No,No
Evan Smotrycz,951,140,790,322,200,150,2737.0,419,157,155.0,371,165,20.6,No,2014,No,No,No
Nick Faust,1553,304,1279,518,471,323,3827.0,581,194,299.0,698,324,23.5,No,2014,No,No,No
Seth Allen,1487,338,1125,484,443,335,3297.0,529,184,292.0,596,300,24.9,No,2014,No,No,No
Charles Mitchell,1085,59,893,462,298,161,2786.0,0,0,227.0,893,462,22.9,No,2014,No,No,No
Roddy Peters,857,237,658,316,290,211,1608.0,61,14,216.0,597,302,29.6,No,2014,No,No,No
Shaquille Cleare,618,32,458,257,161,104,1997.0,1,0,105.0,457,257,16.3,No,2014,No,No,No
Jonathan Graham,283,22,258,116,101,51,1551.0,0,0,72.0,258,116,12.9,No,2014,No,No,No
Damonte Dodd,422,46,273,160,185,102,1797.0,0,0,112.0,273,160,13.8,No,2014,No,No,No
Varun Ram,39,19,39,7,25,19,291.0,29,6,21.0,10,1,12.9,No,2014,No,No,No
John Auslander,21,2,20,7,11,6,132.0,8,1,8.0,12,6,12.7,No,2014,No,No,No
Spencer Barks,7,0,8,0,12,7,44.0,0,0,2.0,8,0,18.2,No,2014,No,No,No
Conner Lipinski,7,1,1,1,6,4,17.0,1,1,2.0,0,0,17.3,No,2014,No,No,No
A.J. Metz,0,0,0,0,0,0,1.0,0,0,0.0,0,0,0.0,No,2014,No,No,No
Jacob Susskind,0,1,9,0,0,0,38.0,4,0,4.0,5,0,17.4,No,2014,No,No,No
Akeem Williams,442,95,379,145,122,98,896.0,157,54,90.0,222,91,31.7,No,2014,No,No,No
Chad Holley,619,187,515,179,228,178,2210.0,263,83,146.0,252,96,19.0,No,2014,No,No,No
Antonio Bivins,218,7,142,72,97,74,440.0,2,0,27.0,140,72,26.4,No,2014,No,No,No
DJ Mlachnik,324,50,288,103,71,53,1194.0,190,65,61.0,98,38,17.2,No,2014,No,No,No
Tyler Livingston,934,107,815,350,73,55,2635.0,491,179,111.0,324,171,18.7,No,2014,No,No,No
Mark Cornelius,386,116,319,143,99,63,1468.0,106,37,101.0,213,106,16.5,No,2014,No,No,No
Kerry Weldon,238,49,214,100,126,38,1215.0,1,0,84.0,213,100,16.2,No,2014,No,No,No
Parris Massey,66,7,47,28,21,10,311.0,0,0,6.0,47,28,10.9,No,2014,No,No,No
Kennedy Chukwuocha,20,3,19,7,11,6,171.0,1,0,15.0,18,7,12.4,No,2014,No,No,No
Carlos Taylor,17,0,22,6,0,0,47.0,16,5,4.0,6,1,29.9,No,2014,No,No,No
Michael Gelineau,7,0,6,2,3,3,9.0,1,0,0.0,5,2,44.5,No,2014,No,No,No
James McDonnell,6,0,3,3,0,0,28.0,0,0,1.0,3,3,7.7,No,2014,No,No,No
Andrew Nene,0,0,0,0,0,0,4.0,0,0,0.0,0,0,0.0,No,2014,No,No,No
Chaz Williams,1978,840,1559,634,667,514,4665.0,521,196,437.0,1038,438,23.5,No,2014,No,No,No
Cady Lalanne,1107,26,767,424,374,249,2799.0,47,10,206.0,720,414,19.9,No,2014,No,No,No
Sampson Carter,963,104,765,316,370,272,2946.0,224,59,179.0,541,257,18.2,No,2014,No,No,No
Derrick Gordon,1305,280,1127,463,518,338,3819.0,164,41,294.0,963,422,21.3,No,2014,No,No,No
Trey Davis,1353,348,1076,420,394,325,3141.0,530,188,222.0,546,232,23.2,No,2014,No,No,No
Raphiael Putney,1019,155,862,385,172,128,2785.0,380,121,210.0,482,264,19.7,No,2014,No,No,No
Maxie Esho,1019,68,764,383,383,243,2734.0,37,10,196.0,727,373,20.1,No,2014,No,No,No
Tyler Bergantino,160,18,114,73,41,14,1136.0,1,0,21.0,113,73,6.7,No,2014,No,No,No
Clyde Santee,25,2,15,9,5,3,42.0,9,4,3.0,6,5,23.2,No,2014,No,No,No
Demetrius Dyson,1183,91,870,393,294,212,2487.0,450,185,161.0,420,208,23.6,No,2014,No,No,No
Seth Berger,361,62,293,142,90,54,1488.0,87,23,68.0,206,119,13.4,No,2014,No,No,No
Ledrick Eackles,1008,159,834,301,398,291,2131.0,360,115,181.0,474,186,27.3,No,2014,No,No,No
Kevin Hardy,1169,430,998,465,366,202,3750.0,109,37,220.0,889,428,18.6,No,2014,No,No,No
Craig McFerrin,834,67,686,353,224,128,2484.0,7,0,185.0,679,353,19.5,No,2014,No,No,No
Desharick Guidry,1352,123,1103,510,375,258,3504.0,216,74,195.0,887,436,21.2,No,2014,No,No,No
Keelan Garrett,548,66,534,193,69,51,1422.0,332,111,64.0,202,82,22.1,No,2014,No,No,No
Adrian Fields,474,56,478,157,156,110,1784.0,179,50,96.0,299,107,18.3,No,2014,No,No,No
Shaun Johnson,324,62,363,104,44,35,1038.0,280,81,37.0,83,23,20.2,No,2014,No,No,No
Jamaya Burr,1148,361,857,341,540,386,3149.0,234,80,266.0,623,261,21.6,No,2014,No,No,No
Brandon Regis,181,47,211,65,56,32,670.0,89,19,54.0,122,46,21.6,No,2014,No,No,No
Austin Lewis,406,16,319,175,107,56,1609.0,1,0,63.0,318,175,13.4,No,2014,No,No,No
Pete Kpan,63,7,41,22,28,19,268.0,1,0,10.0,40,22,12.1,No,2014,No,No,No
Matthew Moss,208,17,205,76,26,16,767.0,135,40,33.0,70,36,16.2,No,2014,No,No,No
Andrija Milovanovic,19,3,19,5,4,4,79.0,14,5,2.0,5,0,14.4,No,2014,No,No,No
Marcus Mathieu,34,16,40,11,14,8,196.0,18,4,18.0,22,7,16.4,No,2014,No,No,No
Lance Potier,367,64,360,145,62,35,1545.0,146,42,77.0,214,103,14.8,No,2014,No,No,No
Jordan Wells,63,7,74,27,16,7,302.0,8,2,18.0,66,25,16.8,No,2014,No,No,No
Joe Jackson,1687,564,1184,540,661,508,3983.0,293,99,373.0,891,441,23.3,No,2014,No,No,No
Michael Dixon,1459,365,1045,480,391,333,2987.0,442,166,201.0,603,314,23.6,No,2014,No,No,No
Shaq Goodwin,1440,206,1003,518,602,395,3504.0,36,9,266.0,967,509,21.5,No,2014,No,No,No
Austin Nichols,684,43,547,294,161,94,1586.0,11,2,72.0,536,292,21.9,No,2014,No,No,No
Geron Johnson,644,237,560,239,154,100,1897.0,213,66,178.0,347,173,20.8,No,2014,No,No,No
Chris Crawford,1223,468,1102,431,158,119,3911.0,659,242,258.0,443,189,18.2,Yes,2014,No,No,No
Nick King,1085,108,845,400,348,229,2080.0,161,56,148.0,684,344,28.2,No,2014,No,No,No
David Pellom,702,103,480,296,207,105,2359.0,28,5,129.0,452,291,15.2,No,2014,No,No,No
Dominic Woodson,63,9,64,28,19,7,184.0,0,0,14.0,64,28,23.4,No,2014,No,No,No
Kuran Iverson,693,126,565,267,212,116,1935.0,136,43,154.0,429,224,21.7,No,2014,No,No,No
Damien Wilson,310,54,293,118,93,67,871.0,53,7,89.0,240,111,24.9,No,2014,No,No,No
Anthony Cole,6,0,5,1,4,4,19.0,1,0,0.0,4,1,17.6,No,2014,No,No,No
Trey Draper,8,1,17,1,11,5,44.0,10,1,6.0,7,0,31.5,No,2014,No,No,No
Jake McDowell,33,7,36,14,10,4,271.0,4,1,8.0,32,13,8.7,No,2014,No,No,No
Langston Hall,1579,633,1221,481,447,361,4541.0,677,256,322.0,544,225,20.5,No,2014,No,No,No
Daniel Coursey,935,40,686,390,231,155,2277.0,0,0,129.0,686,390,21.7,No,2014,No,No,No
Bud Thomas,1059,275,857,397,176,104,3748.0,477,161,170.0,380,236,15.8,No,2014,No,No,No
Anthony White Jr.,451,51,340,150,100,81,1143.0,175,70,37.0,165,80,19.8,No,2014,No,No,No
Jake Gollon,1153,320,891,392,345,279,3762.0,260,90,297.0,631,302,19.1,No,2014,No,No,No
Ike Nwamu,1256,150,951,404,377,272,2815.0,472,176,198.0,479,228,24.6,No,2014,No,No,No
Darious Moten,585,75,417,208,201,142,1528.0,71,27,75.0,346,181,21.0,No,2014,No,No,No
Monty Brown,522,26,333,180,234,162,1332.0,0,0,111.0,333,180,22.3,No,2014,No,No,No
Jibri Bryan,513,69,441,164,130,93,1706.0,280,92,86.0,161,72,18.8,No,2014,No,No,No
Phillip Leonard,770,337,535,247,421,268,2166.0,53,8,144.0,482,239,21.6,No,2014,No,No,No
T.J. Hallice,547,88,431,217,197,106,2264.0,38,7,87.0,393,210,14.8,No,2014,No,No,No
Kevin Canevari,136,129,116,45,25,22,1011.0,66,24,81.0,50,21,11.0,No,2014,No,No,No
James Bento,41,9,45,18,15,5,292.0,1,0,8.0,44,18,10.9,No,2014,No,No,No
John Mosser,3,2,8,0,4,3,21.0,5,0,1.0,3,0,27.3,No,2014,No,No,No
Rion Brown,1124,144,930,377,262,196,3192.0,523,174,127.0,407,203,20.4,No,2014,No,No,No
Garrius Adams,804,197,708,261,267,177,2976.0,360,105,161.0,348,156,18.2,No,2014,No,No,No
Manu Lecomte,1491,392,1120,468,370,314,3893.0,595,241,237.0,525,227,20.8,No,2014,No,No,No
Donnavan Kirk,551,24,476,220,124,84,2166.0,82,27,90.0,394,193,15.2,No,2014,No,No,No
Davon Reed,1343,216,1018,438,340,265,3679.0,512,202,187.0,506,236,20.2,Yes,2014,No,No,No
James Kelly,826,53,613,325,153,112,1491.0,196,64,95.0,417,261,25.2,No,2014,No,No,No
Erik Swoope,291,31,206,107,130,75,1190.0,10,2,31.0,196,105,13.9,No,2014,No,No,No
Tonye Jekiri,769,97,623,312,225,144,3053.0,5,1,142.0,618,311,15.7,No,2014,No,No,No
Raphael Akpejiori,97,5,66,28,67,41,593.0,0,0,22.0,66,28,10.9,No,2014,No,No,No
Justin Heller,4,2,9,2,2,0,20.0,5,0,4.0,4,2,38.5,No,2014,No,No,No
Mike Fernandez,2,0,2,1,0,0,10.0,1,0,3.0,1,1,28.5,No,2014,No,No,No
Steve Sorenson,1,0,0,0,3,1,12.0,0,0,3.0,0,0,19.9,No,2014,No,No,No
Will Felder,1411,118,1056,517,391,306,3431.0,237,71,256.0,819,446,23.1,No,2014,No,No,No
Geovonie McKnight,1215,237,1101,452,400,285,3510.0,116,26,277.0,985,426,23.9,No,2014,No,No,No
Will Sullivan,793,130,587,265,166,127,2950.0,344,136,122.0,243,129,14.5,No,2014,No,No,No
Quinten Rollins,734,391,613,269,284,175,3447.0,87,21,259.0,526,248,16.0,No,2014,No,No,No
Willie Moore,596,118,502,188,205,154,1937.0,219,66,181.0,283,122,21.4,No,2014,No,No,No
Jaryd Eustace,299,28,273,96,70,47,898.0,194,60,51.0,79,36,21.3,No,2014,No,No,No
Joshua Oswald,155,22,157,61,26,20,590.0,60,13,28.0,97,48,17.8,No,2014,No,No,No
Reggie Johnson,1254,225,1124,418,434,292,2917.0,427,126,211.0,697,292,26.1,Yes,2014,No,No,No
Bill Edwards,289,59,279,104,55,47,921.0,107,34,84.0,172,70,23.2,Yes,2014,No,No,No
John Hawkins,37,3,38,16,9,5,165.0,1,0,11.0,37,16,17.2,No,2014,No,No,No
Blake McLimans,91,9,107,37,6,5,415.0,63,12,12.0,44,25,16.3,No,2014,No,No,No
Brian Oddo,30,3,28,11,5,3,147.0,18,5,6.0,10,6,13.2,No,2014,No,No,No
Philip Bennett,3,0,1,1,0,0,12.0,1,1,0.0,0,0,4.4,No,2014,No,No,No
Gary Harris,1025,140,784,345,240,189,2141.0,388,146,111.0,396,199,24.6,Yes,2014,No,No,No
Adreian Payne,1232,85,850,447,367,277,2759.0,149,61,187.0,701,386,22.9,Yes,2014,No,No,No
Keith Appling,1509,465,1140,491,520,389,4229.0,413,138,296.0,727,353,20.7,Yes,2014,No,No,No
Branden Dawson,1309,181,1013,566,317,177,3456.0,9,0,219.0,1004,566,21.2,Yes,2014,No,No,No
Denzel Valentine,1645,639,1309,579,285,222,4182.0,650,265,317.0,659,314,22.1,Yes,2014,No,No,No
Travis Trice,1135,387,952,371,267,191,3164.0,512,202,177.0,440,169,21.1,No,2014,No,No,No
Kenny Kaminski,922,79,745,304,138,112,2232.0,496,202,75.0,249,102,20.0,No,2014,No,No,No
Matt Costello,828,107,573,325,247,176,2281.0,12,2,98.0,561,323,18.0,Yes,2014,No,No,No
Alvin Ellis III,434,110,349,141,136,85,1486.0,186,67,103.0,163,74,18.1,No,2014,No,No,No
Gavin Schilling,442,51,296,172,181,98,1527.0,0,0,96.0,296,172,16.4,No,2014,No,No,No
Alex Gauna,144,10,113,63,40,18,562.0,1,0,33.0,112,63,15.3,No,2014,No,No,No
Russell Byrd,110,25,121,35,32,18,526.0,95,22,28.0,26,13,16.3,No,2014,No,No,No
Keenan Wetzel,16,1,22,6,2,1,71.0,14,3,3.0,8,3,19.4,No,2014,No,No,No
Dan Chapman,5,2,14,2,0,0,52.0,6,1,2.0,8,1,16.0,No,2014,No,No,No
Colby Wollenman,80,26,56,32,29,16,442.0,0,0,30.0,56,32,11.8,No,2014,No,No,No
Trevor Bohnhoff,7,0,2,1,10,5,39.0,0,0,0.0,2,1,9.1,No,2014,No,No,No
Nik Stauskas,1060,170,692,323,291,242,2471.0,390,172,111.0,302,151,21.0,Yes,2014,No,No,No
Glenn Robinson III,912,87,665,349,220,158,2506.0,179,56,78.0,486,293,18.6,Yes,2014,No,No,No
Caris LeVert,1070,275,843,366,265,204,2721.0,334,134,136.0,509,232,22.8,Yes,2014,No,No,No
Derrick Walton Jr.,1471,499,1068,432,447,374,4053.0,581,233,224.0,487,199,20.8,Yes,2014,No,No,No
Zak Irvin,1610,282,1417,600,249,169,4220.0,681,241,199.0,736,359,23.1,No,2014,No,No,No
Jordan Morgan,973,64,664,419,239,135,2988.0,0,0,171.0,664,419,17.9,No,2014,No,No,No
Jon Horford,511,42,393,205,119,87,1706.0,61,14,66.0,332,191,16.7,No,2014,No,No,No
Spike Albrecht,499,271,398,159,111,96,2277.0,224,85,82.0,174,74,13.1,No,2014,No,No,No
Mitch McGary,367,37,279,164,76,39,967.0,2,0,60.0,277,164,21.0,Yes,2014,No,No,No
Max Bielfeldt,478,42,389,190,89,58,1241.0,105,40,64.0,284,150,21.1,No,2014,No,No,No
Sean Lonergan,21,4,16,8,8,5,116.0,3,0,6.0,13,8,12.6,No,2014,No,No,No
Cole McConnell,4,0,3,1,2,1,10.0,3,1,0.0,0,0,22.2,No,2014,No,No,No
Andrew Dakich,123,93,100,44,21,17,849.0,49,18,50.0,51,26,9.9,No,2014,No,No,No
Brad Anlauf,2,1,4,1,0,0,16.0,0,0,1.0,4,1,17.5,No,2014,No,No,No
Shawn Jones,1120,49,827,447,346,226,2516.0,2,0,160.0,825,447,23.5,No,2014,No,No,No
Neiko Hunter,698,43,541,264,196,136,1541.0,100,34,102.0,441,230,24.6,No,2014,No,No,No
Kerry Hammonds,869,206,644,273,245,183,2699.0,375,140,153.0,269,133,17.3,No,2014,No,No,No
Trantell Knight,388,238,279,136,183,103,1483.0,51,13,138.0,228,123,17.5,No,2014,No,No,No
Jaqawn Raymond,684,181,557,214,181,134,2641.0,334,122,158.0,223,92,16.0,No,2014,No,No,No
Reggie Upshaw Jr.,1571,257,1230,598,482,288,3967.0,269,87,213.0,961,511,22.1,No,2014,No,No,No
Marcus Tarrance,373,49,283,109,149,105,1214.0,154,50,57.0,129,59,18.1,No,2014,No,No,No
Jacquez Rozier,406,47,307,142,203,120,1572.0,11,2,96.0,296,140,17.0,No,2014,No,No,No
Eric Wortham Jr.,31,4,19,10,11,7,75.0,8,4,4.0,11,6,19.3,No,2014,No,No,No
Joshua Phillips,313,20,235,120,130,73,1013.0,1,0,75.0,234,120,19.3,No,2014,No,No,No
Tavarres Jefferson,22,11,26,9,0,0,121.0,15,4,9.0,11,5,10.3,No,2014,No,No,No
Tharone Chilton,21,2,12,7,7,6,40.0,5,1,3.0,7,6,23.5,No,2014,No,No,No
Torin Walker,105,4,89,38,39,29,377.0,0,0,24.0,89,38,18.0,No,2014,No,No,No
Zane Gibson,22,21,23,5,11,8,251.0,18,4,10.0,5,1,7.8,No,2014,No,No,No
Gavin Gibson,8,3,15,2,2,2,66.0,13,2,3.0,2,0,15.1,No,2014,No,No,No
Blake Johnson,1,1,2,0,2,1,6.0,1,0,0.0,1,0,25.3,No,2014,No,No,No
Ronald Ross,0,0,1,0,0,0,5.0,0,0,1.0,1,0,20.6,No,2014,No,No,No
Jordan Aaron,918,205,773,288,247,207,2161.0,392,135,188.0,381,153,25.9,No,2014,No,No,No
Kyle Kelm,904,122,668,309,359,241,2805.0,182,45,171.0,486,264,18.7,No,2014,No,No,No
Matt Tiby,1332,191,900,390,574,455,2811.0,282,97,245.0,618,293,26.3,No,2014,No,No,No
Austin Arians,1236,153,984,422,179,145,3529.0,671,247,109.0,313,175,17.0,No,2014,No,No,No
Steve McWhorter,937,376,778,328,271,187,3581.0,283,94,208.0,495,234,16.6,No,2014,No,No,No
Malcolm Moore,179,23,145,65,57,38,633.0,34,11,41.0,111,54,17.8,No,2014,No,No,No
J.J. Panoske,826,103,692,312,133,109,2227.0,278,93,151.0,414,219,21.2,No,2014,No,No,No
J.R. Lyle,359,61,293,126,100,62,1242.0,147,45,64.0,146,81,17.1,No,2014,No,No,No
Cody Wichmann,856,121,680,288,107,82,2516.0,506,198,68.0,174,90,17.1,No,2014,No,No,No
Thierno Niang,98,31,101,36,24,14,494.0,41,12,45.0,60,24,16.5,No,2014,No,No,No
Mitch Roelke,68,19,53,20,17,11,287.0,41,17,17.0,12,3,14.2,No,2014,No,No,No
Quinton Gustavson,39,4,31,14,11,5,133.0,16,6,4.0,15,8,15.7,No,2014,No,No,No
Evan Richard,137,20,140,46,36,31,638.0,59,14,31.0,81,32,15.5,No,2014,No,No,No
Andre Hollins,1765,359,1341,539,499,413,3907.0,701,274,284.0,640,265,24.9,No,2014,No,No,No
Austin Hollins,1321,293,1050,452,303,236,3875.0,530,181,198.0,520,271,18.9,No,2014,No,No,No
Deandre Mathieu,823,346,633,306,233,171,2453.0,96,40,194.0,537,266,20.2,No,2014,No,No,No
Joey King,1140,146,829,372,268,223,3250.0,447,173,153.0,382,199,17.7,No,2014,No,No,No
Malik Smith,712,79,593,212,175,135,1745.0,439,153,91.0,154,59,22.4,No,2014,No,No,No
Maurice Walker,752,70,517,285,266,180,1704.0,5,2,145.0,512,283,23.9,No,2014,No,No,No
Elliott Eliason,451,116,351,184,162,83,2179.0,2,0,106.0,349,184,12.9,No,2014,No,No,No
Oto Osenieks,334,67,308,122,102,64,1231.0,111,26,74.0,197,96,18.5,No,2014,No,No,No
Maverick Ahanmisi,356,143,275,106,132,96,1413.0,138,48,113.0,137,58,16.7,No,2014,No,No,No
Daquein McNeil,62,22,67,23,21,10,367.0,24,6,16.0,43,17,13.4,No,2014,No,No,No
Charles Buggs,368,43,287,138,63,41,1432.0,143,51,49.0,144,87,13.0,No,2014,No,No,No
Wally Ellenson,89,14,99,35,22,11,364.0,38,8,14.0,61,27,17.1,No,2014,No,No,No
Jasen Baranowski,0,0,0,0,0,0,2.0,0,0,0.0,0,0,0.0,No,2014,No,No,No
Kendal Shell,17,10,21,7,2,1,86.0,7,2,6.0,14,5,16.8,No,2014,No,No,No
Craig Sword,1492,305,1152,517,603,383,3354.0,285,75,391.0,867,442,27.9,No,2014,No,No,No
Gavin Ware,1362,52,943,532,435,298,3328.0,1,0,185.0,942,532,20.5,No,2014,No,No,No
Roquez Johnson,862,46,609,289,448,279,2386.0,24,5,189.0,585,284,22.0,No,2014,No,No,No
Fred Thomas,1050,143,931,340,274,204,3229.0,551,166,153.0,380,174,19.4,No,2014,No,No,No
Colin Borchert,546,80,500,203,94,67,1651.0,229,73,133.0,271,130,20.9,No,2014,No,No,No
Trivante Bloodman,532,221,371,152,285,206,2336.0,91,22,196.0,280,130,15.5,No,2014,No,No,No
I.J. Ready,888,401,812,328,177,150,3057.0,278,82,184.0,534,246,18.0,No,2014,No,No,No
Andre Applewhite,66,16,41,17,43,29,214.0,9,3,20.0,32,14,19.5,No,2014,No,No,No
Jacoby Davis,61,19,74,20,5,4,316.0,53,17,17.0,21,3,15.1,No,2014,No,No,No
Tyson Cunningham,133,56,123,43,28,20,918.0,75,27,51.0,48,16,10.4,No,2014,No,No,No
Tevin Moore,15,0,15,5,8,3,52.0,8,2,3.0,7,3,21.4,No,2014,No,No,No
De'Runnya Wilson,6,3,9,1,4,4,52.0,2,0,1.0,7,1,11.7,No,2014,No,No,No
Anthony McDonald,807,69,634,252,158,124,1970.0,483,179,92.0,151,73,20.8,No,2014,No,No,No
DeAngelo Priar,648,111,582,218,236,143,1762.0,231,69,129.0,351,149,22.2,No,2014,No,No,No
James Currington,800,47,609,330,242,140,2236.0,7,0,143.0,602,330,18.9,No,2014,No,No,No
Jordan Washington,540,106,434,176,160,121,1205.0,184,67,100.0,250,109,24.1,No,2014,No,No,No
Jeffrey Simmons,607,110,556,255,129,80,1386.0,74,17,158.0,482,238,26.6,No,2014,No,No,No
Blake Ralling,259,39,246,85,76,53,1079.0,116,36,59.0,130,49,15.1,No,2014,No,No,No
Daniel Hurtt,125,9,117,52,27,14,365.0,23,7,13.0,94,45,18.3,No,2014,No,No,No
Julius Francis,239,15,268,95,81,47,1002.0,8,2,86.0,260,93,18.7,No,2014,No,No,No
Cameron Dobbs,227,28,248,82,29,18,549.0,168,45,28.0,80,37,25.1,No,2014,No,No,No
Darryl Marshall,302,113,262,89,115,79,1075.0,144,45,86.0,118,44,17.9,No,2014,No,No,No
Cordarius Samples,133,36,104,43,57,37,405.0,22,10,50.0,82,33,21.3,No,2014,No,No,No
Vacha Vaughn,403,99,351,154,136,87,1899.0,30,8,102.0,321,146,13.1,No,2014,No,No,No
Ervin Thomas,127,41,147,49,36,19,671.0,47,10,39.0,100,39,14.5,No,2014,No,No,No
Thaddeus Fauntleroy,34,24,44,10,18,13,163.0,17,1,20.0,27,9,20.8,No,2014,No,No,No
Cortlan Henry,84,13,97,32,17,14,525.0,25,6,29.0,72,26,12.2,No,2014,No,No,No
Ben Milshtein,24,3,29,9,14,6,125.0,1,0,7.0,28,9,16.2,No,2014,No,No,No
Darryl Wright,2,1,3,1,0,0,7.0,0,0,1.0,3,1,26.7,No,2014,No,No,No
Marcus Johnson,48,8,47,13,13,12,245.0,39,10,10.0,8,3,12.4,No,2014,No,No,No
Marshall Henderson,1647,151,1341,495,382,325,2891.0,965,332,168.0,376,163,28.8,No,2014,No,No,No
Jarvis Summers,1629,530,1285,520,640,463,3885.0,354,126,291.0,931,394,23.9,No,2014,No,No,No
LaDarius White,964,175,844,336,243,170,2581.0,357,122,174.0,487,214,21.6,No,2014,No,No,No
Anthony Perez,564,68,456,175,204,139,1860.0,224,75,111.0,232,100,17.3,No,2014,No,No,No
Aaron Jones,379,37,335,156,91,64,1777.0,20,3,56.0,315,153,12.0,No,2014,No,No,No
Derrick Millinghaus,371,127,358,123,125,85,1001.0,139,40,61.0,219,83,23.0,No,2014,No,No,No
Sebastian Saiz,1273,77,936,464,464,322,3389.0,83,23,175.0,853,441,18.8,No,2014,No,No,No
Demarco Cox,573,40,447,230,219,113,2110.0,0,0,97.0,447,230,15.5,No,2014,No,No,No
Martavious Newby,403,158,317,122,182,130,2062.0,116,29,120.0,201,93,12.4,No,2014,No,No,No
Dwight Coleby,714,34,478,270,248,174,2035.0,1,0,105.0,477,270,17.2,No,2014,No,No,No
Janari Joesaar,551,76,360,166,190,155,1105.0,172,64,89.0,188,102,25.8,No,2014,No,No,No
Jerron Martin,89,33,86,31,15,11,336.0,55,16,24.0,31,15,17.4,No,2014,No,No,No
Cade Peeper,0,1,0,0,0,0,6.0,0,0,1.0,0,0,7.9,No,2014,No,No,No
Martez Harrison,1652,393,1222,504,722,518,3212.0,402,126,307.0,820,378,29.5,No,2014,No,No,No
Nelson Kirksey,623,89,452,221,199,135,1513.0,129,46,134.0,323,175,22.8,No,2014,No,No,No
Trinity Hall,923,75,785,324,341,220,2675.0,217,55,196.0,568,269,22.3,No,2014,No,No,No
Frank Williams,506,88,503,187,51,37,1765.0,300,95,63.0,203,92,17.0,Yes,2014,No,No,No
Fred Chatmon,589,21,470,246,208,95,1911.0,30,2,134.0,440,244,19.1,No,2014,No,No,No
Caleb Johnson,149,15,112,50,44,31,595.0,38,18,26.0,74,32,13.4,No,2014,No,No,No
John Burke,125,10,103,44,32,26,405.0,39,11,34.0,64,33,19.1,No,2014,No,No,No
Isaac Kreuer,115,7,98,41,51,33,620.0,2,0,29.0,96,41,12.3,No,2014,No,No,No
Jacobby Bledsoe,52,30,66,17,16,10,390.0,46,8,18.0,20,9,11.6,No,2014,No,No,No
Kirk Korver,597,67,479,193,141,111,2038.0,308,100,107.0,171,93,17.1,No,2014,No,No,No
Aaron Washington,52,30,58,24,7,4,363.0,6,0,21.0,52,24,11.8,No,2014,No,No,No
Jordan Brown,0,1,3,0,0,0,23.0,0,0,1.0,3,0,8.6,No,2014,No,No,No
Chandler Levingston Simon,12,3,14,6,0,0,75.0,0,0,1.0,14,6,9.9,No,2014,No,No,No
Jamar Gulley,806,92,626,298,234,166,1682.0,135,44,97.0,491,254,27.1,No,2014,No,No,No
Austin Ruder,946,140,860,309,112,92,3114.0,649,236,82.0,211,73,17.0,No,2014,No,No,No
Ron Mvouika,494,112,398,163,151,94,1438.0,191,74,105.0,207,89,20.2,No,2014,No,No,No
Christian Kirk,718,64,570,301,195,116,2292.0,1,0,123.0,569,301,19.1,No,2014,No,No,No
Dorrian Williams,663,373,656,231,196,135,3102.0,235,66,207.0,421,165,16.8,No,2014,No,No,No
Marcus Marshall,1502,242,1046,445,474,391,3029.0,586,221,141.0,460,224,24.6,No,2014,No,No,No
Gavin Thurman,536,55,570,202,89,68,1507.0,211,64,88.0,359,138,26.0,No,2014,No,No,No
Emmanuel Addo,729,66,520,258,243,174,1811.0,96,39,139.0,424,219,22.2,No,2014,No,No,No
Keith Pickens,568,105,420,199,247,159,2237.0,35,11,116.0,385,188,16.1,No,2014,No,No,No
Nathan Scheer,503,97,423,157,116,85,2416.0,308,104,91.0,115,53,13.1,No,2014,No,No,No
Devon Thomas,318,176,266,122,104,62,1547.0,55,12,92.0,211,110,14.0,No,2014,No,No,No
Tyler McCullough,263,24,226,105,82,53,1178.0,0,0,59.0,226,105,14.9,No,2014,No,No,No
Bruce Marshall,61,2,53,19,20,13,286.0,31,10,12.0,22,9,14.6,No,2014,No,No,No
Michael Simpson,38,9,67,15,0,0,203.0,46,8,2.0,21,7,19.2,No,2014,No,No,No
Jabari Brown,1052,103,696,307,385,301,2164.0,355,137,136.0,341,170,24.0,Yes,2014,No,No,No
Jordan Clarkson,1433,249,1075,473,487,392,2952.0,295,95,254.0,780,378,27.8,Yes,2014,No,No,No
Earnest Ross,1339,178,1064,417,442,336,3391.0,525,169,228.0,539,248,22.5,No,2014,No,No,No
Johnathan Williams,1478,141,1085,554,559,320,3893.0,150,50,254.0,935,504,21.2,Yes,2014,No,No,No
Ryan Rosburg,530,40,353,213,204,104,2106.0,0,0,92.0,353,213,13.4,No,2014,No,No,No
Wes Clark,1015,354,870,348,247,186,2825.0,364,133,210.0,506,215,21.4,No,2014,No,No,No
Anthony Criswell,335,38,283,129,97,68,1268.0,32,9,62.0,251,120,15.7,No,2014,No,No,No
Torren Jones,284,19,216,113,84,58,796.0,0,0,53.0,216,113,19.4,No,2014,No,No,No
Keanau Post,165,4,119,70,51,25,667.0,0,0,37.0,119,70,14.5,No,2014,No,No,No
Shane Rector,523,170,415,175,184,132,1488.0,126,41,134.0,289,134,22.0,No,2014,No,No,No
Stefan Jankovic,856,67,558,283,301,227,1531.0,175,63,109.0,383,220,25.8,No,2014,No,No,No
Danny Feldmann,21,3,22,10,2,0,166.0,10,1,9.0,12,9,9.7,No,2014,No,No,No
Corey Haith,17,5,15,5,4,2,65.0,15,5,6.0,0,0,17.9,No,2014,No,No,No
Deon Jones,1452,160,1112,487,533,405,3636.0,235,73,278.0,877,414,22.8,No,2014,No,No,No
Andrew Nicholas,1180,164,1129,431,218,149,2919.0,512,169,183.0,617,262,24.2,No,2014,No,No,No
Josh James,584,212,550,215,215,124,2691.0,115,30,150.0,435,185,14.5,No,2014,No,No,No
Justin Robinson,2003,497,1512,635,574,476,4002.0,664,257,288.0,848,378,25.3,Yes,2014,No,No,No
Max DiLeo,490,107,367,155,174,128,1803.0,151,52,75.0,216,103,14.9,No,2014,No,No,No
Zac Tillman,591,52,452,228,203,135,1858.0,0,0,97.0,452,228,17.4,No,2014,No,No,No
Tyrone O'Garro,324,73,270,132,135,60,1773.0,2,0,105.0,268,132,12.1,No,2014,No,No,No
Chris Brady,778,37,616,328,174,116,2307.0,26,6,136.0,590,322,17.6,No,2014,No,No,No
Khalil Brown,163,14,131,55,59,40,555.0,47,13,37.0,84,42,17.2,No,2014,No,No,No
Collin Stewart,735,70,639,236,197,149,1776.0,364,114,123.0,275,122,23.7,No,2014,No,No,No
Greg Noack,54,6,40,24,8,6,209.0,0,0,8.0,40,24,12.0,No,2014,No,No,No
Jalen Palm,62,20,68,19,23,16,285.0,37,8,21.0,31,11,17.1,No,2014,No,No,No
Marcelo Ruediger,16,1,16,5,12,6,112.0,0,0,6.0,16,5,12.0,No,2014,No,No,No
Christian White,115,33,94,37,30,17,389.0,66,24,25.0,28,13,16.7,No,2014,No,No,No
Vuk Baletic,0,1,3,0,2,0,14.0,0,0,0.0,3,0,13.7,No,2014,No,No,No
Flavien Davis,700,58,511,247,294,195,1519.0,43,11,103.0,468,236,26.2,No,2014,No,No,No
Marcus Colbert,1372,453,1108,468,343,260,3400.0,460,176,269.0,648,292,23.1,No,2014,No,No,No
Paul Egwuonwu,534,65,429,205,171,124,1594.0,5,0,101.0,424,205,20.2,No,2014,No,No,No
Antonio Biglow,494,154,423,169,168,120,1422.0,121,36,101.0,302,133,22.3,No,2014,No,No,No
Terrell Brown,318,38,269,102,99,85,1089.0,89,29,46.0,180,73,17.6,No,2014,No,No,No
Calen Coleman,392,45,328,135,65,46,1126.0,205,76,55.0,123,59,19.3,No,2014,No,No,No
Stephan Holm,578,33,486,205,59,44,1465.0,321,124,74.0,165,81,20.6,No,2014,No,No,No
Michael Dison,804,162,733,282,196,132,2234.0,305,108,141.0,428,174,22.5,No,2014,No,No,No
Eric Norman,318,90,312,112,69,49,1441.0,159,45,90.0,153,67,15.9,No,2014,No,No,No
Danny Robison,554,37,402,181,212,144,1948.0,148,48,95.0,254,133,15.7,No,2014,No,No,No
Blake Brumwell,149,16,121,65,43,19,911.0,0,0,44.0,121,65,10.6,No,2014,No,No,No
Ryan Shannon,8,2,10,4,0,0,38.0,0,0,2.0,10,4,16.7,No,2014,No,No,No
Kareem Jamar,1673,407,1193,565,556,381,4032.0,426,162,263.0,767,403,23.8,No,2014,No,No,No
Jordan Gregory,1234,210,903,380,340,282,3102.0,503,192,142.0,400,188,22.0,No,2014,No,No,No
Keron DeShields,1100,233,860,374,328,243,2741.0,312,109,148.0,548,265,22.8,No,2014,No,No,No
Michael Weisner,652,93,474,213,110,96,2197.0,311,130,108.0,163,83,16.3,No,2014,No,No,No
Mario Dunn,634,225,462,222,198,128,2471.0,165,62,161.0,297,160,16.1,No,2014,No,No,No
Eric Hutchison,262,10,183,96,101,70,1155.0,0,0,55.0,183,96,14.0,No,2014,No,No,No
Chris Kemp,166,6,118,70,49,26,553.0,0,0,35.0,118,70,18.2,No,2014,No,No,No
Andy Martin,127,9,92,45,48,37,532.0,0,0,23.0,92,45,14.9,No,2014,No,No,No
Brandon Gfeller,756,90,599,238,105,77,2318.0,521,203,76.0,78,35,16.9,No,2014,No,No,No
Jack Lopez,485,76,365,165,71,48,1974.0,249,107,76.0,116,58,12.7,No,2014,No,No,No
Riley Bradshaw,140,46,145,49,25,20,802.0,74,22,39.0,71,27,13.5,No,2014,No,No,No
Nick Emerson,6,0,10,3,1,0,33.0,5,0,6.0,5,3,28.7,No,2014,No,No,No
Morgan Young,3,0,4,1,2,0,18.0,4,1,0.0,0,0,15.5,No,2014,No,No,No
Angelo Warner,1557,299,1105,488,520,417,3606.0,468,164,272.0,637,324,22.1,No,2014,No,No,No
Brent Arrington,1366,303,1157,447,461,339,3657.0,432,133,265.0,725,314,21.9,No,2014,No,No,No
Drew Kelly,1013,103,758,339,365,271,2785.0,213,64,179.0,545,275,20.0,No,2014,No,No,No
Chad Posthumus,574,20,427,214,249,146,1480.0,0,0,98.0,427,214,20.5,No,2014,No,No,No
Kareem Storey,592,399,479,178,252,186,2636.0,174,50,268.0,305,128,16.8,No,2014,No,No,No
Billy Reader,517,51,417,217,123,82,1431.0,2,1,88.0,415,216,19.6,No,2014,No,No,No
Luka Pajkovic,276,45,240,84,114,71,788.0,138,37,96.0,102,47,23.6,No,2014,No,No,No
Greg Dotson,142,21,104,52,57,38,482.0,10,0,20.0,94,52,14.8,No,2014,No,No,No
Bakari Turner,355,38,294,114,132,83,776.0,157,44,61.0,137,70,25.3,No,2014,No,No,No
Jordan Percell,104,12,85,37,51,28,640.0,8,2,23.0,77,35,10.2,No,2014,No,No,No
DeAndre Leatherwood,31,2,23,14,9,3,88.0,0,0,6.0,23,14,17.9,No,2014,No,No,No
Karam Mashour,417,41,316,156,126,82,883.0,77,23,60.0,239,133,24.9,No,2014,No,No,No
Jared Ravenscraft,37,9,27,13,7,3,77.0,21,8,2.0,6,5,20.5,No,2014,No,No,No
Justin Black,1399,274,1177,486,479,297,3173.0,439,130,280.0,738,356,25.9,No,2014,No,No,No
Ian Chiles,1051,78,788,430,297,191,2197.0,0,0,128.0,788,430,23.5,No,2014,No,No,No
Anthony Hubbard,701,111,535,244,314,186,1785.0,116,27,146.0,419,217,22.7,No,2014,No,No,No
Blake Bozeman,914,246,939,296,195,139,3717.0,601,183,202.0,338,113,16.4,No,2014,No,No,No
Cedric Blossom,1084,76,879,403,414,272,2886.0,31,6,126.0,848,397,20.5,No,2014,No,No,No
Shaquille Duncan,438,44,338,186,143,66,1505.0,2,0,93.0,336,186,16.3,No,2014,No,No,No
Donte Pretlow,538,340,659,199,184,109,2789.0,157,31,202.0,502,168,16.7,No,2014,No,No,No
Thair Heath,85,11,65,37,26,11,341.0,0,0,27.0,65,37,15.0,No,2014,No,No,No
Rasean Simpson,455,32,384,157,188,127,1343.0,51,14,67.0,333,143,19.8,No,2014,No,No,No
Kyle Thomas,676,53,705,245,151,99,1847.0,303,87,107.0,402,158,23.3,No,2014,No,No,No
Emmanuel Matey,83,91,77,25,59,31,595.0,13,2,57.0,64,23,13.4,No,2014,No,No,No
Torin Childs-Harris,146,12,146,47,60,41,470.0,57,11,28.0,89,36,21.3,No,2014,No,No,No
Willis Turnipseed,6,0,3,3,0,0,12.0,0,0,1.0,3,3,16.0,No,2014,No,No,No
Hassante Manning,5,4,7,2,2,1,60.0,0,0,2.0,7,2,7.9,No,2014,No,No,No
Rashad Whack,1075,103,851,345,274,214,2269.0,482,171,133.0,369,174,25.0,No,2014,No,No,No
Julian Norfleet,1605,423,1402,569,312,225,4175.0,713,242,279.0,689,327,22.7,No,2014,No,No,No
Sam Prescott,1210,150,1053,418,288,210,3148.0,478,164,200.0,575,254,22.9,No,2014,No,No,No
Taylor Danaher,685,47,482,263,206,152,2375.0,31,7,120.0,451,256,15.1,No,2014,No,No,No
Byron Ashe,1432,189,1302,506,295,214,3561.0,630,206,212.0,672,300,24.0,No,2014,No,No,No
Gregory Graves,827,77,662,275,339,229,2606.0,153,48,135.0,509,227,19.0,No,2014,No,No,No
Will Miller,628,54,573,200,61,46,2111.0,520,182,44.0,53,18,15.8,No,2014,No,No,No
Khalid Nwandu,327,157,258,114,175,96,1705.0,12,3,151.0,246,111,15.1,No,2014,No,No,No
Kristijan Krajina,592,56,503,251,141,78,2035.0,69,12,160.0,434,239,19.0,No,2014,No,No,No
Aaron Brown,16,2,22,7,3,0,68.0,15,2,4.0,7,5,21.0,No,2014,No,No,No
Will Lyle,6,0,6,3,0,0,25.0,0,0,1.0,6,3,14.1,No,2014,No,No,No
Liam McManimon,27,8,33,7,10,8,114.0,25,5,7.0,8,2,20.4,No,2014,No,No,No
Maalik Howard,3,3,2,1,0,0,75.0,1,1,2.0,1,0,2.8,No,2014,No,No,No
Cameron Payne,1279,394,1007,435,324,253,2238.0,434,156,197.0,573,279,30.5,Yes,2014,No,No,No
Jarvis Williams,1055,54,635,383,436,289,2190.0,1,0,115.0,634,383,21.9,No,2014,No,No,No
Jeffery Moss,1409,249,1047,469,309,253,4057.0,538,218,152.0,509,251,17.0,No,2014,No,No,No
Dexter Fields,849,123,722,290,85,57,2836.0,565,212,101.0,157,78,15.7,No,2014,No,No,No
T.J. Sapp,884,172,689,284,224,177,2301.0,382,139,148.0,307,145,20.9,No,2014,No,No,No
Jonathan Fairell,421,52,285,170,184,81,1493.0,0,0,104.0,285,170,16.0,No,2014,No,No,No
Tyler Rambo,279,43,176,95,152,89,985.0,0,0,53.0,176,95,15.4,No,2014,No,No,No
C.J. Ford,99,48,95,34,47,28,512.0,21,3,32.0,74,31,14.7,No,2014,No,No,No
Terron Gilmore,55,4,38,18,31,19,338.0,0,0,25.0,38,18,11.6,No,2014,No,No,No
Zay Henderson,29,1,18,13,13,3,166.0,0,0,9.0,18,13,10.1,No,2014,No,No,No
Jeff Martin,17,2,18,5,6,4,36.0,9,3,3.0,9,2,33.3,Yes,2014,No,No,No
Worth Smith,1172,89,1058,477,218,146,3205.0,231,72,180.0,827,405,23.4,No,2014,No,No,No
Brandon Venturini,1017,230,1008,374,97,62,2787.0,612,207,188.0,396,167,24.9,No,2014,No,No,No
Zach Fong,490,62,445,159,63,48,1345.0,356,124,61.0,89,35,21.6,No,2014,No,No,No
Kendall Knorr,498,138,446,169,96,80,2100.0,265,80,75.0,181,89,14.8,No,2014,No,No,No
Will Kelly,770,86,532,298,319,174,2676.0,0,0,174.0,532,298,17.4,No,2014,No,No,No
Tilman Dunbar,1094,434,926,379,450,310,3240.0,83,26,259.0,843,353,23.8,No,2014,No,No,No
Thurgood Wynn,339,65,265,114,160,94,1169.0,61,17,70.0,204,97,19.3,No,2014,No,No,No
Michael Brown,91,11,87,33,31,19,437.0,19,6,22.0,68,27,15.5,No,2014,No,No,No
Grant Vermeer,95,29,88,38,8,5,374.0,49,14,26.0,39,24,17.2,No,2014,No,No,No
Tim Abruzzo,365,52,364,124,66,46,1103.0,249,71,45.0,115,53,20.9,No,2014,No,No,No
James Loupos,283,40,254,96,132,79,1529.0,40,12,78.0,214,84,13.9,No,2014,No,No,No
James Hemphill,144,18,109,60,58,24,621.0,1,0,29.0,108,60,14.3,No,2014,No,No,No
Earl McLaurin,84,80,73,23,40,25,644.0,37,13,42.0,36,10,11.5,No,2014,No,No,No
Kevin Alter,193,34,161,54,45,37,619.0,148,48,25.0,13,6,18.9,No,2014,No,No,No
Edward Alade,444,63,341,199,99,46,1678.0,1,0,97.0,340,199,15.5,No,2014,No,No,No
Payne Andrus,10,7,18,5,1,0,72.0,5,0,3.0,13,5,16.1,No,2014,No,No,No
Jerome Alexander,74,5,83,32,18,10,245.0,1,0,16.0,82,32,25.2,No,2014,No,No,No
Enouma Ebinum,0,0,1,0,0,0,4.0,0,0,0.0,1,0,13.5,No,2014,No,No,No
Phil Guglielmo,64,3,63,22,10,8,206.0,35,12,10.0,28,10,21.7,No,2014,No,No,No
John Karhoff,794,134,634,312,211,164,1694.0,25,6,98.0,609,306,23.8,No,2014,No,No,No
C.J. Carter,1199,267,957,422,322,241,2817.0,366,114,227.0,591,308,22.8,No,2014,No,No,No
Devin Patterson,1215,311,897,379,422,341,2709.0,328,116,247.0,569,263,23.2,No,2014,No,No,No
Justin Simmons,823,110,709,305,180,143,1511.0,216,70,146.0,493,235,30.4,No,2014,No,No,No
Marcus Tyus,1334,168,967,451,357,268,2648.0,398,164,203.0,569,287,24.0,No,2014,No,No,No
Mike Rostampour,591,26,391,193,268,185,1371.0,51,20,87.0,340,173,20.9,No,2014,No,No,No
Alex Phillips,411,86,326,146,90,67,1161.0,135,52,100.0,191,94,19.7,No,2014,No,No,No
Matt Hagerbaumer,201,37,120,90,42,21,1068.0,0,0,32.0,120,90,7.8,No,2014,No,No,No
Caleb Steffensmeier,218,102,185,69,46,35,1072.0,125,45,41.0,60,24,11.2,No,2014,No,No,No
Jalen Bradley,747,188,626,270,140,115,1950.0,243,92,90.0,383,178,19.8,No,2014,No,No,No
Simon Krych,86,3,69,34,42,18,340.0,2,0,7.0,67,34,13.7,No,2014,No,No,No
Terran Petteway,1231,159,979,398,410,307,2468.0,404,128,227.0,575,270,31.0,No,2014,No,No,No
Shavon Shields,1630,223,1236,562,565,429,3861.0,260,77,254.0,976,485,24.5,No,2014,No,No,No
Walter Pitchford,519,31,454,192,82,50,1576.0,248,85,49.0,206,107,18.8,No,2014,No,No,No
Ray Gallegos,791,109,816,292,79,49,2786.0,517,158,79.0,299,134,18.5,No,2014,No,No,No
Leslee Smith,320,52,261,126,107,62,1128.0,23,6,97.0,238,120,20.2,No,2014,No,No,No
Deverell Biggs,455,73,357,162,134,97,1061.0,89,34,103.0,268,128,26.3,No,2014,No,No,No
Tai Webster,1116,288,922,382,382,273,3295.0,283,79,269.0,639,303,21.2,No,2014,No,No,No
Benny Parker,459,226,416,159,137,103,2910.0,135,38,134.0,281,121,11.4,No,2014,No,No,No
David Rivers,411,59,377,160,138,81,2195.0,46,10,56.0,331,150,12.7,Yes,2014,No,No,No
Nathan Hawkins,489,155,508,181,99,53,2092.0,271,74,137.0,237,107,15.6,No,2014,No,No,No
Sergej Vucetic,12,0,8,6,5,0,34.0,0,0,0.0,8,6,17.1,No,2014,No,No,No
Trevor Menke,10,5,13,3,2,1,95.0,10,3,1.0,3,0,8.8,No,2014,No,No,No
Kye Kurkowski,6,0,4,3,1,0,34.0,0,0,2.0,4,3,10.6,No,2014,No,No,No
Mike Peltz,17,18,18,4,14,7,267.0,3,2,16.0,15,2,8.6,No,2014,No,No,No
Bryce Dejean-Jones,1266,272,1028,441,386,264,2888.0,357,120,212.0,671,321,25.0,Yes,2014,No,No,No
Khem Birch,611,55,392,208,292,195,1755.0,0,0,82.0,392,208,17.6,Yes,2014,No,No,No
Roscoe Smith,748,43,595,269,252,176,2545.0,122,34,103.0,473,235,16.4,No,2014,No,No,No
Kevin Olekaibe,1533,187,1361,508,310,243,3716.0,802,274,178.0,559,234,23.9,No,2014,No,No,No
Deville Smith,887,289,761,317,210,139,2368.0,357,114,202.0,404,203,23.8,No,2014,No,No,No
Jelan Kendrick,523,170,490,194,150,88,1882.0,141,47,125.0,349,147,18.9,No,2014,No,No,No
Christian Wood,654,53,493,235,198,148,1468.0,138,36,95.0,355,199,24.7,Yes,2014,No,No,No
Kendall Smith,1400,354,1177,486,443,304,3128.0,343,124,250.0,834,362,25.3,No,2014,No,No,No
Daquan Cook,237,54,246,80,59,42,785.0,116,35,49.0,130,45,21.0,No,2014,No,No,No
Carlos Lopez-Sosa,430,48,298,159,192,110,1202.0,9,2,85.0,289,157,19.8,No,2014,No,No,No
Jamal Aytes,543,30,382,220,150,102,1067.0,2,1,78.0,380,219,24.1,No,2014,No,No,No
Demetris Morant,646,34,419,279,163,88,1971.0,0,0,100.0,419,279,15.2,No,2014,No,No,No
Charles Rushman,10,2,9,4,2,2,26.0,1,0,0.0,8,4,20.1,No,2014,No,No,No
Deonte Burton,2102,515,1479,649,826,620,4393.0,546,184,280.0,933,465,25.3,Yes,2014,No,No,No
Cole Huff,1242,82,944,416,270,219,3132.0,487,191,120.0,457,225,19.3,No,2014,No,No,No
Jerry Evans,985,100,805,344,251,188,3259.0,314,109,149.0,491,235,17.1,No,2014,No,No,No
Michael Perez,941,237,846,320,244,174,3164.0,380,127,190.0,466,193,19.5,No,2014,No,No,No
Marqueze Coleman,1098,226,837,333,505,379,2694.0,186,53,226.0,651,280,24.1,No,2014,No,No,No
AJ West,601,27,425,210,289,181,1626.0,1,0,116.0,424,210,21.2,No,2014,No,No,No
D.J. Fenner,1345,183,1177,453,381,309,3544.0,394,130,200.0,783,323,21.6,No,2014,No,No,No
Ali Fall,108,16,91,39,44,30,543.0,0,0,40.0,91,39,14.7,No,2014,No,No,No
Ronnie Stevens,129,6,95,43,62,43,579.0,0,0,39.0,95,43,14.6,No,2014,No,No,No
Lucas Stivrins,120,14,88,41,49,30,502.0,17,8,25.0,71,33,13.7,No,2014,No,No,No
Richard Bell,2,3,4,1,0,0,50.0,1,0,1.0,3,1,5.3,No,2014,No,No,No
Patrick Conroy,3,4,6,1,2,1,19.0,5,0,2.0,1,1,24.1,No,2014,No,No,No
Jordon Bronner,692,260,607,223,233,160,3128.0,275,86,129.0,332,137,14.7,No,2014,No,No,No
Patrick Konan,1043,94,877,365,308,196,2795.0,342,117,212.0,535,248,23.6,No,2014,No,No,No
Jacoby Armstrong,1028,106,834,383,358,241,2724.0,89,21,181.0,745,362,22.9,No,2014,No,No,No
Daniel Dion,1200,235,997,383,240,190,3310.0,649,244,186.0,348,139,20.7,No,2014,No,No,No
Chris Pelcher,570,47,450,235,166,100,1600.0,0,0,88.0,450,235,20.6,No,2014,No,No,No
Jaleen Smith,1397,364,1089,457,415,342,3785.0,411,141,266.0,678,316,21.5,No,2014,No,No,No
Frank Okeke,257,42,249,81,63,41,1161.0,175,54,49.0,74,27,15.4,No,2014,No,No,No
Scott Morris,391,43,386,135,14,10,1403.0,313,111,53.0,73,24,17.2,No,2014,No,No,No
John Edwards,102,20,82,28,61,44,383.0,18,2,34.0,64,26,20.8,Yes,2014,No,No,No
Tommy McDonnell,96,51,91,36,34,20,815.0,12,4,50.0,79,32,10.5,No,2014,No,No,No
Williams Gabriel,64,2,49,23,30,18,444.0,0,0,31.0,49,23,11.6,No,2014,No,No,No
Daniel Mullings,1677,342,1240,579,651,463,4008.0,178,56,322.0,1062,523,23.6,No,2014,No,No,No
DK Eldridge,681,146,570,246,172,110,1875.0,231,79,122.0,339,167,21.4,No,2014,No,No,No
Tshilidzi Nephawe,1087,67,692,359,550,369,2979.0,1,0,216.0,691,359,19.8,No,2014,No,No,No
Sim Bhullar,665,68,417,264,276,137,1643.0,0,0,107.0,417,264,20.4,Yes,2014,No,No,No
Renaldo Dixon,578,62,394,202,215,164,1835.0,33,10,106.0,361,192,16.6,No,2014,No,No,No
Kevin Aronis,380,23,305,125,30,19,1039.0,273,111,26.0,32,14,17.0,No,2014,No,No,No
K.C. Ross-Miller,656,256,476,181,302,240,2390.0,176,54,199.0,300,127,17.5,No,2014,No,No,No
Ian Baker,1411,375,1059,443,407,325,3454.0,542,200,238.0,517,243,21.7,No,2014,No,No,No
Travon Landry,121,54,91,31,83,55,671.0,21,4,37.0,70,27,12.9,No,2014,No,No,No
Remi Barry,656,56,504,224,200,149,1696.0,158,59,94.0,346,165,21.3,No,2014,No,No,No
Matej Buovac,486,40,417,148,102,80,1508.0,325,110,51.0,92,38,16.5,No,2014,No,No,No
Cameron Bairstow,1239,102,808,418,559,401,2787.0,6,2,157.0,802,416,23.3,Yes,2014,No,No,No
Kendall Williams,1813,617,1216,526,725,556,4450.0,539,205,286.0,677,321,21.7,No,2014,No,No,No
Alex Kirk,1010,64,791,386,297,203,2552.0,139,35,132.0,652,351,22.1,Yes,2014,No,No,No
Cullen Neal,1198,302,958,359,366,288,3032.0,521,192,256.0,437,167,23.0,No,2014,No,No,No
Hugh Greenwood,1006,372,885,342,198,135,3843.0,547,187,166.0,338,155,16.0,No,2014,No,No,No
Deshawn Delaney,530,114,407,207,137,84,1551.0,91,32,74.0,316,175,19.2,No,2014,No,No,No
Pancake Thomas,1179,208,911,378,301,245,2883.0,443,178,124.0,468,200,21.3,No,2014,No,No,No
Nick Banyard,456,90,419,166,123,66,2100.0,151,58,141.0,268,108,15.3,No,2014,No,No,No
Obij Aget,643,34,438,262,178,119,2268.0,0,0,113.0,438,262,14.5,No,2014,No,No,No
Arthur Edwards,412,67,359,138,84,56,1328.0,234,80,98.0,125,58,19.9,No,2014,No,No,No
Merv Lindsay,23,6,26,10,6,1,155.0,8,2,3.0,18,8,10.7,No,2014,No,No,No
Chris Perez,9,2,9,3,6,3,26.0,2,0,3.0,7,3,29.5,No,2014,No,No,No
Devon Williams,214,21,166,76,82,57,737.0,19,5,48.0,147,71,18.9,No,2014,No,No,No
Tim Myles,112,23,92,41,64,29,613.0,1,1,63.0,91,40,13.9,No,2014,No,No,No
Cory Dixon,603,65,393,196,301,209,1346.0,5,2,155.0,388,194,24.2,No,2014,No,No,No
Tradarrius McPhearson,380,76,316,126,138,89,1222.0,120,39,94.0,196,87,18.4,No,2014,No,No,No
Isaac Mack,348,103,347,129,83,56,1184.0,119,34,103.0,228,95,19.5,No,2014,No,No,No
Kevin Hill,928,61,687,330,363,268,2176.0,0,0,200.0,687,330,22.9,No,2014,No,No,No
Christavious Gill,1356,252,1129,434,376,290,3317.0,602,198,180.0,527,236,21.3,No,2014,No,No,No
Tevin Broyles,807,182,632,271,348,230,2446.0,126,35,237.0,506,236,20.2,No,2014,No,No,No
Matt Derenbecker,458,67,399,159,78,52,1429.0,243,88,65.0,156,71,17.7,No,2014,No,No,No
James Harrison,406,36,346,144,42,30,935.0,235,88,46.0,111,56,21.0,No,2014,No,No,No
Terrance Syon,315,27,237,117,152,81,1100.0,1,0,78.0,236,117,16.8,No,2014,No,No,No
Nate Frye,943,273,686,283,390,303,2492.0,192,74,213.0,494,209,20.6,No,2014,No,No,No
Teris Bourgeois,30,10,31,11,8,6,150.0,9,2,8.0,22,9,13.4,No,2014,No,No,No
Micah Walker,30,2,33,9,12,7,119.0,19,5,10.0,14,4,19.2,No,2014,No,No,No
Travis Avery,56,13,48,21,29,14,196.0,0,0,12.0,48,21,17.7,No,2014,No,No,No
John Reese,23,6,23,9,2,1,99.0,11,4,4.0,12,5,13.3,No,2014,No,No,No
Tommy Hobbs,40,2,29,15,9,6,70.0,9,4,4.0,20,11,25.3,No,2014,No,No,No
Evans Ganapamo,117,9,126,40,28,15,336.0,74,22,29.0,52,18,23.9,No,2014,No,No,No
Andre Gonzague,3,0,2,1,0,0,4.0,2,1,0.0,0,0,23.5,No,2014,No,No,No
Benjamin James,0,0,0,0,0,0,5.0,0,0,3.0,0,0,28.3,No,2014,No,No,No
Antoine Mason,2308,192,1734,727,941,685,4282.0,543,169,288.0,1191,558,28.0,No,2014,No,No,No
Marvin Jordan,1278,253,1152,420,234,164,3889.0,814,274,184.0,338,146,18.1,No,2014,No,No,No
Marcus Ware,848,70,698,293,422,262,2331.0,3,0,186.0,695,293,23.1,No,2014,No,No,No
Ramone Snowden,999,252,730,310,406,258,3668.0,332,121,228.0,398,189,15.8,No,2014,No,No,No
Wesley Myers,1233,184,1006,417,393,281,3198.0,319,118,210.0,687,299,21.7,No,2014,No,No,No
Rayvon Harris,372,39,239,119,193,124,1112.0,29,10,115.0,210,109,19.6,No,2014,No,No,No
Tahjere McCall,1170,363,908,388,536,363,3047.0,135,31,322.0,773,357,23.9,Yes,2014,No,No,No
Joe Thomas,332,37,271,151,99,30,1550.0,0,0,70.0,271,151,12.3,Yes,2014,No,No,No
Cameron Fowler,189,136,240,75,52,20,1364.0,81,19,96.0,159,56,13.1,No,2014,No,No,No
Aaron Bodie,0,0,0,0,0,0,4.0,0,0,0.0,0,0,0.0,No,2014,No,No,No
David Varoli,0,0,1,0,0,0,4.0,1,0,0.0,0,0,13.0,No,2014,No,No,No
Dantrell Thomas,1215,207,902,431,401,300,2575.0,180,53,187.0,722,378,26.0,No,2014,No,No,No
Jeremy Smith,846,112,604,327,235,162,2181.0,88,30,171.0,516,297,21.1,No,2014,No,No,No
T.J. Carpenter,1221,219,1094,403,317,218,3271.0,637,197,241.0,457,206,23.1,No,2014,No,No,No
Sam McBeath,698,138,577,240,202,127,1988.0,289,91,165.0,288,149,21.6,No,2014,No,No,No
Schane Rillieux,730,322,608,231,411,228,3594.0,154,40,266.0,454,191,15.2,No,2014,No,No,No
Amin Torres,575,89,476,191,142,111,1222.0,237,82,122.0,239,109,28.0,No,2014,No,No,No
Luke Doyle,1101,177,962,390,118,88,3111.0,651,233,113.0,311,157,17.7,No,2014,No,No,No
Ja'Dante' Frye,1279,125,952,453,402,305,3148.0,200,68,197.0,752,385,21.2,No,2014,No,No,No
Liam Thomas,808,188,549,311,274,165,2690.0,80,21,196.0,469,290,16.2,No,2014,No,No,No
JaMarkus Horace,259,26,238,111,92,37,927.0,0,0,85.0,238,111,20.4,No,2014,No,No,No
Cade Towers,24,2,29,10,8,2,111.0,5,2,8.0,24,8,19.2,No,2014,No,No,No
Pedro Maciel,66,59,60,21,13,8,595.0,49,16,34.0,11,5,8.7,No,2014,No,No,No
Travis Julien,99,18,95,41,50,17,485.0,12,0,36.0,83,41,16.3,No,2014,No,No,No
Piers Carroll,6,2,3,2,0,0,7.0,3,2,0.0,0,0,22.4,No,2014,No,No,No
Damon Lynn,2153,369,1769,657,498,405,4225.0,1225,434,266.0,544,223,27.1,No,2014,No,No,No
Terrence Smith,621,44,469,275,111,71,1613.0,0,0,77.0,469,275,18.7,No,2014,No,No,No
Ky Howard,1139,416,795,380,479,333,3172.0,124,46,319.0,671,334,21.3,No,2014,No,No,No
Winfield Willis,729,157,535,239,173,148,1863.0,251,103,109.0,284,136,20.0,No,2014,No,No,No
Tim Coleman,1439,244,1066,487,482,347,3191.0,319,118,254.0,747,369,24.4,No,2014,No,No,No
Jake Duncan,127,13,99,42,23,17,316.0,71,26,16.0,28,16,20.2,No,2014,No,No,No
Nigel Sydnor,243,44,197,79,96,60,818.0,79,25,46.0,118,54,17.6,No,2014,No,No,No
Montana Mayfield,95,48,71,29,31,26,364.0,32,11,32.0,39,18,16.5,No,2014,No,No,No
Daquan Holiday,470,58,310,179,180,112,1679.0,0,0,99.0,310,179,15.0,No,2014,No,No,No
Odera Nweke,329,71,261,112,167,104,1540.0,7,1,92.0,254,111,14.2,No,2014,No,No,No
Emmanuel Tselentakis,190,98,195,72,32,19,1310.0,95,27,57.0,100,45,10.4,No,2014,No,No,No
Rob Ukawuba,720,144,532,251,249,163,2085.0,162,55,116.0,370,196,18.4,No,2014,No,No,No
Pendarvis Williams,1646,269,1166,545,417,339,3913.0,566,217,214.0,600,328,20.2,No,2014,No,No,No
Malcolm Hawkins,911,118,712,280,355,253,2112.0,278,98,191.0,434,182,25.7,No,2014,No,No,No
Brandon Goode,679,27,459,274,225,131,1825.0,1,0,116.0,458,274,18.8,No,2014,No,No,No
Anell Alexis,576,53,438,192,186,147,1643.0,129,45,116.0,309,147,20.1,No,2014,No,No,No
Jamel Fuentes,565,552,499,178,361,205,3141.0,27,4,284.0,472,174,15.4,No,2014,No,No,No
Rashid Gaston,1191,86,835,485,414,221,2798.0,0,0,189.0,835,485,22.3,No,2014,No,No,No
Riley Maye,174,14,141,74,29,17,558.0,19,9,30.0,122,65,16.9,No,2014,No,No,No
Marese Phelps,195,104,226,73,39,22,886.0,98,27,82.0,128,46,18.7,No,2014,No,No,No
Kievyn Lila-St. Rose,151,17,173,56,29,18,630.0,81,21,44.0,92,35,18.5,No,2014,No,No,No
Jordan Weathers,94,20,101,33,37,21,461.0,41,7,25.0,60,26,15.6,No,2014,No,No,No
LaTre'e Russell,119,23,97,42,49,35,551.0,3,0,48.0,94,42,16.0,No,2014,No,No,No
Paulius Vinogradovas,26,2,29,10,18,6,240.0,0,0,13.0,29,10,10.9,No,2014,No,No,No
Zieyik Estime,56,1,59,19,2,2,148.0,50,16,6.0,9,3,22.2,No,2014,No,No,No
Hefeng Sun,16,3,12,6,4,4,79.0,0,0,3.0,12,6,11.2,No,2014,No,No,No
Andrew Rowsey,2331,425,1645,693,606,541,3976.0,989,404,313.0,656,289,28.1,No,2014,No,No,No
Jaron Lane,1297,128,832,431,489,366,2934.0,191,69,167.0,641,362,20.3,No,2014,No,No,No
D.J. Cunningham,998,97,815,394,317,209,2650.0,4,1,221.0,811,393,21.6,No,2014,No,No,No
Sam Hughes,904,127,749,340,249,177,2568.0,138,47,181.0,611,293,20.0,No,2014,No,No,No
David Robertson,913,219,756,296,210,150,2871.0,472,171,142.0,284,125,17.3,No,2014,No,No,No
Corey Littlejohn,424,135,353,140,139,105,1674.0,122,39,133.0,231,101,16.2,No,2014,No,No,No
Jaleel Roberts,373,24,265,154,100,65,1106.0,1,0,71.0,264,154,17.1,No,2014,No,No,No
Giacomo Zilli,301,39,210,111,114,79,801.0,0,0,65.0,210,111,20.5,No,2014,No,No,No
Chudier Pal,106,25,80,45,31,16,380.0,0,0,24.0,80,45,15.4,No,2014,No,No,No
Will Weeks,805,211,566,309,346,187,2883.0,0,0,174.0,566,309,15.6,No,2014,No,No,No
Mike Bedulskis,14,0,7,4,9,6,18.0,0,0,1.0,7,4,33.2,No,2014,No,No,No
Ethan Wilmoth,31,10,28,11,9,4,159.0,21,5,6.0,7,6,11.9,No,2014,No,No,No
Alex Biggerstaff,3,5,11,1,2,1,49.0,8,0,1.0,3,1,12.9,No,2014,No,No,No
Jacob Casper,10,1,9,4,0,0,48.0,6,2,5.0,3,2,14.3,No,2014,No,No,No
Lamont Middleton,1016,149,783,274,518,388,2267.0,275,80,198.0,508,194,27.6,No,2014,No,No,No
Richaud Pack,734,92,492,203,315,245,2049.0,241,83,93.0,251,120,18.5,No,2014,No,No,No
Bruce Beckford,1443,107,1115,509,477,361,3473.0,231,64,286.0,884,445,24.2,No,2014,No,No,No
Jeremy Underwood,769,255,634,207,348,241,2761.0,345,114,313.0,289,93,20.1,No,2014,No,No,No
Bryan Akinkugbe,237,16,200,87,107,63,886.0,1,0,74.0,199,87,19.0,No,2014,No,No,No
Khary Doby,421,28,408,153,121,68,1485.0,158,47,77.0,250,106,19.0,No,2014,No,No,No
Waylan Siverand,134,10,96,49,65,36,581.0,0,0,35.0,96,49,13.9,No,2014,No,No,No
Denzel Keyes,655,66,532,246,213,125,2138.0,149,38,95.0,383,208,17.3,No,2014,No,No,No
Jerome Simmons,81,2,67,35,20,11,401.0,0,0,16.0,67,35,11.9,No,2014,No,No,No
Steven Burrough,337,25,235,123,162,91,1400.0,0,0,71.0,235,123,14.1,No,2014,No,No,No
Michael Briscoe,26,29,37,11,11,3,276.0,11,1,24.0,26,10,12.1,No,2014,No,No,No
Ahmad Abdullah,554,198,492,188,148,113,2194.0,181,65,127.0,311,123,16.2,No,2014,No,No,No
Maurice Taylor,189,24,147,67,109,52,1023.0,13,3,90.0,134,64,13.9,Yes,2014,No,No,No
Miles Jenkins,0,0,0,0,0,0,1.0,0,0,0.0,0,0,0.0,No,2014,No,No,No
Julien Johnson,13,0,13,3,7,6,48.0,6,1,3.0,7,2,20.9,No,2014,No,No,No
Jeremy Ingram,1525,123,1062,459,568,437,3035.0,464,170,201.0,598,289,26.6,No,2014,No,No,No
Jordan Parks,858,43,529,349,224,147,1687.0,28,13,97.0,501,336,23.6,No,2014,No,No,No
Alfonzo Houston,430,62,326,143,182,135,1263.0,41,9,57.0,285,134,19.6,No,2014,No,No,No
Jay Copeland,523,16,343,187,240,149,1613.0,0,0,114.0,343,187,18.6,No,2014,No,No,No
Emanuel Chapman,533,617,480,194,113,83,3158.0,181,62,276.0,299,132,13.5,No,2014,No,No,No
Karamo Jawara,620,213,479,222,191,133,2841.0,142,43,131.0,337,179,13.3,No,2014,No,No,No
Reggie Groves,489,211,496,153,142,95,2150.0,304,88,157.0,192,65,17.1,No,2014,No,No,No
Ebuka Anyaorah,457,50,356,147,152,108,1327.0,160,55,100.0,196,92,20.6,No,2014,No,No,No
Dante Holmes,1105,158,934,391,274,177,2711.0,409,146,189.0,525,245,24.0,No,2014,No,No,No
Juwan Moody,32,20,31,11,3,1,137.0,23,9,12.0,8,2,17.0,No,2014,No,No,No
Antonin Galaya,101,12,111,33,12,9,284.0,93,26,15.0,18,7,24.8,No,2014,No,No,No
Ramon Eaton,90,7,89,30,44,30,429.0,8,0,33.0,81,30,17.7,No,2014,No,No,No
Kevin Crawford,38,30,23,14,12,10,127.0,2,0,13.0,21,14,17.7,No,2014,No,No,No
Kyle Cain,878,78,761,368,192,133,2299.0,32,9,153.0,729,359,22.7,No,2014,No,No,No
Tevon Saddler,1274,297,1001,434,535,374,2690.0,136,32,326.0,865,402,28.6,No,2014,No,No,No
Kayel Locke,1522,134,1261,569,512,341,3557.0,162,43,226.0,1099,526,24.4,No,2014,No,No,No
Nicholas Paulos,1030,112,835,352,77,64,3147.0,666,262,127.0,169,90,15.6,No,2014,No,No,No
RJ White,1460,130,1053,591,383,235,3122.0,127,43,222.0,926,548,23.5,No,2014,No,No,No
Jordan Potts,792,240,666,240,225,176,2233.0,411,136,161.0,255,104,20.5,No,2014,No,No,No
Ty Outlaw,670,58,502,226,85,65,2056.0,343,153,57.0,159,73,15.2,No,2014,No,No,No
Diante Baldwin,1226,437,1050,446,388,249,3491.0,246,85,257.0,804,361,21.6,No,2014,No,No,No
Drew Parker,371,294,351,120,70,50,2467.0,227,81,169.0,124,39,10.8,No,2014,No,No,No
Clay Byrd,229,28,205,72,19,17,835.0,193,68,25.0,12,4,14.6,No,2014,No,No,No
Jordy Kuiper,531,76,451,208,98,62,2164.0,162,53,102.0,289,155,13.9,No,2014,No,No,No
Jamal Mitchell,22,4,17,6,10,8,92.0,4,2,0.0,13,4,12.1,No,2014,No,No,No
Tyler McNeely,7,0,6,2,4,3,18.0,0,0,3.0,6,2,26.8,No,2014,No,No,No
Jordan Robertson,77,7,69,33,23,11,307.0,3,0,20.0,66,33,17.2,No,2014,No,No,No
T.J. Warren,1296,68,951,528,298,195,2182.0,143,45,117.0,808,483,28.6,Yes,2014,No,No,No
Ralston Turner,1473,164,1265,488,303,227,3841.0,749,270,190.0,516,218,21.5,No,2014,No,No,No
Anthony Barber,1507,403,1169,500,536,425,3256.0,236,82,220.0,933,418,25.5,No,2014,No,No,No
Desmond Lee,382,70,290,111,185,138,1089.0,86,22,77.0,204,89,21.8,No,2014,No,No,No
Kyle Washington,1275,76,1066,520,278,193,3049.0,113,42,166.0,953,478,23.0,No,2014,No,No,No
Tyler Lewis,669,402,507,207,241,192,2435.0,209,63,116.0,298,144,15.6,No,2014,No,No,No
Jordan Vandenberg,238,47,175,107,48,24,1317.0,1,0,45.0,174,107,9.5,No,2014,No,No,No
Lennard Freeman,635,77,448,244,268,147,2700.0,0,0,88.0,448,244,12.3,No,2014,No,No,No
BeeJay Anya,462,39,309,180,214,102,2200.0,0,0,112.0,309,180,12.0,No,2014,No,No,No
Patrick Wallace,443,77,390,145,44,36,1277.0,330,117,60.0,60,28,18.4,No,2014,No,No,No
Jevoni Robinson,7,0,5,2,4,3,19.0,0,0,2.0,5,2,23.6,No,2014,No,No,No
Staats Battle,19,2,25,7,3,0,39.0,23,5,1.0,2,2,35.9,No,2014,No,No,No
Chris Brickhouse,4,1,5,2,0,0,24.0,0,0,3.0,5,2,17.0,No,2014,No,No,No
Chase Cannon,7,2,14,3,2,0,32.0,8,1,2.0,6,2,27.0,No,2014,No,No,No
Cedrick Williams,974,89,793,376,316,213,3319.0,37,9,139.0,756,367,16.7,No,2014,No,No,No
Addison Spruill,754,84,679,275,244,173,1683.0,132,31,111.0,547,244,27.6,No,2014,No,No,No
Chris Dixon,517,161,488,181,138,98,1571.0,198,57,139.0,290,124,22.8,No,2014,No,No,No
Freddie Jackson,932,206,833,352,232,148,3168.0,266,80,207.0,567,272,18.6,No,2014,No,No,No
Tanner Milson,719,211,659,228,123,92,2714.0,471,171,195.0,188,57,17.6,No,2014,No,No,No
Shane Reybold,237,19,183,91,96,55,977.0,0,0,46.0,183,91,14.6,No,2014,No,No,No
Craig Ponder,1160,257,965,393,367,252,3216.0,321,122,222.0,644,271,21.3,No,2014,No,No,No
Luke Hager,190,27,203,74,63,34,777.0,39,8,53.0,164,66,19.0,No,2014,No,No,No
Dylan Sherwood,462,26,402,170,60,42,1325.0,238,80,49.0,164,90,18.2,No,2014,No,No,No
Ben Eblen,154,151,186,66,48,18,1433.0,32,4,87.0,154,62,10.8,No,2014,No,No,No
C.J. Gettys,551,64,432,222,165,107,1648.0,0,0,90.0,432,222,18.0,No,2014,No,No,No
Chuck Ogbodo,203,8,144,84,62,35,980.0,0,0,62.0,144,84,11.9,No,2014,No,No,No
Marcus Graham,32,5,30,11,12,8,76.0,8,2,2.0,22,9,25.7,No,2014,No,No,No
Zack Allen,0,1,3,0,0,0,14.0,3,0,0.0,0,0,11.1,No,2014,No,No,No
Marcus Paige,1844,602,1471,599,411,347,4570.0,798,299,274.0,673,300,20.2,Yes,2014,No,No,No
James Michael McAdoo,1232,111,1044,467,524,298,2696.0,9,0,173.0,1035,467,25.5,Yes,2014,No,No,No
Brice Johnson,1716,133,1242,714,407,288,3102.0,0,0,188.0,1242,714,24.9,Yes,2014,No,No,No
J.P. Tokoto,722,293,617,285,241,131,2383.0,79,21,180.0,538,264,18.3,No,2014,No,No,No
Leslie McDonald,841,115,786,287,173,120,2129.0,442,147,96.0,344,140,21.1,No,2014,No,No,No
Kennedy Meeks,1482,141,1097,608,422,266,3068.0,1,0,187.0,1096,608,22.7,No,2014,No,No,No
Nate Britt,774,299,688,256,223,181,2650.0,242,81,167.0,446,175,17.1,No,2014,No,No,No
Joel James,293,18,272,123,75,47,1188.0,0,0,73.0,272,123,15.2,No,2014,No,No,No
Isaiah Hicks,1112,100,735,420,374,271,2442.0,6,1,159.0,729,419,20.5,Yes,2014,No,No,No
Jackson Simmons,129,19,89,53,42,23,562.0,0,0,14.0,89,53,10.3,No,2014,No,No,No
Desmond Hubert,84,14,73,36,53,12,729.0,0,0,35.0,73,36,8.6,No,2014,No,No,No
Wade Moody,14,8,13,5,0,0,43.0,8,4,5.0,5,1,19.8,No,2014,No,No,No
James Manor,12,1,17,5,0,0,30.0,8,2,0.0,9,3,26.7,No,2014,No,No,No
Luke Davis,241,171,219,75,68,48,1251.0,134,43,108.0,85,32,14.8,No,2014,No,No,No
Denzel Robinson,4,1,4,2,0,0,30.0,0,0,2.0,4,2,9.5,No,2014,No,No,No
Taylor Braun,1651,338,1105,536,581,454,3495.0,302,125,268.0,803,411,25.5,No,2014,No,No,No
Marshall Bjorklund,1440,122,907,592,405,256,3221.0,0,0,173.0,907,592,21.4,No,2014,No,No,No
TrayVonn Wright,1131,84,957,443,201,143,3128.0,320,102,114.0,637,341,20.3,No,2014,No,No,No
Lawrence Alexander,1755,408,1362,587,491,374,4629.0,532,207,320.0,830,380,23.1,No,2014,No,No,No
Kory Brown,934,244,687,349,293,204,3344.0,106,32,203.0,581,317,17.1,No,2014,No,No,No
Mike Felt,978,72,779,315,124,104,2294.0,607,244,76.0,172,71,21.5,No,2014,No,No,No
Jordan Aaberg,401,24,270,167,85,67,1287.0,0,0,68.0,270,167,15.7,No,2014,No,No,No
Chris Kading,499,39,379,197,126,77,2350.0,113,28,37.0,266,169,11.3,No,2014,No,No,No
Carlin Dupree,797,214,714,301,263,162,2903.0,133,33,187.0,581,268,19.2,No,2014,No,No,No
Dexter Werner,943,91,648,351,364,241,2168.0,2,0,104.0,646,351,23.1,No,2014,No,No,No
Zach Checkal,6,0,10,1,4,3,37.0,5,1,1.0,5,0,19.3,No,2014,No,No,No
Fred Newell,41,13,39,13,21,12,154.0,13,3,9.0,26,10,20.6,No,2014,No,No,No
Troy Huff,2005,172,1609,698,686,468,3596.0,479,141,271.0,1130,557,31.4,No,2014,No,No,No
Aaron Anderson,1430,359,943,415,555,451,3772.0,362,149,207.0,581,266,19.2,No,2014,No,No,No
Jaron Nash,783,42,632,318,256,115,1785.0,109,32,109.0,523,286,25.0,No,2014,No,No,No
Jamal Webb,1165,483,969,438,296,173,3935.0,334,116,389.0,635,322,19.5,No,2014,No,No,No
Alonzo Traylor,283,4,202,119,79,45,647.0,0,0,35.0,202,119,21.4,No,2014,No,No,No
Quinton Hooker,1787,417,1278,592,523,433,3917.0,436,170,216.0,842,422,22.2,No,2014,No,No,No
Josh Schuler,852,179,712,273,229,180,2904.0,365,126,93.0,347,147,16.2,No,2014,No,No,No
Cole Stefan,295,70,277,96,46,35,1026.0,197,68,47.0,80,28,16.8,No,2014,No,No,No
Chad Calcaterra,166,5,121,66,61,34,620.0,0,0,31.0,121,66,15.1,No,2014,No,No,No
Lenny Antwi,494,83,445,167,80,60,1796.0,277,100,74.0,168,67,16.0,No,2014,No,No,No
Ryan Salmonson,97,2,81,39,24,19,375.0,2,0,32.0,79,39,16.9,No,2014,No,No,No
Shane Benton,138,28,130,45,57,32,638.0,59,16,31.0,71,29,15.1,No,2014,No,No,No
Dustin Hobaugh,224,25,191,70,87,59,1035.0,87,25,45.0,104,45,13.0,No,2014,No,No,No
Thomas Blake,20,8,27,7,8,4,90.0,15,2,8.0,12,5,21.4,No,2014,No,No,No
Dallas Moore,2437,551,1870,904,463,354,4463.0,705,275,302.0,1165,629,26.3,No,2014,No,No,No
Travis Wallace,1338,100,1048,552,384,233,2670.0,4,1,173.0,1044,551,26.7,No,2014,No,No,No
Beau Beech,1557,184,1193,505,322,245,3817.0,769,302,227.0,424,203,20.8,No,2014,No,No,No
Jalen Nesbitt,632,194,397,183,287,214,1890.0,145,52,146.0,252,131,18.2,No,2014,No,No,No
Chris Davenport,1353,335,917,482,410,298,3311.0,260,91,371.0,657,391,22.1,No,2014,No,No,No
Charles McRoy,651,101,563,230,200,139,2249.0,188,52,149.0,375,178,18.3,No,2014,No,No,No
BaeBae Daniels,1022,111,780,375,251,178,2601.0,275,94,126.0,505,281,19.9,No,2014,No,No,No
Romelo Banks,554,17,414,215,249,124,1702.0,0,0,101.0,414,215,18.2,No,2014,No,No,No
Devin Wilson,111,69,94,31,51,33,574.0,54,16,44.0,40,15,14.2,No,2014,No,No,No
Sean Brennan,51,16,30,13,25,15,125.0,18,10,15.0,12,3,22.4,No,2014,No,No,No
Aaron Bodager,549,100,443,182,47,37,1979.0,385,148,96.0,58,34,13.7,No,2014,No,No,No
Jordan Williams,1501,126,1249,504,469,350,3389.0,477,143,253.0,772,361,25.6,Yes,2014,No,No,No
Alzee Williams,1064,144,858,381,381,285,3137.0,77,17,125.0,781,364,18.4,No,2014,No,No,No
Chris Jones,648,282,573,237,216,148,1769.0,100,26,180.0,473,211,24.0,No,2014,No,No,No
Colin Voss,538,83,448,207,166,121,1983.0,6,3,104.0,442,204,16.1,No,2014,No,No,No
Vertrail Vaughns,848,97,693,280,220,170,2300.0,315,118,106.0,378,162,20.0,No,2014,No,No,No
Brandan Walton,502,53,417,160,129,86,1351.0,265,96,66.0,152,64,19.9,No,2014,No,No,No
T.J. Taylor,435,100,353,154,121,81,1350.0,142,46,105.0,211,108,19.3,No,2014,No,No,No
Maurice Aniefiok,475,69,429,163,81,56,1612.0,258,93,82.0,171,70,17.3,No,2014,No,No,No
Keith Coleman,126,8,138,54,44,18,671.0,0,0,67.0,138,54,16.7,No,2014,No,No,No
Armani Flannigan,203,9,151,81,93,41,739.0,1,0,35.0,150,81,15.8,No,2014,No,No,No
Kelvin Gaines,37,4,44,17,17,3,418.0,0,0,26.0,44,17,9.4,No,2014,No,No,No
Scott Eatherton,1536,125,1002,581,494,341,3149.0,97,33,242.0,905,548,25.4,No,2014,No,No,No
David Walker,1631,420,1200,517,418,347,4710.0,653,250,244.0,547,267,18.8,No,2014,No,No,No
Demetrius Pollard,707,145,630,230,173,119,2153.0,394,128,128.0,236,102,20.4,No,2014,No,No,No
Reggie Spencer,992,128,744,375,361,241,3192.0,2,1,186.0,742,374,18.6,No,2014,No,No,No
Zach Stahl,1030,198,787,397,327,226,3125.0,39,10,253.0,748,387,20.6,No,2014,No,No,No
T.J. Williams,1377,403,991,445,585,406,3671.0,257,81,260.0,734,364,22.3,No,2014,No,No,No
Marco Banegas-Flores,363,131,315,113,141,97,1655.0,113,40,141.0,202,73,17.2,No,2014,No,No,No
Derrico Peck,382,68,266,168,109,45,1686.0,7,1,91.0,259,167,12.4,No,2014,No,No,No
Chris Avenant,57,13,62,21,8,6,386.0,35,9,21.0,27,12,12.1,No,2014,No,No,No
Jimmy Marshall,161,27,155,54,28,19,687.0,113,34,29.0,42,20,15.3,No,2014,No,No,No
Quincy Ford,1617,245,1277,526,478,361,4148.0,585,204,269.0,692,322,23.1,No,2014,No,No,No
Kwesi Abakah,100,28,83,35,70,30,824.0,0,0,33.0,83,35,9.7,No,2014,No,No,No
Quinton Upshur,1203,97,940,383,359,263,2635.0,495,174,137.0,445,209,24.4,No,2014,No,No,No
Max Jacobsen,727,85,542,315,143,92,1767.0,18,5,131.0,524,310,22.1,No,2014,No,No,No
Aaseem Dixon,837,155,755,284,160,124,2320.0,387,145,113.0,368,139,21.3,No,2014,No,No,No
Kris Yanku,1245,419,956,336,639,518,2819.0,169,55,282.0,787,281,28.2,No,2014,No,No,No
Gaellen Bewernick,774,142,664,337,148,81,3329.0,76,19,185.0,588,318,14.4,No,2014,No,No,No
Ako Kaluna,1173,113,977,437,300,205,2814.0,276,94,167.0,701,343,23.0,No,2014,No,No,No
Jordyn Martin,881,117,681,366,217,140,3143.0,21,9,156.0,660,357,15.0,No,2014,No,No,No
Len Springs,165,12,146,66,57,33,1102.0,1,0,55.0,145,66,10.8,No,2014,No,No,No
Christopher Miller,51,5,56,18,14,8,222.0,21,7,12.0,35,11,18.0,No,2014,No,No,No
Travis Meeker,5,4,12,1,4,2,90.0,8,1,0.0,4,0,8.3,No,2014,No,No,No
Alex Stecca,8,1,3,2,8,4,26.0,0,0,0.0,3,2,13.6,No,2014,No,No,No
Chris Heine,12,3,12,4,4,3,56.0,8,1,8.0,4,3,20.6,No,2014,No,No,No
Zachary Reynolds,46,2,34,18,15,9,266.0,1,1,10.0,33,17,9.9,No,2014,No,No,No
Jordan Banks,0,2,0,0,0,0,9.0,0,0,2.0,0,0,12.0,No,2014,No,No,No
Derrick Barden,872,69,613,343,230,153,1973.0,79,33,83.0,534,310,21.5,No,2014,No,No,No
Tate Unruh,1194,139,890,406,150,141,2963.0,559,241,142.0,331,165,19.5,No,2014,No,No,No
Tim Huskisson,1058,165,731,378,335,222,2576.0,211,80,186.0,520,298,22.0,No,2014,No,No,No
Tevin Svihovec,1391,331,1080,474,473,359,3539.0,230,84,260.0,850,390,23.3,No,2014,No,No,No
Jordan Wilson,910,234,734,318,165,130,2541.0,371,144,117.0,363,174,18.9,No,2014,No,No,No
Dominique Lee,520,37,324,201,179,107,1272.0,26,11,57.0,298,190,19.5,No,2014,No,No,No
Connor Osborne,542,63,408,210,232,121,1977.0,4,1,126.0,404,209,17.0,No,2014,No,No,No
Corey Spence,251,123,234,87,86,63,1138.0,56,14,83.0,178,73,16.8,No,2014,No,No,No
Anthony Johnson,1020,61,779,334,238,196,2009.0,412,156,122.0,367,178,25.1,Yes,2014,No,No,No
Cody McDavis,264,12,215,110,61,43,873.0,3,1,39.0,212,109,17.3,No,2014,No,No,No
Brendan Keane,99,8,106,38,39,22,461.0,4,1,25.0,102,37,16.9,No,2014,No,No,No
Xzaivier James,18,9,11,6,9,4,109.0,7,2,9.0,4,4,11.7,No,2014,No,No,No
Jon'te Dotson,203,40,183,64,77,48,1101.0,97,27,59.0,86,37,12.7,No,2014,No,No,No
Collin Sanger,0,0,0,0,0,0,0.0,0,0,0.0,0,0,0,No,2014,No,No,No
Darrell Bowie,871,91,709,302,465,250,2532.0,62,17,248.0,647,285,24.2,No,2014,No,No,No
Jordan Threloff,692,47,443,231,335,230,2013.0,0,0,122.0,443,231,18.9,No,2014,No,No,No
Travon Baker,996,356,866,293,362,265,3306.0,469,145,257.0,397,148,20.1,No,2014,No,No,No
Aaric Armstead,1191,121,1055,395,435,295,3530.0,348,106,213.0,707,289,21.1,No,2014,No,No,No
Aaron Armstead,526,59,465,179,129,97,1661.0,216,71,97.0,249,108,19.6,No,2014,No,No,No
Aksel Bolin,671,123,516,223,216,151,2633.0,223,74,160.0,293,149,15.5,No,2014,No,No,No
Daveon Balls,225,99,249,73,70,56,1157.0,95,23,91.0,154,50,17.0,No,2014,No,No,No
Dontel Highsmith,587,125,466,200,189,137,2021.0,166,50,106.0,300,150,16.5,No,2014,No,No,No
Pete Rakocevic,240,23,219,93,84,53,931.0,22,1,76.0,197,92,18.8,No,2014,No,No,No
J.J. Cravatta,145,12,136,39,49,35,513.0,110,32,21.0,26,7,18.5,No,2014,No,No,No
Kevin Gray,251,33,254,97,111,57,1479.0,1,0,73.0,253,97,13.6,No,2014,No,No,No
Antone Christian,422,62,440,143,85,66,1323.0,242,70,82.0,198,73,22.0,No,2014,No,No,No
Marin Maric,1371,104,925,500,487,349,2943.0,70,22,238.0,855,478,23.2,No,2014,No,No,No
Seth Tuttle,1747,282,1041,600,675,508,3672.0,109,39,270.0,932,561,25.5,No,2014,No,No,No
Deon Mitchell,1200,373,964,406,414,283,3207.0,285,105,283.0,679,301,25.5,No,2014,No,No,No
Matt Bohannon,1092,115,846,351,156,122,3837.0,690,268,74.0,156,83,14.8,No,2014,No,No,No
Nate Buss,657,20,483,241,103,83,1427.0,208,92,52.0,275,149,23.6,No,2014,No,No,No
Wes Washpun,1051,422,759,350,428,298,3092.0,165,53,248.0,594,297,22.5,No,2014,No,No,No
Jeremy Morgan,1218,235,908,393,331,259,3669.0,475,173,165.0,433,220,19.2,No,2014,No,No,No
Chip Rank,592,53,503,200,110,81,2233.0,336,111,53.0,167,89,15.3,No,2014,No,No,No
Marvin Singleton,301,40,230,119,87,57,1378.0,33,6,63.0,197,113,14.2,No,2014,No,No,No
Max Martino,95,12,97,34,12,5,627.0,67,22,26.0,30,12,11.4,No,2014,No,No,No
Matt Morrison,190,54,166,65,29,26,740.0,82,34,45.0,84,31,17.1,No,2014,No,No,No
Ted Friedman,86,22,69,34,48,16,774.0,4,2,29.0,65,32,8.8,No,2014,No,No,No
Nate Buchheit,4,0,4,2,1,0,10.0,1,0,0.0,3,2,24.0,No,2014,No,No,No
Matt MacDougall,0,0,3,0,0,0,12.0,0,0,1.0,3,0,17.9,No,2014,No,No,No
Jordan Jackson,515,133,354,165,268,178,1319.0,34,7,110.0,320,158,24.1,No,2014,No,No,No
Tyler White,1114,216,1061,394,190,140,3084.0,566,186,175.0,495,208,22.9,No,2014,No,No,No
Jalen Billups,1061,48,710,438,282,184,1959.0,5,1,169.0,705,437,27.4,No,2014,No,No,No
Todd Johnson,505,136,422,160,94,64,1839.0,326,121,90.0,96,39,16.4,No,2014,No,No,No
Cole Murray,930,88,720,316,52,39,2615.0,630,259,71.0,90,57,15.9,No,2014,No,No,No
Daniel Camps,248,37,178,95,82,54,638.0,19,4,46.0,159,91,22.2,No,2014,No,No,No
Jack Flournoy,232,21,206,81,30,22,658.0,142,48,27.0,64,33,21.1,No,2014,No,No,No
Jake Giesler,284,40,268,117,76,37,1164.0,59,13,52.0,209,104,16.2,No,2014,No,No,No
Dean Danos,236,75,173,76,44,36,888.0,109,48,66.0,64,28,15.4,No,2014,No,No,No
Anthony Monaco,227,69,202,68,67,58,1221.0,116,33,75.0,86,35,13.7,No,2014,No,No,No
Deontae Cole,254,40,246,86,13,10,1027.0,214,72,13.0,32,14,13.6,No,2014,No,No,No
Matt Rosenwinkel,48,7,46,15,11,8,382.0,38,10,7.0,8,5,7.9,No,2014,No,No,No
Jalan West,1690,652,1158,522,474,410,3191.0,579,236,248.0,579,286,23.2,No,2014,No,No,No
DeQuan Hicks,875,132,628,327,318,219,1343.0,15,2,169.0,613,325,31.6,No,2014,No,No,No
Zeek Woodley,2033,109,1336,743,492,414,3092.0,324,133,145.0,1012,610,25.6,No,2014,No,No,No
Brison White,661,133,575,263,145,95,1399.0,157,40,84.0,418,223,23.3,No,2014,No,No,No
Marvin Frazier,546,57,454,202,176,119,1735.0,70,23,86.0,384,179,16.4,No,2014,No,No,No
Gary Stewart,609,106,497,206,144,106,1908.0,259,91,151.0,238,115,17.2,No,2014,No,No,No
Sabri Thompson,1086,179,883,362,225,169,2649.0,484,193,168.0,399,169,20.3,No,2014,No,No,No
Patrick Robinson,398,116,326,138,172,103,2084.0,93,19,136.0,233,119,12.0,No,2014,No,No,No
Tra'von Joseph,591,115,446,219,180,126,2124.0,89,27,127.0,357,192,14.4,No,2014,No,No,No
Ryan King,137,6,99,57,47,23,524.0,0,0,19.0,99,57,12.1,No,2014,No,No,No
Tyler Washington,183,63,179,61,48,29,765.0,101,32,40.0,78,29,14.6,No,2014,No,No,No
Matt Killian,258,34,244,93,68,44,1285.0,88,28,63.0,156,65,12.2,No,2014,No,No,No
Dadrian Harris,33,9,48,12,7,4,172.0,24,5,17.0,24,7,17.8,No,2014,No,No,No
Dustin Adams,18,1,15,6,8,6,65.0,0,0,3.0,15,6,15.1,No,2014,No,No,No
Austin Adams,15,1,16,5,6,3,35.0,10,2,5.0,6,3,30.7,No,2014,No,No,No
Drew Crawford,1920,286,1575,687,432,314,4627.0,658,232,235.0,917,455,24.4,No,2014,No,No,No
Tre Demps,1518,292,1404,554,297,199,3867.0,619,211,149.0,785,343,24.6,No,2014,No,No,No
JerShon Cobb,782,153,674,273,183,137,2390.0,295,99,122.0,379,174,20.9,No,2014,No,No,No
Alex Olah,1161,171,902,439,367,253,3225.0,112,30,181.0,790,409,22.0,No,2014,No,No,No
Dave Sobolewski,806,334,647,236,307,215,3194.0,379,119,158.0,268,117,16.9,No,2014,No,No,No
Kale Abrahamson,714,64,623,234,184,114,2122.0,391,132,89.0,232,102,20.5,No,2014,No,No,No
Sanjay Lumpkin,607,158,441,213,190,127,3475.0,171,54,143.0,270,159,10.7,No,2014,No,No,No
Nathan Taphorn,436,60,334,149,55,37,1241.0,244,101,66.0,90,48,18.8,No,2014,No,No,No
Nikola Cerina,402,43,323,156,154,82,1623.0,32,8,101.0,291,148,16.3,No,2014,No,No,No
James Mongomery III,23,10,35,9,13,3,197.0,20,2,4.0,15,7,13.0,No,2014,No,No,No
Aaron Liberman,12,2,8,6,2,0,54.0,0,0,2.0,8,6,10.9,No,2014,No,No,No
Chier Ajou,11,3,11,3,5,4,70.0,1,1,4.0,10,2,13.6,No,2014,No,No,No
Eric Atkins,1421,589,1149,480,412,283,4628.0,469,178,249.0,680,302,18.8,No,2014,No,No,No
Pat Connaughton,1465,257,1145,515,215,167,4484.0,695,268,135.0,450,247,16.9,Yes,2014,No,No,No
Garrick Sherman,806,54,627,342,194,122,2024.0,0,0,165.0,627,342,23.3,No,2014,No,No,No
Jerian Grant,1739,690,1276,556,567,448,4337.0,519,179,266.0,757,377,23.1,Yes,2014,No,No,No
Zach Auguste,1274,80,894,507,424,260,2726.0,1,0,194.0,893,507,25.6,No,2014,No,No,No
Demetrius Jackson,1204,335,888,415,308,241,3243.0,349,133,170.0,539,282,20.1,Yes,2014,No,No,No
Steve Vasturia,1400,331,1102,483,286,244,4402.0,521,190,190.0,581,293,17.3,No,2014,No,No,No
Tom Knight,365,49,305,154,82,57,1192.0,0,0,53.0,305,154,18.2,No,2014,No,No,No
Austin Burgett,160,29,123,58,38,28,709.0,66,16,31.0,57,42,13.1,No,2014,No,No,No
V.J. Beachem,1215,81,994,435,159,117,3067.0,582,228,96.0,412,207,20.2,No,2014,No,No,No
Patrick Crowley,9,3,16,4,0,0,49.0,4,1,2.0,12,3,20.4,No,2014,No,No,No
Eric Katenda,221,8,157,82,82,56,560.0,1,1,38.0,156,81,20.3,No,2014,No,No,No
Travis Bader,2351,171,1726,703,502,441,4705.0,1246,504,150.0,480,199,22.3,No,2014,No,No,No
Corey Petros,1636,174,1152,664,603,308,4516.0,1,0,195.0,1151,664,18.3,No,2014,No,No,No
Duke Mondy,1054,358,949,363,275,199,3167.0,420,129,240.0,529,234,20.4,No,2014,No,No,No
Kay Felder,1765,788,1300,554,625,514,3626.0,415,143,350.0,885,411,26.5,Yes,2014,No,No,No
Dante Williams,733,124,625,263,133,87,2734.0,348,120,93.0,277,143,14.6,No,2014,No,No,No
Tommie McCune,397,59,323,140,132,96,1126.0,89,21,104.0,234,119,22.4,No,2014,No,No,No
Mitch Baenziger,138,18,116,44,29,19,545.0,83,31,18.0,33,13,13.9,No,2014,No,No,No
Ralph Hill,218,31,168,75,40,28,690.0,112,40,23.0,56,35,15.7,No,2014,No,No,No
Lloyd Neely II,65,11,57,25,23,12,317.0,8,3,19.0,49,22,13.9,No,2014,No,No,No
Joey Asbury,47,1,42,15,16,14,278.0,15,3,8.0,27,12,10.3,No,2014,No,No,No
Jalen Hayes,1814,175,1322,697,541,403,3901.0,57,17,217.0,1265,680,22.2,No,2014,No,No,No
LaQuinton Ross,858,47,662,299,242,181,1676.0,217,79,124.0,445,220,28.6,No,2014,No,No,No
Lenzelle Smith Jr.,1014,194,795,349,266,185,3104.0,372,131,136.0,423,218,17.9,No,2014,No,No,No
Aaron Craft,1314,694,958,440,464,342,4818.0,276,92,324.0,682,348,16.4,No,2014,No,No,No
Sam Thompson,1001,155,801,378,260,172,3344.0,231,73,123.0,570,305,16.4,No,2014,No,No,No
Amir Williams,660,27,392,236,317,188,2254.0,0,0,123.0,392,236,15.5,No,2014,No,No,No
Shannon Scott,786,528,730,296,201,133,3164.0,218,61,229.0,512,235,17.5,No,2014,No,No,No
Marc Loving,1338,141,988,414,442,334,3414.0,477,176,228.0,511,238,21.4,No,2014,No,No,No
Amedeo Della Valle,171,10,153,54,46,29,501.0,100,34,27.0,53,20,21.5,No,2014,No,No,No
Trey McDonald,195,16,153,80,88,35,1016.0,0,0,49.0,153,80,12.6,No,2014,No,No,No
Jake Lorbach,8,0,9,3,7,2,31.0,1,0,3.0,8,3,26.2,No,2014,No,No,No
Andrew Goldstein,0,0,1,0,0,0,2.0,0,0,0.0,1,0,26.6,No,2014,No,No,No
Nick Kellogg,1449,265,1084,479,238,201,3998.0,728,290,163.0,356,189,17.6,No,2014,No,No,No
Maurice Ndour,977,106,695,346,317,240,2131.0,116,45,178.0,579,301,25.4,Yes,2014,No,No,No
Stevie Taylor,755,246,737,269,167,111,2322.0,363,106,151.0,374,163,21.8,No,2014,No,No,No
Javarez Willis,1032,287,883,359,148,121,2997.0,528,193,255.0,355,166,21.3,No,2014,No,No,No
Travis Wilkins,348,76,266,116,50,38,1255.0,183,78,32.0,83,38,13.5,No,2014,No,No,No
Jon Smith,620,74,414,257,161,106,2599.0,0,0,99.0,414,257,11.9,No,2014,No,No,No
T.J. Hall,670,135,632,232,170,115,2126.0,330,91,151.0,302,141,21.0,No,2014,No,No,No
Antonio Campbell,1257,64,929,498,251,166,2396.0,272,95,129.0,657,403,25.2,No,2014,No,No,No
Ricardo Johnson,431,92,347,139,206,133,1609.0,81,20,106.0,266,119,17.6,No,2014,No,No,No
Treg Setty,810,106,655,295,251,168,2418.0,173,52,166.0,482,243,20.1,No,2014,No,No,No
Wadly Mompremier,217,13,160,77,100,51,816.0,39,12,66.0,121,65,17.4,No,2014,No,No,No
Drew Crabtree,16,3,16,5,2,2,58.0,13,4,4.0,3,1,18.5,No,2014,No,No,No
Markel Brown,1655,308,1255,551,555,407,4088.0,421,146,239.0,834,405,22.2,Yes,2014,No,No,No
Marcus Smart,1064,287,760,314,465,349,2120.0,295,87,193.0,465,227,28.2,Yes,2014,No,No,No
Le'Bryan Nash,1839,217,1381,635,715,539,3893.0,144,30,322.0,1237,605,27.6,No,2014,No,No,No
Phil Forte,1746,178,1237,512,445,393,3994.0,832,329,132.0,405,183,20.1,No,2014,No,No,No
Brian Williams,850,95,664,310,267,190,2523.0,141,40,108.0,523,270,18.1,No,2014,No,No,No
Kamari Murphy,740,79,610,309,210,120,3219.0,12,2,149.0,598,307,13.9,No,2014,No,No,No
Stevie Clark,264,151,204,76,93,73,751.0,120,39,81.0,84,37,21.2,No,2014,No,No,No
Michael Cobbins,613,57,469,251,178,111,2669.0,2,0,108.0,467,251,13.1,No,2014,No,No,No
Leyton Hammonds,676,60,594,244,120,88,2043.0,305,100,96.0,289,144,18.5,No,2014,No,No,No
Christien Sager,58,16,45,16,35,16,384.0,33,10,11.0,12,6,9.9,No,2014,No,No,No
Gary Gaskins,9,1,8,4,2,1,34.0,0,0,5.0,8,4,20.7,No,2014,No,No,No
Mason Cox,7,2,3,2,10,3,57.0,1,0,5.0,2,2,11.3,No,2014,No,No,No
Marek Soucek,48,13,45,19,10,5,277.0,21,5,16.0,24,14,12.5,No,2014,No,No,No
Ford Stuen,15,5,13,6,1,1,53.0,7,2,3.0,6,4,16.2,No,2014,No,No,No
Jackson Perez,4,0,2,2,0,0,4.0,0,0,0.0,2,2,25.2,No,2014,No,No,No
Alex Budke,9,2,8,3,0,0,32.0,6,3,4.0,2,0,19.6,No,2014,No,No,No
Buddy Hield,2291,254,1748,783,450,376,4182.0,894,349,285.0,854,434,26.6,Yes,2014,No,No,No
Cameron Clark,1284,122,1079,497,297,222,3385.0,171,68,160.0,908,429,20.5,No,2014,No,No,No
Isaiah Cousins,1326,365,1162,474,284,202,3794.0,432,176,254.0,730,298,20.2,No,2014,No,No,No
Jordan Woodard,1440,471,1091,419,542,440,3733.0,421,162,261.0,670,257,21.1,No,2014,No,No,No
Ryan Spangler,1087,167,739,420,310,202,3414.0,132,45,153.0,607,375,15.0,No,2014,No,No,No
Tyler Neal,466,54,361,145,136,103,1410.0,210,73,86.0,151,72,18.2,No,2014,No,No,No
Frank Booker,912,90,724,281,199,152,2304.0,560,198,97.0,164,83,19.5,No,2014,No,No,No
Je'lon Hornbeak,1035,249,786,317,305,233,2859.0,437,168,194.0,349,149,18.9,No,2014,No,No,No
D.J. Bennett,143,5,100,54,55,35,517.0,0,0,27.0,100,54,14.5,No,2014,No,No,No
Austin Mankin,13,5,16,4,4,3,105.0,6,2,2.0,10,2,9.4,No,2014,No,No,No
C.J. Cole,24,2,23,10,14,4,133.0,3,0,7.0,20,10,13.5,No,2014,No,No,No
James Fraschilla,8,3,5,1,10,6,41.0,3,0,5.0,2,1,17.8,No,2014,No,No,No
Trey Slate,10,1,13,4,0,0,27.0,8,2,2.0,5,2,27.6,No,2014,No,No,No
Daniel Harper,3,4,6,1,0,0,36.0,3,1,2.0,3,0,10.9,No,2014,No,No,No
Aaron Bacote,1609,354,1233,495,560,446,3773.0,525,173,283.0,708,322,24.8,No,2014,No,No,No
Dimitri Batten,1227,161,1048,425,324,211,3250.0,490,166,197.0,558,259,22.3,No,2014,No,No,No
Keenan Palmore,686,219,556,257,277,171,2159.0,19,1,173.0,537,256,20.7,No,2014,No,No,No
Richard Ross,981,110,772,424,242,127,3250.0,19,6,170.0,753,418,17.0,No,2014,No,No,No
Ambrose Mosley,815,108,713,272,100,72,2456.0,551,199,79.0,162,73,17.7,No,2014,No,No,No
Jordan Baker,632,242,590,205,110,70,3293.0,459,152,149.0,131,53,12.7,No,2014,No,No,No
Denzell Taylor,540,153,407,228,202,84,3724.0,2,0,185.0,405,228,9.8,No,2014,No,No,No
Joe Ebondo,55,10,53,22,26,11,641.0,0,0,23.0,53,22,7.2,No,2014,No,No,No
Anton Larsen,97,11,107,40,20,12,480.0,29,5,24.0,78,35,14.8,No,2014,No,No,No
Martin Shaw,21,5,32,7,10,7,102.0,7,0,8.0,25,7,23.3,No,2014,No,No,No
Sean-Michael King,0,0,2,0,0,0,7.0,1,0,0.0,1,0,15.0,No,2014,No,No,No
Shawn Glover,1467,154,1255,586,290,224,3356.0,221,71,192.0,1034,515,24.5,No,2014,No,No,No
Korey Billbury,1524,294,1276,543,480,336,3855.0,284,102,269.0,992,441,23.5,No,2014,No,No,No
Bobby Word,1193,113,1012,382,248,181,3412.0,686,248,124.0,326,134,19.0,No,2014,No,No,No
Brandon Conley,631,74,432,249,219,133,2243.0,0,0,167.0,432,249,16.0,No,2014,No,No,No
D.J. Jackson,307,186,245,83,116,96,1649.0,130,45,100.0,115,38,12.6,No,2014,No,No,No
Jorden Kaufman,639,67,516,280,144,79,1612.0,0,0,87.0,516,280,20.4,No,2014,No,No,No
Jabbar Singleton,510,255,449,157,155,97,2688.0,277,99,158.0,172,58,12.8,No,2014,No,No,No
Adrion Webber,224,20,187,64,66,58,806.0,129,38,24.0,58,26,15.7,No,2014,No,No,No
Obi Emegano,1798,171,1269,580,684,550,3406.0,225,88,213.0,1044,492,28.2,No,2014,No,No,No
Drew Wilson,147,18,116,67,62,13,857.0,1,0,31.0,115,67,11.3,No,2014,No,No,No
Denell Henderson,342,32,250,126,127,86,887.0,15,4,80.0,235,122,22.9,No,2014,No,No,No
Corbin Byford,41,6,28,14,17,10,136.0,11,3,13.0,17,11,18.8,No,2014,No,No,No
David Mason,14,14,13,6,2,1,58.0,3,1,7.0,10,5,18.9,No,2014,No,No,No
Adam Glenville,15,3,12,4,6,5,30.0,6,2,2.0,6,2,28.3,No,2014,No,No,No
Roberto Nelson,1745,307,1270,540,614,486,3217.0,479,179,280.0,791,361,28.4,No,2014,No,No,No
Devon Collier,1489,181,935,539,668,411,3158.0,0,0,205.0,935,539,22.8,No,2014,No,No,No
Angus Brandt,918,126,703,344,239,166,2420.0,159,64,154.0,544,280,20.0,No,2014,No,No,No
Hallice Cooke,518,165,395,174,90,67,1935.0,232,103,89.0,163,71,13.8,No,2014,No,No,No
Eric Moreland,640,116,445,238,294,156,2227.0,24,8,161.0,421,230,16.6,Yes,2014,No,No,No
Langston Morris-Walker,613,86,547,201,178,121,2259.0,272,90,80.0,275,111,16.8,No,2014,No,No,No
Malcolm Duvivier,1079,289,953,371,263,176,3296.0,444,161,255.0,509,210,21.3,No,2014,No,No,No
Challe Barton,231,105,205,77,62,48,1336.0,97,29,98.0,108,48,12.3,No,2014,No,No,No
Daniel Gomis,218,25,158,81,102,56,1064.0,0,0,74.0,158,81,14.3,No,2014,No,No,No
Victor Robbins,248,32,196,82,104,67,682.0,56,17,39.0,140,65,22.4,No,2014,No,No,No
Olaf Schaftenaar,623,130,537,201,110,89,2335.0,373,132,95.0,164,69,15.4,No,2014,No,No,No
Jarmal Reid,412,84,358,144,187,123,1634.0,7,1,99.0,351,143,17.8,No,2014,No,No,No
Cheikh N'diaye,116,6,74,48,38,20,521.0,0,0,37.0,74,48,13.2,No,2014,No,No,No
C.J. Mitchell,7,1,4,1,6,4,36.0,3,1,5.0,1,0,16.0,No,2014,No,No,No
Daniel Jones,10,0,12,4,3,1,42.0,4,1,0.0,8,3,15.6,No,2014,No,No,No
Michael Moyer,3,0,2,1,0,0,9.0,1,1,0.0,1,0,10.9,No,2014,No,No,No
Joe Young,2304,351,1718,778,519,460,4333.0,739,288,221.0,979,490,25.3,Yes,2014,No,No,No
Mike Moser,1149,177,995,430,226,172,2729.0,352,117,221.0,643,313,24.1,No,2014,No,No,No
Jason Calliste,1539,261,1024,425,560,447,3991.0,614,242,228.0,410,183,18.8,No,2014,No,No,No
Damyean Dotson,1732,149,1390,645,250,199,3906.0,639,243,154.0,751,402,21.5,Yes,2014,No,No,No
Johnathan Loyd,723,458,615,229,258,192,3021.0,243,73,229.0,372,156,16.0,No,2014,No,No,No
Elgin Cook,1259,162,864,437,487,357,2838.0,96,28,189.0,768,409,22.7,No,2014,No,No,No
Richard Amardi,219,13,171,89,72,40,546.0,3,1,39.0,168,88,22.3,No,2014,No,No,No
Dominic Artis,1215,502,1065,430,359,235,3321.0,376,120,269.0,689,310,22.9,No,2014,No,No,No
Ben Carter,357,93,258,121,153,115,1407.0,4,0,86.0,254,121,14.3,No,2014,No,No,No
Waverly Austin,164,15,144,63,67,38,712.0,0,0,48.0,144,63,15.6,No,2014,No,No,No
Jalil Abdul-Bassit,320,29,261,110,46,34,805.0,154,66,40.0,107,44,20.4,No,2014,No,No,No
Theo Friedman,11,3,6,3,6,4,45.0,2,1,2.0,4,2,12.2,No,2014,No,No,No
Arik Armstead,2,0,1,1,0,0,4.0,0,0,0.0,1,1,12.5,No,2014,No,No,No
Brian Crow,0,0,3,0,0,0,16.0,3,0,0.0,0,0,9.4,No,2014,No,No,No
A.J. Lapray,163,22,156,56,14,10,592.0,113,41,34.0,43,15,17.0,No,2014,No,No,No
Nicholas Lucenti,5,4,16,2,2,1,50.0,10,0,1.0,6,2,18.1,No,2014,No,No,No
Tony Gill,640,64,456,237,148,106,1491.0,152,60,85.0,304,177,21.6,No,2014,No,No,No
Andrew Bock,557,176,387,138,275,235,1721.0,151,46,113.0,236,92,19.2,No,2014,No,No,No
Sama Taku,660,141,612,241,178,136,1834.0,139,42,117.0,473,199,23.5,No,2014,No,No,No
Ross Rivera,861,46,608,279,310,254,1910.0,132,49,99.0,476,230,23.9,No,2014,No,No,No
T.J. Wallace,1278,265,1089,425,409,297,3255.0,387,131,244.0,702,294,24.2,No,2014,No,No,No
Trevin Harris,476,125,364,160,92,68,1575.0,222,88,62.0,142,72,15.9,No,2014,No,No,No
Khalil Kelley,629,57,507,252,301,125,2044.0,1,0,139.0,506,252,20.7,No,2014,No,No,No
Aaron Short,156,37,116,54,21,19,583.0,57,29,32.0,59,25,13.9,No,2014,No,No,No
Tim Thomas,140,12,120,59,37,22,432.0,2,0,28.0,118,59,20.0,Yes,2014,No,No,No
David Taylor,545,110,516,186,96,71,1886.0,317,102,112.0,199,84,18.6,No,2014,No,No,No
Gabriel Aguirre,257,26,168,90,129,77,847.0,1,0,45.0,167,90,17.2,No,2014,No,No,No
Spencer Llewellyn,38,3,38,14,1,1,168.0,29,9,9.0,9,5,15.2,No,2014,No,No,No
Thomas Peters,8,1,7,4,4,0,20.0,0,0,1.0,7,4,26.2,No,2014,No,No,No
D.J. Newbill,2105,340,1621,727,715,518,4542.0,395,133,342.0,1226,594,26.6,No,2014,No,No,No
Tim Frazier,1543,641,1214,508,585,453,4132.0,239,74,355.0,975,434,24.0,Yes,2014,No,No,No
Brandon Taylor,1289,106,1169,463,239,180,3366.0,558,183,199.0,611,280,23.2,No,2014,No,No,No
Ross Travis,831,92,752,318,300,174,3391.0,108,21,162.0,644,297,16.4,No,2014,No,No,No
Donovon Jack,524,42,415,193,164,104,1671.0,118,34,69.0,297,159,17.7,No,2014,No,No,No
John Johnson,422,81,344,137,107,81,1309.0,187,67,78.0,157,70,18.9,Yes,2014,No,Yes,Yes
Allen Roberts,827,122,673,260,271,209,2295.0,311,98,172.0,362,162,23.1,No,2014,No,No,No
Geno Thorpe,858,195,678,276,295,240,2216.0,193,66,164.0,485,210,22.7,No,2014,No,No,No
Graham Woodward,954,221,811,322,190,130,2797.0,461,180,194.0,350,142,20.4,No,2014,No,No,No
Jordan Dickerson,226,25,168,84,99,58,1540.0,2,0,64.0,166,84,9.5,No,2014,No,No,No
Alan Wisniewski,21,2,11,7,15,7,151.0,0,0,5.0,11,7,8.1,No,2014,No,No,No
Julian Moore,351,32,273,131,137,88,1728.0,3,1,78.0,270,130,12.3,No,2014,No,No,No
Kevin Montminy,24,0,20,9,7,2,101.0,12,4,2.0,8,5,13.3,No,2014,No,No,No
Zach Cooper,0,0,0,0,0,0,5.0,0,0,0.0,0,0,0.0,No,2014,No,No,No
Tony Hicks,1146,223,990,400,305,234,2410.0,328,112,262.0,662,288,30.2,No,2014,No,No,No
Fran Dougherty,740,63,560,295,235,139,2057.0,43,11,150.0,517,284,21.0,No,2014,No,No,No
Miles Jackson-Cartwright,1401,353,1051,441,448,364,3896.0,449,155,325.0,602,286,21.8,No,2014,No,No,No
Darien Nelson-Henry,1054,110,745,414,346,224,2443.0,6,2,237.0,739,412,24.4,No,2014,No,No,No
Henry Brooks,632,57,627,287,95,58,2160.0,2,0,156.0,625,287,19.9,No,2014,No,No,No
Steve Rennard,248,89,194,75,68,49,1329.0,143,49,70.0,51,26,11.8,No,2014,No,No,No
Jamal Lewis,232,133,233,81,79,47,1288.0,85,23,102.0,148,58,14.8,No,2014,No,No,No
Julian Harrell,239,48,197,88,59,32,728.0,87,31,39.0,110,57,18.2,No,2014,No,No,No
Dau Jok,169,17,166,51,34,27,668.0,140,40,20.0,26,11,15.7,No,2014,No,No,No
Tony Bagtas,41,40,45,16,8,6,271.0,11,3,25.0,34,13,13.6,No,2014,No,No,No
Greg Louis,280,24,222,110,89,51,1051.0,27,9,70.0,195,101,17.0,No,2014,No,No,No
Matt Howard,965,107,740,352,263,169,2548.0,281,92,128.0,459,260,20.4,No,2014,No,No,No
Dylan Jones,140,9,103,54,72,32,486.0,0,0,37.0,103,54,18.5,No,2014,No,No,No
Cameron Gunter,97,6,78,36,50,25,566.0,2,0,38.0,76,36,13.0,No,2014,No,No,No
Patrick Lucas-Perry,161,25,134,53,20,16,557.0,95,39,14.0,39,14,14.8,No,2014,No,No,No
Camryn Crocker,121,105,109,36,59,37,902.0,42,12,85.0,67,24,13.2,No,2014,No,No,No
Matt Poplawski,25,5,26,7,12,7,106.0,20,4,7.0,6,3,20.0,No,2014,No,No,No
Preston Troutt,0,2,3,0,0,0,7.0,2,0,0.0,1,0,21.4,No,2014,No,No,No
Stacy Davis,1786,211,1318,607,654,503,3941.0,196,69,301.0,1122,538,25.8,No,2014,No,No,No
Brendan Lane,585,65,447,241,145,83,1781.0,61,20,97.0,386,221,17.9,No,2014,No,No,No
Malcolm Brooks,613,77,474,209,139,110,1427.0,222,85,63.0,252,124,21.4,No,2014,No,No,No
Jeremy Major,1236,494,1074,429,373,219,3809.0,431,159,248.0,643,270,20.4,No,2014,No,No,No
Malte Kramer,138,22,108,46,24,14,439.0,78,32,18.0,30,14,16.4,No,2014,No,No,No
Amadi Udenyi,544,426,541,175,190,118,2563.0,262,76,188.0,279,99,16.6,No,2014,No,No,No
Nikolas Skouen,497,51,421,163,69,57,1567.0,304,114,75.0,117,49,18.0,No,2014,No,No,No
Lamond Murray Jr.,1492,107,1217,575,337,255,2876.0,233,87,175.0,984,488,27.6,No,2014,No,No,No
Atif Russell,581,93,484,211,180,117,1804.0,140,42,110.0,344,169,19.2,No,2014,No,No,No
Jett Raines,1037,44,781,398,303,222,2739.0,76,19,100.0,705,379,19.7,No,2014,No,No,No
Austin Mills,143,54,127,40,60,44,584.0,80,19,53.0,47,21,18.9,No,2014,No,No,No
David Jesperson,413,56,337,150,59,45,1576.0,188,68,68.0,149,82,13.2,No,2014,No,No,No
Jeff Van Dyke,15,4,21,5,0,0,116.0,20,5,6.0,1,0,12.1,No,2014,No,No,No
Jonathan Allen,68,20,59,24,17,8,528.0,32,12,24.0,27,12,8.7,No,2014,No,No,No
Allen Stevens,4,0,2,1,2,2,10.0,1,0,0.0,1,1,16.0,No,2014,No,No,No
Lamar Patterson,1410,427,1097,477,394,285,3628.0,463,171,244.0,634,306,22.5,Yes,2014,No,No,No
Talib Zanna,1117,56,743,411,454,295,2924.0,3,0,137.0,740,411,20.0,No,2014,No,No,No
Cameron Wright,834,225,754,341,217,131,2719.0,89,21,147.0,665,320,19.9,No,2014,No,No,No
James Robinson,1115,604,937,353,381,303,4204.0,332,106,175.0,605,247,16.4,Yes,2014,No,No,No
Michael Young,1835,243,1313,642,644,490,3924.0,180,61,221.0,1133,581,24.7,Yes,2014,No,No,No
Jamel Artis,1696,304,1231,579,485,368,3726.0,450,170,252.0,781,409,24.2,Yes,2014,No,No,No
Josh Newkirk,892,348,786,324,200,135,2997.0,313,109,212.0,473,215,18.8,No,2014,No,No,No
Durand Johnson,659,92,573,222,149,112,1572.0,301,103,90.0,272,119,23.4,No,2014,No,No,No
Derrick Randall,251,4,185,99,102,53,1081.0,0,0,52.0,185,99,13.9,No,2014,No,No,No
Chris Jones,792,193,635,280,231,154,2809.0,245,78,123.0,390,202,16.3,No,2014,No,No,No
Aron Phillips-Nwankwo,28,2,28,11,7,5,120.0,4,1,5.0,24,10,16.3,No,2014,No,No,No
Joshua Ko,25,5,35,10,2,0,64.0,17,5,4.0,18,5,31.2,No,2014,No,No,No
Joseph Uchebo,469,34,351,197,134,75,1075.0,0,0,51.0,351,197,21.1,No,2014,No,No,No
Mike Lecak,7,4,17,2,2,2,58.0,13,1,4.0,4,1,19.9,No,2014,No,No,No
DaShaun Wiggins,853,90,587,245,365,273,1532.0,229,90,100.0,358,155,29.6,No,2014,No,No,No
Tim Douglas,1048,354,892,352,297,237,3084.0,321,107,273.0,571,245,22.3,No,2014,No,No,No
Gary Winston,1070,298,877,372,196,153,3122.0,400,173,211.0,477,199,19.8,No,2014,No,No,No
Kyle Richardson,421,39,333,174,123,73,1439.0,2,0,113.0,331,174,18.4,No,2014,No,No,No
Dre' Winston,488,135,354,162,195,142,1620.0,88,22,101.0,266,140,18.1,No,2014,No,No,No
Marcus Hall,384,77,306,124,81,55,1544.0,215,81,57.0,91,43,13.6,No,2014,No,No,No
Brandon Cataldo,235,13,179,101,52,33,680.0,0,0,36.0,179,101,18.6,No,2014,No,No,No
Aaron Moore,475,56,360,184,148,106,1119.0,8,1,75.0,352,183,24.1,No,2014,No,No,No
Zach Gengler,710,203,559,261,124,103,2235.0,235,85,96.0,324,176,15.6,No,2014,No,No,No
Alyx Foster,32,11,23,10,14,8,318.0,9,4,9.0,14,6,6.5,No,2014,No,No,No
Kyle Benton,466,22,302,180,189,106,1474.0,2,0,55.0,300,180,15.1,No,2014,No,No,No
Joel King,8,4,11,3,3,2,34.0,2,0,2.0,9,3,21.9,No,2014,No,No,No
Lamont Prosser,38,4,26,14,20,10,153.0,0,0,16.0,26,14,17.9,No,2014,No,No,No
Jacob Begin,0,2,4,0,0,0,23.0,3,0,0.0,1,0,9.4,No,2014,No,No,No
Thomas van der Mars,1252,98,893,497,392,258,3218.0,1,0,176.0,892,497,20.2,No,2014,No,No,No
Ryan Nicholas,1238,113,968,450,364,270,3000.0,180,68,181.0,788,382,22.7,No,2014,No,No,No
Kevin Bailey,1362,156,1068,457,451,344,2750.0,289,104,256.0,779,353,28.9,No,2014,No,No,No
Bryce Pressley,1104,314,882,388,234,173,3372.0,388,155,163.0,494,233,17.2,No,2014,No,No,No
Bobby Sharp,416,58,387,135,51,38,1128.0,299,108,29.0,88,27,20.2,No,2014,No,No,No
Alec Wintering,1548,568,1104,471,631,499,3492.0,267,107,324.0,837,364,25.1,No,2014,No,No,No
Riley Barker,379,38,311,145,135,86,1593.0,10,3,79.0,301,142,14.8,No,2014,No,No,No
Volodymyr Gerun,392,35,318,149,132,88,1181.0,29,6,82.0,289,143,20.4,No,2014,No,No,No
Korey Thieleke,209,49,206,79,68,43,1015.0,40,8,58.0,166,71,15.1,No,2014,No,No,No
David Carr,244,118,265,88,60,28,1202.0,129,40,56.0,136,48,14.9,No,2014,No,No,No
Tanner Riley,458,64,455,166,44,38,1300.0,273,88,76.0,182,78,22.0,No,2014,No,No,No
John Bailey,67,16,72,25,26,15,295.0,6,2,19.0,66,23,18.0,No,2014,No,No,No
Aitor Zubizarreta,20,19,21,7,7,5,169.0,11,1,20.0,10,6,13.7,No,2014,No,No,No
Montrael Scott,1227,199,1018,428,300,218,3142.0,447,153,222.0,571,275,21.5,No,2014,No,No,No
John Brisco,829,113,720,292,186,140,1959.0,298,105,132.0,422,187,23.7,No,2014,No,No,No
Demondre Chapman,918,39,704,352,466,214,2323.0,2,0,153.0,702,352,22.4,No,2014,No,No,No
Louis Munks,663,47,587,222,187,139,1466.0,251,80,106.0,336,142,25.8,No,2014,No,No,No
Treshawn Hagood,672,303,596,237,286,175,2200.0,95,23,215.0,501,214,21.2,No,2014,No,No,No
Hershey Robinson,162,18,149,59,20,12,600.0,91,32,30.0,58,27,15.7,No,2014,No,No,No
Jules Montgomery,585,69,623,248,119,68,2128.0,83,21,99.0,540,227,17.4,No,2014,No,No,No
Karim York,549,43,480,217,135,80,1526.0,119,35,143.0,361,182,22.3,No,2014,No,No,No
Andre Adams,48,35,45,15,21,16,374.0,13,2,33.0,32,13,11.7,No,2014,No,No,No
Reggis Onwukamuche,252,10,193,94,111,64,1127.0,0,0,76.0,193,94,14.1,No,2014,No,No,No
Patrick Agho,56,3,47,22,32,12,224.0,0,0,19.0,47,22,17.6,No,2014,No,No,No
Rasi Jenkins,110,20,89,39,56,32,844.0,1,0,45.0,88,39,9.1,No,2014,No,No,No
Rashaan Surles,465,157,451,173,118,83,1591.0,129,36,124.0,322,137,19.2,No,2014,No,No,No
Jordan Downing,1626,143,1414,595,273,211,3456.0,594,225,207.0,820,370,27.7,No,2014,No,No,No
Reggie Dillard,1419,344,1211,500,341,231,3969.0,536,188,324.0,675,312,22.7,No,2014,No,No,No
William Truss,906,45,602,368,255,164,2666.0,13,6,154.0,589,362,18.1,No,2014,No,No,No
Markus Terry,757,124,631,265,227,161,2344.0,209,66,121.0,422,199,19.5,No,2014,No,No,No
Danny Herrera,216,16,178,80,50,35,675.0,60,21,28.0,118,59,18.3,No,2014,No,No,No
Austin Anderson,312,196,332,110,60,44,1942.0,184,48,117.0,148,62,13.6,No,2014,No,No,No
Ed Drew,721,49,622,272,241,174,2490.0,26,3,131.0,596,269,18.4,No,2014,No,No,No
Will Adams,341,58,337,118,38,30,1344.0,222,75,45.0,115,43,15.5,No,2014,No,No,No
Jake Campbell,19,4,17,7,9,5,229.0,0,0,9.0,17,7,7.3,No,2014,No,No,No
Bradford Allen,3,0,1,1,2,1,11.0,0,0,0.0,1,1,9.6,No,2014,No,No,No
Russell McCray,7,6,6,2,10,3,34.0,0,0,6.0,6,2,27.8,No,2014,No,No,No
Charlie Inclan,5,2,12,2,2,1,15.0,3,0,2.0,9,2,52.6,No,2014,No,No,No
Mac Lake,14,10,15,5,2,2,95.0,8,2,3.0,7,3,11.4,No,2014,No,No,No
T.J. Bray,1024,374,696,338,283,213,3293.0,348,135,174.0,348,203,17.1,No,2014,No,No,No
Hans Brase,913,173,704,300,280,208,2645.0,306,105,173.0,398,195,21.2,No,2014,No,No,No
Will Barrett,686,114,517,222,152,113,2028.0,321,129,113.0,196,93,19.6,No,2014,No,No,No
Spencer Weisz,1241,383,979,422,255,188,3723.0,555,209,194.0,424,213,18.8,No,2014,No,No,No
Ben Hazel,353,48,284,102,110,85,1391.0,197,64,58.0,87,38,15.8,No,2014,No,No,No
Denton Koon,982,132,777,367,244,169,2956.0,223,79,171.0,554,288,19.3,No,2014,No,No,No
Jimmy Sherburne,156,69,139,51,51,37,795.0,54,17,55.0,85,34,15.2,No,2014,No,No,No
Steven Cook,1148,159,858,400,271,192,2913.0,394,156,149.0,464,244,21.0,No,2014,No,No,No
Clay Wilson,398,42,321,132,58,42,1189.0,249,92,40.0,72,40,18.5,No,2014,No,No,No
Pete Miller,526,136,428,224,166,77,1911.0,1,1,126.0,427,223,17.8,No,2014,No,No,No
Chris Clement,113,31,93,32,36,31,663.0,57,18,28.0,36,14,11.8,No,2014,No,No,No
Bobby Garbade,30,17,27,9,13,10,164.0,8,2,15.0,19,7,16.6,No,2014,No,No,No
Khyan Rayner,58,10,51,16,28,16,236.0,31,10,11.0,20,6,16.8,No,2014,No,No,No
Henry Caruso,1069,128,705,355,350,276,2535.0,209,83,143.0,496,272,21.3,No,2014,No,No,No
Mike Washington Jr.,21,9,32,10,3,0,113.0,14,1,10.0,18,9,20.5,No,2014,No,No,No
Daniel Edwards,19,1,16,7,8,3,62.0,4,2,9.0,12,5,25.9,No,2014,No,No,No
Hashim Moore,15,1,9,6,5,3,28.0,0,0,4.0,9,6,30.8,No,2014,No,No,No
Bryce Cotton,1975,384,1452,611,581,487,4314.0,736,266,193.0,716,345,22.7,Yes,2014,No,No,No
LaDontae Henton,2059,158,1655,724,560,424,4909.0,555,187,246.0,1100,537,22.6,No,2014,No,No,No
Kadeem Batts,1289,103,1019,455,521,366,3257.0,40,13,198.0,979,442,22.6,No,2014,No,No,No
Tyler Harris,1196,131,942,408,437,318,3021.0,208,62,200.0,734,346,22.5,No,2014,No,No,No
Josh Fortune,1037,247,924,351,207,158,3413.0,526,177,233.0,398,174,18.3,No,2014,No,No,No
Carson Desrosiers,613,92,518,225,203,139,2742.0,72,24,104.0,446,201,13.6,No,2014,No,No,No
Brice Kofane,335,29,248,124,157,87,1672.0,0,0,123.0,248,124,14.1,No,2014,No,No,No
Kris Dunn,1214,552,943,424,423,293,2997.0,206,73,315.0,737,351,24.6,Yes,2014,No,No,No
Ted Bancroft,55,17,69,19,22,9,563.0,45,8,25.0,24,11,9.4,No,2014,No,No,No
Lee Goldsbrough,89,24,78,34,28,16,802.0,16,5,51.0,62,29,8.9,No,2014,No,No,No
Casey Woodring,11,0,21,4,0,0,40.0,16,3,0.0,5,1,27.0,No,2014,No,No,No
Terone Johnson,1318,299,1207,496,376,206,3507.0,365,120,197.0,842,376,23.0,No,2014,No,No,No
Ronnie Johnson,1238,420,1082,441,417,283,3177.0,228,73,248.0,854,368,23.8,No,2014,No,No,No
A.J. Hammons,1593,104,1138,613,523,361,3201.0,23,6,271.0,1115,607,26.2,No,2014,No,No,No
Kendall Stephens,1181,123,980,376,158,128,2777.0,775,301,104.0,205,75,21.1,No,2014,No,No,No
Bryson Scott,1569,235,1196,531,515,393,2723.0,362,114,247.0,834,417,29.8,No,2014,No,No,No
Rapheal Davis,1009,231,766,333,376,273,3224.0,219,70,176.0,547,263,17.6,No,2014,No,No,No
Basil Smotherman,321,67,249,134,77,44,1259.0,46,9,46.0,203,125,13.2,No,2014,No,No,No
Errick Peck,826,116,721,311,219,148,2150.0,158,56,156.0,563,255,23.6,No,2014,No,No,No
Sterling Carter,888,141,822,298,142,94,1982.0,553,198,170.0,269,100,24.4,No,2014,No,No,No
Jay Simpson,138,17,136,58,41,21,388.0,10,1,29.0,126,57,23.5,No,2014,No,No,No
Travis Carroll,229,40,189,100,45,25,1341.0,10,4,36.0,179,96,9.5,No,2014,No,No,No
Stephen Toyra,24,5,19,6,18,12,102.0,8,0,11.0,11,6,18.9,No,2014,No,No,No
Jon McKeeman,10,0,11,4,2,0,50.0,4,2,3.0,7,2,15.0,No,2014,No,No,No
Anfernee Brown,7,2,8,3,0,0,20.0,4,1,1.0,4,2,22.8,No,2014,No,No,No
Neal Beshears,9,2,8,3,2,2,61.0,4,1,7.0,4,2,13.5,No,2014,No,No,No
Ike Azotam,1603,97,1240,628,561,347,3444.0,1,0,191.0,1239,628,23.2,No,2014,No,No,No
Zaid Hearst,1610,224,1254,542,492,389,3764.0,402,137,193.0,852,405,21.2,No,2014,No,No,No
Ousmane Drame,1363,86,1022,497,535,368,3037.0,3,1,242.0,1019,496,23.7,No,2014,No,No,No
Umar Shannon,1307,226,1078,404,383,308,3033.0,528,191,216.0,550,213,24.8,No,2014,No,No,No
Shaq Shannon,387,145,321,119,139,91,1469.0,157,58,96.0,164,61,15.4,No,2014,No,No,No
Kasim Chandler,302,136,248,84,171,128,910.0,42,6,97.0,206,78,22.0,No,2014,No,No,No
Evan Conti,740,228,654,251,190,130,2444.0,314,108,157.0,340,143,17.6,No,2014,No,No,No
James Ford Jr.,498,92,453,157,136,93,1725.0,262,91,86.0,191,66,16.5,No,2014,No,No,No
AJ Sumbry,613,34,484,224,289,165,2015.0,3,0,142.0,481,224,18.7,No,2014,No,No,No
Justin Harris,332,32,295,118,129,95,1112.0,19,1,63.0,276,117,18.2,No,2014,No,No,No
Marquis Barnett,33,4,27,14,9,5,189.0,0,0,8.0,27,14,9.8,No,2014,No,No,No
T'ziah Wood-Smith,7,1,10,3,2,1,32.0,2,0,3.0,8,3,20.3,No,2014,No,No,No
Emanuel Binyam,2,0,7,0,4,2,15.0,3,0,1.0,4,0,31.3,No,2014,No,No,No
Alain Chigha,150,21,141,55,53,26,914.0,53,14,38.0,88,41,10.8,No,2014,No,No,No
Samir Kalil,0,0,1,0,0,0,17.0,1,0,1.0,0,0,5.7,No,2014,No,No,No
Kendrick Ray,1322,220,1085,493,278,206,2461.0,357,130,184.0,728,363,27.7,No,2014,No,No,No
Javonte Green,1911,141,1350,701,739,485,3378.0,101,24,245.0,1249,677,29.0,Yes,2014,No,No,No
R.J. Price,1649,369,1477,544,367,260,3900.0,848,301,248.0,629,243,24.5,No,2014,No,No,No
Ya Ya Anderson,1141,213,961,392,194,135,3336.0,615,222,120.0,346,170,17.6,No,2014,No,No,No
Rashun Davis,1304,457,1062,441,449,336,3237.0,301,86,323.0,761,355,24.7,No,2014,No,No,No
Kion Brown,614,39,495,245,227,124,1908.0,0,0,146.0,495,245,19.6,No,2014,No,No,No
Jalen Carethers,553,52,462,216,173,121,1611.0,3,0,63.0,459,216,19.0,No,2014,No,No,No
Brandon Holcomb,681,86,517,273,208,135,2566.0,0,0,176.0,517,273,15.5,No,2014,No,No,No
Kyle Noreen,498,183,442,189,97,50,3037.0,237,70,73.0,205,119,9.3,No,2014,No,No,No
Allen Dickerson,113,27,111,39,26,16,531.0,70,19,29.0,41,20,14.3,No,2014,No,No,No
Justin Cousin,624,111,589,211,91,62,1950.0,408,140,108.0,181,71,19.5,No,2014,No,No,No
Taj Owens,206,91,174,68,71,59,764.0,34,11,46.0,140,57,16.6,No,2014,No,No,No
Juwan Wells,31,8,43,13,3,1,147.0,21,4,11.0,22,9,18.6,No,2014,No,No,No
Lucas Dyer,104,7,75,31,62,42,480.0,0,0,23.0,75,31,13.3,No,2014,No,No,No
Kyle Gonzalez,23,4,12,8,9,5,82.0,6,2,8.0,6,6,14.8,No,2014,No,No,No
Xavier Munford,1045,134,884,352,297,211,2166.0,388,130,165.0,496,222,29.0,Yes,2014,No,No,No
E.C. Matthews,1899,213,1503,632,564,413,3931.0,668,222,303.0,835,410,26.8,No,2014,No,No,No
Gilvydas Biruta,1225,139,901,455,437,296,3039.0,78,19,223.0,823,436,22.6,No,2014,No,No,No
Hassan Martin,1300,71,894,518,427,261,3284.0,24,3,164.0,870,515,19.8,No,2014,No,No,No
T.J. Buchanan,591,233,433,192,288,186,2679.0,73,21,149.0,360,171,13.7,No,2014,No,No,No
Jarelle Reischel,1011,158,701,325,414,289,2337.0,201,72,230.0,500,253,24.0,No,2014,No,No,No
Biggie Minnis,504,255,441,195,187,95,2174.0,63,19,192.0,378,176,17.6,No,2014,No,No,No
Ifeanyi Onyekaba,100,2,67,33,63,34,420.0,0,0,27.0,67,33,15.0,No,2014,No,No,No
Matthew Butler,1037,233,929,374,134,103,2703.0,516,186,228.0,413,188,22.5,No,2014,No,No,No
Mike Powell,551,229,513,166,209,154,2128.0,212,65,189.0,301,101,19.3,No,2014,No,No,No
Mike Aaman,847,44,695,329,295,189,2037.0,1,0,130.0,694,329,23.7,No,2014,No,No,No
Eric Youncofski,7,0,5,1,6,5,14.0,2,0,1.0,3,1,33.5,No,2014,No,No,No
A.J. Kemp,1,1,1,0,2,1,12.0,0,0,0.0,1,0,0.0,No,2014,No,No,No
Jonathan Nazarko,0,0,4,0,0,0,13.0,3,0,0.0,1,0,16.3,No,2014,No,No,No
Shane Plunkett,3,1,7,1,2,0,23.0,5,1,1.0,2,0,20.5,No,2014,No,No,No
Sean Obi,376,26,258,152,132,72,945.0,0,0,68.0,258,152,22.5,No,2014,No,No,No
Austin Ramljak,615,62,493,193,95,68,1737.0,418,161,55.0,75,32,19.0,No,2014,No,No,No
Max Guercy,1115,503,893,338,366,304,4035.0,428,135,282.0,465,203,18.3,No,2014,No,No,No
Seth Gearhart,875,142,653,267,255,203,2698.0,380,138,135.0,273,129,18.8,No,2014,No,No,No
Keith Washington,326,128,323,110,111,75,1200.0,116,31,125.0,207,79,23.2,No,2014,No,No,No
Marcus Jackson,1307,369,1066,429,291,224,3692.0,626,225,240.0,440,204,20.5,No,2014,No,No,No
Andrew Drone,636,37,425,255,205,126,1891.0,0,0,120.0,425,255,17.9,No,2014,No,No,No
Drew Bender,99,22,95,35,20,13,326.0,59,16,25.0,36,19,21.8,No,2014,No,No,No
Nizar Kapic,70,12,75,25,10,6,296.0,43,14,13.0,32,11,17.3,No,2014,No,No,No
Ross Wilson,144,41,130,63,34,18,875.0,0,0,55.0,130,63,12.9,No,2014,No,No,No
Bahrom Firozgary,55,5,31,16,36,23,319.0,0,0,19.0,31,16,11.8,No,2014,No,No,No
Dan Peera,123,48,99,46,14,3,852.0,65,28,33.0,34,18,9.1,No,2014,No,No,No
Joey Burbach,3,0,5,1,1,0,15.0,3,1,0.0,2,0,20.3,No,2014,No,No,No
Hunter Eggers,0,1,2,0,0,0,4.0,1,0,0.0,1,0,27.5,No,2014,No,No,No
Kendall Anthony,1909,236,1504,628,475,383,3918.0,689,270,193.0,815,358,27.3,No,2014,No,No,No
Cedrick Lindsay,1276,355,937,403,489,372,3272.0,296,98,209.0,641,305,23.0,No,2014,No,No,No
Terry Allen,1491,168,1080,547,471,333,3409.0,214,64,209.0,866,483,24.3,No,2014,No,No,No
Alonzo Nelson-Ododa,556,84,447,195,220,132,2414.0,124,34,118.0,323,161,15.3,No,2014,No,No,No
ShawnDre' Jones,1608,364,1236,539,374,303,3750.0,588,227,187.0,648,312,23.0,No,2014,No,No,No
Trey Davis,531,256,457,200,219,107,3410.0,93,24,153.0,364,176,11.5,No,2014,No,No,No
Deion Taylor,460,135,388,164,160,76,2696.0,198,56,99.0,190,108,11.5,No,2014,No,No,No
Derrick Williams,816,80,477,250,372,277,2056.0,112,39,141.0,365,211,21.1,Yes,2014,No,No,No
Wayne Sparrow,577,135,565,208,158,89,1990.0,242,72,139.0,323,136,21.5,No,2014,No,No,No
Josh Jones,105,23,94,36,22,13,454.0,63,20,15.0,31,16,15.0,No,2014,No,No,No
Zach Chu,14,2,6,4,2,2,15.0,6,4,2.0,0,0,33.4,No,2014,No,No,No
Chase Fletcher,0,0,0,0,0,0,3.0,0,0,0.0,0,0,0.0,No,2014,No,No,No
John Moran,109,32,109,32,21,13,472.0,97,32,38.0,12,0,16.2,No,2014,No,No,No
Tim Singleton,0,0,1,0,0,0,3.0,1,0,0.0,0,0,18.1,No,2014,No,No,No
Anthony Myles,1417,196,1105,449,447,329,3519.0,531,190,251.0,574,259,22.9,No,2014,No,No,No
Danny Stewart,1414,98,907,456,665,476,3722.0,70,26,252.0,837,430,20.4,No,2014,No,No,No
Jimmie Taylor,1539,201,1223,517,412,290,4076.0,548,215,198.0,675,302,20.0,No,2014,No,No,No
Zedric Sadler,816,250,731,286,208,140,3085.0,313,104,182.0,418,182,17.2,No,2014,No,No,No
Kahlil Thomas,1141,107,851,448,377,233,2889.0,39,12,194.0,812,436,21.2,No,2014,No,No,No
Khalil Alford,535,54,481,208,101,69,1507.0,154,50,87.0,327,158,21.5,No,2014,No,No,No
Tommy Pereira,347,52,297,116,16,11,1297.0,273,104,35.0,24,12,13.5,No,2014,No,No,No
Shawn Valentine,487,125,448,166,138,90,2359.0,211,65,144.0,237,101,14.6,No,2014,No,No,No
Junior Fortunat,415,18,315,164,213,87,1429.0,0,0,102.0,315,164,18.9,No,2014,No,No,No
Brandon Channer,11,2,10,3,8,4,35.0,4,1,5.0,6,2,27.3,No,2014,No,No,No
Xavier Lundy,883,90,737,334,169,123,2356.0,282,92,141.0,455,242,20.4,No,2014,No,No,No
Emerson Bursis,10,0,10,5,1,0,42.0,3,0,1.0,7,5,14.3,No,2014,No,No,No
Davis Graham,0,0,0,0,0,0,7.0,0,0,0.0,0,0,0.0,No,2014,No,No,No
Karvel Anderson,1123,85,787,391,166,140,1925.0,444,201,82.0,343,190,25.5,No,2014,No,No,No
Lucky Jones,1632,186,1219,494,562,448,3769.0,558,196,264.0,661,298,23.9,No,2014,No,No,No
Anthony Myers,805,449,677,263,268,197,3367.0,256,82,232.0,421,181,15.8,No,2014,No,No,No
Charles Oliver,652,48,501,192,212,172,1470.0,294,96,72.0,207,96,23.3,No,2014,No,No,No
Jeremiah Worthem,201,24,154,66,79,57,558.0,27,12,33.0,127,54,20.7,No,2014,No,No,No
Stephan Hawkins,247,16,224,103,57,41,1104.0,0,0,50.0,224,103,14.1,No,2014,No,No,No
Kavon Stewart,995,503,815,291,584,376,3458.0,143,37,364.0,672,254,21.4,No,2014,No,No,No
David Appolon,381,91,322,130,142,101,1552.0,85,20,88.0,237,110,15.9,No,2014,No,No,No
Mike McFadden,777,67,589,300,293,176,2353.0,1,1,148.0,588,299,19.2,No,2014,No,No,No
Aaron Tate,457,50,371,190,138,77,2403.0,0,0,100.0,371,190,11.4,No,2014,No,No,No
Desjuan Newton,47,15,41,17,9,5,165.0,19,8,7.0,22,9,16.4,No,2014,No,No,No
Evan Grey,0,0,0,0,0,0,2.0,0,0,0.0,0,0,0.0,No,2014,No,No,No
Britton Lee,0,0,3,0,2,0,10.0,0,0,1.0,3,0,25.6,No,2014,No,No,No
Shaire Tolson-Ford,0,0,0,0,0,0,4.0,0,0,0.0,0,0,0.0,No,2014,No,No,No
Myles Mack,1658,425,1311,541,393,337,3931.0,648,239,278.0,663,302,23.1,No,2014,No,No,No
Kadeem Jack,1044,62,898,409,330,209,2581.0,51,17,181.0,847,392,24.4,No,2014,No,No,No
J.J. Moore,1005,74,784,337,281,217,2380.0,360,114,103.0,424,223,22.1,No,2014,No,No,No
Wally Judge,667,81,533,256,298,155,2073.0,2,0,169.0,531,256,20.1,No,2014,No,No,No
Jerome Seagears,987,385,850,335,225,174,3235.0,394,143,203.0,456,192,17.8,No,2014,No,No,No
Junior Etou,1239,125,898,403,436,313,3418.0,340,120,221.0,558,283,19.9,No,2014,No,No,No
D'Von Campbell,188,58,167,62,55,36,699.0,83,28,44.0,84,34,17.5,No,2014,No,No,No
Craig Brown,162,18,201,53,61,41,801.0,63,15,42.0,138,38,17.4,No,2014,No,No,No
Malick Kone,267,49,255,105,78,47,1212.0,45,10,62.0,210,95,14.9,No,2014,No,No,No
Greg Lewis,350,64,340,139,133,72,1833.0,0,0,114.0,340,139,14.3,No,2014,No,No,No
Kerwin Okoro,247,36,239,88,46,32,678.0,119,39,62.0,120,49,23.7,No,2014,No,No,No
Jalen Hyde,9,2,12,4,5,1,67.0,5,0,4.0,7,4,13.8,No,2014,No,No,No
Stephen Zurich,1,2,3,0,4,1,64.0,1,0,4.0,2,0,7.0,No,2014,No,No,No
Mikh McKinney,1468,369,1082,508,395,320,3105.0,339,132,197.0,743,376,25.9,No,2014,No,No,No
Dylan Garrity,1406,527,965,434,378,316,3991.0,532,222,261.0,433,212,19.1,No,2014,No,No,No
Cody Demps,914,286,695,317,344,242,3055.0,143,38,200.0,552,279,18.6,No,2014,No,No,No
Zach Mills,388,39,325,146,50,39,1301.0,132,57,43.0,193,89,16.6,No,2014,No,No,No
Jordan Salley,242,8,155,96,79,50,671.0,0,0,37.0,155,96,18.7,No,2014,No,No,No
Eric Stuteville,1013,34,717,403,368,206,2595.0,4,1,150.0,713,402,21.3,No,2014,No,No,No
Alex Tiffin,422,51,360,168,149,84,1834.0,15,2,138.0,345,166,16.8,No,2014,No,No,No
Nick Hornsby,914,180,743,340,299,204,2997.0,93,30,195.0,650,310,19.1,No,2014,No,No,No
Dreon Barlett,415,45,330,135,62,51,1484.0,232,94,48.0,98,41,14.5,No,2014,No,No,No
Joey Quigley,95,17,101,33,42,24,489.0,19,5,24.0,82,28,16.1,No,2014,No,No,No
Case Rada,31,3,38,11,4,1,85.0,32,8,2.0,6,3,27.0,No,2014,No,No,No
Ryan Okwudibonye,11,0,8,4,3,3,28.0,0,0,4.0,8,4,26.2,No,2014,No,No,No
Kendall Groom,34,27,50,14,13,5,276.0,6,1,19.0,44,13,14.5,No,2014,No,No,No
Trevis Jackson,113,76,81,33,44,32,792.0,52,15,37.0,29,18,9.1,No,2014,No,No,No
Louis Montes,1261,104,967,435,424,304,2952.0,264,87,201.0,703,348,23.3,No,2014,No,No,No
Steve Glowiak,1028,126,923,346,140,104,2868.0,672,232,100.0,251,114,18.9,No,2014,No,No,No
Evan Kelley,1194,243,1015,435,414,268,3327.0,229,56,259.0,786,379,22.1,No,2014,No,No,No
Chris Evans,747,140,574,244,329,230,2025.0,92,29,149.0,482,215,22.0,No,2014,No,No,No
DeVon Barnett,1008,86,804,433,247,142,2546.0,6,0,160.0,798,433,20.8,No,2014,No,No,No
Phil Gaetano,661,730,558,198,150,130,3781.0,383,135,355.0,175,63,13.0,No,2014,No,No,No
Mostafa Abdel Latif,191,10,170,82,46,27,849.0,0,0,40.0,170,82,13.6,No,2014,No,No,No
Tevin Falzon,749,87,641,237,339,252,2273.0,103,23,129.0,538,214,19.9,No,2014,No,No,No
Cole Walton,98,22,93,38,43,22,677.0,1,0,32.0,92,38,10.5,No,2014,No,No,No
Leo Vincent,562,69,479,188,117,95,1526.0,278,91,99.0,201,97,21.0,No,2014,No,No,No
Eyimofe Edukugho,169,11,140,69,65,31,473.0,0,0,46.0,140,69,21.9,No,2014,No,No,No
Lewis Cramer,39,4,34,15,15,9,185.0,0,0,6.0,34,15,13.2,No,2014,No,No,No
Earl Brown,1373,171,1000,527,478,299,3409.0,68,20,292.0,932,507,24.6,No,2014,No,No,No
Malik Harmon,907,327,806,272,320,223,3321.0,435,140,186.0,371,132,18.4,No,2014,No,No,No
Ben Millaud-Meunier,989,117,737,289,237,199,2243.0,548,212,130.0,189,77,23.3,No,2014,No,No,No
Dominique Major,550,72,500,177,85,49,1917.0,411,147,55.0,89,30,17.1,No,2014,No,No,No
Ronnie Drinnon,971,131,795,388,296,172,3005.0,77,23,144.0,718,365,19.2,No,2014,No,No,No
Stephon Whyatt,574,181,493,203,150,100,2108.0,210,68,157.0,283,135,18.8,No,2014,No,No,No
Ollie Jackson,789,145,764,269,127,89,2658.0,504,162,191.0,260,107,21.0,No,2014,No,No,No
Greg Brown,855,292,766,312,222,156,3221.0,234,75,187.0,532,237,17.5,No,2014,No,No,No
Stephon Mosley,202,13,164,74,67,50,600.0,13,4,48.0,151,70,22.2,No,2014,No,No,No
Georgios Angelou,397,91,302,124,55,48,1271.0,251,101,79.0,51,23,16.0,No,2014,No,No,No
Patrick Wrencher,122,12,96,51,30,20,513.0,0,0,33.0,96,51,14.4,No,2014,No,No,No
Dalton Cesarz,2,1,3,1,0,0,14.0,1,0,0.0,2,1,11.9,No,2014,No,No,No
Aric Gresko,3,2,6,1,0,0,32.0,4,1,3.0,2,0,15.5,No,2014,No,No,No
Matthew Mazzara,0,0,2,0,0,0,18.0,2,0,3.0,0,0,15.4,No,2014,No,No,No
Langston Galloway,1991,296,1501,657,407,334,4720.0,806,343,156.0,695,314,21.0,Yes,2014,No,No,No
Ronald Roberts,1398,100,953,543,527,312,3541.0,0,0,190.0,953,543,21.1,No,2014,No,No,No
DeAndre Bembry,1590,364,1270,580,494,310,3645.0,385,120,248.0,885,460,24.9,No,2014,No,No,No
Halil Kanacevic,1163,407,980,444,364,227,3707.0,180,48,343.0,800,396,20.9,No,2014,No,No,No
Chris Wilson,876,377,775,294,260,166,3815.0,388,122,219.0,387,172,15.6,No,2014,No,No,No
Isaiah Miles,1097,69,810,375,250,210,2529.0,376,137,113.0,434,238,21.2,No,2014,No,No,No
Papa Ndao,319,71,275,107,44,33,1383.0,205,72,86.0,70,35,14.3,No,2014,No,No,No
Daryus Quarles,435,75,475,164,87,53,1849.0,193,54,67.0,282,110,16.9,No,2014,No,No,No
Evan Maschmeyer,64,26,70,20,26,19,353.0,27,5,31.0,43,15,17.0,No,2014,No,No,No
Javon Baumann,232,24,155,97,105,38,1191.0,0,0,55.0,155,97,11.3,No,2014,No,No,No
Brendan Casper,200,49,185,78,62,38,709.0,38,6,42.0,147,72,18.2,No,2014,No,No,No
Colin Kelly,3,0,3,1,4,1,29.0,1,0,2.0,2,1,12.7,No,2014,No,No,No
Kyle Molock,2,1,1,0,3,2,28.0,0,0,6.0,1,0,15.9,No,2014,No,No,No
Eric Kindler,20,7,29,6,9,5,84.0,20,3,7.0,9,3,24.4,No,2014,No,No,No
Dwayne Evans,1499,126,1081,543,547,393,3616.0,66,20,232.0,1015,523,23.2,No,2014,No,No,No
Jordair Jett,1239,422,953,453,500,306,3497.0,109,27,295.0,844,426,22.6,No,2014,No,No,No
Rob Loe,973,153,809,342,224,156,2822.0,408,133,174.0,401,209,20.6,No,2014,No,No,No
Mike McCall Jr.,1212,339,998,413,285,225,3704.0,449,161,197.0,549,252,19.2,No,2014,No,No,No
Austin McBroom,1492,314,1149,461,376,313,3508.0,643,257,238.0,506,204,23.1,No,2014,No,No,No
Jake Barnett,717,119,637,228,166,123,2537.0,403,138,158.0,234,90,19.1,No,2014,No,No,No
Grandy Glaze,670,52,521,289,154,92,1639.0,11,0,96.0,510,289,21.2,No,2014,No,No,No
John Manning,186,25,152,71,74,43,972.0,5,1,47.0,147,70,12.9,No,2014,No,No,No
Tanner Lancona,92,17,88,34,32,16,393.0,40,8,18.0,48,26,16.5,No,2014,No,No,No
Mike Crawford,950,144,790,327,252,188,2680.0,334,108,136.0,456,219,20.9,No,2014,No,No,No
Reggie Agbeko,633,39,449,249,234,134,2150.0,1,1,164.0,448,248,18.1,No,2014,No,No,No
Austin Eagleton,0,0,0,0,0,0,7.0,0,0,2.0,0,0,14.8,No,2014,No,No,No
Joey Lepak,2,1,1,0,2,2,14.0,1,0,0.0,0,0,7.4,No,2014,No,No,No
Royce Simpson,0,0,0,0,0,0,1.0,0,0,0.0,0,0,0.0,No,2014,No,No,No
Brad Waldow,1743,141,1162,683,632,377,3486.0,1,0,187.0,1161,683,25.3,No,2014,No,No,No
Stephen Holt,1370,305,924,409,496,401,3962.0,396,151,184.0,528,258,17.8,No,2014,No,No,No
James Walker,587,104,473,186,174,122,1905.0,250,93,100.0,223,93,18.2,No,2014,No,No,No
Kerry Carter,702,76,541,222,165,116,1970.0,359,142,101.0,182,80,19.8,No,2014,No,No,No
Beau Levesque,829,135,595,276,240,186,2132.0,241,91,124.0,354,185,20.6,No,2014,No,No,No
Matt Hodgson,518,27,366,200,182,115,1731.0,12,3,154.0,354,197,18.1,No,2014,No,No,No
Jordan Giusti,197,84,173,64,63,41,1183.0,86,28,45.0,87,36,11.0,No,2014,No,No,No
Garrett Jackson,686,80,581,267,153,103,2037.0,146,49,110.0,435,218,20.9,No,2014,No,No,No
Paul McCoy,612,161,510,220,198,128,1963.0,140,44,156.0,370,176,20.4,No,2014,No,No,No
Dane Pineau,782,111,544,335,165,92,2388.0,73,20,106.0,471,315,17.1,No,2014,No,No,No
Eividas Petrulis,72,11,56,23,14,8,176.0,46,18,18.0,10,5,24.1,No,2014,No,No,No
Treaven Duffy,29,5,20,8,20,12,95.0,4,1,13.0,16,7,24.3,No,2014,No,No,No
Marvin Dominique,1160,48,925,417,339,255,2882.0,203,71,158.0,722,346,23.3,No,2014,No,No,No
Desmond Washington,1596,126,1323,514,384,325,3883.0,695,243,192.0,628,271,24.1,No,2014,No,No,No
Trevis Wyche,1228,501,919,394,483,351,3871.0,252,89,237.0,667,305,19.5,No,2014,No,No,No
Chris Burke,604,124,536,222,135,94,2540.0,205,66,139.0,331,156,15.5,No,2014,No,No,No
Quadir Welton,1191,165,924,435,575,321,3482.0,0,0,246.0,924,435,22.6,No,2014,No,No,No
Jamel Fields,502,158,379,141,288,176,2059.0,148,44,140.0,231,97,17.0,No,2014,No,No,No
Tyler Gaskins,407,77,388,153,76,43,1324.0,171,58,88.0,217,95,21.5,No,2014,No,No,No
Elias Desport,281,46,250,98,128,83,1638.0,8,2,99.0,242,96,13.5,No,2014,No,No,No
Kris Rolle,48,6,33,17,33,14,321.0,0,0,10.0,33,17,10.0,No,2014,No,No,No
Vic Adams,28,5,25,9,7,6,67.0,15,4,9.0,10,5,30.1,No,2014,No,No,No
Howard Sellars,26,5,35,10,7,5,145.0,11,1,5.0,24,9,16.1,No,2014,No,No,No
Markese Tucker,267,12,229,116,57,35,732.0,0,0,32.0,229,116,21.0,No,2014,No,No,No
Mohamed Farih,12,0,6,4,6,4,18.0,0,0,6.0,6,4,44.7,No,2014,No,No,No
Jabari Peters,830,242,603,238,372,250,2345.0,301,104,154.0,302,134,20.0,No,2014,No,No,No
Kaheem Ransom,754,267,592,216,264,203,2082.0,341,119,145.0,251,97,20.8,No,2014,No,No,No
Paul Baxter,1103,362,905,377,339,228,3501.0,347,121,216.0,558,256,18.2,No,2014,No,No,No
James Thomas,617,63,463,227,268,163,1858.0,1,0,95.0,462,227,18.8,Yes,2014,No,No,No
Terrance Motley,504,25,424,202,155,96,1081.0,7,4,79.0,417,198,27.1,No,2014,No,No,No
Michael Holyfield,732,31,489,286,289,160,2165.0,1,0,181.0,488,286,19.0,No,2014,No,No,No
Dakarai Henderson,1325,126,1206,449,281,189,2978.0,703,238,147.0,503,211,24.5,No,2014,No,No,No
Nathaniel Mason,351,38,273,113,135,99,906.0,78,26,63.0,195,87,22.5,No,2014,No,No,No
Will Bond,374,58,310,120,56,43,1193.0,237,91,39.0,73,29,16.0,No,2014,No,No,No
Aurimas Majauskas,1170,118,705,398,437,334,2122.0,110,40,150.0,595,358,24.6,No,2014,No,No,No
Marquel McKinney,353,82,319,109,117,71,1817.0,206,64,74.0,113,45,12.6,No,2014,No,No,No
Mitch McCormick,26,4,29,8,5,3,99.0,24,7,2.0,5,1,16.8,No,2014,No,No,No
Jesse Lopez,72,9,57,27,21,15,236.0,9,3,9.0,48,24,15.8,No,2014,No,No,No
Kyle McLeroy,17,11,12,4,7,6,64.0,10,3,7.0,2,1,17.4,No,2014,No,No,No
Tim Williams,1939,115,1309,759,599,419,3990.0,8,2,194.0,1301,757,23.4,No,2014,No,No,No
Isaiah Williams,1135,295,893,372,291,233,2971.0,422,158,177.0,471,214,21.3,No,2014,No,No,No
Raijon Kelly,1064,303,889,394,192,152,2795.0,341,124,213.0,548,270,23.6,No,2014,No,No,No
Tyler Hood,1161,128,898,409,241,175,2988.0,473,168,131.0,425,241,20.6,No,2014,No,No,No
Connor Miller,475,168,440,155,92,58,2471.0,302,107,122.0,138,48,13.5,No,2014,No,No,No
Jordan Capps,978,57,720,388,349,175,1926.0,77,27,149.0,643,361,27.1,No,2014,No,No,No
Brandon Roberts,313,49,294,115,58,42,760.0,140,41,58.0,154,74,25.9,No,2014,No,No,No
Russell Wilson,188,139,156,69,90,48,1193.0,16,2,130.0,140,67,15.1,No,2014,No,No,No
Michael Bradley,311,19,218,121,92,69,963.0,1,0,64.0,217,121,17.5,Yes,2014,No,No,No
Chris Longoria,251,56,233,82,81,63,859.0,96,24,66.0,137,58,21.1,No,2014,No,No,No
Brandon Hayman,244,28,206,113,50,16,846.0,15,2,41.0,191,111,17.4,No,2014,No,No,No
Nnamdi Enechionyia,508,84,461,168,98,70,2178.0,291,102,88.0,170,66,14.8,No,2014,No,No,No
Emeka Ikezu,17,1,12,7,10,3,115.0,0,0,9.0,12,7,11.6,No,2014,No,No,No
Hamilton Bailey,4,1,3,0,5,4,44.0,2,0,0.0,1,0,6.5,No,2014,No,No,No
Eric Adams,443,33,267,167,157,109,1211.0,1,0,79.0,266,167,17.4,No,2014,No,No,No
Tony Thompson,0,0,2,0,0,0,7.0,0,0,1.0,2,0,23.1,No,2014,No,No,No
Xavier Thames,1374,354,1080,427,488,397,3581.0,353,123,211.0,727,304,22.0,No,2014,No,No,No
Winston Shepard,1403,315,1165,467,653,428,3583.0,169,41,308.0,996,426,26.1,No,2014,No,No,No
Dwayne Polee II,654,52,541,234,173,119,1737.0,200,67,87.0,341,167,21.5,No,2014,No,No,No
J.J. O'Brien,1028,204,882,415,298,179,3686.0,77,19,189.0,805,396,17.3,No,2014,No,No,No
Josh Davis,1305,176,1033,475,562,344,3675.0,30,11,229.0,1003,464,21.6,Yes,2014,No,No,No
Matt Shrigley,536,79,527,179,59,40,2003.0,420,138,65.0,107,41,16.3,No,2014,No,No,No
Skylar Spencer,546,45,389,226,204,94,3104.0,0,0,93.0,389,226,9.8,No,2014,No,No,No
Aqeel Quinn,772,172,683,250,203,154,2274.0,342,118,145.0,341,132,21.0,No,2014,No,No,No
Dakarai Allen,676,116,529,235,256,165,2476.0,155,41,128.0,374,194,16.3,No,2014,No,No,No
James Johnson,240,14,178,94,91,52,813.0,0,0,79.0,178,94,19.2,Yes,2014,No,No,No
D'Erryl Williams,101,52,91,38,36,19,717.0,16,6,39.0,75,32,10.7,No,2014,No,No,No
Niksha Federico,19,2,18,7,0,0,30.0,15,5,0.0,3,2,31.3,No,2014,No,No,No
Kibret Woldemichael,17,4,7,5,4,2,32.0,7,5,5.0,0,0,23.2,No,2014,No,No,No
Desmond Maxwell,8,2,7,3,0,0,9.0,4,2,0.0,3,1,40.4,No,2014,No,No,No
Ryan Staten,11,3,18,5,5,1,43.0,2,0,1.0,16,5,26.1,No,2014,No,No,No
Johnny Dee,2046,157,1542,666,419,381,4081.0,835,333,169.0,707,333,25.2,No,2014,No,No,No
Duda Sanadze,991,85,872,335,274,207,2125.0,386,114,156.0,486,221,29.2,No,2014,No,No,No
Dennis Kramer,865,61,693,344,174,116,2409.0,186,61,156.0,507,283,20.8,No,2014,No,No,No
Christopher Anderson,1181,757,935,390,462,300,4108.0,271,101,365.0,664,289,19.9,No,2014,No,No,No
Jito Kok,645,52,475,234,312,177,2935.0,2,0,188.0,473,234,14.8,No,2014,No,No,No
Brett Bailey,876,114,751,306,307,204,2593.0,210,60,145.0,541,246,21.8,No,2014,No,No,No
Thomas Jacobs,378,35,289,142,128,90,1493.0,18,4,64.0,271,138,14.7,No,2014,No,No,No
Chris Sarbaugh,365,180,287,133,130,88,1805.0,37,11,128.0,250,122,13.9,No,2014,No,No,No
Simi Fajemisin,319,19,221,109,167,101,1497.0,1,0,104.0,220,109,14.5,No,2014,No,No,No
Nick Kerr,63,6,57,21,5,3,171.0,45,18,7.0,12,3,20.8,No,2014,No,No,No
Therone Tillett,13,0,6,5,0,0,8.0,4,3,0.0,2,2,40.8,No,2014,No,No,No
Forrest Greenwalt,4,0,2,2,0,0,10.0,0,0,1.0,2,2,16.3,No,2014,No,No,No
Michael Marconi,2,1,3,1,0,0,12.0,2,0,1.0,1,1,18.1,No,2014,No,No,No
Mike Davis,257,55,226,98,90,51,849.0,45,10,42.0,181,88,18.6,Yes,2014,No,No,No
Cole Dickerson,1253,131,966,487,310,164,2852.0,304,115,191.0,662,372,23.8,No,2014,No,No,No
Avry Holmes,1259,251,912,377,368,288,3444.0,529,217,161.0,383,160,19.0,No,2014,No,No,No
Kruize Pinkins,849,78,595,298,350,220,1662.0,94,33,107.0,501,265,27.3,No,2014,No,No,No
Mark Tollefsen,1253,166,885,474,240,171,3309.0,356,134,102.0,529,340,17.3,No,2014,No,No,No
Tim Derksen,1434,197,1005,497,442,294,3355.0,358,146,179.0,647,351,21.2,No,2014,No,No,No
Matt Glover,537,249,473,168,298,161,2529.0,150,40,175.0,323,128,16.3,No,2014,No,No,No
Chris Adams,419,89,391,143,16,11,1853.0,325,122,54.0,66,21,12.8,No,2014,No,No,No
Cody Doolin,1217,579,966,416,328,253,4345.0,410,132,240.0,556,284,16.3,No,2014,No,No,No
Corey Hilliard,109,26,112,37,37,23,457.0,40,12,33.0,72,25,18.9,No,2014,No,No,No
Gavin Hoffmann,60,21,47,18,23,14,407.0,27,10,13.0,20,8,9.0,No,2014,No,No,No
Matt Christiansen,201,36,172,87,50,27,998.0,1,0,51.0,171,87,13.1,No,2014,No,No,No
Tao Xu,92,7,80,34,36,24,427.0,0,0,39.0,80,34,17.0,No,2014,No,No,No
Dominique Williams,5,1,4,2,0,0,13.0,2,1,1.0,2,1,20.2,No,2014,No,No,No
David Irby,3,0,1,1,0,0,9.0,1,1,0.0,0,0,5.9,No,2014,No,No,No
Rashad Muhammad,783,55,644,240,210,169,1744.0,354,134,90.0,290,106,25.7,No,2014,No,No,No
Jaleel Williams,699,59,626,252,142,88,1971.0,337,107,97.0,289,145,21.4,No,2014,No,No,No
Chris Cunningham,689,71,516,235,290,213,2235.0,20,6,189.0,496,229,19.2,No,2014,No,No,No
Devante Wilson,251,20,238,76,56,44,731.0,171,55,37.0,67,21,21.8,No,2014,No,No,No
Jalen James,675,274,639,226,188,143,2560.0,267,80,232.0,372,146,19.2,No,2014,No,No,No
D.J. Brown,898,347,748,256,311,231,3213.0,468,155,183.0,280,101,17.4,No,2014,No,No,No
Isaac Thornton,589,250,520,185,239,166,2629.0,184,53,210.0,336,132,16.6,No,2014,No,No,No
Brandon Mitchell,334,29,298,117,134,83,1452.0,65,17,84.0,233,100,16.1,No,2014,No,No,No
Dylan Alexander,69,15,60,25,12,7,218.0,37,12,8.0,23,13,17.9,No,2014,No,No,No
Matt Pollard,38,4,42,18,11,2,323.0,0,0,15.0,42,18,10.3,No,2014,No,No,No
Mike VanKirk,12,0,9,4,7,4,65.0,0,0,3.0,9,4,11.7,No,2014,No,No,No
Jared Brownridge,2313,322,1723,729,560,470,4519.0,956,385,208.0,767,344,26.7,No,2014,No,No,No
Brandon Clark,1549,410,1225,493,474,398,3437.0,486,165,240.0,739,328,26.3,No,2014,No,No,No
Evan Roquemore,1627,578,1258,469,600,484,4272.0,577,205,326.0,681,264,22.2,No,2014,No,No,No
Jerry Brown,789,75,552,272,409,244,2803.0,6,1,128.0,546,271,16.8,No,2014,No,No,No
Jalen Richard,172,58,160,57,62,40,802.0,69,18,46.0,91,39,15.8,No,2014,No,No,No
Nate Kratch,914,84,725,364,204,116,3111.0,183,70,119.0,542,294,16.8,No,2014,No,No,No
John McArthur,392,49,400,157,96,72,2059.0,29,6,75.0,371,151,12.9,No,2014,No,No,No
Yannick Atanga,295,18,230,112,140,71,1748.0,1,0,63.0,229,112,10.6,No,2014,No,No,No
Denzel Johnson,609,111,608,229,127,93,2055.0,187,58,78.0,421,171,19.5,No,2014,No,No,No
Julian Clarke,131,28,132,45,25,15,556.0,88,26,25.0,44,19,15.5,No,2014,No,No,No
Robert Garrett,145,8,114,59,65,27,773.0,0,0,32.0,114,59,11.7,No,2014,No,No,No
Andrew Papenfus,10,2,12,3,2,2,98.0,8,2,5.0,4,1,9.9,No,2014,No,No,No
Deven Williams,531,48,468,190,79,64,1003.0,239,87,76.0,229,103,30.7,No,2014,No,No,No
Joshua Montgomery,744,54,609,249,242,174,2163.0,250,72,116.0,359,177,20.4,No,2014,No,No,No
Jyles Smith,641,76,499,249,258,143,2984.0,7,0,200.0,492,249,14.5,No,2014,No,No,No
Jeremiah Hill,204,31,205,68,35,27,583.0,133,41,34.0,72,27,23.0,No,2014,No,No,No
Alante Fenner,914,141,775,313,290,210,2058.0,263,78,179.0,512,235,25.1,No,2014,No,No,No
Keierre Richards,366,99,342,110,175,127,2029.0,73,19,157.0,269,91,15.0,No,2014,No,No,No
Terel Hall,460,179,352,159,217,135,1559.0,34,7,138.0,318,152,19.8,No,2014,No,No,No
Khiry White,203,69,170,70,85,53,1121.0,44,10,111.0,126,60,15.2,No,2014,No,No,No
Saadiq Muhammad,305,15,247,118,136,69,1155.0,2,0,73.0,245,118,17.4,No,2014,No,No,No
Hikeem Champaigne,104,7,96,47,24,10,384.0,0,0,34.0,96,47,19.3,No,2014,No,No,No
Patrick Hendley,147,28,144,55,33,22,579.0,44,15,46.0,100,40,18.7,No,2014,No,No,No
Whitley Carter,38,14,37,12,8,7,206.0,20,7,13.0,17,5,13.6,No,2014,No,No,No
Stephen Wilson,236,66,243,72,89,63,999.0,109,29,80.0,134,43,19.2,No,2014,No,No,No
Javaris Jenkins,631,69,576,216,125,95,1673.0,335,104,78.0,241,112,19.9,No,2014,No,No,No
Angelo Davis,39,5,26,8,32,23,122.0,1,0,13.0,25,8,23.3,No,2014,No,No,No
Marcus Hutchins,43,6,30,11,28,20,188.0,11,1,15.0,19,10,17.2,No,2014,No,No,No
Isiah Umipig,1797,311,1411,582,345,285,3789.0,887,348,272.0,524,234,24.9,No,2014,No,No,No
Jarell Flora,999,104,864,363,134,99,2650.0,463,174,155.0,401,189,21.1,No,2014,No,No,No
Clarence Trent,815,97,702,300,236,158,1952.0,212,57,196.0,490,243,24.3,No,2014,No,No,No
D'Vonne Pickett,422,198,371,166,145,82,1371.0,42,8,133.0,329,158,20.1,No,2014,No,No,No
Deshaun Sunderhaus,527,43,411,213,139,94,1204.0,23,7,95.0,388,206,23.1,No,2014,No,No,No
Shore Adenekan,266,17,182,102,112,62,965.0,0,0,53.0,182,102,15.4,No,2014,No,No,No
Jack Crook,770,148,652,306,255,156,2739.0,11,2,212.0,641,304,18.5,No,2014,No,No,No
Emerson Murray,266,155,250,86,98,55,1597.0,141,39,109.0,109,47,13.2,No,2014,No,No,No
William Powell,952,257,654,327,471,298,3178.0,7,0,286.0,647,327,19.2,No,2014,No,No,No
Luiz Bidart,129,42,98,36,41,32,651.0,71,25,38.0,27,11,11.5,No,2014,No,No,No
Emmanuel Chibuogwu,459,127,396,162,142,85,2125.0,164,50,112.0,232,112,14.0,No,2014,No,No,No
David Trimble,19,17,20,7,12,5,123.0,1,0,10.0,19,7,14.0,No,2014,No,No,No
Sterling Gibbs,1413,349,997,411,522,393,3358.0,501,198,209.0,496,213,22.7,No,2014,No,No,No
Fuquan Edwin,1633,182,1358,606,366,249,3847.0,472,172,235.0,886,434,24.1,No,2014,No,No,No
Brian Oliver,1018,120,927,350,114,92,2687.0,617,226,152.0,310,124,21.5,Yes,2014,No,No,No
Gene Teague,1034,101,658,388,452,258,2593.0,0,0,240.0,658,388,22.9,No,2014,No,No,No
Patrik Auda,604,96,415,212,203,142,1970.0,111,38,103.0,304,174,16.4,No,2014,No,No,No
Brandon Mobley,890,77,715,313,217,171,2529.0,274,93,122.0,441,220,19.5,No,2014,No,No,No
Jaren Sina,680,247,578,197,183,147,2750.0,392,139,133.0,186,58,15.1,No,2014,No,No,No
Stephane Manga,132,18,112,51,52,27,492.0,12,3,45.0,100,48,19.4,No,2014,No,No,No
Aaron Geramipoor,126,6,104,55,45,16,783.0,0,0,34.0,104,55,10.7,No,2014,No,No,No
Haralds Karlis,336,85,293,108,83,56,1806.0,208,64,78.0,85,44,11.9,No,2014,No,No,No
Tom Maayan,82,128,83,30,29,12,864.0,35,10,115.0,48,20,13.1,No,2014,No,No,No
Hakeem Harris,5,0,4,2,0,0,26.0,2,1,0.0,2,1,8.3,No,2014,No,No,No
Travis Berry,0,3,3,0,0,0,43.0,1,0,2.0,2,0,5.9,No,2014,No,No,No
Kevin Lynch,0,0,1,0,0,0,7.0,1,0,0.0,0,0,7.7,Yes,2014,No,No,No
Rob Poole,1493,218,1208,469,441,340,4051.0,610,215,207.0,598,254,20.4,No,2014,No,No,No
Brett Bisping,1528,151,1116,532,477,368,3750.0,274,96,235.0,842,436,20.4,No,2014,No,No,No
Lavon Long,1379,281,1016,479,533,394,3729.0,81,27,313.0,935,452,20.7,No,2014,No,No,No
Marquis Wright,1546,614,1295,544,496,359,4251.0,293,99,354.0,1002,445,21.6,No,2014,No,No,No
Evan Hymes,1338,361,1138,422,403,314,3554.0,527,180,341.0,611,242,24.2,No,2014,No,No,No
Ryan Oliver,684,125,583,236,112,76,2410.0,368,136,98.0,215,100,15.0,No,2014,No,No,No
Maurice White,223,26,244,73,113,76,704.0,17,1,59.0,227,72,25.2,No,2014,No,No,No
Imoh Silas,267,38,225,118,69,31,1243.0,0,0,102.0,225,118,14.7,No,2014,No,No,No
Michael Wolfe,85,8,60,27,37,28,241.0,16,3,8.0,44,24,17.6,No,2014,No,No,No
Javion Ogunyemi,1327,107,951,499,508,317,3313.0,43,12,185.0,908,487,20.1,No,2014,No,No,No
Rich Audu,93,14,100,30,18,16,467.0,50,17,33.0,50,13,16.0,No,2014,No,No,No
Steven Cruz,11,2,7,3,7,4,27.0,3,1,7.0,4,2,32.6,No,2014,No,No,No
Mike Wilson,6,0,6,3,0,0,27.0,2,0,1.0,4,3,13.0,Yes,2014,No,No,No
Augustine Rubit,1917,125,1359,673,763,550,3756.0,75,21,269.0,1284,652,26.2,No,2014,No,No,No
Antoine Allen,652,94,613,202,177,130,1797.0,368,118,128.0,245,84,22.9,No,2014,No,No,No
Mychal Ammons,901,108,724,312,319,209,2496.0,185,68,187.0,539,244,21.2,No,2014,No,No,No
Ken Williams,1725,343,1508,553,464,366,3847.0,778,253,269.0,730,300,25.9,No,2014,No,No,No
Barrington Stevens III,758,300,690,259,179,130,3481.0,317,110,198.0,373,149,13.9,No,2014,No,No,No
Aakim Saintil,586,203,471,167,254,199,1611.0,200,53,135.0,271,114,21.8,No,2014,No,No,No
Dionte Ferguson,525,27,337,178,250,169,1453.0,2,0,113.0,335,178,19.9,No,2014,No,No,No
Georgi Boyanov,858,60,585,300,323,208,2226.0,143,50,130.0,442,250,19.3,No,2014,No,No,No
T.J. Johnson,51,9,47,19,7,5,190.0,22,8,9.0,25,11,15.9,No,2014,No,No,No
Isaiah Maston,51,9,44,18,2,1,257.0,35,14,8.0,9,4,10.5,No,2014,No,No,No
Austin Karazsia,54,3,49,19,17,9,282.0,24,7,11.0,25,12,12.2,No,2014,No,No,No
Viktor Juricek,125,8,109,40,39,27,510.0,56,18,40.0,53,22,16.9,No,2014,No,No,No
E.J. Conley,0,1,1,0,0,0,16.0,0,0,1.0,1,0,6.4,No,2014,No,No,No
Matthew Hezekiah,763,37,591,326,158,111,1834.0,3,0,101.0,588,326,21.0,No,2014,No,No,No
Adama Adams,507,148,424,163,171,129,1462.0,166,52,164.0,258,111,23.0,No,2014,No,No,No
Darryl Palmer,968,122,901,391,264,159,3307.0,125,27,145.0,776,364,18.0,No,2014,No,No,No
Jalen White,353,114,316,120,139,97,1033.0,50,16,97.0,266,104,23.6,No,2014,No,No,No
Jordan Smith,173,13,178,59,21,18,419.0,126,37,24.0,52,22,25.3,No,2014,No,No,No
Karon Wright,387,30,404,128,52,37,918.0,297,94,62.0,107,34,27.4,No,2014,No,No,No
Devin Joint,366,94,382,150,94,45,1852.0,88,21,97.0,294,129,14.0,No,2014,No,No,No
Theron Stephens,127,22,141,41,19,16,371.0,93,29,17.0,48,12,22.3,No,2014,No,No,No
Patrick Kirksey,176,19,152,62,146,52,875.0,1,0,47.0,151,62,15.7,No,2014,No,No,No
Luka Radovic,345,23,307,135,100,65,1609.0,46,10,105.0,261,125,14.1,No,2014,No,No,No
Greg Mortimer,922,210,779,315,305,222,2582.0,224,70,192.0,555,245,21.9,No,2014,No,No,No
Darrion Eastmon,35,35,22,10,20,12,257.0,8,3,32.0,14,7,12.4,No,2014,No,No,No
Shaquiell Mitchell,184,44,227,60,93,47,867.0,69,17,79.0,158,43,20.3,No,2014,No,No,No
Patrick Myers,144,40,171,51,40,27,759.0,62,15,51.0,109,36,16.0,No,2014,No,No,No
Chasen Campbell,52,4,64,18,11,7,181.0,28,9,14.0,36,9,23.1,No,2014,No,No,No
Torrey Craig,2128,236,1808,747,502,337,4061.0,899,297,347.0,909,450,29.5,Yes,2014,No,No,No
Ricardo Glenn,1255,204,858,476,484,300,3046.0,13,3,213.0,845,473,21.3,No,2014,No,No,No
Ty Greene,1884,329,1447,590,548,419,4213.0,755,285,190.0,692,305,22.5,No,2014,No,No,No
Jodd Maxey,878,138,693,356,267,166,2693.0,5,0,164.0,688,356,18.1,No,2014,No,No,No
Fred Miller,889,346,836,322,207,153,2789.0,297,92,224.0,539,230,20.9,No,2014,No,No,No
Karim Mawuenyega,140,44,134,51,23,12,462.0,77,26,27.0,57,25,18.9,No,2014,No,No,No
Mario Blessing,556,293,534,194,85,55,3213.0,339,113,187.0,195,81,11.8,No,2014,No,No,No
Michael Buchanan,1286,109,909,527,423,231,2381.0,1,1,199.0,908,526,27.1,No,2014,No,No,No
ShunQuez Stephens,336,60,296,123,89,61,1203.0,115,29,62.0,181,94,17.0,No,2014,No,No,No
Babatunde Olomuwiya,588,75,423,236,222,115,2068.0,5,1,140.0,418,235,16.1,No,2014,No,No,No
Josh Cuthbertson,845,258,717,310,153,105,2612.0,371,120,151.0,346,190,17.8,No,2014,No,No,No
Brenton Williams,986,101,700,297,252,223,2005.0,410,169,97.0,290,128,23.1,No,2014,No,No,No
Sindarius Thornwell,1941,390,1521,596,739,570,4194.0,528,179,331.0,993,417,25.8,Yes,2014,No,No,No
Duane Notice,1409,353,1181,454,393,282,3989.0,599,219,236.0,582,235,19.8,No,2014,No,No,No
Michael Carrera,1143,86,860,368,462,330,2743.0,215,77,182.0,645,291,22.6,No,2014,No,No,No
Mindaugas Kacinas,879,82,618,328,280,188,3129.0,118,35,167.0,500,293,14.4,No,2014,No,No,No
Tyrone Johnson,601,234,507,182,241,195,1978.0,141,42,151.0,366,140,19.7,No,2014,No,No,No
Laimonas Chatkevicius,890,71,703,361,213,150,2234.0,65,18,167.0,638,343,21.4,No,2014,No,No,No
Demetrius Henry,430,39,354,176,141,77,1573.0,4,1,105.0,350,175,17.0,No,2014,No,No,No
Jaylen Shaw,1485,479,1176,528,357,276,3424.0,408,153,298.0,768,375,23.5,No,2014,No,No,No
Desmond Ringer,793,50,523,299,249,193,2517.0,5,2,163.0,518,297,16.8,No,2014,No,No,No
Brian Steele,99,27,110,34,12,8,476.0,79,23,18.0,31,11,14.2,No,2014,No,No,No
Bruce Ellington,893,238,957,322,184,123,2435.0,411,126,211.0,546,196,25.9,No,2014,No,No,No
Justin McKie,286,81,280,101,65,44,1193.0,135,40,45.0,145,61,14.7,No,2014,No,No,No
Reggie Theus Jr.,287,35,292,118,87,44,1131.0,22,7,53.0,270,111,17.5,No,2014,No,No,No
Austin Constable,0,0,4,0,0,0,12.0,2,0,1.0,2,0,20.8,No,2014,No,No,No
Jordan Dykstra,1661,190,1171,568,428,332,3595.0,434,193,202.0,737,375,22.9,No,2014,No,No,No
Brayden Carlson,1132,287,805,363,330,249,3835.0,405,157,191.0,400,206,15.8,No,2014,No,No,No
Cody Larson,921,129,667,337,342,243,2073.0,16,4,148.0,651,333,24.7,No,2014,No,No,No
Chad White,1169,203,852,389,242,176,3445.0,526,215,169.0,326,174,17.2,No,2014,No,No,No
Jake Bittle,829,225,630,289,226,174,2674.0,223,77,180.0,407,212,17.8,No,2014,No,No,No
Marcus Heemstra,414,83,309,162,123,87,1377.0,8,3,85.0,301,159,17.3,No,2014,No,No,No
Anders Broman,795,134,593,246,185,149,2190.0,399,154,78.0,194,92,17.3,No,2014,No,No,No
Zach Horstman,347,51,284,121,98,67,1198.0,121,38,41.0,163,83,16.3,No,2014,No,No,No
Connor Devine,160,15,102,57,91,46,646.0,0,0,26.0,102,57,13.6,No,2014,No,No,No
Cory Jacobsen,59,12,53,19,13,6,276.0,46,15,11.0,7,4,13.3,No,2014,No,No,No
Matt Donlan,738,97,598,251,102,87,2016.0,354,149,86.0,244,102,17.4,No,2014,No,No,No
Joshua White,240,44,227,90,36,23,757.0,122,37,32.0,105,53,18.3,No,2014,No,No,No
Brandon Bos,1200,223,959,376,355,303,2895.0,382,145,184.0,577,231,23.8,No,2014,No,No,No
Trevor Gruis,1340,191,920,512,486,316,3491.0,0,0,259.0,920,512,20.7,No,2014,No,No,No
Tyler Flack,952,65,711,370,238,178,2173.0,108,34,128.0,603,336,22.1,No,2014,No,No,No
Trey Norris,703,379,560,243,201,152,2961.0,181,65,188.0,379,178,14.6,No,2014,No,No,No
Adam Thoseby,332,36,311,111,92,69,920.0,141,41,56.0,170,70,23.7,No,2014,No,No,No
Casey Kasperbauer,1163,168,891,379,163,148,3378.0,610,257,101.0,281,122,16.3,No,2014,No,No,No
Karim Rowson,396,39,287,126,189,135,1163.0,36,9,80.0,251,117,20.9,No,2014,No,No,No
Tyler Larson,624,130,472,205,229,169,1633.0,121,45,104.0,351,160,21.8,No,2014,No,No,No
Tavian Pomlee,81,8,71,29,12,10,239.0,44,13,19.0,27,16,21.2,No,2014,No,No,No
Eric Robertson,566,39,490,214,159,118,1892.0,76,20,63.0,414,194,17.0,No,2014,No,No,No
Jack Foley,6,1,11,1,4,3,43.0,9,1,5.0,2,0,22.0,Yes,2014,No,No,No
Victor Rudd,1254,140,1103,435,355,261,3197.0,440,123,187.0,663,312,25.1,No,2014,No,No,No
Martino Brock,1230,208,1002,445,464,276,3342.0,216,64,227.0,786,381,22.2,No,2014,No,No,No
Corey Allen Jr.,721,159,587,249,204,161,1923.0,185,62,138.0,402,187,22.6,No,2014,No,No,No
Chris Perry,764,57,625,302,263,160,1803.0,7,0,126.0,618,302,25.1,No,2014,No,No,No
John Egbunu,816,31,533,302,387,211,2184.0,2,1,157.0,531,301,19.8,No,2014,No,No,No
Zach LeDay,1346,109,916,442,552,420,3029.0,134,42,152.0,782,400,22.7,No,2014,No,No,No
Javontae Hawkins,1169,107,893,406,351,274,2559.0,254,83,188.0,639,323,25.2,No,2014,No,No,No
Shemiye McLendon,446,129,461,156,113,82,1803.0,186,52,132.0,275,104,18.7,No,2014,No,No,No
Musa Abdul-Aleem,551,31,463,185,113,88,1136.0,274,93,64.0,189,92,26.6,No,2014,No,No,No
Anthony Collins,987,724,813,346,298,236,4374.0,156,59,344.0,657,287,16.2,No,2014,No,No,No
Josh Heath,444,384,411,161,140,101,2558.0,82,21,180.0,329,140,13.1,No,2014,No,No,No
Jordan Omogbehin,23,1,23,11,16,1,189.0,0,0,13.0,23,11,12.6,No,2014,No,No,No
Jarekious Bradley,1029,87,781,364,219,180,1771.0,342,121,107.0,439,243,27.6,No,2014,No,No,No
Tyler Stone,1568,125,1208,632,369,262,3029.0,137,42,152.0,1071,590,25.4,No,2014,No,No,No
Antonius Cleveland,1556,242,1184,585,529,324,3488.0,215,62,225.0,969,523,23.6,Yes,2014,No,No,No
Nino Johnson,988,117,661,369,434,248,2755.0,9,2,207.0,652,367,19.6,No,2014,No,No,No
Lucas Nutt,931,604,634,259,356,296,3576.0,312,117,272.0,322,142,15.2,No,2014,No,No,No
Darrian Gray,228,40,203,87,36,22,701.0,104,32,32.0,99,55,17.3,No,2014,No,No,No
Josh Langford,481,40,399,189,129,78,1396.0,74,25,108.0,325,164,20.5,No,2014,No,No,No
Jamaal Calvin,596,180,519,185,114,94,2232.0,371,132,104.0,148,53,15.0,No,2014,No,No,No
Paul McRoberts,77,15,56,31,13,6,228.0,24,9,9.0,32,22,15.0,No,2014,No,No,No
C.J. Reese,48,39,41,19,16,9,238.0,1,1,30.0,40,18,15.9,No,2014,No,No,No
Will Holifield,14,1,11,5,0,0,38.0,9,4,1.0,2,1,15.2,No,2014,No,No,No
Caleb Woods,32,4,26,11,10,6,64.0,10,4,1.0,16,7,24.5,No,2014,No,No,No
Kyle Stroder,11,0,8,4,2,0,20.0,4,3,1.0,4,1,23.9,No,2014,No,No,No
JaMichael Hawkins,787,80,698,256,166,134,2058.0,400,141,129.0,298,115,22.7,No,2014,No,No,No
Antonnio Benton,597,65,506,220,179,129,2025.0,112,28,132.0,394,192,18.8,No,2014,No,No,No
Dre Evans,617,165,516,212,112,79,2006.0,268,114,112.0,248,98,17.7,No,2014,No,No,No
Onochie Ochie,743,36,532,273,249,162,1795.0,95,35,123.0,437,238,22.5,No,2014,No,No,No
Devonte Upson,594,45,402,241,195,112,1846.0,1,0,97.0,401,241,16.7,No,2014,No,No,No
Joshua Filmore,1035,278,915,360,171,98,3435.0,609,217,140.0,306,143,16.9,No,2014,No,No,No
Julian Chiera,190,22,125,61,43,38,614.0,68,30,32.0,57,31,15.3,No,2014,No,No,No
Jeffery Ricard,444,88,401,153,142,108,1470.0,113,30,113.0,288,123,20.8,No,2014,No,No,No
Quin Cooper,190,27,186,64,58,42,618.0,79,20,37.0,107,44,20.7,No,2014,No,No,No
Jeremy Campbell,316,55,303,115,132,78,1290.0,42,8,79.0,261,107,18.0,No,2014,No,No,No
Forrest Johnson,7,1,3,1,8,5,51.0,0,0,1.0,3,1,8.1,No,2014,No,No,No
Antonio Evans,5,2,3,2,0,0,13.0,1,1,0.0,2,1,12.2,No,2014,No,No,No
Byron Wesley,1569,273,1273,583,516,345,4179.0,170,58,251.0,1103,525,22.4,No,2014,No,No,No
Pe'Shon Howard,721,410,631,230,223,169,2833.0,305,92,252.0,326,138,17.2,No,2014,No,No,No
Omar Oraby,698,33,444,267,256,164,1644.0,0,0,132.0,444,267,21.5,No,2014,No,No,No
Nikola Jovanovic,1063,43,783,406,347,233,2440.0,59,18,162.0,724,388,22.2,No,2014,No,No,No
JT Terrell,951,99,858,317,226,171,2220.0,437,146,166.0,421,171,25.7,No,2014,No,No,No
Julian Jacobs,842,397,661,307,263,186,2730.0,136,42,254.0,525,265,18.5,No,2014,No,No,No
Roschon Prince,945,98,664,319,448,307,2514.0,11,0,146.0,653,319,19.6,No,2014,No,No,No
DJ Haley,315,17,247,135,110,45,1561.0,0,0,63.0,247,135,11.7,No,2014,No,No,No
Strahinja Gavrilovic,248,8,200,86,105,68,773.0,30,8,41.0,170,78,18.6,No,2014,No,No,No
Kahlil Dukes,1294,254,983,427,287,261,2498.0,435,179,175.0,548,248,24.4,No,2014,No,No,No
Chass Bryan,101,79,105,34,49,26,666.0,25,7,48.0,80,27,13.4,No,2014,No,No,No
Brendyn Taylor,113,34,102,39,46,22,539.0,45,13,25.0,57,26,14.5,No,2014,No,No,No
Devon Pflueger,9,0,8,3,2,1,22.0,3,2,0.0,5,1,20.2,No,2014,No,No,No
Samer Dhillon,7,0,8,3,0,0,27.0,2,1,1.0,6,2,16.4,No,2014,No,No,No
Daniel Munoz,5,8,12,1,2,2,123.0,12,1,15.0,0,0,13.0,No,2014,No,No,No
Donivine Stewart,796,367,673,283,218,141,2861.0,261,89,150.0,412,194,16.3,No,2014,No,No,No
Keaton Jackson,510,26,313,202,161,104,1132.0,3,2,82.0,310,200,21.3,No,2014,No,No,No
Kris Davis,1305,278,1015,450,338,223,3493.0,418,182,263.0,597,268,21.3,No,2014,No,No,No
Rozell Nunn,487,72,395,173,128,94,1348.0,122,47,102.0,273,126,21.2,No,2014,No,No,No
Maurice Wiltz,462,79,347,138,143,105,1291.0,199,81,77.0,148,57,19.6,No,2014,No,No,No
Tim Johnson,579,99,524,214,135,96,1612.0,193,55,125.0,331,159,22.6,No,2014,No,No,No
Christian Salecich,509,164,457,169,122,88,2169.0,281,83,111.0,176,86,15.4,No,2014,No,No,No
Ray Lester,299,32,245,109,185,81,1216.0,2,0,103.0,243,109,18.2,No,2014,No,No,No
Michael Messer,887,149,688,307,258,184,2641.0,235,89,155.0,453,218,18.9,No,2014,No,No,No
Grant Fiorentinos,286,23,227,107,109,71,938.0,3,1,56.0,224,106,18.2,No,2014,No,No,No
Cameron Craig,26,18,29,9,9,7,176.0,9,1,22.0,20,8,16.0,No,2014,No,No,No
Keaton Scheer,3,1,3,1,0,0,9.0,2,1,1.0,1,0,22.6,No,2014,No,No,No
Akintoye Okunrinboye,2,0,2,1,1,0,4.0,1,0,0.0,1,1,31.4,No,2014,No,No,No
Desmar Jackson,1884,251,1442,665,625,460,3545.0,333,94,369.0,1109,571,31.1,No,2014,No,No,No
Anthony Beane,1917,189,1563,679,474,366,4272.0,537,193,255.0,1026,486,25.4,No,2014,No,No,No
Jalen Pendleton,643,121,510,227,283,173,1771.0,63,16,113.0,447,211,23.3,No,2014,No,No,No
Sean O'Brien,1244,244,1036,500,355,207,3754.0,150,37,255.0,886,463,20.3,No,2014,No,No,No
Tyler Smithpeters,750,185,563,217,236,169,2779.0,385,147,169.0,178,70,16.0,No,2014,No,No,No
Bola Olaniyan,573,63,417,214,232,145,2201.0,0,0,163.0,417,214,16.4,No,2014,No,No,No
Mike Balogun,78,10,68,24,15,13,214.0,57,17,5.0,11,7,20.1,No,2014,No,No,No
Davante Drinkard,232,26,224,92,100,48,1425.0,0,0,85.0,224,92,13.4,No,2014,No,No,No
Marcus Fillyaw,73,48,64,28,11,8,470.0,30,9,29.0,34,19,11.2,No,2014,No,No,No
Bronson Verhines,73,8,61,32,16,9,366.0,0,0,13.0,61,32,11.9,No,2014,No,No,No
Dawson Verhines,62,24,51,17,29,20,566.0,26,8,22.0,25,9,8.4,No,2014,No,No,No
Colby Long,26,8,28,9,3,1,128.0,21,7,12.0,7,2,17.5,No,2014,No,No,No
Ibby Djimde,126,17,113,51,43,24,643.0,0,0,41.0,113,51,14.3,No,2014,No,No,No
K.C. Goodwin,58,21,63,16,21,14,418.0,37,12,33.0,26,4,14.1,No,2014,No,No,No
Nic Moore,1811,643,1338,571,464,388,4363.0,678,281,319.0,660,290,22.7,No,2014,No,No,No
Markus Kennedy,1097,167,855,446,349,201,2579.0,14,4,185.0,841,442,24.2,No,2014,No,No,No
Nick Russell,951,293,852,339,251,196,2811.0,239,77,253.0,613,262,22.7,No,2014,No,No,No
Ben Moore,1214,242,852,459,445,295,3303.0,5,1,195.0,847,458,19.9,Yes,2014,No,No,No
Keith Frazier,734,95,615,258,120,92,1839.0,351,126,107.0,264,132,22.1,No,2014,No,No,No
Cannen Cunningham,802,106,603,314,234,166,2425.0,41,8,187.0,562,306,20.1,No,2014,No,No,No
Shawn Williams,606,110,520,234,144,81,2354.0,182,57,87.0,338,177,15.6,No,2014,No,No,No
Ryan Manuel,878,210,541,258,502,348,3083.0,43,14,177.0,498,244,16.8,No,2014,No,No,No
Sterling Brown,1110,294,782,394,252,194,3492.0,284,128,210.0,498,266,16.7,Yes,2014,No,No,No
Yanick Moreira,515,42,365,197,187,121,1138.0,0,0,84.0,365,197,25.2,No,2014,No,No,No
Crandall Head,57,33,73,22,14,9,348.0,26,4,34.0,47,18,17.2,No,2014,No,No,No
Jonathan Wilfong,29,6,34,13,3,1,165.0,13,2,12.0,21,11,15.0,No,2014,No,No,No
Kevin Dunleavy Jr.,4,0,9,2,3,0,38.0,6,0,5.0,3,2,21.6,No,2014,No,No,No
Jean-Micheal Mudiay,3,0,10,0,9,3,28.0,5,0,3.0,5,0,32.8,No,2014,No,No,No
Neil Watson,1157,473,823,329,393,335,3322.0,415,164,229.0,408,165,19.1,No,2014,No,No,No
Daveon Boardingham,684,36,421,242,299,200,1542.0,1,0,100.0,420,242,22.0,No,2014,No,No,No
Michael Craig,582,128,388,230,180,121,1277.0,7,1,124.0,381,229,23.9,No,2014,No,No,No
Aaron Brown,1131,144,866,364,359,250,2813.0,435,153,144.0,431,211,22.4,No,2014,No,No,No
Jerrold Brooks,729,172,646,251,122,91,2071.0,392,136,107.0,254,115,20.0,No,2014,No,No,No
Matt Bingaya,596,78,465,215,214,140,1420.0,99,26,108.0,366,189,25.8,No,2014,No,No,No
Jeremiah Eason,253,37,214,92,140,69,1155.0,3,0,67.0,211,92,15.8,No,2014,No,No,No
Chip Armelin,957,124,815,372,181,104,2356.0,333,109,128.0,482,263,23.5,No,2014,No,No,No
Deonte Houston,140,64,116,40,81,52,651.0,28,8,37.0,88,32,15.1,No,2014,No,No,No
Norville Carey,869,51,668,340,288,183,2076.0,23,6,161.0,645,334,23.4,No,2014,No,No,No
Ude Ifeanyichukwu,9,1,7,3,5,3,51.0,0,0,2.0,7,3,11.4,No,2014,No,No,No
Jamie Chapman,45,22,39,14,24,11,318.0,17,6,20.0,22,8,12.0,No,2014,No,No,No
Trey Kennedy,735,187,611,240,266,198,2109.0,181,57,168.0,430,183,23.0,No,2014,No,No,No
A.J. Hess,1115,115,870,353,225,192,3041.0,575,217,130.0,295,136,19.0,No,2014,No,No,No
Casey Oliverson,679,44,524,297,150,83,2025.0,7,2,96.0,517,295,18.2,No,2014,No,No,No
Jaren Jeffery,356,48,276,134,144,79,1315.0,30,9,68.0,246,125,17.0,No,2014,No,No,No
John Marshall,664,282,471,190,337,250,2605.0,100,34,161.0,371,156,15.5,No,2014,No,No,No
Juwan Major,428,109,370,162,154,98,1810.0,28,6,162.0,342,156,17.9,No,2014,No,No,No
Race Parsons,596,91,506,190,129,98,1857.0,344,118,83.0,162,72,18.2,No,2014,No,No,No
Cal Hanks,354,21,278,121,178,112,1098.0,1,0,92.0,277,121,21.6,No,2014,No,No,No
Jayson Cheesman,304,40,298,113,128,78,1001.0,0,0,83.0,298,113,22.5,No,2014,No,No,No
Eric Rippetoe,66,5,54,23,13,8,184.0,30,12,12.0,24,11,21.3,No,2014,No,No,No
Chris Nsenki,126,56,164,46,15,12,799.0,89,22,51.0,75,24,14.4,No,2014,No,No,No
McKay Anderson,48,11,44,19,2,1,227.0,19,9,10.0,25,10,13.1,No,2014,No,No,No
Drake Thomas,12,22,25,5,6,1,198.0,6,1,14.0,19,4,11.0,No,2014,No,No,No
Taylor Jenson,9,1,10,3,0,0,26.0,9,3,1.0,1,0,23.0,No,2014,No,No,No
Malcolm Miller,920,68,685,326,134,98,1766.0,404,170,74.0,281,156,24.2,Yes,2014,No,No,No
Calvin Godfrey,708,52,506,267,268,174,1855.0,1,0,99.0,505,267,19.7,No,2014,No,No,No
Yondarius Johnson,694,70,576,243,223,133,1879.0,233,75,109.0,343,168,21.5,No,2014,No,No,No
Tre Lynch,748,85,615,253,194,145,1534.0,293,97,93.0,322,156,26.3,No,2014,No,No,No
Trelun Banks,1407,423,1325,466,484,320,4173.0,485,155,347.0,840,311,22.8,No,2014,No,No,No
Javan Mitchell,628,54,504,236,251,156,1893.0,1,0,130.0,503,236,20.7,No,2014,No,No,No
Damian Goodwin,244,46,228,87,117,60,783.0,50,10,52.0,178,77,21.5,No,2014,No,No,No
Bryce Clark,104,11,114,39,37,23,356.0,33,3,26.0,81,36,22.5,No,2014,No,No,No
Cameron Monroe,336,100,331,123,131,81,1678.0,42,9,141.0,289,114,16.8,No,2014,No,No,No
Frank Snow,218,11,159,79,106,60,745.0,0,0,49.0,159,79,17.8,No,2014,No,No,No
Christopher Hyder,599,476,456,204,241,173,3321.0,74,18,174.0,382,186,11.5,No,2014,No,No,No
Mike Harrell,67,72,93,24,28,17,646.0,17,2,47.0,76,22,12.1,No,2014,No,No,No
Matthew Wright,1073,292,890,352,254,213,3111.0,468,156,210.0,422,196,20.0,No,2014,No,No,No
Charlon Kloof,751,310,550,236,303,217,2504.0,193,62,173.0,357,174,17.5,No,2014,No,No,No
Youssou Ndoye,971,58,660,335,447,301,2765.0,1,0,233.0,659,335,20.4,No,2014,No,No,No
Dion Wright,1263,102,1020,509,280,214,3042.0,101,31,120.0,919,478,21.1,No,2014,No,No,No
Marquise Simmons,617,46,457,249,196,118,2019.0,3,1,105.0,454,248,16.5,No,2014,No,No,No
Jordan Gathers,547,180,481,189,119,86,2054.0,239,83,111.0,242,106,15.9,No,2014,No,No,No
Andell Cumberbatch,566,106,496,205,144,96,1705.0,175,60,102.0,321,145,19.8,No,2014,No,No,No
Chris Dees,87,9,98,41,13,5,566.0,1,0,17.0,97,41,10.8,No,2014,No,No,No
Denzel Gregg,816,90,658,312,282,176,2390.0,65,16,149.0,593,296,19.5,No,2014,No,No,No
Xavier Smith,10,1,14,4,7,2,94.0,2,0,2.0,12,4,10.4,No,2014,No,No,No
Jean Yves Toupane,18,1,17,6,6,3,42.0,13,3,1.0,4,3,25.2,No,2014,No,No,No
Danny Farrell,3,0,7,1,2,0,12.0,4,1,4.0,3,0,50.7,No,2014,No,No,No
Matthias Runs,0,1,1,0,0,0,5.0,0,0,0.0,1,0,9.9,No,2014,No,No,No
Jalen Cannon,1720,115,1198,629,613,416,3789.0,153,46,162.0,1045,583,21.8,No,2014,No,No,No
Ben Mockford,1077,96,927,355,137,107,2752.0,688,260,97.0,239,95,19.8,No,2014,No,No,No
Brent Jones,1142,616,985,380,399,286,3306.0,309,96,370.0,676,284,23.3,No,2014,No,No,No
Wayne Martin,983,44,744,389,313,195,2246.0,45,10,201.0,699,379,24.3,No,2014,No,No,No
Sheldon Hagigal,199,25,171,67,57,43,465.0,73,22,44.0,98,45,26.5,No,2014,No,No,No
Amdy Fall,534,50,369,171,288,192,2001.0,0,0,121.0,369,171,15.8,No,2014,No,No,No
Anthony White,186,66,202,73,36,30,857.0,57,10,49.0,145,63,15.8,No,2014,No,No,No
Kevin Douglas,462,41,404,169,109,71,1488.0,173,53,97.0,231,116,18.5,No,2014,No,No,No
Lowell Ulmer,264,50,239,97,109,56,1137.0,58,14,65.0,181,83,15.7,No,2014,No,No,No
Aleksandar Isailovic,181,25,202,61,20,16,888.0,159,43,28.0,43,18,13.5,No,2014,No,No,No
Matt Milk,215,22,176,93,47,29,1083.0,0,0,50.0,176,93,11.4,No,2014,No,No,No
Yunus Hopkinson,856,196,852,264,222,174,2290.0,512,154,178.0,340,110,24.8,No,2014,No,No,No
PJ Santavenere,195,21,186,68,33,25,644.0,124,34,27.0,62,34,17.6,No,2014,No,No,No
Edon Molic,5,0,8,2,0,0,9.0,7,1,1.0,1,1,50.1,No,2014,No,No,No
D'Angelo Harrison,2178,253,1686,660,732,594,4311.0,743,264,231.0,943,396,26.7,No,2014,No,No,No
JaKarr Sampson,915,74,816,383,244,148,1997.0,13,1,118.0,803,382,26.7,Yes,2014,No,No,No
Rysheed Jordan,718,183,569,243,261,172,1713.0,179,60,158.0,390,183,25.5,No,2014,No,No,No
Phil Greene,1243,281,1262,491,175,123,4041.0,424,138,154.0,838,353,18.9,No,2014,No,No,No
Orlando Sanchez,238,44,180,92,56,43,714.0,44,11,43.0,136,81,17.8,No,2014,No,No,No
Sir'Dominic Pointer,1078,299,852,406,360,245,3660.0,109,21,218.0,743,385,17.3,No,2014,No,No,No
Jamal Branch,436,198,392,170,107,74,1722.0,75,22,119.0,317,148,16.8,No,2014,No,No,No
Chris Obekpa,425,78,361,175,164,75,2318.0,1,0,112.0,360,175,12.1,No,2014,No,No,No
Max Hooper,651,33,490,208,38,33,1709.0,479,202,38.0,11,6,15.6,No,2014,No,No,No
God'sgift Achiuwa,379,10,255,138,167,102,1246.0,7,1,67.0,248,137,16.2,No,2014,No,No,No
Marc-Antoine Bourgault,107,9,107,37,5,4,349.0,87,29,12.0,20,8,17.6,No,2014,No,No,No
Felix Balamou,267,80,263,107,81,52,1085.0,7,1,70.0,256,106,16.7,No,2014,No,No,No
Khadim Ndiaye,2,0,5,1,0,0,37.0,0,0,1.0,5,1,8.3,No,2014,No,No,No
Christian Jones,609,77,532,252,178,104,1893.0,4,1,118.0,528,251,18.9,No,2014,No,No,No
Tyler Walston,0,0,0,0,0,0,8.0,0,0,0.0,0,0,0.0,No,2014,No,No,No
Chasson Randle,2375,354,1775,760,684,551,4791.0,787,304,324.0,988,456,25.9,Yes,2014,No,No,No
Dwight Powell,1465,240,1110,515,557,402,3569.0,114,33,283.0,996,482,23.8,Yes,2014,No,No,No
Anthony Brown,1562,231,1211,518,410,308,4200.0,541,218,228.0,670,300,20.1,Yes,2014,No,No,No
Josh Huestis,1019,113,870,392,277,169,3376.0,207,66,125.0,663,326,17.0,Yes,2014,No,No,No
Stefan Nastic,875,107,645,307,365,259,2182.0,8,2,162.0,637,305,23.3,No,2014,No,No,No
John Gage,513,31,415,169,72,60,1305.0,297,115,58.0,118,54,19.8,No,2014,No,No,No
Robbie Lemons,156,24,147,55,24,14,742.0,93,32,17.0,54,23,12.1,No,2014,No,No,No
Marcus Allen,847,171,709,309,289,184,2716.0,187,45,143.0,522,264,18.7,No,2014,No,No,No
Aaron Bright,1241,428,1027,386,326,271,3626.0,556,198,247.0,471,188,20.4,No,2014,No,No,No
Grant Verhoeven,250,27,192,90,92,60,1156.0,22,10,39.0,170,80,12.1,No,2014,No,No,No
Malcolm Allen,99,40,85,42,19,9,503.0,20,6,37.0,65,36,13.6,No,2014,No,No,No
Schuyler Rimmer,70,5,59,25,32,19,347.0,2,1,17.0,57,24,13.0,No,2014,No,No,No
Jack Ryan,14,2,7,5,4,3,46.0,2,1,2.0,5,4,12.1,No,2014,No,No,No
Wade Morgan,4,7,15,1,8,2,58.0,4,0,7.0,11,1,22.7,No,2014,No,No,No
Rosco Allen,811,105,641,255,283,202,2288.0,292,99,126.0,349,156,20.2,No,2014,No,No,No
Desmond Haymon,1159,191,896,376,408,269,3141.0,411,138,148.0,485,238,20.8,No,2014,No,No,No
Jacob Parker,1251,201,898,439,335,267,3090.0,261,106,160.0,637,333,20.3,No,2014,No,No,No
Thomas Walkup,1744,395,1114,633,577,438,3532.0,131,40,215.0,983,593,22.9,No,2014,No,No,No
Deshaunt Walker,473,49,441,169,51,41,957.0,281,94,37.0,160,75,27.1,No,2014,No,No,No
Nikola Gajic,380,71,278,133,96,67,955.0,126,47,60.0,152,86,20.7,No,2014,No,No,No
Trey Pinkney,358,422,266,97,212,141,2911.0,98,23,164.0,168,74,9.2,No,2014,No,No,No
Tanner Clayton,231,36,189,96,47,32,1002.0,17,7,32.0,172,89,12.3,No,2014,No,No,No
Connor Brooks,157,55,133,57,39,27,631.0,50,16,43.0,83,41,15.6,No,2014,No,No,No
Dallas Cameron,627,243,503,192,221,162,2672.0,257,81,138.0,246,111,13.9,No,2014,No,No,No
Justin Dotson,72,12,75,23,31,19,201.0,36,7,21.0,39,16,27.8,No,2014,No,No,No
Reed Westbrook,17,3,17,4,8,7,44.0,12,2,2.0,5,2,26.4,No,2014,No,No,No
Sharife Sergeant,14,1,12,4,13,6,66.0,0,0,4.0,12,4,17.1,No,2014,No,No,No
Jason Martin,11,2,11,4,2,2,50.0,7,1,3.0,4,3,15.1,No,2014,No,No,No
Patrick Costello,3,1,3,1,1,1,37.0,0,0,7.0,3,1,14.4,No,2014,No,No,No
Ben Brown-White,0,0,1,0,0,0,27.0,0,0,4.0,1,0,9.4,No,2014,No,No,No
Willie Green,888,125,645,337,294,198,2282.0,65,16,136.0,580,321,20.8,Yes,2014,No,No,No
Kentwan Smith,780,92,587,298,215,138,1900.0,157,46,152.0,430,252,23.4,No,2014,No,No,No
Raymone Andrews,689,285,554,200,299,211,2911.0,234,78,175.0,320,122,15.3,No,2014,No,No,No
Brian Pegg,1088,116,855,446,361,190,2936.0,25,6,209.0,830,440,21.3,No,2014,No,No,No
Aaron Graham,1125,200,937,348,284,223,3007.0,599,206,238.0,338,142,22.1,No,2014,No,No,No
Hunter Miller,425,256,391,131,149,106,2236.0,187,57,188.0,204,74,14.8,No,2014,No,No,No
B.J. Glasford,752,142,750,285,133,86,2338.0,319,96,132.0,431,189,20.2,No,2014,No,No,No
Kyle Sikora,215,7,154,88,84,39,1217.0,0,0,72.0,154,88,11.4,No,2014,No,No,No
Glenn Baral,70,12,90,25,5,3,320.0,63,17,10.0,27,8,17.4,No,2014,No,No,No
Raekwon Harney,25,11,26,10,3,1,110.0,7,4,13.0,19,6,20.0,No,2014,No,No,No
Leke Solanke,32,6,23,12,14,8,265.0,3,0,13.0,20,12,8.4,No,2014,No,No,No
Tanner Plemmons,51,4,39,18,0,0,94.0,34,15,6.0,5,3,24.7,No,2014,No,No,No
Aidan Hadley,0,0,0,0,0,0,2.0,0,0,0.0,0,0,0.0,No,2014,No,No,No
Jameel Warney,2132,220,1482,884,615,364,4140.0,0,0,184.0,1482,884,24.2,Yes,2014,No,No,No
Carson Puriefoy,1572,345,1242,494,517,398,3651.0,503,186,296.0,739,308,24.9,No,2014,No,No,No
Anthony Jackson,1048,177,876,357,185,164,2578.0,463,170,200.0,413,187,23.6,No,2014,No,No,No
Dave Coley,1228,198,1136,418,382,289,3373.0,312,103,256.0,824,315,24.5,No,2014,No,No,No
Eric McAlister,499,47,398,200,119,85,1867.0,49,14,71.0,349,186,14.7,No,2014,No,No,No
Ahmad Walker,574,209,455,195,255,167,1779.0,87,17,165.0,368,178,20.9,No,2014,No,No,No
Rayshaun McGrew,731,80,639,309,201,113,2087.0,5,0,110.0,634,309,20.5,No,2014,No,No,No
Scott King,349,43,305,125,48,34,1028.0,186,65,50.0,119,60,18.9,No,2014,No,No,No
Anthony Mayo,202,18,210,78,66,46,1069.0,0,0,42.0,210,78,14.0,No,2014,No,No,No
Kameron Mitchell,285,84,256,94,69,44,1666.0,150,53,72.0,106,41,11.1,No,2014,No,No,No
Chris Braley,62,14,64,23,11,6,355.0,38,10,20.0,26,13,12.9,No,2014,No,No,No
Ryan Burnett,45,10,47,17,8,5,174.0,25,6,8.0,22,11,17.4,No,2014,No,No,No
Ben Resner,27,15,25,6,20,14,115.0,7,1,26.0,18,5,27.4,No,2014,No,No,No
C.J. Fair,1660,119,1367,631,466,337,4251.0,178,61,204.0,1189,570,22.0,No,2014,No,No,No
Tyler Ennis,440,187,360,148,149,114,1215.0,85,30,58.0,275,118,21.9,Yes,2014,No,No,No
Trevor Cooney,1437,211,1285,466,281,224,4034.0,835,281,145.0,450,185,20.2,No,2014,No,No,No
Jerami Grant,541,62,385,187,251,161,1577.0,20,6,63.0,365,181,19.1,Yes,2014,No,No,No
Rakeem Christmas,1046,86,731,409,335,228,3126.0,1,0,162.0,730,409,17.4,Yes,2014,No,No,No
Michael Gbinije,1177,310,900,409,313,200,3061.0,411,159,194.0,489,250,21.1,Yes,2014,No,No,No
Baye Moussa Keita,364,25,237,142,138,80,2110.0,0,0,78.0,237,142,9.3,No,2014,No,No,No
DaJuan Coleman,448,25,327,169,198,110,1388.0,1,0,98.0,326,169,19.3,No,2014,No,No,No
Tyler Roberson,779,130,647,317,252,145,2797.0,10,0,134.0,637,317,16.6,No,2014,No,No,No
Ron Patterson,709,172,645,260,85,50,2052.0,397,139,107.0,248,121,19.2,No,2014,No,No,No
B.J. Johnson,1188,62,947,403,300,253,2317.0,385,129,157.0,562,274,27.7,No,2014,No,No,No
Nolan Hart,3,3,13,1,3,1,25.0,9,0,6.0,4,1,42.0,No,2014,No,No,No
Russ DeRemer,0,0,5,0,0,0,26.0,3,0,2.0,2,0,14.0,No,2014,No,No,No
Albert Nassar,5,0,5,2,0,0,11.0,2,1,0.0,3,1,24.1,No,2014,No,No,No
Dalton Pepper,843,122,756,305,113,94,2123.0,400,139,93.0,356,166,21.3,No,2014,No,No,No
Will Cummings,1245,357,942,392,499,386,3144.0,270,75,193.0,672,317,22.2,No,2014,No,No,No
Quenton DeCosey,1513,251,1260,499,494,349,3574.0,477,166,206.0,783,333,24.3,No,2014,No,No,No
Anthony Lee,925,40,717,372,286,180,2438.0,5,1,119.0,712,371,20.1,No,2014,No,No,No
Mark Williams,540,109,536,197,145,98,1774.0,186,48,110.0,350,149,20.6,No,2014,No,No,No
Josh Brown,927,390,818,329,246,186,3858.0,227,83,172.0,591,246,14.8,No,2014,No,No,No
Devontae Watson,191,9,183,84,47,23,1009.0,0,0,32.0,183,84,12.0,No,2014,No,No,No
Daniel Dingle,757,220,659,246,269,168,2657.0,311,97,151.0,348,149,18.2,No,2014,No,No,No
Jimmy McDonnell,49,15,45,15,18,12,363.0,18,7,22.0,27,8,10.4,No,2014,No,No,No
Nick Pendergast,13,1,14,6,2,0,52.0,6,1,3.0,8,5,17.6,No,2014,No,No,No
Terence Smith,1171,293,877,370,380,306,3096.0,320,125,202.0,557,245,20.0,No,2014,No,No,No
Myles Taylor,1734,96,1128,588,705,534,3186.0,81,24,222.0,1047,564,26.5,No,2014,No,No,No
Marshun Newell,770,198,646,254,233,167,2033.0,264,95,153.0,382,159,23.2,No,2014,No,No,No
Mike Liabo,1524,247,1421,529,285,220,3092.0,723,246,243.0,698,283,29.0,No,2014,No,No,No
Dee Oldham,654,145,538,210,192,149,2119.0,251,85,100.0,287,125,17.1,No,2014,No,No,No
Justin Childs,446,86,417,164,122,89,1378.0,109,29,123.0,308,135,21.2,No,2014,No,No,No
Bobby Jones,236,15,230,76,60,37,634.0,148,47,32.0,82,29,22.4,Yes,2014,No,Yes,Yes
Javier Martinez,752,65,475,319,153,114,1924.0,0,0,95.0,475,319,16.8,No,2014,No,No,No
Tobias Dowdell,122,8,107,54,20,13,595.0,1,1,23.0,106,53,11.4,No,2014,No,No,No
Khristian Taylor,105,66,96,38,59,24,663.0,20,5,57.0,76,33,13.5,No,2014,No,No,No
DeMarc Richardson,58,57,57,21,27,15,566.0,8,1,42.0,49,20,9.6,No,2014,No,No,No
Chandler Rowe,301,87,203,101,147,87,1767.0,27,12,85.0,176,89,10.2,No,2014,No,No,No
Pierre Mopo,23,3,30,9,14,5,415.0,0,0,19.0,30,9,6.6,No,2014,No,No,No
Omari Minor,151,136,150,52,64,43,1418.0,18,4,104.0,132,48,10.1,No,2014,No,No,No
Patrick Miller,1900,520,1433,609,754,555,4451.0,392,127,375.0,1041,482,24.8,No,2014,No,No,No
M.J. Rhett,866,71,637,339,274,188,2968.0,1,0,196.0,636,339,16.4,No,2014,No,No,No
Jay Harris,721,161,636,238,214,145,2300.0,292,100,186.0,344,138,21.0,No,2014,No,No,No
Kennedy Eubanks,432,44,379,159,127,70,1331.0,160,44,71.0,219,115,18.6,No,2014,No,No,No
Jamonte Graham,117,35,112,41,35,24,438.0,43,11,31.0,69,30,18.6,No,2014,No,No,No
Jaleel Queary,182,64,171,72,85,37,981.0,5,1,73.0,166,71,14.7,No,2014,No,No,No
Jacquan Nobles,686,63,556,237,80,66,1730.0,363,146,109.0,193,91,20.6,No,2014,No,No,No
Chaed Wellian,83,4,60,33,4,3,265.0,34,14,13.0,26,19,14.4,No,2014,No,No,No
Jordan Gaither,100,25,105,34,31,16,492.0,66,16,28.0,39,18,15.2,No,2014,No,No,No
Ugo Mmonu,160,5,121,52,72,51,626.0,20,5,52.0,101,47,16.6,No,2014,No,No,No
Alex Bates,83,13,65,34,40,15,827.0,1,0,34.0,64,34,7.4,No,2014,No,No,No
Gerald Williams,22,2,24,7,10,8,86.0,11,0,1.0,13,7,17.7,No,2014,No,No,No
Michael Green,290,23,254,108,89,67,1343.0,40,7,68.0,214,101,13.8,No,2014,No,No,No
Cameron Johnson,0,0,1,0,0,0,2.0,1,0,1.0,0,0,51.1,Yes,2014,No,No,No
Dwan Caldwell,703,33,541,275,217,146,1611.0,19,7,115.0,522,268,23.2,No,2014,No,No,No
Dennis Ogbe,859,60,534,326,234,167,2116.0,125,40,129.0,409,286,18.2,No,2014,No,No,No
Jeremiah Samarrippas,1093,531,971,375,200,164,3947.0,515,179,352.0,456,196,19.4,No,2014,No,No,No
Josiah Moore,560,74,440,187,189,125,1426.0,179,61,104.0,261,126,22.0,No,2014,No,No,No
Ladon Carter,214,21,143,92,64,30,549.0,0,0,35.0,143,92,18.6,No,2014,No,No,No
Ty Allen,186,19,173,60,56,44,461.0,80,22,36.0,93,38,25.1,No,2014,No,No,No
Jordan Johnson,312,59,277,102,54,37,1016.0,195,71,56.0,82,31,17.3,No,2014,No,No,No
Javon McKay,513,111,378,171,199,146,2077.0,96,25,118.0,282,146,14.2,No,2014,No,No,No
Shirmane Thomas,642,231,584,212,262,163,2519.0,177,55,213.0,407,157,17.7,No,2014,No,No,No
Matt Marseille,490,47,381,170,188,113,1486.0,104,37,112.0,277,133,19.4,No,2014,No,No,No
DeOndre Haynes,117,42,110,39,53,37,445.0,15,2,41.0,95,37,19.5,No,2014,No,No,No
Anthony Morse,418,27,299,157,182,104,1479.0,2,0,78.0,297,157,15.7,No,2014,No,No,No
Ammanuel Diressa,85,16,90,28,18,12,375.0,67,17,21.0,23,11,16.1,No,2014,No,No,No
Mitchell Hill,59,17,57,18,15,11,350.0,38,12,16.0,19,6,11.6,No,2014,No,No,No
Jordan McRae,1521,209,1190,496,455,350,3088.0,522,179,225.0,668,317,27.8,Yes,2014,No,No,No
Jarnell Stokes,1129,129,776,411,489,307,2587.0,3,0,180.0,773,411,24.2,Yes,2014,No,No,No
Josh Richardson,1252,246,1005,458,314,238,3842.0,308,98,209.0,697,360,19.0,Yes,2014,No,No,No
Jeronne Maymon,852,86,568,306,374,240,2248.0,8,0,170.0,560,306,21.3,No,2014,No,No,No
Antonio Barton,936,218,743,317,226,151,2966.0,390,151,145.0,353,166,17.1,No,2014,No,No,No
Armani Moore,907,245,804,343,319,186,2892.0,131,35,200.0,673,308,20.5,No,2014,No,No,No
Darius Thompson,975,394,746,344,257,183,3309.0,308,104,165.0,438,240,16.6,No,2014,No,No,No
Robert Hubbs,1047,127,937,409,222,174,2826.0,197,55,102.0,740,354,20.1,No,2014,No,No,No
Derek Reese,408,71,352,143,113,75,1915.0,142,47,71.0,210,96,13.0,No,2014,No,No,No
A.J. Davis,1030,235,802,317,450,321,3213.0,249,75,232.0,553,242,20.2,No,2014,No,No,No
D'Montre Edwards,63,5,60,20,19,14,195.0,25,9,9.0,35,11,21.1,No,2014,No,No,No
Rawane Ndiaye,20,0,18,8,8,4,71.0,0,0,8.0,18,8,22.0,No,2014,No,No,No
Galen Campbell,7,0,6,3,1,1,21.0,2,0,0.0,4,3,16.2,No,2014,No,No,No
Quinton Chievous,891,93,666,335,313,173,2069.0,178,48,159.0,488,287,22.7,No,2014,No,No,No
Brandon Lopez,5,8,10,2,3,1,121.0,1,0,10.0,9,2,9.4,No,2014,No,No,No
Johnathan Jordan,1576,652,1145,492,827,559,4341.0,138,33,335.0,1007,459,23.1,No,2014,No,No,No
Jeff Beverly,931,61,803,334,288,213,2040.0,179,50,159.0,624,284,27.1,No,2014,No,No,No
Hameed Ali,983,363,963,341,251,191,3322.0,345,110,181.0,618,231,19.7,No,2014,No,No,No
Rashawn Thomas,2034,173,1348,737,802,539,3475.0,70,21,381.0,1278,716,31.0,No,2014,No,No,No
Joy Williamson,479,67,358,162,169,123,1593.0,100,32,95.0,258,130,18.0,No,2014,No,No,No
Zane Knowles,390,21,302,168,115,54,1307.0,1,0,80.0,301,168,17.8,No,2014,No,No,No
Brandon Pye,916,103,792,324,112,88,3049.0,449,180,83.0,343,144,15.9,No,2014,No,No,No
Jake Kocher,563,101,460,214,119,80,1977.0,187,55,86.0,273,159,15.6,No,2014,No,No,No
Cole Martinez,414,55,304,126,83,75,1225.0,233,87,36.0,71,39,16.1,No,2014,No,No,No
Jelani Currie,447,79,361,151,164,107,1842.0,107,38,87.0,254,113,14.8,No,2014,No,No,No
Dale Francis,197,12,197,78,14,8,1276.0,103,33,46.0,94,45,10.3,No,2014,No,No,No
James King,58,14,75,19,11,7,344.0,49,13,15.0,26,6,14.8,No,2014,No,No,No
Kevin Lynch,4,0,7,2,1,0,75.0,0,0,3.0,7,2,7.4,Yes,2014,No,No,No
Marcus Ellison,0,0,0,0,0,0,3.0,0,0,0.0,0,0,0.0,No,2014,No,No,No
Emmanuel Toney,424,172,351,144,126,87,2007.0,140,49,117.0,211,95,13.6,No,2014,No,No,No
Jamal Jones,463,45,416,151,104,78,970.0,229,83,55.0,187,68,29.2,No,2014,No,No,No
Kourtney Roberson,1077,96,718,435,359,207,3011.0,0,0,153.0,718,435,18.7,No,2014,No,No,No
Alex Caruso,1090,649,840,382,343,235,3933.0,268,91,346.0,572,291,18.1,Yes,2014,No,No,No
Jordan Green,630,184,507,224,195,135,2553.0,165,47,140.0,342,177,15.7,No,2014,No,No,No
Antwan Space,451,72,425,170,158,85,1619.0,111,26,104.0,314,144,19.5,No,2014,No,No,No
Fabyon Harris,572,94,437,195,130,105,1663.0,196,77,85.0,241,118,19.3,No,2014,No,No,No
Davonte Fitzgerald,715,36,671,264,179,108,1805.0,264,79,88.0,407,185,24.0,No,2014,No,No,No
Shawn Smith,154,35,156,51,60,40,600.0,56,12,23.0,100,39,18.8,No,2014,No,No,No
Tavario Miller,292,29,226,110,148,72,1298.0,2,0,81.0,224,110,14.9,No,2014,No,No,No
J-Mychal Reese,1034,279,879,363,291,217,2849.0,252,91,250.0,627,272,22.3,No,2014,No,No,No
Dylan Johns,103,16,79,46,24,11,663.0,0,0,43.0,79,46,10.0,No,2014,No,No,No
Blake McDonald,18,19,18,5,8,6,193.0,6,2,12.0,12,3,9.5,No,2014,No,No,No
Kyle Dobbins,25,11,16,7,24,11,55.0,1,0,10.0,15,7,35.0,No,2014,No,No,No
Don Thomas,1,0,3,0,2,1,9.0,3,0,2.0,0,0,36.0,No,2014,No,No,No
Payton Carrell,0,0,2,0,0,0,1.0,0,0,0.0,2,0,100.0,No,2014,No,No,No
Reger Dowell,813,116,647,267,215,161,1565.0,333,118,127.0,314,149,27.9,No,2014,No,No,No
Brandon Edwards,1078,75,705,387,341,252,3007.0,156,52,126.0,549,335,16.2,No,2014,No,No,No
Lonnie McClanahan,808,205,596,267,368,273,1618.0,10,1,192.0,586,266,29.1,No,2014,No,No,No
Jamel Outler,890,66,746,274,235,161,2250.0,520,181,126.0,226,93,21.6,No,2014,No,No,No
Vincent Dillard,113,6,100,36,60,30,342.0,39,11,30.0,61,25,22.6,No,2014,No,No,No
Anthony Walker,226,10,144,97,54,32,784.0,0,0,37.0,144,97,12.9,No,2014,No,No,No
Shaquille White-Miller,514,455,476,152,226,155,2745.0,182,55,294.0,294,97,15.6,No,2014,No,No,No
Brandon Williams,186,8,133,77,60,32,761.0,3,0,31.0,130,77,12.4,Yes,2014,No,No,No
Jorge Bilbao,727,122,541,275,281,175,2554.0,26,2,158.0,515,273,15.4,No,2014,No,No,No
Kyle McElvain,40,3,45,14,2,2,177.0,34,10,6.0,11,4,14.4,No,2014,No,No,No
Luke Davis,22,4,23,8,0,0,108.0,14,6,1.0,9,2,10.9,No,2014,No,No,No
Stuart Lagerson,69,10,60,27,30,15,590.0,1,0,25.0,59,27,8.0,No,2014,No,No,No
Courtney Austin,27,10,25,9,10,6,131.0,12,3,13.0,13,6,15.3,No,2014,No,No,No
Kyan Anderson,1624,480,1232,520,479,394,4126.0,529,190,328.0,703,330,22.8,No,2014,No,No,No
Jarvis Ray,413,69,397,162,135,80,1428.0,64,9,103.0,333,153,21.1,No,2014,No,No,No
Karviar Shepherd,855,96,718,313,326,222,2743.0,22,7,166.0,696,306,19.4,No,2014,No,No,No
Brandon Parrish,948,109,831,335,212,128,3284.0,409,150,138.0,422,185,16.6,No,2014,No,No,No
Amric Fields,1019,89,810,385,283,170,2496.0,241,79,134.0,569,306,22.3,No,2014,No,No,No
Christian Gore,174,43,135,46,85,59,760.0,65,23,41.0,70,23,15.2,No,2014,No,No,No
Michael Williams,314,123,293,103,96,66,1515.0,134,42,73.0,159,61,13.9,No,2014,No,No,No
Charles Hill Jr.,218,43,239,78,57,35,798.0,94,27,50.0,145,51,21.4,No,2014,No,No,No
Hudson Price,378,58,296,123,96,71,1497.0,165,61,71.0,131,62,13.9,No,2014,No,No,No
Thomas Montigel,36,7,37,10,16,13,312.0,19,3,7.0,18,7,8.9,No,2014,No,No,No
Clyde Smith III,31,21,44,11,13,6,282.0,13,3,22.0,31,8,14.1,No,2014,No,No,No
Kemal Dincer,5,1,11,2,2,1,28.0,5,0,1.0,6,2,25.1,No,2014,No,No,No
Julian Washburn,1526,274,1360,592,319,223,4448.0,349,119,213.0,1011,473,21.3,Yes,2014,No,No,No
Vince Hunter,911,98,611,330,409,247,1816.0,12,4,159.0,599,326,28.3,No,2014,No,No,No
John Bohannon,1204,194,800,455,444,290,3063.0,25,4,252.0,775,451,22.7,No,2014,No,No,No
C.J. Cooper,844,275,692,254,221,178,3008.0,460,158,157.0,232,96,17.2,No,2014,No,No,No
Cedrick Lang,938,118,573,333,453,272,3037.0,1,0,164.0,572,333,17.2,No,2014,No,No,No
Matt Willms,886,107,606,348,310,190,2475.0,3,0,188.0,603,348,20.1,No,2014,No,No,No
McKenzie Moore,360,81,253,114,133,102,911.0,84,30,89.0,169,84,24.7,No,2014,No,No,No
Justin Crosgile,516,147,485,168,113,81,1571.0,302,99,135.0,183,69,22.0,No,2014,No,No,No
Jake Flaggert,326,87,260,95,69,51,2066.0,232,85,50.0,28,10,8.6,No,2014,No,No,No
Jalen Ragland,167,26,196,53,33,29,666.0,126,32,19.0,70,21,19.4,No,2014,No,No,No
Tevin Caldwell,108,26,64,38,41,32,461.0,1,0,14.0,63,38,10.6,No,2014,No,No,No
Hooper Vint,439,43,341,181,104,64,1376.0,55,13,83.0,286,168,17.5,No,2014,No,No,No
Aaron Jones,6,6,7,2,4,2,48.0,0,0,9.0,7,2,19.8,No,2014,No,No,No
Victor Mbachu,11,2,7,2,10,7,36.0,1,0,2.0,6,2,19.4,No,2014,No,No,No
Tyler Tafoya,4,0,12,1,2,2,32.0,5,0,1.0,7,1,23.0,No,2014,No,No,No
Alvin Jones,0,0,0,0,0,0,5.0,0,0,0.0,0,0,0.0,Yes,2014,No,No,No
Darnell Vandivort,0,0,0,0,0,0,3.0,0,0,0.0,0,0,0.0,No,2014,No,No,No
Javorn Farrell,1046,287,956,368,354,255,2937.0,200,55,238.0,756,313,22.7,No,2014,No,No,No
Shaquille Boga,812,211,750,291,199,144,2067.0,267,86,124.0,483,205,24.5,No,2014,No,No,No
Shaquille Hines,1325,184,1112,542,310,194,3514.0,161,47,223.0,951,495,22.0,No,2014,No,No,No
Justin Leathers,429,66,384,152,121,88,1499.0,109,37,98.0,275,115,18.8,No,2014,No,No,No
Josh Cleveland,518,55,413,206,219,106,1809.0,0,0,112.0,413,206,18.2,No,2014,No,No,No
Hurley Johnson,188,29,171,65,67,36,667.0,83,22,42.0,88,43,19.1,No,2014,No,No,No
Alex Majewski,101,8,86,32,22,15,328.0,63,22,18.0,23,10,18.0,No,2014,No,No,No
Lauri Toivonen,198,54,154,74,78,49,1213.0,9,1,44.0,145,73,10.1,No,2014,No,No,No
Jamal Dantzler,137,29,119,51,59,25,609.0,28,10,39.0,91,41,16.0,No,2014,No,No,No
L.J. McIntosh,56,16,73,19,11,7,246.0,52,11,12.0,21,8,18.9,No,2014,No,No,No
Christian Hildebrandt,29,9,34,8,9,7,139.0,23,6,4.0,11,2,15.7,No,2014,No,No,No
Blake Provost,13,6,19,4,4,3,146.0,13,2,9.0,6,2,10.2,No,2014,No,No,No
Moe McDonald,372,131,319,110,153,109,1515.0,173,43,110.0,146,67,15.5,No,2014,No,No,No
Jacob Raspopovich,0,9,5,0,0,0,63.0,1,0,3.0,4,0,6.5,No,2014,No,No,No
Marcel Simon,0,1,1,0,0,0,4.0,1,0,1.0,0,0,25.8,No,2014,No,No,No
Devon Agusi,366,70,248,108,175,129,830.0,65,21,90.0,183,87,25.3,No,2014,No,No,No
Keon Lewis,801,159,578,220,361,300,1736.0,183,61,133.0,395,159,25.0,No,2014,No,No,No
Jordan Sims,620,79,549,204,97,55,2426.0,462,157,71.0,87,47,14.0,No,2014,No,No,No
Hyjii Thomas,434,77,342,133,196,133,1444.0,111,35,124.0,231,98,19.7,No,2014,No,No,No
Edrico McGregor,351,44,234,145,106,60,1250.0,1,1,104.0,233,144,15.8,No,2014,No,No,No
Phillip Jones,399,40,319,136,227,123,1198.0,18,4,111.0,301,132,22.0,No,2014,No,No,No
Kaj-Bjorn Sherman,470,37,279,151,220,168,1340.0,0,0,89.0,279,151,17.6,No,2014,No,No,No
James Williams,86,13,98,31,10,4,308.0,77,20,17.0,21,11,19.4,No,2014,No,No,No
George Matthews,158,13,160,60,28,19,466.0,86,19,44.0,74,41,23.5,No,2014,No,No,No
Tyler Wood,169,34,152,56,43,27,945.0,101,30,36.0,51,26,11.2,No,2014,No,No,No
Lucas O'Brien,509,37,423,187,114,83,1513.0,164,52,57.0,259,135,17.1,No,2014,No,No,No
Keith Benford,11,0,6,4,0,0,11.0,4,3,0.0,2,1,27.2,No,2014,No,No,No
Trey Moore,0,6,2,0,0,0,13.0,0,0,1.0,2,0,11.5,No,2014,No,No,No
Aaric Murray,1859,146,1422,679,555,405,3433.0,277,96,271.0,1145,583,27.9,No,2014,No,No,No
Jose Rodriguez,659,96,486,226,228,154,1496.0,128,53,112.0,358,173,23.7,No,2014,No,No,No
Madarious Gibbs,1186,469,904,404,474,311,3932.0,213,67,313.0,691,337,19.1,No,2014,No,No,No
D.D. Scarver,647,80,593,211,153,118,1511.0,346,107,86.0,247,104,24.4,No,2014,No,No,No
D'Angelo Scott,366,64,226,121,156,119,1440.0,28,5,102.0,198,116,14.2,No,2014,No,No,No
Lawrence Johnson-Danner,1109,134,913,362,187,155,3391.0,617,230,169.0,296,132,17.8,No,2014,No,No,No
Ray Penn,895,364,780,284,216,167,2792.0,452,160,217.0,328,124,20.4,No,2014,No,No,No
Aaron Clayborn,727,62,585,288,264,151,2489.0,5,0,154.0,580,288,17.8,No,2014,No,No,No
Tyree Bynum,181,26,181,64,25,16,858.0,115,37,29.0,66,27,13.0,No,2014,No,No,No
Vicktor Arnick,12,1,13,5,2,0,70.0,6,2,5.0,7,3,13.6,No,2014,No,No,No
Davonte Chaney,0,0,1,0,0,0,3.0,0,0,1.0,1,0,33.6,No,2014,No,No,No
Edward Chung,0,0,0,0,0,0,2.0,0,0,0.0,0,0,0.0,No,2014,No,No,No
Bobby Griffin,0,0,0,0,0,0,1.0,0,0,0.0,0,0,0.0,No,2014,No,No,No
Victor Haywood-Harris,0,0,0,0,0,0,7.0,0,0,0.0,0,0,0.0,No,2014,No,No,No
Christian McCoggle,12,2,13,3,14,6,128.0,0,0,3.0,13,3,9.1,No,2014,No,No,No
Eric Washington Jr.,4,0,3,1,4,2,13.0,1,0,0.0,2,1,18.7,No,2014,No,No,No
Joel Wright,1143,114,854,380,474,351,2001.0,115,32,266.0,739,348,34.3,No,2014,No,No,No
Emani Gant,1055,128,823,415,341,224,2448.0,3,1,180.0,820,414,25.6,No,2014,No,No,No
Wesley Davis,877,182,789,322,238,147,3016.0,295,86,148.0,494,236,17.8,No,2014,No,No,No
Phil Hawkins,427,145,379,137,135,104,1793.0,151,49,96.0,228,88,15.5,No,2014,No,No,No
Kavin Gilder-Tilbury,1385,182,1057,477,381,262,3345.0,451,169,232.0,606,308,23.6,No,2014,No,No,No
Reid Koenen,684,69,550,228,172,134,2007.0,290,94,123.0,260,134,18.6,No,2014,No,No,No
Corey Stern,354,42,264,123,166,99,1112.0,33,9,62.0,231,114,18.6,No,2014,No,No,No
Gordon Ball,162,23,132,70,35,22,486.0,5,0,43.0,127,70,19.8,No,2014,No,No,No
Naiel Smith,151,134,170,58,35,16,1106.0,67,19,90.0,103,39,13.4,No,2014,No,No,No
Ray Dorsey,88,38,74,29,43,22,505.0,26,8,22.0,48,21,12.0,No,2014,No,No,No
Kendell Ramlal,185,24,150,76,65,33,930.0,0,0,57.0,150,76,13.1,No,2014,No,No,No
Victor Bermudez,67,26,100,24,12,4,347.0,72,15,17.0,28,9,19.2,No,2014,No,No,No
Jeremiah Moore,0,0,5,0,2,0,11.0,2,0,0.0,3,0,29.4,No,2014,No,No,No
Nate Velasco,0,1,0,0,0,0,14.0,0,0,1.0,0,0,3.9,No,2014,No,No,No
Jaye Crockett,1232,111,933,466,338,251,2883.0,156,49,207.0,777,417,23.5,No,2014,No,No,No
Jordan Tolbert,1354,80,934,506,499,330,3096.0,38,12,229.0,896,494,23.6,No,2014,No,No,No
Robert Turner,561,143,516,198,169,112,1686.0,183,53,106.0,333,145,22.2,No,2014,No,No,No
Dusty Hannahs,1509,123,1139,487,330,293,3156.0,612,242,156.0,527,245,22.7,Yes,2014,No,No,No
Dejan Kravic,513,63,417,213,137,86,1345.0,2,1,94.0,415,212,22.1,No,2014,No,No,No
Toddrick Gotcher,952,219,732,293,310,228,3220.0,377,138,120.0,355,155,16.4,No,2014,No,No,No
Aaron Ross,739,79,518,225,252,216,1806.0,208,73,93.0,310,152,21.4,No,2014,No,No,No
Randy Onwuasor,1146,211,944,374,408,314,2601.0,289,84,232.0,655,290,25.7,No,2014,No,No,No
"Jamal Williams,",203,66,195,63,66,48,895.0,103,29,52.0,92,34,16.0,No,2014,No,No,No
Kader Tapsoba,122,8,70,44,50,34,439.0,0,0,24.0,70,44,13.9,No,2014,No,No,No
Alex Foster,256,13,194,104,99,48,906.0,1,0,66.0,193,104,17.5,No,2014,No,No,No
Stan Mays,28,2,17,8,8,6,49.0,15,6,6.0,2,2,29.3,No,2014,No,No,No
Clark Lammert,108,26,76,31,55,35,529.0,28,11,20.0,48,20,12.3,No,2014,No,No,No
Luke Adams,133,43,109,32,53,42,600.0,80,27,48.0,29,5,16.3,No,2014,No,No,No
Isaiah Taylor,1254,415,1019,412,499,395,2831.0,119,35,207.0,900,377,26.1,Yes,2014,No,No,No
Jonathan Holmes,1166,92,869,397,384,278,2931.0,299,94,179.0,570,303,21.1,No,2014,No,No,No
Javan Felix,1249,366,1159,448,232,183,3427.0,485,170,217.0,674,278,21.9,No,2014,No,No,No
Cameron Ridley,943,37,634,346,462,251,2458.0,0,0,179.0,634,346,21.1,No,2014,No,No,No
Demarcus Holland,707,212,606,257,228,137,3033.0,177,56,194.0,429,201,15.1,No,2014,No,No,No
Connor Lammert,763,135,639,281,144,98,3119.0,330,103,111.0,309,178,13.3,No,2014,No,No,No
Martez Walker,1489,129,1033,458,484,391,3132.0,535,182,156.0,498,276,21.6,No,2014,No,No,No
Prince Ibeh,400,14,282,157,199,86,1769.0,1,0,105.0,281,157,13.8,No,2014,No,No,No
Kendal Yancy,576,118,484,204,174,109,1996.0,174,59,86.0,310,145,16.7,No,2014,No,No,No
Damarcus Croaker,688,100,615,269,135,85,2022.0,219,65,128.0,396,204,20.0,No,2014,No,No,No
Danny Newsome,16,0,14,6,4,1,40.0,6,3,3.0,8,3,23.9,No,2014,No,No,No
Brandon Allums,3,0,5,1,2,1,15.0,0,0,1.0,5,1,23.9,No,2014,No,No,No
Tarale Murry,3,0,12,1,6,1,16.0,8,0,1.0,4,1,50.5,No,2014,No,No,No
Julius Brown,1838,694,1512,635,459,369,4328.0,578,199,369.0,934,436,24.9,No,2014,No,No,No
Rian Pearson,1794,197,1444,680,565,391,3668.0,128,43,251.0,1316,637,27.7,No,2014,No,No,No
Justin Drummond,1460,181,1087,489,516,386,2977.0,276,96,217.0,811,393,26.4,No,2014,No,No,No
J.D. Weatherspoon,880,76,569,316,379,228,2241.0,68,20,111.0,501,296,19.4,No,2014,No,No,No
Nathan Boothe,1494,249,1235,599,297,247,3523.0,137,49,185.0,1098,550,22.4,No,2014,No,No,No
Jonathan Williams,1757,286,1388,607,418,321,3664.0,642,222,281.0,746,385,25.7,No,2014,No,No,No
Jordan Lauf,702,159,430,231,275,188,3045.0,149,52,83.0,281,179,10.7,No,2014,No,No,No
Matt Smith,814,37,579,282,226,165,2364.0,208,85,114.0,371,197,17.6,No,2014,No,No,No
Zach Garber,377,41,219,107,231,162,1590.0,7,1,71.0,212,106,12.6,No,2014,No,No,No
Aubrey Williams,682,70,433,243,284,196,1777.0,2,0,89.0,431,243,18.0,No,2014,No,No,No
Donald Beatty,0,0,1,0,0,0,6.0,0,0,0.0,1,0,8.3,No,2014,No,No,No
Jerrelle Benimon,1287,233,848,443,532,365,3101.0,110,36,294.0,738,407,23.1,Yes,2014,No,No,No
Rafriel Guthrie,664,63,507,214,297,188,1557.0,143,48,108.0,364,166,24.9,No,2014,No,No,No
Marcus Damas,1140,139,960,387,344,244,3140.0,378,122,210.0,582,265,21.9,No,2014,No,No,No
Mike Burwell,747,121,642,246,224,151,2269.0,323,104,139.0,319,142,20.1,No,2014,No,No,No
Four McGlynn,1518,166,1107,425,442,398,3753.0,719,270,183.0,388,155,21.1,No,2014,No,No,No
Timajh Parker-Rivera,751,100,536,271,382,209,3120.0,8,0,141.0,528,271,14.1,No,2014,No,No,No
John Davis,1114,55,881,431,336,221,2483.0,91,31,138.0,790,400,24.0,No,2014,No,No,No
Walter Foster,386,42,353,152,148,82,1832.0,1,0,89.0,352,152,14.3,No,2014,No,No,No
Marquis Marshall,34,2,31,11,9,6,105.0,24,6,3.0,7,5,18.8,No,2014,No,No,No
Jerome Hairston,333,86,316,121,70,51,1007.0,123,40,91.0,193,81,22.2,No,2014,No,No,No
Jamel Flash,38,2,42,13,26,12,399.0,0,0,15.0,42,13,9.0,No,2014,No,No,No
Jonah Meredith,4,0,1,1,2,2,9.0,0,0,1.0,1,1,16.9,No,2014,No,No,No
Ben Mesuda,3,0,2,1,0,0,12.0,1,1,1.0,1,0,12.9,No,2014,No,No,No
Barrington Alston,7,0,12,3,7,1,103.0,1,0,6.0,11,3,10.6,No,2014,No,No,No
Larry McCollum,2,1,4,1,0,0,10.0,1,0,0.0,3,1,20.6,No,2014,No,No,No
Hunter Williams,772,208,721,265,122,82,2292.0,418,160,145.0,303,105,21.4,No,2014,No,No,No
Antoine Myers,638,167,442,212,332,213,1885.0,9,1,135.0,433,211,20.7,No,2014,No,No,No
Tevin Calhoun,507,32,458,174,133,85,1369.0,245,74,60.0,213,100,22.5,No,2014,No,No,No
Kevin Thomas,573,64,421,233,170,107,1773.0,2,0,166.0,419,233,19.5,No,2014,No,No,No
Jeff Mullahey,382,72,335,116,108,83,1418.0,197,67,50.0,138,49,16.2,No,2014,No,No,No
Westley Hinton,276,18,246,98,59,41,819.0,122,39,45.0,124,59,20.6,No,2014,No,No,No
Kelton Ford,389,119,334,116,203,121,1365.0,152,36,103.0,182,80,20.0,No,2014,No,No,No
JC Bonny,82,8,60,23,39,28,303.0,30,8,26.0,30,15,17.8,No,2014,No,No,No
Josh Warren,148,11,122,63,44,22,826.0,1,0,27.0,121,63,11.0,No,2014,No,No,No
Phillip Coleman,2,0,4,1,0,0,6.0,1,0,0.0,3,1,34.5,No,2014,No,No,No
Jordan Howard,6,1,8,3,2,0,20.0,1,0,5.0,7,3,34.9,No,2014,No,No,No
Hobie Hughes,0,1,0,0,0,0,8.0,0,0,0.0,0,0,0.0,No,2014,No,No,No
Louis Dabney,1471,201,1225,468,511,387,3372.0,461,148,213.0,764,320,26.2,No,2014,No,No,No
Jonathan Stark,2231,578,1762,749,547,440,4621.0,755,293,333.0,1007,456,26.2,No,2014,No,No,No
Jay Hook,955,62,724,290,229,187,2477.0,480,188,121.0,244,102,20.7,No,2014,No,No,No
Tre Drye,650,73,480,234,300,173,3072.0,36,9,153.0,444,225,13.4,No,2014,No,No,No
Cameron Reynolds,1370,157,1262,489,278,199,3546.0,577,193,163.0,685,296,22.1,Yes,2014,No,No,No
Payton Henson,1072,124,842,374,314,241,2975.0,266,83,151.0,576,291,20.8,No,2014,No,No,No
Tomas Bruha,247,10,181,94,95,59,1056.0,0,0,69.0,181,94,14.7,No,2014,No,No,No
Kevin Thomas,240,10,182,99,72,42,1133.0,0,0,65.0,182,99,13.2,No,2014,No,No,No
Ryan Smith,415,32,343,169,132,77,1617.0,1,0,93.0,342,169,15.5,No,2014,No,No,No
Max Keenan,11,0,6,2,8,5,59.0,4,2,6.0,2,0,14.5,No,2014,No,No,No
Josh Hearlihy,454,123,346,141,162,122,1453.0,133,50,122.0,213,91,18.9,No,2014,No,No,No
Mikael Herbert,6,1,7,1,6,4,39.0,5,0,4.0,2,1,19.3,No,2014,No,No,No
Ray Barreno,195,18,150,76,64,43,839.0,0,0,76.0,150,76,15.2,No,2014,No,No,No
Cole Currie,2,1,7,0,2,2,24.0,3,0,4.0,4,0,27.1,No,2014,No,No,No
James Woodard,1881,236,1410,595,579,430,4272.0,733,261,221.0,677,334,23.0,No,2014,No,No,No
Rashad Smith,915,95,711,361,310,176,2486.0,67,17,137.0,644,344,20.7,No,2014,No,No,No
Shaquille Harrison,1481,461,1156,513,654,422,4017.0,153,33,306.0,1003,480,22.7,Yes,2014,No,No,No
D'Andre Wright,861,62,663,303,340,236,2282.0,72,19,164.0,591,284,22.3,No,2014,No,No,No
Rashad Ray,840,298,682,270,280,213,2867.0,273,87,161.0,409,183,17.6,No,2014,No,No,No
Lew Evans,542,78,457,170,198,134,1816.0,229,68,117.0,228,102,18.4,No,2014,No,No,No
Tim Peete,487,188,446,170,147,94,2456.0,175,53,140.0,271,117,13.8,No,2014,No,No,No
Patrick Swilling Jr.,482,90,438,158,98,59,1387.0,297,107,97.0,141,51,21.5,No,2014,No,No,No
Brandon Swannegan,550,24,395,201,252,148,1893.0,0,0,87.0,395,201,16.3,No,2014,No,No,No
Stevie Repichowski,409,24,349,132,50,39,1270.0,297,106,34.0,52,26,15.7,No,2014,No,No,No
Marquel Curtis,482,128,408,176,144,96,1815.0,125,34,108.0,283,142,16.8,No,2014,No,No,No
Nick Wood,27,0,21,9,5,4,42.0,13,5,3.0,8,4,32.3,No,2014,No,No,No
Barrett Hunter,3,4,12,1,2,1,41.0,2,0,4.0,10,1,21.0,No,2014,No,No,No
TK Edogi,486,22,337,195,148,95,1443.0,7,1,86.0,330,194,17.4,No,2014,No,No,No
Riley Kemmer,0,0,0,0,0,0,1.0,0,0,0.0,0,0,0.0,No,2014,No,No,No
Jordan Adams,1131,142,798,373,342,287,2081.0,296,98,94.0,502,275,25.3,Yes,2014,No,No,No
Kyle Anderson,865,355,670,303,303,223,2242.0,96,36,183.0,574,267,22.2,Yes,2014,No,No,No
Norman Powell,1376,214,1090,503,347,259,3555.0,354,111,180.0,736,392,20.3,Yes,2014,No,No,No
Zach LaVine,349,66,288,127,68,47,904.0,128,48,42.0,160,79,20.1,Yes,2014,No,Yes,Yes
Bryce Alford,1922,537,1443,584,515,425,4509.0,829,329,235.0,614,255,20.8,No,2014,No,No,No
Tony Parker,1128,41,822,456,419,216,2485.0,0,0,159.0,822,456,23.4,Yes,2014,Yes,Yes,Yes
Travis Wear,1052,85,843,425,228,182,2845.0,50,20,115.0,793,405,18.8,Yes,2014,No,No,No
David Wear,888,96,748,354,163,120,2832.0,142,60,120.0,606,294,16.8,Yes,2014,No,No,No
Wanaah Bail,38,5,36,15,17,8,159.0,1,0,5.0,35,15,15.5,No,2014,No,No,No
Noah Allen,555,104,441,194,165,119,1511.0,161,48,106.0,280,146,21.1,No,2014,No,No,No
Kory Alford,9,2,10,2,6,4,74.0,6,1,3.0,4,1,11.1,No,2014,No,No,No
David Brown,15,5,23,6,2,2,76.0,8,1,11.0,15,5,23.3,No,2014,No,No,No
Aubrey Williams,1,0,2,0,2,1,21.0,0,0,1.0,2,0,9.4,No,2014,No,No,No
Nick Kazemi,0,1,5,0,0,0,34.0,0,0,2.0,5,0,10.3,No,2014,No,No,No
Spencer Butterfield,768,158,545,261,155,129,1827.0,263,117,102.0,282,144,21.5,No,2014,No,No,No
Preston Medlin,1368,320,966,445,329,265,3172.0,511,213,173.0,455,232,22.4,No,2014,No,No,No
Jarred Shaw,865,54,693,352,220,160,1897.0,10,1,134.0,683,351,26.7,No,2014,No,No,No
Kyle Davis,1045,128,727,393,381,248,2505.0,32,11,185.0,695,382,21.6,No,2014,No,No,No
Jalen Moore,1645,241,1210,574,435,325,3833.0,449,172,166.0,761,402,22.1,No,2014,No,No,No
TeNale Roland,367,152,314,123,76,51,1399.0,180,70,73.0,134,53,16.5,No,2014,No,No,No
Marcel Davis,996,453,809,342,345,234,3223.0,234,78,252.0,575,264,19.8,No,2014,No,No,No
Danny Berger,331,105,282,108,87,68,1239.0,144,47,60.0,138,61,17.0,No,2014,No,No,No
Jordan Stone,224,20,136,77,124,70,1017.0,0,0,55.0,136,77,13.4,No,2014,No,No,No
JoJo McGlaston,549,106,497,183,186,117,1757.0,198,66,120.0,299,117,21.6,No,2014,No,No,No
Ben Clifford,380,49,264,125,136,108,1425.0,65,22,69.0,199,103,15.3,No,2014,No,No,No
Viko Noma'aea,30,6,35,10,5,4,147.0,24,6,4.0,11,4,15.7,No,2014,No,No,No
Sean Harris,67,17,59,29,17,9,420.0,0,0,20.0,59,29,11.8,No,2014,No,No,No
Holton Hunsaker,1555,438,1220,427,531,463,4161.0,705,238,320.0,515,189,22.6,No,2014,No,No,No
Ben Aird,1535,162,1142,577,502,359,3766.0,65,22,175.0,1077,555,21.6,No,2014,No,No,No
Zach Nelson,1001,246,775,386,229,153,2859.0,262,76,217.0,513,310,20.3,No,2014,No,No,No
Mitch Bruneel,812,87,594,302,208,143,2528.0,192,65,98.0,402,237,17.2,No,2014,No,No,No
Hayes Garrity,354,68,325,123,78,63,979.0,138,45,60.0,187,78,23.2,No,2014,No,No,No
Keawe Enos,391,101,304,123,73,63,1582.0,216,82,69.0,88,41,13.9,No,2014,No,No,No
Brenden Evans,218,30,177,77,96,62,855.0,10,2,52.0,167,75,17.7,No,2014,No,No,No
Chad Ross,96,13,98,37,25,15,486.0,23,7,33.0,75,30,16.2,No,2014,No,No,No
Taylor Brown,201,66,193,62,55,30,1238.0,159,47,39.0,34,15,10.4,No,2014,No,No,No
Eli Robison,36,4,40,12,11,8,147.0,18,4,10.0,22,8,20.7,No,2014,No,No,No
Cory Cardwell,109,33,97,35,15,13,396.0,80,26,14.0,17,9,14.7,No,2014,No,No,No
Delon Wright,1022,352,634,339,376,306,2367.0,127,38,152.0,507,301,22.1,Yes,2014,No,No,No
Jordan Loveridge,1568,231,1264,513,399,319,3993.0,586,223,211.0,678,290,22.4,No,2014,No,No,No
Brandon Taylor,1270,428,992,419,233,188,3877.0,620,244,259.0,372,175,18.9,No,2014,No,No,No
Dakarai Tucker,717,79,557,247,98,78,2234.0,372,145,72.0,185,102,16.3,No,2014,No,No,No
Dallin Bachynski,550,50,358,193,229,158,1559.0,15,6,89.0,343,187,19.2,No,2014,No,No,No
Jeremy Olsen,282,15,228,123,60,36,803.0,0,0,59.0,228,123,21.2,No,2014,No,No,No
Princeton Onwas,472,98,354,167,218,120,1346.0,88,18,110.0,266,149,21.1,No,2014,No,No,No
Renan Lenz,211,25,160,83,56,42,615.0,13,3,30.0,147,80,19.0,No,2014,No,No,No
Kenneth Ogbe,1014,111,696,317,312,219,2412.0,384,161,144.0,312,156,20.5,No,2014,No,No,No
Ahmad Fields,81,11,61,25,41,25,190.0,15,6,14.0,46,19,26.3,No,2014,No,No,No
Parker Van Dyke,606,166,521,212,58,40,2166.0,390,142,72.0,131,70,14.8,No,2014,No,No,No
Marko Kovacevic,24,3,15,9,8,6,69.0,0,0,7.0,15,9,19.8,No,2014,No,No,No
Connor Van Brocklin,11,1,5,3,2,2,17.0,4,3,0.0,1,0,18.5,No,2014,No,No,No
Xan Ricketts,8,0,5,4,2,0,35.0,0,0,2.0,5,4,12.1,No,2014,No,No,No
Austin Eastman,13,5,13,2,10,7,78.0,10,2,5.0,3,0,15.7,No,2014,No,No,No
LaVonte Dority,795,157,586,242,257,217,1880.0,242,94,145.0,344,148,24.1,No,2014,No,No,No
Alec Peters,2348,204,1623,790,566,479,4250.0,694,289,248.0,929,501,25.6,Yes,2014,No,No,No
Jordan Coleman,378,45,283,118,161,118,1087.0,91,24,62.0,192,94,20.6,No,2014,No,No,No
Lexus Williams,722,228,600,243,162,129,2479.0,305,107,160.0,295,136,17.1,No,2014,No,No,No
Bobby Capobianco,481,74,348,172,166,104,1605.0,91,33,105.0,257,139,17.4,No,2014,No,No,No
Jubril Adekoya,648,105,468,234,226,149,2227.0,77,31,144.0,391,203,16.5,No,2014,No,No,No
Moussa Gueye,219,17,162,79,91,61,1209.0,0,0,136.0,162,79,15.1,No,2014,No,No,No
Vashil Fernandez,612,38,442,242,264,128,2596.0,0,0,131.0,442,242,13.9,No,2014,No,No,No
Keith Carter,707,304,568,247,156,98,2146.0,293,115,140.0,275,132,18.6,No,2014,No,No,No
Clay Yeo,116,27,94,42,17,12,360.0,44,20,24.0,50,22,18.4,No,2014,No,No,No
David Chadwick,143,14,122,61,22,10,536.0,38,11,24.0,84,50,15.2,No,2014,No,No,No
Nick Davidson,118,41,93,34,38,34,441.0,46,16,17.0,47,18,14.8,No,2014,No,No,No
Rod Odom,985,96,833,322,239,158,3165.0,492,183,143.0,341,139,18.7,No,2014,No,No,No
Damian Jones,1313,71,897,508,524,296,2684.0,8,1,197.0,889,507,26.6,Yes,2014,No,No,No
Kyle Fuller,706,267,629,229,270,190,2473.0,231,58,184.0,398,171,20.7,No,2014,No,No,No
Dai-Jon Parker,499,183,437,172,104,69,2177.0,237,86,125.0,200,86,15.3,No,2014,No,No,No
James Siakam,593,65,332,196,283,199,1829.0,8,2,101.0,324,194,16.9,No,2014,No,No,No
Eric McClellan,846,190,622,278,321,228,2177.0,191,62,200.0,431,216,23.5,No,2014,No,No,No
Luke Kornet,1135,143,918,383,281,219,3085.0,469,150,138.0,449,233,20.5,Yes,2014,No,No,No
Josh Henderson,416,56,341,164,148,86,1400.0,6,2,90.0,335,162,19.5,No,2014,No,No,No
Shelby Moats,158,38,154,59,45,20,957.0,76,20,52.0,78,39,13.1,No,2014,No,No,No
Nathan Watkins,25,1,23,7,13,8,106.0,18,3,7.0,5,4,18.4,No,2014,No,No,No
Rob Cross,0,1,0,0,0,0,2.0,0,0,0.0,0,0,0.0,No,2014,No,No,No
Carter Josephs,6,46,3,2,8,2,316.0,0,0,18.0,3,2,4.1,No,2014,No,No,No
Clancy Rugg,991,64,565,290,497,386,2395.0,88,25,140.0,477,265,21.4,No,2014,No,No,No
Sandro Carissimo,1141,278,946,394,270,218,3610.0,345,135,176.0,601,259,18.7,No,2014,No,No,No
Candon Rusin,1071,84,894,371,203,141,3148.0,505,188,214.0,389,183,20.8,No,2014,No,No,No
Luke Apfeld,1048,53,734,358,372,290,2461.0,127,42,140.0,607,316,23.1,No,2014,No,No,No
Brian Voelkel,805,679,576,233,485,309,4134.0,108,30,295.0,468,203,14.3,No,2014,No,No,No
Kurt Steidl,1146,135,851,362,244,198,3461.0,567,224,129.0,284,138,16.8,No,2014,No,No,No
Ethan O'Day,1233,104,944,523,291,187,3098.0,1,0,181.0,943,523,21.9,No,2014,No,No,No
Hector Harold,518,66,488,184,137,84,1669.0,215,66,122.0,273,118,22.0,No,2014,No,No,No
Josh Elbaum,165,123,122,60,89,44,1322.0,7,1,97.0,115,59,10.7,No,2014,No,No,No
Dre Wills,772,188,523,304,290,159,2290.0,25,5,161.0,498,299,19.2,No,2014,No,No,No
Ryan Pierson,401,38,362,154,117,91,1370.0,14,2,71.0,348,152,19.5,No,2014,No,No,No
Naasir Williams,24,15,27,8,9,6,104.0,11,2,7.0,16,6,20.0,No,2014,No,No,No
Harrison Taggart,9,3,7,3,2,2,56.0,4,1,1.0,3,2,8.7,No,2014,No,No,No
James Bell,1046,143,836,344,213,168,2866.0,522,190,170.0,314,154,19.6,No,2014,No,No,No
Darrun Hilliard,1511,248,1125,491,428,320,3537.0,569,209,206.0,556,282,22.4,Yes,2014,No,No,No
JayVaughn Pinkston,1590,182,1063,495,780,567,3571.0,115,33,288.0,948,462,24.6,No,2014,No,No,No
Ryan Arcidiacono,1604,535,1228,487,461,369,4592.0,729,261,253.0,499,226,19.2,Yes,2014,No,No,No
Josh Hart,1921,266,1326,677,500,360,4093.0,532,207,194.0,794,470,22.7,Yes,2014,No,No,No
Daniel Ochefu,1015,185,673,404,333,207,3060.0,4,0,220.0,669,404,17.9,Yes,2014,No,No,No
Dylan Ennis,1233,440,991,412,353,244,3681.0,475,165,247.0,516,247,19.6,No,2014,No,No,No
Kris Jenkins,1383,215,1039,432,305,255,3319.0,708,264,137.0,331,168,21.1,No,2014,No,No,No
Tony Chennault,559,230,532,197,219,144,2315.0,90,21,184.0,442,176,18.4,No,2014,No,No,No
Darryl Reynolds,327,38,179,120,138,87,1634.0,0,0,79.0,179,120,10.5,No,2014,No,No,No
Henry Lowe,8,3,10,3,5,0,74.0,8,2,9.0,2,1,15.1,No,2014,No,No,No
Nick McMahon,2,1,4,1,0,0,34.0,3,0,2.0,1,1,8.9,No,2014,No,No,No
Patrick Farrell,11,2,10,3,5,2,73.0,10,3,4.0,0,0,11.8,No,2014,No,No,No
Treveon Graham,1882,199,1431,618,645,446,3558.0,565,200,191.0,866,418,26.8,Yes,2014,No,No,No
Juvonte Reddic,1438,76,1091,574,452,286,3362.0,18,4,210.0,1073,570,22.3,No,2014,No,No,No
Melvin Johnson,1657,218,1459,598,224,176,3482.0,774,285,171.0,685,313,24.4,No,2014,No,No,No
Rob Brandenberg,1219,191,1089,423,281,194,3242.0,525,179,148.0,564,244,21.1,No,2014,No,No,No
Briante Weber,862,378,695,296,299,230,2965.0,146,40,186.0,549,256,17.0,Yes,2014,No,No,No
JeQuan Lewis,1444,505,1074,457,416,341,3447.0,505,189,320.0,569,268,22.8,No,2014,No,No,No
Jordan Burgess,636,131,625,225,175,95,2812.0,314,91,118.0,311,134,14.5,No,2014,No,No,No
Mo Alie-Cox,1092,112,705,405,409,281,3322.0,1,1,162.0,704,404,15.8,No,2014,No,No,No
Terrance Shannon,432,38,357,160,201,112,1193.0,2,0,109.0,355,160,23.6,No,2014,No,No,No
Jarred Guest,198,20,204,86,45,24,1005.0,9,2,58.0,195,84,13.8,No,2014,No,No,No
Doug Brooks,563,139,529,179,142,97,1889.0,343,108,93.0,186,71,18.1,No,2014,No,No,No
Jairus Lyles,1764,264,1367,607,525,388,3078.0,460,162,240.0,907,445,30.4,No,2014,No,No,No
Torey Burston,18,16,30,4,17,9,173.0,7,1,6.0,23,3,12.6,No,2014,No,No,No
Emerson Burk,0,0,0,0,0,0,8.0,0,0,0.0,0,0,0.0,No,2014,No,No,No
D.J. Covington,1516,66,1029,599,466,317,2927.0,9,1,185.0,1020,598,22.1,No,2014,No,No,No
QJ Peterson,2200,300,1794,715,614,487,3681.0,845,283,300.0,949,432,30.5,No,2014,No,No,No
Rodney Glasgow,1440,530,1102,489,314,259,3536.0,547,203,199.0,555,286,18.5,No,2014,No,No,No
Jordan Weethee,736,101,645,253,114,84,2081.0,432,146,107.0,213,107,17.7,No,2014,No,No,No
Brian Brown,828,143,744,286,63,53,2540.0,569,203,111.0,175,83,15.6,No,2014,No,No,No
Tim Marshall,914,101,875,306,132,87,2072.0,681,215,106.0,194,91,23.1,No,2014,No,No,No
Trey Chapman,841,115,723,301,282,183,2679.0,210,56,179.0,513,245,18.3,No,2014,No,No,No
Phillip Anglade,726,53,562,315,241,96,2401.0,2,0,96.0,560,315,14.9,No,2014,No,No,No
Julian Eleby,1178,234,931,364,348,274,2865.0,517,176,223.0,414,188,22.0,No,2014,No,No,No
Craig Hinton,478,58,383,166,79,52,1593.0,256,94,81.0,127,72,14.5,No,2014,No,No,No
Jarid Watson,193,28,153,81,71,31,901.0,0,0,34.0,153,81,11.0,No,2014,No,No,No
Christian Burton,123,30,113,40,35,20,394.0,81,23,32.0,32,17,18.1,No,2014,No,No,No
Drew Absher,54,18,47,16,17,13,176.0,32,9,15.0,15,7,18.0,No,2014,No,No,No
Tyrell Mason,9,3,15,3,2,2,60.0,6,1,6.0,9,2,16.1,No,2014,No,No,No
Jarell Eddie,1182,139,995,383,276,224,3176.0,526,192,183.0,469,191,21.7,Yes,2014,No,No,No
Devin Wilson,659,414,470,195,368,238,3298.0,108,31,204.0,362,164,13.8,No,2014,No,No,No
Ben Emelogu,828,195,745,289,155,105,2891.0,391,145,152.0,354,144,18.0,No,2014,No,No,No
Joey van Zegeren,524,21,396,216,233,92,1711.0,2,0,117.0,394,216,19.5,No,2014,No,No,No
C.J. Barksdale,433,40,331,164,121,94,1464.0,31,11,60.0,300,153,16.1,No,2014,No,No,No
Adam Smith,1562,178,1358,549,242,192,3384.0,696,272,137.0,662,277,24.8,No,2014,No,No,No
Trevor Thompson,717,26,502,259,280,199,1851.0,0,0,131.0,502,259,21.4,No,2014,No,No,No
Cadarian Raines,553,46,486,234,163,85,1947.0,0,0,90.0,486,234,17.5,No,2014,No,No,No
Marshall Wood,565,42,489,188,124,77,1937.0,321,112,95.0,168,76,17.3,No,2014,No,No,No
Will Johnston,218,36,192,68,33,20,1206.0,172,62,21.0,20,6,10.1,No,2014,No,No,No
Christian Beyer,169,25,126,69,44,26,835.0,18,5,38.0,108,64,11.9,No,2014,No,No,No
Greg Donlon,14,0,10,5,6,4,37.0,0,0,1.0,10,5,19.1,No,2014,No,No,No
Malcolm Brogdon,1809,335,1399,601,482,422,4157.0,507,185,207.0,892,416,25.3,Yes,2014,No,No,No
Joe Harris,1698,254,1276,568,414,299,4084.0,646,263,213.0,630,305,23.6,Yes,2014,No,No,No
Anthony Gill,1458,108,949,528,572,389,3412.0,31,13,172.0,918,515,23.0,No,2014,No,No,No
Justin Anderson,873,180,669,288,266,200,2364.0,272,97,125.0,397,191,22.3,Yes,2014,No,No,No
Akil Mitchell,912,147,695,361,331,189,3164.0,11,1,155.0,684,360,18.2,No,2014,No,No,No
Mike Tobey,945,51,749,398,203,143,2247.0,19,6,106.0,730,392,24.2,Yes,2014,No,No,No
London Perrantes,1225,569,981,397,271,220,4425.0,516,211,211.0,465,186,17.2,Yes,2014,No,No,No
Darion Atkins,545,46,465,236,130,73,1857.0,1,0,89.0,464,236,19.1,No,2014,No,No,No
Evan Nolte,451,79,382,149,85,61,1880.0,274,92,56.0,108,57,14.6,No,2014,No,No,No
Teven Jones,101,42,96,31,43,28,531.0,37,11,28.0,59,20,15.5,No,2014,No,No,No
Thomas Rogers,10,4,21,3,4,1,82.0,16,3,8.0,5,0,21.5,No,2014,No,No,No
Rob Vozenilek,13,5,15,5,3,1,68.0,5,2,4.0,10,3,17.2,No,2014,No,No,No
Caid Kirven,11,0,13,5,0,0,77.0,3,1,6.0,10,4,14.1,No,2014,No,No,No
Jeff Jones,10,1,14,4,3,1,70.0,7,1,5.0,7,3,16.7,No,2014,No,No,No
Maleek Frazier,2,2,6,1,1,0,40.0,1,0,6.0,5,1,17.8,No,2014,No,No,No
Kenneth Ortiz,1080,451,881,353,519,356,3077.0,72,18,318.0,809,335,23.3,No,2014,No,No,No
Latif Rivers,1513,244,1190,470,441,377,3314.0,547,196,259.0,643,274,25.2,No,2014,No,No,No
Marcus Burton,1137,174,962,377,290,235,2580.0,451,148,160.0,511,229,23.9,No,2014,No,No,No
Mario Moody,975,64,758,369,292,199,2289.0,117,38,166.0,641,331,22.9,No,2014,No,No,No
Jay Harris,1127,296,894,338,312,281,2981.0,517,170,243.0,377,168,22.4,No,2014,No,No,No
Orlando Parker,715,54,591,290,209,135,2417.0,6,0,113.0,585,290,16.8,No,2014,No,No,No
Dwaun Anderson,629,98,631,247,149,99,2108.0,180,36,148.0,451,211,19.8,No,2014,No,No,No
Naofall Folahan,485,25,353,192,154,101,2118.0,0,0,102.0,353,192,12.5,No,2014,No,No,No
Greg Senat,238,13,193,92,110,54,1094.0,0,0,57.0,193,92,13.5,No,2014,No,No,No
Nolan Long,166,1,114,64,54,38,487.0,0,0,30.0,114,64,16.9,No,2014,No,No,No
Hugo Naurais,75,8,93,32,17,6,457.0,31,5,32.0,62,27,14.2,No,2014,No,No,No
Langston Burnett,39,10,55,12,22,9,292.0,39,6,16.0,16,6,13.7,No,2014,No,No,No
Codi Miller-McIntyre,1329,441,1150,496,426,269,3607.0,245,68,255.0,905,428,22.4,No,2014,No,No,No
Devin Thomas,1486,212,1047,544,702,398,3533.0,1,0,336.0,1046,544,24.2,No,2014,No,No,No
Travis McKie,1687,146,1228,568,567,430,4020.0,367,121,234.0,861,447,22.2,No,2014,No,No,No
Coron Williams,1288,165,1021,442,158,123,3360.0,673,281,92.0,348,161,18.2,No,2014,No,No,No
Tyler Cavanaugh,1724,155,1221,545,584,479,3502.0,417,155,257.0,804,390,25.6,Yes,2014,No,No,No
Arnaud William Adala Moto,1284,129,964,413,609,424,2957.0,137,34,246.0,827,379,25.3,No,2014,No,No,No
Madison Jones,564,359,456,199,264,150,2918.0,60,16,255.0,396,183,14.4,No,2014,No,No,No
Miles Overton,372,63,369,111,128,95,996.0,201,55,83.0,168,56,25.3,No,2014,No,No,No
Andre Washington,344,34,240,127,173,90,1237.0,1,0,69.0,239,127,16.2,No,2014,No,No,No
Aaron Rountree III,390,150,322,151,139,80,1885.0,31,8,99.0,291,143,12.8,No,2014,No,No,No
Trent VanHorn,46,13,40,13,25,19,319.0,13,1,15.0,27,12,10.1,No,2014,No,No,No
Grant O'Brien,11,0,16,4,3,2,76.0,8,1,0.0,8,3,11.3,No,2014,No,No,No
Duke Antonelli,2,0,3,1,0,0,6.0,0,0,0.0,3,1,25.7,No,2014,No,No,No
Stephen Prendergast,5,0,9,2,2,1,25.0,2,0,3.0,7,2,24.1,No,2014,No,No,No
Doug Niedrich,0,1,7,0,0,0,16.0,0,0,0.0,7,0,21.9,No,2014,No,No,No
DaVonte Lacy,1548,217,1141,467,476,365,3516.0,693,249,202.0,448,218,24.1,No,2014,No,No,No
D.J. Shelton,674,116,541,231,233,159,2314.0,191,53,147.0,350,178,19.0,No,2014,No,No,No
Que Johnson,1257,142,1065,423,297,225,3122.0,514,186,163.0,551,237,23.0,No,2014,No,No,No
Royce Woolridge,924,251,724,305,347,240,2753.0,233,74,200.0,491,231,21.6,No,2014,No,No,No
Dexter Kernich-Drew,665,94,559,227,117,84,2252.0,345,127,106.0,214,100,17.4,No,2014,No,No,No
Ike Iroegbu,1232,375,965,418,387,280,3409.0,329,116,252.0,636,302,21.6,No,2014,No,No,No
Junior Longrus,236,80,205,100,96,36,1761.0,3,0,79.0,202,100,10.0,No,2014,No,No,No
Jordan Railey,354,57,319,147,138,59,1282.0,3,1,86.0,316,146,19.3,No,2014,No,No,No
Josh Hawkinson,1414,158,995,520,399,324,3259.0,143,50,150.0,852,470,21.4,No,2014,No,No,No
Brett Boese,245,46,226,86,17,10,985.0,175,63,32.0,51,23,14.2,No,2014,No,No,No
Will DiIorio,154,34,119,55,75,36,943.0,23,8,39.0,96,47,11.2,No,2014,No,No,No
James Hunter,201,9,169,83,52,35,480.0,0,0,30.0,169,83,24.3,No,2014,No,No,No
Dominic Ballard,6,11,8,2,2,2,88.0,0,0,4.0,8,2,8.1,No,2014,No,No,No
C.J. Wilcox,1880,214,1478,640,356,299,3735.0,773,301,178.0,705,339,24.1,Yes,2014,No,No,No
Nigel Williams-Goss,1536,496,1236,574,361,291,3415.0,293,97,258.0,943,477,24.7,Yes,2014,No,No,No
Andrew Andrews,1812,387,1340,520,709,578,3929.0,552,194,264.0,788,326,23.9,No,2014,No,No,No
Perris Blackwell,1245,99,872,477,511,291,3046.0,2,0,210.0,870,477,21.9,No,2014,No,No,No
Darin Johnson,712,89,531,212,294,235,1856.0,184,53,93.0,347,159,20.2,No,2014,No,No,No
Mike Anderson,436,134,305,134,166,119,1808.0,129,49,101.0,176,85,13.8,No,2014,No,No,No
Shawn Kemp Jr.,620,13,455,259,163,102,1892.0,0,0,86.0,455,259,16.7,No,2014,No,No,No
Desmond Simmons,582,116,499,197,208,145,2757.0,136,43,116.0,363,154,13.2,No,2014,No,No,No
Jahmel Taylor,760,156,566,238,134,102,2320.0,421,182,79.0,145,56,15.5,No,2014,No,No,No
Quinn Sterling,8,1,2,1,6,5,21.0,2,1,4.0,0,0,21.3,No,2014,No,No,No
Hikeem Stewart,24,15,36,10,3,2,237.0,16,2,13.0,20,8,10.5,No,2014,No,No,No
Gilles Dierickx,93,18,102,42,13,9,642.0,0,0,50.0,102,42,12.9,No,2014,No,No,No
Connor Smith,2,0,1,1,0,0,7.0,0,0,0.0,1,1,7.2,No,2014,No,No,No
Jernard Jarreau,344,61,302,129,118,74,1307.0,29,12,90.0,273,117,17.5,No,2014,No,No,No
Davion Berry,1160,262,727,342,447,355,2217.0,302,121,161.0,425,221,27.0,No,2014,No,No,No
Kyle Tresnak,1214,64,866,489,346,236,2894.0,0,0,149.0,866,489,22.0,No,2014,No,No,No
Jeremy Senglin,2078,345,1444,668,545,397,4183.0,823,345,269.0,621,323,25.0,No,2014,No,No,No
Joel Bolomboy,1484,93,931,492,651,464,3743.0,97,36,260.0,834,456,21.4,Yes,2014,No,No,No
Jordan Richardson,722,300,624,231,139,108,3058.0,407,152,160.0,217,79,15.0,No,2014,No,No,No
Richaud Gittens,1063,262,858,356,301,214,3482.0,367,137,212.0,491,219,18.2,No,2014,No,No,No
Kyndahl Hill,1005,110,663,343,388,294,3224.0,83,25,169.0,580,318,16.7,No,2014,No,No,No
Royce Williams,147,37,112,52,27,18,552.0,57,25,32.0,55,27,15.4,No,2014,No,No,No
Byron Fulton,529,39,449,204,70,46,1463.0,169,75,65.0,280,129,20.0,No,2014,No,No,No
Josh Fuller,18,0,9,6,5,4,51.0,4,2,4.0,5,4,16.6,No,2014,No,No,No
James Hajek,238,22,190,94,91,50,1049.0,0,0,51.0,190,94,14.5,No,2014,No,No,No
Juwan Staten,1558,623,1269,542,628,443,4046.0,108,31,269.0,1161,511,22.4,No,2014,No,No,No
Eron Harris,1489,200,1128,487,366,296,3068.0,545,219,214.0,583,268,25.0,No,2014,No,No,No
Terry Henderson,1006,107,755,328,231,183,2355.0,434,167,109.0,321,161,20.5,No,2014,No,No,No
Devin Williams,1134,119,854,380,561,374,2505.0,1,0,207.0,853,380,25.1,No,2014,No,No,No
Remi Dibo,235,21,200,79,31,26,621.0,136,51,20.0,64,28,18.9,No,2014,No,No,No
Gary Browne,804,241,614,236,359,259,2774.0,240,73,182.0,374,163,17.3,No,2014,No,No,No
Nathan Adrian,792,198,686,284,178,120,2920.0,334,104,127.0,352,180,14.5,No,2014,No,No,No
Brandon Watkins,296,26,254,127,91,42,1069.0,0,0,58.0,254,127,15.8,No,2014,No,No,No
Kevin Noreen,226,62,138,74,109,70,1391.0,27,8,53.0,111,66,8.8,No,2014,No,No,No
Chase Connor,61,6,58,21,0,0,174.0,55,19,4.0,3,2,17.0,No,2014,No,No,No
Tyrone Hughes,11,3,11,4,5,2,35.0,8,1,3.0,3,3,22.9,No,2014,No,No,No
Richard Romeo,15,3,12,5,4,4,55.0,3,1,4.0,9,4,15.7,No,2014,No,No,No
Trey Sumler,1996,496,1490,645,599,489,4648.0,564,217,379.0,926,428,22.9,No,2014,No,No,No
Brandon Boggs,1370,150,1304,528,300,195,3593.0,379,119,224.0,925,409,23.0,No,2014,No,No,No
James Sinclair,1302,241,1162,465,323,244,3384.0,419,128,202.0,743,337,22.4,No,2014,No,No,No
Tom Tankelewicz,779,73,662,256,101,88,2020.0,484,179,101.0,178,77,19.9,No,2014,No,No,No
Tawaski King,1009,73,816,393,359,223,3285.0,1,0,207.0,815,393,18.0,No,2014,No,No,No
Mike Brown,1309,235,1065,446,421,304,3396.0,335,113,226.0,730,333,21.7,Yes,2014,No,No,No
Torrion Brummitt,977,103,760,362,389,243,2243.0,66,10,206.0,694,352,25.4,No,2014,No,No,No
Rhett Harrelson,838,160,660,248,184,150,2430.0,492,192,153.0,168,56,18.4,No,2014,No,No,No
Kenneth Hall,231,64,178,94,76,43,1506.0,0,0,72.0,178,94,9.5,No,2014,No,No,No
Justin Browning,588,122,398,212,202,135,2237.0,97,29,133.0,301,183,13.8,No,2014,No,No,No
Josh Mendenhall,76,10,70,32,17,12,394.0,0,0,26.0,70,32,13.1,No,2014,No,No,No
Ethan Freeman,5,3,4,1,2,2,15.0,1,1,0.0,3,0,16.3,No,2014,No,No,No
Garret Covington,1896,261,1460,602,479,396,3764.0,768,296,270.0,692,306,27.7,No,2014,No,No,No
Adam Link,583,95,400,218,219,146,1883.0,6,1,103.0,394,217,19.1,No,2014,No,No,No
Jabari Sandifer,765,369,666,248,294,201,2820.0,218,68,231.0,448,180,19.8,No,2014,No,No,No
Michael Ochereobia,371,24,250,148,134,75,1031.0,0,0,75.0,250,148,21.9,No,2014,No,No,No
Tate Stensgaard,469,59,309,181,157,106,1564.0,4,1,103.0,305,180,16.8,No,2014,No,No,No
Mike Miklusak,727,121,622,249,130,92,2118.0,362,137,108.0,260,112,19.8,No,2014,No,No,No
Jordan Foster,184,80,165,59,66,45,876.0,67,21,77.0,98,38,18.4,No,2014,No,No,No
Mohamed Conde,257,24,218,100,96,57,1220.0,1,0,52.0,217,100,14.1,No,2014,No,No,No
Remy Roberts-Burnett,379,105,400,173,54,26,1660.0,26,7,70.0,374,166,17.6,No,2014,No,No,No
Jason Hawthorne,78,18,67,30,13,6,355.0,36,12,22.0,31,18,15.8,No,2014,No,No,No
T.J. Price,1782,318,1425,581,440,334,3881.0,769,286,300.0,656,295,25.1,No,2014,No,No,No
George Fant,1621,123,1171,592,723,437,3671.0,3,0,273.0,1168,592,24.5,No,2014,No,No,No
Trency Jackson,657,143,544,210,238,154,1836.0,227,83,123.0,317,127,21.5,No,2014,No,No,No
Chris Harrison-Docks,938,188,791,294,187,152,2648.0,551,198,168.0,240,96,19.9,No,2014,No,No,No
Brandon Harris,462,99,419,136,117,85,1614.0,325,105,77.0,94,31,17.3,No,2014,No,No,No
Caden Dickerson,596,131,511,197,108,84,2927.0,335,118,127.0,176,79,11.8,No,2014,No,No,No
Aaron Adeoye,376,46,329,145,127,80,1610.0,25,6,113.0,304,139,16.1,No,2014,No,No,No
Payton Hulsey,472,251,418,166,201,125,2165.0,56,15,158.0,362,151,15.6,No,2014,No,No,No
Aleksej Rostov,445,46,349,160,140,98,1465.0,100,27,101.0,249,133,17.8,No,2014,No,No,No
O'Karo Akamune,241,30,181,95,106,51,1058.0,1,0,61.0,180,95,13.9,No,2014,No,No,No
Kevin Kaspar,351,108,316,113,71,53,1396.0,210,72,81.0,106,41,15.5,No,2014,No,No,No
Brandon Price,53,22,40,14,30,20,208.0,16,5,22.0,24,9,18.5,No,2014,No,No,No
Nigel Snipes,494,60,420,169,92,72,1546.0,224,84,103.0,196,85,18.2,No,2014,No,No,No
Ben Lawson,487,43,306,176,206,134,1747.0,5,1,101.0,301,175,14.7,No,2014,No,No,No
Daouda Soumaoro,10,0,3,0,10,10,52.0,0,0,0.0,3,0,7.5,No,2014,No,No,No
David Brown,1536,176,1136,455,562,409,3279.0,671,217,220.0,465,238,26.0,No,2014,No,No,No
Shayne Whittington,1119,81,807,416,367,279,2574.0,48,8,150.0,759,408,22.9,Yes,2014,No,No,No
Connar Tava,1154,314,777,409,501,327,3407.0,55,9,322.0,722,400,20.5,No,2014,No,No,No
Austin Richie,943,279,696,270,341,243,3605.0,426,160,173.0,270,110,15.0,No,2014,No,No,No
Tucker Haymond,1545,233,1150,518,528,382,3557.0,388,127,252.0,762,391,23.6,No,2014,No,No,No
Jared Klein,289,67,237,96,67,52,1201.0,124,45,76.0,113,51,14.9,No,2014,No,No,No
Kellen McCormick,457,36,335,156,44,32,1250.0,258,113,48.0,77,43,16.7,No,2014,No,No,No
A.J. Avery,384,34,300,137,161,106,1475.0,10,4,72.0,290,133,15.6,No,2014,No,No,No
Taylor Perry,296,119,270,100,101,65,1944.0,94,31,113.0,176,69,11.5,No,2014,No,No,No
Charles Harris,47,7,40,20,10,4,106.0,11,3,6.0,29,17,25.1,No,2014,No,No,No
Von Washington,49,2,50,17,9,4,135.0,39,11,5.0,11,6,23.3,No,2014,No,No,No
Hayden Hoerdemann,98,22,91,30,24,17,311.0,61,21,13.0,30,9,19.1,No,2014,No,No,No
Mario Matasovic,554,59,414,212,133,97,1600.0,104,33,120.0,310,179,18.5,No,2014,No,No,No
Tim Brennan,6,1,13,2,5,2,66.0,6,0,8.0,7,2,18.6,No,2014,No,No,No
Cleanthony Early,1135,50,790,371,342,280,1965.0,325,113,131.0,465,258,28.6,Yes,2014,No,No,No
Ron Baker,1636,345,1205,522,437,350,3795.0,655,242,177.0,550,280,22.0,Yes,2014,No,No,No
Fred VanVleet,1439,637,1086,463,462,372,3775.0,365,141,207.0,721,322,21.1,Yes,2014,No,No,No
Tekele Cotton,1047,276,853,375,292,189,3403.0,319,108,151.0,534,267,17.7,No,2014,No,No,No
Darius Carter,674,31,485,254,252,162,1389.0,7,4,53.0,478,250,25.4,No,2014,No,No,No
Chadrack Lufile,259,17,180,100,106,59,836.0,0,0,53.0,180,100,17.7,No,2014,No,No,No
Nick Wiggins,358,31,296,117,112,71,1007.0,161,53,51.0,135,64,20.7,No,2014,No,No,No
Kadeem Coleby,387,31,282,149,178,89,1219.0,0,0,92.0,282,149,18.7,No,2014,No,No,No
Evan Wessel,362,80,356,131,52,24,2182.0,253,76,50.0,103,55,10.4,No,2014,No,No,No
Derail Green,603,94,496,208,126,103,1677.0,222,84,100.0,274,124,19.5,No,2014,No,No,No
John Robert Simon,83,36,56,22,39,26,323.0,35,13,23.0,21,9,15.6,No,2014,No,No,No
Zach Bush,16,13,26,5,11,4,155.0,13,2,8.0,13,3,13.0,No,2014,No,No,No
Marcus Thornton,2178,308,1649,709,551,435,4328.0,809,325,324.0,840,384,28.7,Yes,2014,No,No,No
Omar Prewitt,1831,320,1340,626,555,390,3822.0,537,189,239.0,803,437,25.5,No,2014,No,No,No
Tim Rusthoven,1205,167,831,470,389,260,2624.0,32,5,167.0,799,465,25.1,No,2014,No,No,No
Brandon Britt,1254,199,947,407,444,312,2932.0,371,128,203.0,576,279,26.0,No,2014,No,No,No
Kyle Gaillard,756,169,594,285,177,106,2934.0,222,80,109.0,372,205,15.0,No,2014,No,No,No
Terry Tarpey,946,270,676,335,306,228,3141.0,171,48,179.0,505,287,17.3,No,2014,No,No,No
Julian Boatner,605,135,497,196,66,52,2303.0,420,161,104.0,77,35,15.4,No,2014,No,No,No
Sean Sheldon,571,150,378,235,173,101,2039.0,0,0,96.0,378,235,14.8,No,2014,No,No,No
Daniel Dixon,1355,179,1029,452,257,210,2918.0,618,241,153.0,411,211,23.3,No,2014,No,No,No
Fred Heldring,104,43,96,36,43,29,859.0,20,3,50.0,76,33,10.8,No,2014,No,No,No
Ben Whitlatch,21,0,20,7,2,1,56.0,15,6,1.0,5,1,21.9,No,2014,No,No,No
Tom Schalk,174,41,129,70,47,32,848.0,11,2,40.0,118,68,12.6,No,2014,No,No,No
Michael Schlotman,59,45,42,15,43,26,434.0,7,3,25.0,35,12,10.8,No,2014,No,No,No
Keon Moore,1000,84,729,321,229,193,1855.0,397,165,101.0,332,156,26.2,No,2014,No,No,No
Keon Johnson,2076,270,1474,632,610,517,3940.0,740,295,219.0,734,337,25.2,No,2014,No,No,No
Joab Jerome,907,216,648,291,393,276,2817.0,152,49,247.0,496,242,20.4,No,2014,No,No,No
Andre Smith,1071,322,930,348,205,161,3258.0,581,214,185.0,349,134,19.7,No,2014,No,No,No
Larry Brown,341,29,306,147,99,47,1401.0,4,0,89.0,302,147,16.9,No,2014,No,No,No
Tevin Prescott,528,22,365,214,176,100,1807.0,1,0,66.0,364,214,14.5,No,2014,No,No,No
James Bourne,489,23,309,170,244,149,2189.0,2,0,116.0,307,170,13.2,No,2014,No,No,No
Josh Davenport,592,165,455,208,237,161,2106.0,55,15,144.0,400,193,17.0,No,2014,No,No,No
Brandon Vega,113,61,84,39,44,34,416.0,3,1,37.0,81,38,17.6,No,2014,No,No,No
Christian Farmer,256,21,239,82,46,34,624.0,185,58,27.0,54,24,25.0,No,2014,No,No,No
Jarad Scott,231,21,175,84,56,34,762.0,79,29,46.0,96,55,16.6,No,2014,No,No,No
Carlin Bremner,89,20,109,33,12,7,311.0,57,16,17.0,52,17,19.5,No,2014,No,No,No
Donovan Carter,5,3,10,2,4,1,137.0,0,0,9.0,10,2,7.9,No,2014,No,No,No
Hunter Sadlon,6,7,10,1,8,4,97.0,4,0,3.0,6,1,8.7,No,2014,No,No,No
Ivan Saicic,0,0,4,0,0,0,19.0,1,0,3.0,3,0,19.0,No,2014,No,No,No
Frank Kaminsky,1458,188,1013,529,389,297,2943.0,279,103,121.0,734,426,25.5,Yes,2014,No,No,No
Ben Brust,1148,156,952,392,156,129,3332.0,607,235,95.0,345,157,18.9,No,2014,No,No,No
Sam Dekker,1363,148,1012,499,321,223,3153.0,408,142,114.0,604,357,22.9,Yes,2014,No,No,No
Traevon Jackson,839,307,683,273,285,223,2741.0,211,70,194.0,472,203,20.7,No,2014,No,No,No
Josh Gasser,1075,284,693,313,349,292,4774.0,391,157,126.0,302,156,11.9,No,2014,No,No,No
Nigel Hayes,1857,319,1358,605,820,546,4439.0,304,101,238.0,1054,504,24.3,Yes,2014,No,No,No
Bronson Koenig,1459,296,1210,498,237,193,4075.0,695,270,154.0,515,228,19.6,No,2014,No,No,No
Duje Dukan,298,37,248,106,64,42,970.0,134,44,36.0,114,62,18.6,Yes,2014,No,No,No
Zach Bohannon,161,36,110,57,50,30,541.0,46,17,32.0,64,40,17.9,No,2014,No,No,No
Jordan Hill,599,155,526,203,123,92,1960.0,294,101,129.0,232,102,18.3,Yes,2014,No,No,No
Vitto Brown,661,76,593,251,108,77,1918.0,233,82,110.0,360,169,21.0,No,2014,No,No,No
Evan Anderson,20,6,19,9,5,1,109.0,6,1,6.0,13,8,14.2,No,2014,No,No,No
George Marshall,907,172,769,300,194,144,2429.0,420,163,110.0,349,137,20.7,No,2014,No,No,No
Karl Cochran,1894,320,1814,701,262,180,4068.0,914,312,267.0,900,389,29.8,No,2014,No,No,No
Spencer Collins,1696,194,1385,573,471,368,3882.0,512,182,203.0,873,391,25.5,No,2014,No,No,No
Lee Skinner,1242,269,985,455,481,316,4074.0,81,16,227.0,904,439,19.4,No,2014,No,No,No
Eric Garcia,1260,537,829,360,409,332,3777.0,486,208,177.0,343,152,17.0,No,2014,No,No,No
Justin Gordon,872,146,690,344,319,176,2421.0,25,8,195.0,665,336,23.4,No,2014,No,No,No
Jaylen Allen,655,94,582,231,121,76,1954.0,313,117,120.0,269,114,21.0,No,2014,No,No,No
C.J. Neumann,521,82,375,197,186,124,2662.0,10,3,99.0,365,194,11.5,No,2014,No,No,No
John Swinton,196,121,144,58,70,59,1215.0,62,21,55.0,82,37,10.5,No,2014,No,No,No
Aerris Smith,283,11,225,121,74,41,1632.0,0,0,62.0,225,121,10.8,No,2014,No,No,No
Indiana Faithfull,174,150,167,57,50,40,1097.0,66,20,87.0,101,37,13.8,No,2014,No,No,No
Zac Grossenbacher,32,2,28,11,4,2,94.0,21,8,4.0,7,3,19.6,No,2014,No,No,No
Zach Korkowski,35,7,16,11,13,13,96.0,3,0,9.0,13,11,17.7,No,2014,No,No,No
Eric Wagenlander,9,6,19,3,0,0,68.0,17,3,6.0,2,0,19.6,No,2014,No,No,No
Jeremiah Tate,2,3,4,1,8,0,35.0,0,0,3.0,4,1,16.8,No,2014,No,No,No
A.J. Pacher,873,78,650,317,261,183,2127.0,182,56,172.0,468,261,24.8,No,2014,No,No,No
Miles Dixon,884,176,781,303,289,222,2564.0,187,56,177.0,594,247,22.2,No,2014,No,No,No
Jerran Young,594,75,432,218,185,119,1421.0,109,39,122.0,323,179,25.0,No,2014,No,No,No
Cole Darling,839,81,682,283,273,209,2258.0,185,64,133.0,497,219,23.4,No,2014,No,No,No
JT Yoho,1171,182,972,426,222,162,2848.0,412,157,190.0,560,269,24.4,No,2014,No,No,No
Matt Vest,619,206,461,226,168,101,2627.0,187,66,111.0,274,160,13.9,No,2014,No,No,No
Reggie Arceneaux,1049,296,975,369,181,138,3556.0,472,173,244.0,503,196,20.5,No,2014,No,No,No
Chrishawn Hopkins,748,197,627,246,241,181,2309.0,227,75,189.0,400,171,21.6,No,2014,No,No,No
Kendall Griffin,461,149,322,142,155,116,2077.0,180,61,122.0,142,81,13.9,No,2014,No,No,No
Steven Davis,637,54,472,222,176,131,1390.0,186,62,106.0,286,160,24.2,No,2014,No,No,No
Tavares Sledge,292,24,283,119,96,53,1222.0,10,1,79.0,273,118,18.7,No,2014,No,No,No
Mark Howell,61,33,62,19,23,18,393.0,25,5,21.0,37,14,13.2,No,2014,No,No,No
Stephen Gossard,20,0,9,8,6,4,48.0,0,0,1.0,9,8,14.9,No,2014,No,No,No
Daniel Collie,26,13,33,10,3,2,221.0,17,4,11.0,16,6,11.2,No,2014,No,No,No
Josh Adams,1819,398,1333,579,621,472,4299.0,572,189,325.0,761,390,27.0,No,2014,No,No,No
Larry Nance,1386,172,978,510,428,330,3631.0,117,36,193.0,861,474,22.8,Yes,2014,No,Yes,Yes
Riley Grabau,852,239,605,232,246,217,3457.0,465,171,143.0,140,61,15.1,No,2014,No,No,No
Nathan Sobey,439,88,340,145,161,109,1434.0,128,40,64.0,212,105,20.1,No,2014,No,No,No
Jerron Granberry,1273,167,978,365,378,310,3766.0,654,233,204.0,324,132,19.4,No,2014,No,No,No
Derek Cooke Jr.,589,73,378,244,215,100,2109.0,3,1,96.0,375,243,16.6,No,2014,No,No,No
Charles Hankerson Jr.,539,157,485,183,161,93,2066.0,240,80,108.0,245,103,19.0,No,2014,No,No,No
Trey Washington,160,51,149,52,45,27,773.0,103,29,35.0,46,23,15.7,No,2014,No,No,No
Matt Sellers,77,11,62,31,25,15,280.0,0,0,22.0,62,31,20.8,No,2014,No,No,No
Aaron Tyser,13,1,7,5,0,0,18.0,4,3,2.0,3,2,30.4,No,2014,No,No,No
Jack Bentz,35,50,44,12,23,11,414.0,7,0,16.0,37,12,10.3,No,2014,No,No,No
Austin Haldorson,37,4,43,14,4,4,216.0,17,5,6.0,26,9,14.0,No,2014,No,No,No
Zane Stull,0,0,0,0,0,0,6.0,0,0,1.0,0,0,10.1,No,2014,No,No,No
Semaj Christon,1034,281,785,363,421,282,2227.0,77,26,198.0,708,337,28.2,Yes,2014,No,No,No
Justin Martin,769,82,589,262,215,153,2196.0,273,92,140.0,316,170,20.0,No,2014,No,No,No
Matt Stainbrook,1481,250,1055,601,410,274,3489.0,21,5,237.0,1034,596,22.0,No,2014,No,No,No
Isaiah Philmore,1169,69,819,412,441,321,3212.0,82,24,165.0,737,388,19.5,No,2014,No,No,No
Dee Davis,874,493,722,284,249,185,3417.0,350,121,249.0,372,163,16.9,No,2014,No,No,No
Myles Davis,930,245,722,273,262,216,2601.0,462,168,135.0,260,105,19.1,No,2014,No,No,No
James Farr,692,40,554,278,155,101,1740.0,111,35,103.0,443,243,21.0,No,2014,No,No,No
Jalen Reynolds,811,41,581,328,234,153,1818.0,7,2,114.0,574,326,22.3,No,2014,No,No,No
Brandon Randolph,838,353,724,297,239,173,2676.0,222,71,232.0,502,226,19.7,No,2014,No,No,No
Erik Stenger,84,8,63,34,45,16,440.0,0,0,22.0,63,34,13.0,No,2014,No,No,No
Kamall Richards,5,2,7,2,1,1,23.0,2,0,2.0,5,2,21.4,No,2014,No,No,No
Tim Whelan,1,0,4,0,2,1,18.0,0,0,4.0,4,0,26.8,No,2014,No,No,No
Landen Amos,9,3,12,1,14,7,183.0,0,0,6.0,12,1,7.3,No,2014,No,No,No
Kevin Coker,2,0,2,1,0,0,19.0,0,0,1.0,2,1,8.1,No,2014,No,No,No
Tim Stainbrook,3,3,6,1,2,0,70.0,5,1,1.0,1,0,5.7,No,2014,No,No,No
Justin Sears,1700,198,1184,607,707,475,3507.0,37,11,281.0,1147,596,26.8,No,2014,No,No,No
Javier Duren,1134,312,849,333,445,352,2724.0,341,116,267.0,508,217,25.8,No,2014,No,No,No
Armani Cotton,695,95,549,214,237,180,2379.0,266,87,118.0,283,127,17.3,No,2014,No,No,No
Brandon Sherrod,847,93,584,294,437,259,2304.0,2,0,125.0,582,294,20.3,No,2014,No,No,No
Matt Townsend,613,102,474,240,191,132,2218.0,8,1,122.0,466,239,16.4,No,2014,No,No,No
Nick Victor,428,167,358,161,132,59,2047.0,126,47,144.0,232,114,14.1,No,2014,No,No,No
Jack Montague,571,170,463,187,80,57,1864.0,322,140,135.0,141,47,17.9,No,2014,No,No,No
Greg Kelley,396,41,347,138,69,53,1149.0,196,67,45.0,151,71,19.6,No,2014,No,No,No
Jesse Pritchard,203,43,190,63,54,36,1215.0,129,41,39.0,61,22,10.9,No,2014,No,No,No
Anthony Dallier,527,198,437,169,174,119,2097.0,208,70,121.0,229,99,15.6,No,2014,No,No,No
Isaiah Salafia,141,50,132,42,40,29,744.0,75,28,67.0,57,14,15.2,No,2014,No,No,No
J.T. Flowers,19,1,18,7,8,2,63.0,7,3,1.0,11,4,18.8,No,2014,No,No,No
Will Childs-Klein,39,6,36,17,8,4,96.0,5,1,11.0,31,16,27.5,No,2014,No,No,No
Sam Downey,609,45,443,250,148,104,1567.0,18,5,59.0,425,245,18.7,No,2014,No,No,No
A.J. Edwards,17,6,18,5,6,4,81.0,16,3,4.0,2,2,15.9,No,2014,No,No,No
Khaliq Ghani,117,19,97,38,22,17,455.0,67,24,24.0,30,14,14.8,No,2014,No,No,No
Kendrick Perry,1991,505,1374,643,670,504,4183.0,577,201,241.0,797,442,24.0,No,2014,No,No,No
Ryan Weber,1095,173,829,350,224,182,3090.0,562,213,173.0,267,137,18.3,No,2014,No,No,No
Bobby Hain,1187,151,925,469,324,225,2786.0,104,24,144.0,821,445,22.4,No,2014,No,No,No
Kamren Belin,728,99,623,244,154,123,1984.0,328,117,111.0,295,127,21.0,No,2014,No,No,No
DJ Cole,803,418,619,260,299,210,3071.0,211,73,227.0,408,187,16.6,No,2014,No,No,No
Shawn Amiker,777,91,580,289,288,186,2306.0,50,13,153.0,530,276,19.5,No,2014,No,No,No
Marcus Keene,1602,293,1199,527,385,310,2655.0,625,238,242.0,574,289,29.1,No,2014,No,No,No
Kyle Steward,655,56,517,227,172,120,1678.0,206,81,96.0,311,146,20.1,No,2014,No,No,No
Fletcher Larson,132,25,129,59,17,14,792.0,0,0,32.0,129,59,11.1,No,2014,No,No,No
Jalon Plummer,97,19,101,34,34,19,404.0,50,10,23.0,51,24,17.8,No,2014,No,No,No
Mike Podolsky,32,9,43,11,9,2,265.0,25,8,11.0,18,3,11.4,No,2014,No,No,No
Ronnye Beamon,272,44,203,93,116,67,1171.0,48,19,61.0,155,74,13.1,No,2014,No,No,No
Josh Chojnacki,100,20,85,37,34,23,696.0,17,3,33.0,68,34,10.1,No,2014,No,No,No
Larry Johnson,23,2,23,8,18,7,114.0,0,0,5.0,23,8,16.5,Yes,2014,Yes,Yes,Yes
