Name,Points,Assists,FGA,FG,FTAs,FTs,Minutes,3s attempts,3s,turnovers,2s attempts,2s,usage,Appear_In_NBA,Year
JaMychal Green,1656,152,1184,614,598,425,3340,17,3,312,1167,611,27.4,Yes,2012
Tony Mitchell,1128,106,929,458,227,143,2549,229,69,125,700,389,23.8,Yes,2012
Carrick Felix,955,125,748,341,247,174,2626,304,99,162,444,242,21,Yes,2012
Solomon Hill,1430,304,1012,487,458,341,4030,307,115,290,705,372,19.7,Yes,2012
Nick Johnson,1333,304,1048,441,418,307,3339,401,144,197,647,297,22.7,Yes,2012
James White,863,78,706,357,240,146,2188,15,3,157,691,354,22.6,Yes,2012
Mitchell Anderson,602,70,575,231,164,97,1687,162,43,110,413,188,23.2,Yes,2012
Clay Johnson,148,82,106,52,66,42,1065,17,2,90,89,50,11.1,Yes,2012
Mo Williams,368,93,314,110,144,101,2002,163,47,103,151,63,12.3,Yes,2012
Pierre Jackson,1235,478,884,390,369,298,2424,414,157,256,470,233,27.1,Yes,2012
Quincy Acy,1360,86,835,503,496,351,3488,7,3,214,828,500,19.1,Yes,2012
Quincy Miller,393,53,309,138,114,93,903,69,24,66,240,114,23.9,Yes,2012
Anthony Jones,738,89,600,272,155,109,2653,247,85,129,353,187,15.2,Yes,2012
Cory Jefferson,1159,51,794,431,424,280,2589,50,17,101,744,414,21.4,Yes,2012
Ian Clark,1920,289,1406,681,269,218,3818,800,340,277,606,341,23.6,Yes,2012
Ryan Anderson,1787,151,1295,630,706,495,3906,120,32,235,1175,598,25.9,Yes,2012
Dee Brown,1041,193,874,375,249,188,2773,279,103,164,595,272,21.2,Yes,2012
Brandon Davies,1680,213,1166,609,691,456,3251,18,6,283,1148,603,26.4,Yes,2012
Mike Muscala,2036,211,1443,723,695,569,3815,67,21,217,1376,702,28.4,Yes,2012
Eddie Miller,650,88,552,233,162,113,1562,196,71,115,356,162,25.3,Yes,2012
Chris McNealy,1207,277,1062,439,278,198,3480,355,131,177,707,308,19.9,Yes,2012
Phil Martin,951,70,792,353,218,180,2005,184,65,146,608,288,27.5,Yes,2012
Robert Smith,846,293,818,288,244,165,2914,347,105,274,471,183,21.6,Yes,2012
Orlando Johnson,2208,319,1615,738,708,510,3878,568,222,324,1047,516,31.3,Yes,2012
James Nunnally,1685,247,1201,558,487,382,3618,484,187,276,717,371,25,Yes,2012
Alan Williams,1732,117,1295,637,649,458,3026,3,0,196,1292,637,32,Yes,2012
Allen Crabbe,1537,219,1195,533,320,262,3402,547,209,182,648,324,23.3,Yes,2012
Jorge Gutierrez,1232,423,959,412,438,323,3425,250,85,274,709,327,21.8,Yes,2012
Joe Harris,47,5,42,19,4,0,151,24,9,6,18,10,14.9,Yes,2012
Terrence Williams,972,228,857,326,372,265,2930,195,55,244,662,271,21.6,Yes,2012
Aaron Williams,240,29,279,91,60,36,936,95,22,73,184,69,20.2,Yes,2012
Sean Kilpatrick,2145,279,1687,707,536,418,4315,901,313,236,786,394,26,Yes,2012
Justin Jackson,770,166,633,322,267,124,2740,21,2,212,612,320,18.3,Yes,2012
Devin Booker,1154,99,897,445,368,242,3089,80,22,199,817,423,21.8,Yes,2012
Greg Smith,1051,133,839,356,391,282,2578,163,57,212,676,299,25.1,Yes,2012
Andre Roberson,1012,119,741,382,340,198,2970,143,50,183,598,332,19,Yes,2012
Spencer Dinwiddie,1115,227,690,290,506,420,2590,298,115,153,392,175,21.8,Yes,2012
Jeremy Lamb,1060,124,828,399,180,145,2406,336,117,120,492,282,22.2,Yes,2012
Shabazz Napier,1959,646,1447,595,626,509,4614,693,260,350,754,335,24,Yes,2012
Andre Drummond,340,15,292,157,88,26,967,2,0,52,290,157,20.9,Yes,2012
Doug McDermott,3150,194,2075,1141,715,594,4569,598,274,321,1477,867,32.3,Yes,2012
Chris Johnson,1467,145,1095,468,357,295,3439,636,236,158,459,232,21,Yes,2012
Kyle Anderson,1292,138,1152,435,198,153,4048,780,269,149,372,166,17.6,Yes,2012
Royce O'Neale,1268,400,862,411,401,301,4057,363,145,258,499,266,18.1,Yes,2012
Ray McCallum,1618,451,1173,546,593,429,3519,335,97,233,838,449,23.7,Yes,2012
Damion Lee,2016,244,1468,636,578,487,4104,710,257,217,758,379,26,Yes,2012
Austin Rivers,527,71,402,174,184,121,1129,159,58,79,243,116,25.2,Yes,2012
Seth Curry,2101,290,1582,682,498,412,4357,825,325,225,757,357,23.8,Yes,2012
Mason Plumlee,1384,212,915,525,569,332,3652,10,2,282,905,523,20.2,Yes,2012
Ryan Kelly,949,117,682,314,272,219,2437,269,102,104,413,212,18.8,Yes,2012
Andre Dawkins,1014,66,763,330,160,123,2468,568,231,88,195,99,18.7,Yes,2012
Miles Plumlee,650,45,470,262,200,125,2133,1,1,138,469,261,16.2,Yes,2012
Quinn Cook,1571,509,1235,534,313,267,4033,629,236,201,606,298,20.2,Yes,2012
Michael Gbinije,1177,310,900,409,313,200,3061,411,159,194,489,250,21.1,Yes,2012
T.J. McConnell,1414,751,1123,550,235,176,4425,363,138,281,760,412,17.4,Yes,2012
Alfonzo McKinnie,689,23,536,271,193,120,1811,77,27,121,459,244,21.9,Yes,2012
Quintin Dailey,230,59,220,81,43,31,1049,112,37,60,108,44,15.4,Yes,2012
Brandon Williams,0,1,4,0,0,0,12,1,0,1,3,0,17.5,Yes,2012
Reggie Lewis,1176,167,1139,432,172,124,3169,517,188,143,622,244,20.3,Yes,2012
Bernard Thompson,1835,246,1466,636,487,344,4031,601,219,278,865,417,24.8,Yes,2012
Bernard James,671,24,437,274,233,123,1698,0,0,123,437,274,19.7,Yes,2012
Okaro White,1402,95,944,466,502,401,3417,211,69,217,733,397,21,Yes,2012
Bradley Beal,546,83,393,175,173,133,1267,186,63,79,207,112,23,Yes,2012
Erik Murphy,1052,95,773,397,152,115,2488,329,143,139,444,254,21,Yes,2012
Tyler Johnson,1350,303,1077,491,348,249,3538,320,119,176,757,372,21.5,Yes,2012
Jordan Loyd,165,51,150,55,62,41,588,54,14,46,96,41,20.1,Yes,2012
Hollis Thompson,859,105,645,308,170,115,2434,291,128,107,354,180,18.3,Yes,2012
Henry Sims,591,167,447,214,246,161,1822,17,2,158,430,212,21.3,Yes,2012
Kentavious Caldwell-Pope,1013,96,814,338,250,188,2114,439,149,100,375,189,27,Yes,2012
Marcus Thornton,829,91,687,289,361,230,2885,72,21,165,615,268,18.9,Yes,2012
Elias Harris,1857,177,1289,666,618,447,3785,219,78,242,1070,588,24.6,Yes,2012
Robert Sacre,1270,91,812,409,614,451,2946,4,1,220,808,408,22.8,Yes,2012
David Stockton,661,423,526,223,207,145,2741,229,70,202,297,153,15.5,Yes,2012
Devin Brown,1427,149,1047,439,450,358,2991,507,191,230,540,248,25.6,Yes,2012
Malcolm Miller,1013,164,746,332,319,244,2917,284,105,175,462,227,20.1,Yes,2012
Jonathon Simmons,441,65,301,154,141,101,902,83,32,100,218,122,26.1,Yes,2012
Joe Young,2304,351,1718,778,519,460,4333,739,288,221,979,490,25.3,Yes,2012
Brandon Paul,1654,310,1356,521,554,401,3665,650,211,312,706,310,27.5,Yes,2012
Meyers Leonard,502,48,349,198,144,105,1290,12,1,94,337,197,21.1,Yes,2012
Myke Henry,991,76,808,384,209,147,2344,228,76,178,580,308,23.9,Yes,2012
Cody Zeller,1157,92,674,399,475,359,2087,2,0,141,672,399,25.4,Yes,2012
Victor Oladipo,1117,175,754,406,359,257,2558,142,48,203,612,358,22.7,Yes,2012
Scott Machado,1613,880,1232,529,584,432,4143,360,123,440,872,406,23.6,Yes,2012
Royce White,456,170,328,175,205,102,1072,12,4,130,316,171,26.5,Yes,2012
Chris Babb,942,215,802,302,161,118,3448,613,220,102,189,82,14.5,Yes,2012
Dion Waiters,77,46,63,22,47,33,385,13,0,30,50,22,15.6,Yes,2012
Rodney McGruder,1576,186,1257,568,332,252,3702,494,188,171,763,380,21.3,Yes,2012
Thomas Robinson,1026,101,753,395,378,229,1960,14,7,173,739,388,28.3,Yes,2012
Tyshawn Taylor,1580,575,1156,551,506,358,4039,324,120,379,832,431,21.8,Yes,2012
Jeff Withey,938,69,576,327,390,283,2319,1,1,138,575,326,19.7,Yes,2012
Anthony Davis,567,50,337,210,203,144,1281,20,3,41,317,207,18.8,Yes,2012
Doron Lamb,1018,122,693,336,249,202,2327,303,144,94,390,192,19.9,Yes,2012
Michael Kidd-Gilchrist,476,75,326,160,192,143,1245,51,13,87,275,147,20.6,Yes,2012
Terrence Jones,1064,111,820,383,401,256,2311,128,42,137,692,341,25.4,Yes,2012
Marquis Teague,401,191,352,145,119,85,1303,80,26,109,272,119,20.2,Yes,2012
Darius Miller,1248,278,990,444,227,185,3789,462,175,214,528,269,17.3,Yes,2012
Kyle Wiltjer,1909,190,1417,690,341,281,3504,583,248,186,834,442,26,Yes,2012
Mike James,847,107,709,313,183,147,1437,218,74,106,491,239,29.1,Yes,2012
Stan Brown,679,38,544,252,273,175,2085,4,0,120,540,252,18.1,Yes,2012
Jordan Hamilton,403,45,327,139,89,67,1375,179,58,63,148,81,15.7,Yes,2012
Marvin Williams,493,24,413,205,132,81,1372,9,2,95,404,203,21.6,Yes,2012
Casper Ware,1841,545,1458,586,582,456,4319,610,213,368,848,373,25.1,Yes,2012
David Robinson,578,88,465,178,160,131,1800,264,91,93,201,87,17.1,Yes,2012
Anthony Taylor,89,24,91,29,46,28,357,14,3,50,77,26,22.1,Yes,2012
Elfrid Payton,1426,486,1032,501,645,394,3155,112,30,336,920,471,25.6,Yes,2012
Darnell Jackson,65,12,64,24,21,11,326,19,6,19,45,18,13.9,Yes,2012
Fred Brown,1150,207,1042,416,184,135,2716,479,183,219,563,233,27.6,Yes,2012
Justin Hamilton,758,45,540,289,239,177,2091,12,3,101,528,286,18.4,Yes,2012
Ronald Martin,0,0,0,0,0,0,1,0,0,0,0,0,0,Yes,2012
Russ Smith,1908,378,1501,620,642,488,3228,521,180,316,980,440,32.6,Yes,2012
Chris Smith,1310,222,1115,449,357,251,3474,458,161,191,657,288,20.9,Yes,2012
Gorgui Dieng,851,127,620,338,272,174,2789,3,1,166,617,337,16.4,Yes,2012
Peyton Siva,1215,677,989,412,396,292,3774,340,99,384,649,313,20.7,Yes,2012
Mark Jackson,17,4,22,7,0,0,98,9,3,10,13,4,17.6,Yes,2012
Darius Johnson-Odom,1649,262,1257,558,432,312,3238,549,221,223,708,337,26.2,Yes,2012
Jae Crowder,1049,131,762,375,287,196,2174,294,103,74,468,272,21.9,Yes,2012
Vander Blue,982,212,820,352,321,226,2727,188,52,208,632,300,22,Yes,2012
Jamil Wilson,1077,205,908,397,277,196,3067,259,87,175,649,310,20.3,Yes,2012
Alex Len,583,50,418,225,199,132,1470,9,1,93,409,224,20.7,Yes,2012
Will Barton,1062,201,842,397,262,192,2306,254,76,164,588,321,24.9,Yes,2012
Tarik Black,1130,41,722,443,440,244,2797,1,0,158,721,443,19.5,Yes,2012
Chris Crawford,1223,468,1102,431,158,119,3911,659,242,258,443,189,18.2,Yes,2012
Adonis Thomas,589,84,523,223,137,102,1511,126,41,82,397,182,22.1,Yes,2012
Chris Smith,271,40,233,83,127,80,1125,82,25,78,151,58,17.5,Yes,2012
Shane Larkin,760,245,585,256,182,147,2131,269,101,142,316,155,20.4,Yes,2012
Reggie Johnson,1039,104,723,370,416,294,2524,21,5,186,702,365,22.9,Yes,2012
Trey McKinney-Jones,998,202,772,343,254,188,3323,342,124,171,430,219,17.7,Yes,2012
DeQuan Jones,508,53,457,201,152,96,1606,59,10,123,398,191,20.7,Yes,2012
Bill Edwards,289,59,279,104,55,47,921,107,34,84,172,70,23.2,Yes,2012
Draymond Green,1517,425,1163,543,495,340,3619,252,91,277,911,452,23.7,Yes,2012
Keith Appling,1509,465,1140,491,520,389,4229,413,138,296,727,353,20.7,Yes,2012
Branden Dawson,1309,181,1013,566,317,177,3456,9,0,219,1004,566,21.2,Yes,2012
Adreian Payne,1232,85,850,447,367,277,2759,149,61,187,701,386,22.9,Yes,2012
Trey Burke,1231,416,969,436,291,226,2605,362,133,180,607,303,27.4,Yes,2012
Tim Hardaway Jr.,1532,225,1239,527,381,276,3560,589,202,182,650,325,25.2,Yes,2012
Andre Ingram,115,8,93,45,52,25,604,0,0,34,93,45,13.1,Yes,2012
Arnett Moultrie,1142,100,863,441,343,232,3020,97,28,206,766,413,21.9,Yes,2012
Rodney Hood,890,139,699,318,176,136,2200,298,118,84,401,200,20.5,Yes,2012
Kim English,1570,204,1227,515,414,301,3409,606,239,236,621,276,23.8,Yes,2012
Phil Pressey,959,580,812,321,268,203,2943,329,114,270,483,207,20.5,Yes,2012
Will Cherry,1484,397,1138,489,564,405,3565,354,101,273,784,388,25.6,Yes,2012
Kevin Henderson,111,14,101,42,20,14,437,42,13,27,59,29,17.3,Yes,2012
Kevin Thompson,1499,177,1177,584,564,330,3738,2,1,306,1175,583,22.5,Yes,2012
Isaiah Canaan,2050,385,1411,635,593,476,3876,725,304,311,686,331,26.7,Yes,2012
David Rivers,411,59,377,160,138,81,2195,46,10,56,331,150,12.7,Yes,2012
Reggie Smith,655,155,500,197,272,193,1670,210,68,150,290,129,24.9,Yes,2012
Deonte Burton,2102,515,1479,649,826,620,4393,546,184,280,933,465,25.3,Yes,2012
Drew Gordon,1007,71,752,407,277,191,2323,4,2,173,748,405,23.5,Yes,2012
Tony Snell,952,213,738,311,201,165,2583,434,165,154,304,146,20.1,Yes,2012
Cameron Bairstow,1239,102,808,418,559,401,2787,6,2,157,802,416,23.3,Yes,2012
Joe Thomas,332,37,271,151,99,30,1550,0,0,70,271,151,12.3,Yes,2012
Eric Williams,183,11,142,74,60,35,709,0,0,44,142,74,15,Yes,2012
Kyle O'Quinn,1607,122,1104,610,486,333,3542,207,54,262,897,556,23,Yes,2012
Lorenzo Brown,1167,589,955,410,382,283,3289,210,64,304,745,346,21.8,Yes,2012
C.J. Williams,779,164,681,315,112,82,2746,218,67,130,463,248,15.9,Yes,2012
Harrison Barnes,1226,96,1018,438,319,234,2198,332,116,146,686,322,27.3,Yes,2012
Tyler Zeller,1503,69,1010,548,525,407,2696,2,0,165,1008,548,24.1,Yes,2012
John Henson,1124,108,955,475,349,169,2594,24,5,166,931,470,22.7,Yes,2012
Reggie Bullock,989,169,815,358,118,85,2457,486,188,94,329,170,18.2,Yes,2012
Kendall Marshall,523,581,406,181,163,113,2101,131,48,193,275,133,14.7,Yes,2012
James Michael McAdoo,1232,111,1044,467,524,298,2696,9,0,173,1035,467,25.5,Yes,2012
Tony Mitchell,755,62,526,258,272,191,1713,141,48,143,385,210,23.2,Yes,2012
Jordan Williams,1501,126,1249,504,469,350,3389,477,143,253,772,361,25.6,Yes,2012
Luis Flores,77,19,66,26,20,10,312,42,15,23,24,11,16.3,Yes,2012
Abdel Nader,1207,127,1106,432,294,215,2845,420,128,267,686,304,27.5,Yes,2012
Reggie Hearn,671,95,484,221,202,152,1923,218,77,110,266,144,20.3,Yes,2012
Jerian Grant,1739,690,1276,556,567,448,4337,519,179,266,757,377,23.1,Yes,2012
Jack Cooley,1017,66,656,394,344,228,2435,2,1,110,654,393,21.1,Yes,2012
Pat Connaughton,1465,257,1145,515,215,167,4484,695,268,135,450,247,16.9,Yes,2012
Jared Sullinger,1282,89,849,450,495,363,2295,52,19,130,797,431,27.4,Yes,2012
Jordan Sibert,1153,158,852,366,321,237,2660,506,184,138,346,182,23.2,Yes,2012
Markel Brown,1655,308,1255,551,555,407,4088,421,146,239,834,405,22.2,Yes,2012
Kent Bazemore,1416,379,1155,516,489,284,3681,299,100,320,856,416,23.8,Yes,2012
Jared Cunningham,1271,193,835,380,566,427,2733,244,84,251,591,296,24.5,Yes,2012
Eric Moreland,640,116,445,238,294,156,2227,24,8,161,421,230,16.6,Yes,2012
Jabari Brown,1052,103,696,307,385,301,2164,355,137,136,341,170,24,Yes,2012
Tim Frazier,1543,641,1214,508,585,453,4132,239,74,355,975,434,24,Yes,2012
Don Martin,0,4,8,0,0,0,55,3,0,3,5,0,10.3,Yes,2012
Lamar Patterson,1410,427,1097,477,394,285,3628,463,171,244,634,306,22.5,Yes,2012
John Johnson,422,81,344,137,107,81,1309,187,67,78,157,70,18.9,Yes,2012
Khem Birch,611,55,392,208,292,195,1755,0,0,82,392,208,17.6,Yes,2012
Eric Washington,1251,560,892,389,469,380,3498,282,93,340,610,296,22.8,Yes,2012
Bryce Cotton,1975,384,1452,611,581,487,4314,736,266,193,716,345,22.7,Yes,2012
Robbie Hummel,1772,268,1315,583,464,390,3830,555,216,138,760,367,24.2,Yes,2012
Anthony Johnson,643,101,593,237,180,112,1756,184,57,91,409,180,22.8,Yes,2012
James Johnson,1731,479,1511,581,443,351,4285,589,218,283,922,363,22.5,Yes,2012
Javonte Green,1911,141,1350,701,739,485,3378,101,24,245,1249,677,29,Yes,2012
Derrick Williams,816,80,477,250,372,277,2056,112,39,141,365,211,21.1,Yes,2012
Chris Johnson,389,265,304,130,144,98,1762,75,31,162,229,99,16,Yes,2012
Langston Galloway,1991,296,1501,657,407,334,4720,806,343,156,695,314,21,Yes,2012
Matthew Dellavedova,1933,768,1423,590,541,465,4944,761,288,342,662,302,21.2,Yes,2012
Jamaal Franklin,1162,162,849,362,436,340,2198,325,98,218,524,264,29.9,Yes,2012
Avery Johnson,427,127,356,142,107,80,2297,182,63,105,174,79,12,Yes,2012
Torrey Craig,2128,236,1808,747,502,337,4061,899,297,347,909,450,29.5,Yes,2012
Nate Wolters,2352,668,1716,773,807,648,4204,462,158,280,1254,615,29.3,Yes,2012
Jack Foley,6,1,11,1,4,3,43,9,1,5,2,0,22,Yes,2012
Ron Anderson,752,129,528,279,362,194,2686,3,0,155,525,279,17.1,Yes,2012
Dewayne Dedmon,360,25,294,153,88,54,1156,4,0,78,290,153,19.5,Yes,2012
Jalen Jones,1635,97,1247,568,627,434,3523,208,65,212,1039,503,26.4,Yes,2012
Andrew Nicholson,2103,87,1407,809,633,456,3672,77,29,296,1330,780,29.1,Yes,2012
Chris Johnson,563,70,432,182,182,149,1309,130,50,85,302,132,23.9,Yes,2012
Maurice Harkless,497,47,427,193,139,94,1155,79,17,80,348,176,24.9,Yes,2012
Chasson Randle,2375,354,1775,760,684,551,4791,787,304,324,988,456,25.9,Yes,2012
Anthony Brown,1562,231,1211,518,410,308,4200,541,218,228,670,300,20.1,Yes,2012
Dwight Powell,1465,240,1110,515,557,402,3569,114,33,283,996,482,23.8,Yes,2012
Josh Huestis,1019,113,870,392,277,169,3376,207,66,125,663,326,17,Yes,2012
Willie Green,888,125,645,337,294,198,2282,65,16,136,580,321,20.8,Yes,2012
Kris Joseph,1476,208,1094,491,544,382,3725,338,112,217,756,379,21.9,Yes,2012
Dion Waiters,690,142,547,248,166,125,1445,198,69,78,349,179,25,Yes,2012
James Southerland,880,68,724,325,104,77,2089,413,153,66,311,172,20.4,Yes,2012
Fab Melo,311,29,229,132,85,47,1090,0,0,68,229,132,15.9,Yes,2012
Rakeem Christmas,1046,86,731,409,335,228,3126,1,0,162,730,409,17.4,Yes,2012
Michael Carter-Williams,544,345,452,180,209,142,1678,137,42,154,315,138,21.3,Yes,2012
Robert Covington,1748,145,1309,623,399,320,3536,431,182,275,878,441,25.5,Yes,2012
Kevin Murphy,2019,249,1594,706,567,416,3718,513,191,381,1081,515,30,Yes,2012
Jordan McRae,1521,209,1190,496,455,350,3088,522,179,225,668,317,27.8,Yes,2012
Jarnell Stokes,1129,129,776,411,489,307,2587,3,0,180,773,411,24.2,Yes,2012
Josh Richardson,1252,246,1005,458,314,238,3842,308,98,209,697,360,19,Yes,2012
Jason Smith,91,18,86,29,39,27,275,22,6,33,64,23,26,Yes,2012
Kevin Lynch,4,0,7,2,1,0,75,0,0,3,7,2,7.4,Yes,2012
Elston Turner,1310,207,1109,456,243,188,3194,561,210,167,548,246,24.3,Yes,2012
Khris Middleton,981,175,789,340,272,209,2263,287,92,173,502,248,25.5,Yes,2012
Julian Washburn,1526,274,1360,592,319,223,4448,349,119,213,1011,473,21.3,Yes,2012
Josh Davis,1305,176,1033,475,562,344,3675,30,11,229,1003,464,21.6,Yes,2012
Jordan Clarkson,1433,249,1075,473,487,392,2952,295,95,254,780,378,27.8,Yes,2012
Travis Wear,1052,85,843,425,228,182,2845,50,20,115,793,405,18.8,Yes,2012
David Wear,888,96,748,354,163,120,2832,142,60,120,606,294,16.8,Yes,2012
Norman Powell,1376,214,1090,503,347,259,3555,354,111,180,736,392,20.3,Yes,2012
Ryan Broekhoff,1591,246,1103,512,385,315,3642,618,252,186,485,260,21.5,Yes,2012
John Jenkins,1658,111,1102,516,374,320,2998,699,306,130,403,210,24.2,Yes,2012
Jeffery Taylor,1897,252,1378,665,652,452,3923,321,115,309,1057,550,26,Yes,2012
Festus Ezeli,934,18,587,330,469,274,2168,0,0,195,587,330,23.7,Yes,2012
Maalik Wayns,1191,323,919,379,400,339,2464,323,94,223,596,285,26.9,Yes,2012
Darrun Hilliard,1511,248,1125,491,428,320,3537,569,209,206,556,282,22.4,Yes,2012
Troy Daniels,913,48,764,297,87,68,2109,650,251,73,114,46,20.9,Yes,2012
Treveon Graham,1882,199,1431,618,645,446,3558,565,200,191,866,418,26.8,Yes,2012
Briante Weber,862,378,695,296,299,230,2965,146,40,186,549,256,17,Yes,2012
Erick Green,1742,326,1356,592,520,418,3648,414,140,178,942,452,25.3,Yes,2012
Jarell Eddie,1182,139,995,383,276,224,3176,526,192,183,469,191,21.7,Yes,2012
Dorian Finney-Smith,1429,256,1168,480,432,284,3834,511,185,240,657,295,21.9,Yes,2012
Mike Scott,1538,124,1122,585,454,352,3457,44,16,211,1078,569,24.1,Yes,2012
Joe Harris,1698,254,1276,568,414,299,4084,646,263,213,630,305,23.6,Yes,2012
Malcolm Brogdon,1809,335,1399,601,482,422,4157,507,185,207,892,416,25.3,Yes,2012
James Johnson,240,14,178,94,91,52,813,0,0,79,178,94,19.2,Yes,2012
Terrence Ross,847,82,700,317,127,97,1681,319,116,94,381,201,23.8,Yes,2012
Tony Wroten,559,130,447,198,264,154,1062,56,9,132,391,189,31.2,Yes,2012
C.J. Wilcox,1880,214,1478,640,356,299,3735,773,301,178,705,339,24.1,Yes,2012
Damian Lillard,1934,362,1310,584,600,520,3363,630,246,246,680,338,28.6,Yes,2012
Mike Brown,26,4,16,8,6,4,99,10,6,7,6,2,13.8,Yes,2012
Kevin Jones,1822,141,1475,728,378,256,4347,349,110,136,1126,618,20.8,Yes,2012
Shayne Whittington,1119,81,807,416,367,279,2574,48,8,150,759,408,22.9,Yes,2012
Toure' Murry,1539,429,1280,519,480,366,3999,434,135,340,846,384,23.5,Yes,2012
Marcus Thornton,2178,308,1649,709,551,435,4328,809,325,324,840,384,28.7,Yes,2012
Reggie King,76,47,68,25,33,24,593,12,2,32,56,23,10.5,Yes,2012
Frank Kaminsky,1458,188,1013,529,389,297,2943,279,103,121,734,426,25.5,Yes,2012
Duje Dukan,298,37,248,106,64,42,970,134,44,36,114,62,18.6,Yes,2012
Larry Nance,1386,172,978,510,428,330,3631,117,36,193,861,474,22.8,Yes,2012
Carrick Felix,955,125,748,341,247,174,2626,304,99,162,444,242,21,Yes,2012
Solomon Hill,1430,304,1012,487,458,341,4030,307,115,290,705,372,19.7,Yes,2012
Nick Johnson,1333,304,1048,441,418,307,3339,401,144,197,647,297,22.7,Yes,2012
James White,863,78,706,357,240,146,2188,15,3,157,691,354,22.6,Yes,2012
Mitchell Anderson,602,70,575,231,164,97,1687,162,43,110,413,188,23.2,Yes,2012
Mo Williams,368,93,314,110,144,101,2002,163,47,103,151,63,12.3,Yes,2012
Pierre Jackson,1235,478,884,390,369,298,2424,414,157,256,470,233,27.1,Yes,2012
Cory Jefferson,1159,51,794,431,424,280,2589,50,17,101,744,414,21.4,Yes,2012
Ian Clark,1920,289,1406,681,269,218,3818,800,340,277,606,341,23.6,Yes,2012
Ryan Anderson,1787,151,1295,630,706,495,3906,120,32,235,1175,598,25.9,Yes,2012
Brandon Davies,1680,213,1166,609,691,456,3251,18,6,283,1148,603,26.4,Yes,2012
Mike Muscala,2036,211,1443,723,695,569,3815,67,21,217,1376,702,28.4,Yes,2012
James Johnson,306,10,206,123,98,60,1186,0,0,47,206,123,12.8,Yes,2012
Ian Clark,13,5,9,4,5,3,48,6,2,7,3,2,17.9,Yes,2012
Chris McNealy,1207,277,1062,439,278,198,3480,355,131,177,707,308,19.9,Yes,2012
Robert Smith,846,293,818,288,244,165,2914,347,105,274,471,183,21.6,Yes,2012
Alan Williams,1732,117,1295,637,649,458,3026,3,0,196,1292,637,32,Yes,2012
Allen Crabbe,1537,219,1195,533,320,262,3402,547,209,182,648,324,23.3,Yes,2012
Terrence Williams,972,228,857,326,372,265,2930,195,55,244,662,271,21.6,Yes,2012
Aaron Williams,240,29,279,91,60,36,936,95,22,73,184,69,20.2,Yes,2012
Sean Kilpatrick,2145,279,1687,707,536,418,4315,901,313,236,786,394,26,Yes,2012
Justin Jackson,770,166,633,322,267,124,2740,21,2,212,612,320,18.3,Yes,2012
Devin Booker,1154,99,897,445,368,242,3089,80,22,199,817,423,21.8,Yes,2012
Greg Smith,1051,133,839,356,391,282,2578,163,57,212,676,299,25.1,Yes,2012
Spencer Dinwiddie,1115,227,690,290,506,420,2590,298,115,153,392,175,21.8,Yes,2012
Andre Roberson,1012,119,741,382,340,198,2970,143,50,183,598,332,19,Yes,2012
Shabazz Napier,1959,646,1447,595,626,509,4614,693,260,350,754,335,24,Yes,2012
Doug McDermott,3150,194,2075,1141,715,594,4569,598,274,321,1477,867,32.3,Yes,2012
Kyle Anderson,1292,138,1152,435,198,153,4048,780,269,149,372,166,17.6,Yes,2012
Royce O'Neale,1268,400,862,411,401,301,4057,363,145,258,499,266,18.1,Yes,2012
Ray McCallum,1618,451,1173,546,593,429,3519,335,97,233,838,449,23.7,Yes,2012
Damion Lee,2016,244,1468,636,578,487,4104,710,257,217,758,379,26,Yes,2012
Mason Plumlee,1384,212,915,525,569,332,3652,10,2,282,905,523,20.2,Yes,2012
Seth Curry,2101,290,1582,682,498,412,4357,825,325,225,757,357,23.8,Yes,2012
Quinn Cook,1571,509,1235,534,313,267,4033,629,236,201,606,298,20.2,Yes,2012
Ryan Kelly,949,117,682,314,272,219,2437,269,102,104,413,212,18.8,Yes,2012
Brandon Williams,0,1,4,0,0,0,12,1,0,1,3,0,17.5,Yes,2012
Reggie Lewis,1176,167,1139,432,172,124,3169,517,188,143,622,244,20.3,Yes,2012
Bernard Thompson,1835,246,1466,636,487,344,4031,601,219,278,865,417,24.8,Yes,2012
Okaro White,1402,95,944,466,502,401,3417,211,69,217,733,397,21,Yes,2012
Erik Murphy,1052,95,773,397,152,115,2488,329,143,139,444,254,21,Yes,2012
Tyler Johnson,1350,303,1077,491,348,249,3538,320,119,176,757,372,21.5,Yes,2012
Jordan Loyd,165,51,150,55,62,41,588,54,14,46,96,41,20.1,Yes,2012
Kentavious Caldwell-Pope,1013,96,814,338,250,188,2114,439,149,100,375,189,27,Yes,2012
Marcus Thornton,829,91,687,289,361,230,2885,72,21,165,615,268,18.9,Yes,2012
Elias Harris,1857,177,1289,666,618,447,3785,219,78,242,1070,588,24.6,Yes,2012
David Stockton,661,423,526,223,207,145,2741,229,70,202,297,153,15.5,Yes,2012
Malcolm Miller,1013,164,746,332,319,244,2917,284,105,175,462,227,20.1,Yes,2012
Joe Young,2304,351,1718,778,519,460,4333,739,288,221,979,490,25.3,Yes,2012
Brandon Paul,1654,310,1356,521,554,401,3665,650,211,312,706,310,27.5,Yes,2012
Myke Henry,991,76,808,384,209,147,2344,228,76,178,580,308,23.9,Yes,2012
Cody Zeller,1157,92,674,399,475,359,2087,2,0,141,672,399,25.4,Yes,2012
Victor Oladipo,1117,175,754,406,359,257,2558,142,48,203,612,358,22.7,Yes,2012
Chris Babb,942,215,802,302,161,118,3448,613,220,102,189,82,14.5,Yes,2012
Rodney McGruder,1576,186,1257,568,332,252,3702,494,188,171,763,380,21.3,Yes,2012
Jeff Withey,938,69,576,327,390,283,2319,1,1,138,575,326,19.7,Yes,2012
Kyle Wiltjer,1909,190,1417,690,341,281,3504,583,248,186,834,442,26,Yes,2012
Stan Brown,679,38,544,252,273,175,2085,4,0,120,540,252,18.1,Yes,2012
David Robinson,578,88,465,178,160,131,1800,264,91,93,201,87,17.1,Yes,2012
Anthony Taylor,89,24,91,29,46,28,357,14,3,50,77,26,22.1,Yes,2012
Elfrid Payton,1426,486,1032,501,645,394,3155,112,30,336,920,471,25.6,Yes,2012
Russ Smith,1908,378,1501,620,642,488,3228,521,180,316,980,440,32.6,Yes,2012
Peyton Siva,1215,677,989,412,396,292,3774,340,99,384,649,313,20.7,Yes,2012
Gorgui Dieng,851,127,620,338,272,174,2789,3,1,166,617,337,16.4,Yes,2012
Mark Jackson,17,4,22,7,0,0,98,9,3,10,13,4,17.6,Yes,2012
Vander Blue,982,212,820,352,321,226,2727,188,52,208,632,300,22,Yes,2012
Jamil Wilson,1077,205,908,397,277,196,3067,259,87,175,649,310,20.3,Yes,2012
Alex Len,583,50,418,225,199,132,1470,9,1,93,409,224,20.7,Yes,2012
Adonis Thomas,589,84,523,223,137,102,1511,126,41,82,397,182,22.1,Yes,2012
Chris Crawford,1223,468,1102,431,158,119,3911,659,242,258,443,189,18.2,Yes,2012
Tarik Black,1130,41,722,443,440,244,2797,1,0,158,721,443,19.5,Yes,2012
Chris Smith,271,40,233,83,127,80,1125,82,25,78,151,58,17.5,Yes,2012
Shane Larkin,760,245,585,256,182,147,2131,269,101,142,316,155,20.4,Yes,2012
Trey McKinney-Jones,998,202,772,343,254,188,3323,342,124,171,430,219,17.7,Yes,2012
Reggie Johnson,1039,104,723,370,416,294,2524,21,5,186,702,365,22.9,Yes,2012
Reggie Johnson,1254,225,1124,418,434,292,2917,427,126,211,697,292,26.1,Yes,2012
Bill Edwards,289,59,279,104,55,47,921,107,34,84,172,70,23.2,Yes,2012
Keith Appling,1509,465,1140,491,520,389,4229,413,138,296,727,353,20.7,Yes,2012
Adreian Payne,1232,85,850,447,367,277,2759,149,61,187,701,386,22.9,Yes,2012
Branden Dawson,1309,181,1013,566,317,177,3456,9,0,219,1004,566,21.2,Yes,2012
Trey Burke,1231,416,969,436,291,226,2605,362,133,180,607,303,27.4,Yes,2012
Tim Hardaway Jr.,1532,225,1239,527,381,276,3560,589,202,182,650,325,25.2,Yes,2012
Andre Ingram,115,8,93,45,52,25,604,0,0,34,93,45,13.1,Yes,2012
Phil Pressey,959,580,812,321,268,203,2943,329,114,270,483,207,20.5,Yes,2012
Jabari Brown,1052,103,696,307,385,301,2164,355,137,136,341,170,24,Yes,2012
Will Cherry,1484,397,1138,489,564,405,3565,354,101,273,784,388,25.6,Yes,2012
Kevin Henderson,111,14,101,42,20,14,437,42,13,27,59,29,17.3,Yes,2012
Isaiah Canaan,2050,385,1411,635,593,476,3876,725,304,311,686,331,26.7,Yes,2012
David Rivers,411,59,377,160,138,81,2195,46,10,56,331,150,12.7,Yes,2012
Khem Birch,611,55,392,208,292,195,1755,0,0,82,392,208,17.6,Yes,2012
Deonte Burton,2102,515,1479,649,826,620,4393,546,184,280,933,465,25.3,Yes,2012
Tony Snell,952,213,738,311,201,165,2583,434,165,154,304,146,20.1,Yes,2012
Cameron Bairstow,1239,102,808,418,559,401,2787,6,2,157,802,416,23.3,Yes,2012
Joe Thomas,332,37,271,151,99,30,1550,0,0,70,271,151,12.3,Yes,2012
Lorenzo Brown,1167,589,955,410,382,283,3289,210,64,304,745,346,21.8,Yes,2012
James Michael McAdoo,1232,111,1044,467,524,298,2696,9,0,173,1035,467,25.5,Yes,2012
Reggie Bullock,989,169,815,358,118,85,2457,486,188,94,329,170,18.2,Yes,2012
Jordan Williams,1501,126,1249,504,469,350,3389,477,143,253,772,361,25.6,Yes,2012
Tony Mitchell,755,62,526,258,272,191,1713,141,48,143,385,210,23.2,Yes,2012
Luis Flores,77,19,66,26,20,10,312,42,15,23,24,11,16.3,Yes,2012
Abdel Nader,1207,127,1106,432,294,215,2845,420,128,267,686,304,27.5,Yes,2012
Brandon Williams,0,0,5,0,2,0,16,0,0,0,5,0,16.9,Yes,2012
Reggie Hearn,671,95,484,221,202,152,1923,218,77,110,266,144,20.3,Yes,2012
Jerian Grant,1739,690,1276,556,567,448,4337,519,179,266,757,377,23.1,Yes,2012
Jack Cooley,1017,66,656,394,344,228,2435,2,1,110,654,393,21.1,Yes,2012
Pat Connaughton,1465,257,1145,515,215,167,4484,695,268,135,450,247,16.9,Yes,2012
Markel Brown,1655,308,1255,551,555,407,4088,421,146,239,834,405,22.2,Yes,2012
Eric Moreland,640,116,445,238,294,156,2227,24,8,161,421,230,16.6,Yes,2012
Tim Frazier,1543,641,1214,508,585,453,4132,239,74,355,975,434,24,Yes,2012
Lamar Patterson,1410,427,1097,477,394,285,3628,463,171,244,634,306,22.5,Yes,2012
Eric Washington,1251,560,892,389,469,380,3498,282,93,340,610,296,22.8,Yes,2012
Bryce Cotton,1975,384,1452,611,581,487,4314,736,266,193,716,345,22.7,Yes,2012
Anthony Johnson,643,101,593,237,180,112,1756,184,57,91,409,180,22.8,Yes,2012
Javonte Green,1911,141,1350,701,739,485,3378,101,24,245,1249,677,29,Yes,2012
Derrick Williams,816,80,477,250,372,277,2056,112,39,141,365,211,21.1,Yes,2012
Langston Galloway,1991,296,1501,657,407,334,4720,806,343,156,695,314,21,Yes,2012
Matthew Dellavedova,1933,768,1423,590,541,465,4944,761,288,342,662,302,21.2,Yes,2012
Jamaal Franklin,1162,162,849,362,436,340,2198,325,98,218,524,264,29.9,Yes,2012
James Johnson,240,14,178,94,91,52,813,0,0,79,178,94,19.2,Yes,2012
Torrey Craig,2128,236,1808,747,502,337,4061,899,297,347,909,450,29.5,Yes,2012
Nate Wolters,2352,668,1716,773,807,648,4204,462,158,280,1254,615,29.3,Yes,2012
Jack Foley,6,1,11,1,4,3,43,9,1,5,2,0,22,Yes,2012
Dewayne Dedmon,360,25,294,153,88,54,1156,4,0,78,290,153,19.5,Yes,2012
Jalen Jones,1635,97,1247,568,627,434,3523,208,65,212,1039,503,26.4,Yes,2012
Malcolm Miller,920,68,685,326,134,98,1766,404,170,74,281,156,24.2,Yes,2012
Chris Johnson,563,70,432,182,182,149,1309,130,50,85,302,132,23.9,Yes,2012
Dwight Powell,1465,240,1110,515,557,402,3569,114,33,283,996,482,23.8,Yes,2012
Chasson Randle,2375,354,1775,760,684,551,4791,787,304,324,988,456,25.9,Yes,2012
Josh Huestis,1019,113,870,392,277,169,3376,207,66,125,663,326,17,Yes,2012
Anthony Brown,1562,231,1211,518,410,308,4200,541,218,228,670,300,20.1,Yes,2012
Willie Green,888,125,645,337,294,198,2282,65,16,136,580,321,20.8,Yes,2012
Michael Carter-Williams,544,345,452,180,209,142,1678,137,42,154,315,138,21.3,Yes,2012
James Southerland,880,68,724,325,104,77,2089,413,153,66,311,172,20.4,Yes,2012
Rakeem Christmas,1046,86,731,409,335,228,3126,1,0,162,730,409,17.4,Yes,2012
Robert Covington,1748,145,1309,623,399,320,3536,431,182,275,878,441,25.5,Yes,2012
Jordan McRae,1521,209,1190,496,455,350,3088,522,179,225,668,317,27.8,Yes,2012
Jarnell Stokes,1129,129,776,411,489,307,2587,3,0,180,773,411,24.2,Yes,2012
Josh Richardson,1252,246,1005,458,314,238,3842,308,98,209,697,360,19,Yes,2012
Elston Turner,1310,207,1109,456,243,188,3194,561,210,167,548,246,24.3,Yes,2012
Julian Washburn,1526,274,1360,592,319,223,4448,349,119,213,1011,473,21.3,Yes,2012
Josh Davis,1305,176,1033,475,562,344,3675,30,11,229,1003,464,21.6,Yes,2012
Travis Wear,1052,85,843,425,228,182,2845,50,20,115,793,405,18.8,Yes,2012
Kyle Anderson,865,355,670,303,303,223,2242,96,36,183,574,267,22.2,Yes,2012
David Wear,888,96,748,354,163,120,2832,142,60,120,606,294,16.8,Yes,2012
Norman Powell,1376,214,1090,503,347,259,3555,354,111,180,736,392,20.3,Yes,2012
Ryan Broekhoff,1591,246,1103,512,385,315,3642,618,252,186,485,260,21.5,Yes,2012
Darrun Hilliard,1511,248,1125,491,428,320,3537,569,209,206,556,282,22.4,Yes,2012
Treveon Graham,1882,199,1431,618,645,446,3558,565,200,191,866,418,26.8,Yes,2012
Troy Daniels,913,48,764,297,87,68,2109,650,251,73,114,46,20.9,Yes,2012
Briante Weber,862,378,695,296,299,230,2965,146,40,186,549,256,17,Yes,2012
Erick Green,1742,326,1356,592,520,418,3648,414,140,178,942,452,25.3,Yes,2012
Jarell Eddie,1182,139,995,383,276,224,3176,526,192,183,469,191,21.7,Yes,2012
Joe Harris,1698,254,1276,568,414,299,4084,646,263,213,630,305,23.6,Yes,2012
C.J. Wilcox,1880,214,1478,640,356,299,3735,773,301,178,705,339,24.1,Yes,2012
Mike Brown,1309,235,1065,446,421,304,3396,335,113,226,730,333,21.7,Yes,2012
Shayne Whittington,1119,81,807,416,367,279,2574,48,8,150,759,408,22.9,Yes,2012
Marcus Thornton,2178,308,1649,709,551,435,4328,809,325,324,840,384,28.7,Yes,2012
Reggie King,76,47,68,25,33,24,593,12,2,32,56,23,10.5,Yes,2012
Frank Kaminsky,1458,188,1013,529,389,297,2943,279,103,121,734,426,25.5,Yes,2012
Larry Nance,1386,172,978,510,428,330,3631,117,36,193,861,474,22.8,Yes,2012
Nick Johnson,1333,304,1048,441,418,307,3339,401,144,197,647,297,22.7,Yes,2012
T.J. McConnell,1414,751,1123,550,235,176,4425,363,138,281,760,412,17.4,Yes,2012
Chris Johnson,4,0,1,1,2,1,6,1,1,0,0,0,17.1,Yes,2012
James White,863,78,706,357,240,146,2188,15,3,157,691,354,22.6,Yes,2012
Mo Williams,368,93,314,110,144,101,2002,163,47,103,151,63,12.3,Yes,2012
Cory Jefferson,1159,51,794,431,424,280,2589,50,17,101,744,414,21.4,Yes,2012
Royce O'Neale,1268,400,862,411,401,301,4057,363,145,258,499,266,18.1,Yes,2012
Ryan Anderson,1787,151,1295,630,706,495,3906,120,32,235,1175,598,25.9,Yes,2012
James Johnson,306,10,206,123,98,60,1186,0,0,47,206,123,12.8,Yes,2012
Avery Johnson,427,127,356,142,107,80,2297,182,63,105,174,79,12,Yes,2012
Chris McNealy,1207,277,1062,439,278,198,3480,355,131,177,707,308,19.9,Yes,2012
Alan Williams,1732,117,1295,637,649,458,3026,3,0,196,1292,637,32,Yes,2012
Terrence Williams,972,228,857,326,372,265,2930,195,55,244,662,271,21.6,Yes,2012
Sean Kilpatrick,2145,279,1687,707,536,418,4315,901,313,236,786,394,26,Yes,2012
Justin Jackson,770,166,633,322,267,124,2740,21,2,212,612,320,18.3,Yes,2012
Spencer Dinwiddie,1115,227,690,290,506,420,2590,298,115,153,392,175,21.8,Yes,2012
Shabazz Napier,1959,646,1447,595,626,509,4614,693,260,350,754,335,24,Yes,2012
Doug McDermott,3150,194,2075,1141,715,594,4569,598,274,321,1477,867,32.3,Yes,2012
Jordan Sibert,1153,158,852,366,321,237,2660,506,184,138,346,182,23.2,Yes,2012
Kyle Anderson,1292,138,1152,435,198,153,4048,780,269,149,372,166,17.6,Yes,2012
Damion Lee,2016,244,1468,636,578,487,4104,710,257,217,758,379,26,Yes,2012
Rodney Hood,890,139,699,318,176,136,2200,298,118,84,401,200,20.5,Yes,2012
Quinn Cook,1571,509,1235,534,313,267,4033,629,236,201,606,298,20.2,Yes,2012
Andre Dawkins,1014,66,763,330,160,123,2468,568,231,88,195,99,18.7,Yes,2012
Reggie Smith,655,155,500,197,272,193,1670,210,68,150,290,129,24.9,Yes,2012
Anthony Johnson,89,17,75,32,27,17,399,25,8,23,50,24,14.8,Yes,2012
Reggie Lewis,1176,167,1139,432,172,124,3169,517,188,143,622,244,20.3,Yes,2012
Bernard Thompson,1835,246,1466,636,487,344,4031,601,219,278,865,417,24.8,Yes,2012
Okaro White,1402,95,944,466,502,401,3417,211,69,217,733,397,21,Yes,2012
Dorian Finney-Smith,1429,256,1168,480,432,284,3834,511,185,240,657,295,21.9,Yes,2012
Tyler Johnson,1350,303,1077,491,348,249,3538,320,119,176,757,372,21.5,Yes,2012
Marcus Thornton,829,91,687,289,361,230,2885,72,21,165,615,268,18.9,Yes,2012
David Stockton,661,423,526,223,207,145,2741,229,70,202,297,153,15.5,Yes,2012
Alfonzo McKinnie,689,23,536,271,193,120,1811,77,27,121,459,244,21.9,Yes,2012
Malcolm Miller,1013,164,746,332,319,244,2917,284,105,175,462,227,20.1,Yes,2012
Mike Scott,715,235,605,264,146,109,1663,226,78,87,379,186,23.5,Yes,2012
Tarik Black,1130,41,722,443,440,244,2797,1,0,158,721,443,19.5,Yes,2012
Elfrid Payton,1426,486,1032,501,645,394,3155,112,30,336,920,471,25.6,Yes,2012
Marvin Williams,493,24,413,205,132,81,1372,9,2,95,404,203,21.6,Yes,2012
Russ Smith,1908,378,1501,620,642,488,3228,521,180,316,980,440,32.6,Yes,2012
Jamil Wilson,1077,205,908,397,277,196,3067,259,87,175,649,310,20.3,Yes,2012
Deonte Burton,1052,108,845,404,265,176,2053,168,68,150,677,336,27.7,Yes,2012
Chris Crawford,1223,468,1102,431,158,119,3911,659,242,258,443,189,18.2,Yes,2012
Reggie Johnson,1254,225,1124,418,434,292,2917,427,126,211,697,292,26.1,Yes,2012
Bill Edwards,289,59,279,104,55,47,921,107,34,84,172,70,23.2,Yes,2012
Adreian Payne,1232,85,850,447,367,277,2759,149,61,187,701,386,22.9,Yes,2012
Keith Appling,1509,465,1140,491,520,389,4229,413,138,296,727,353,20.7,Yes,2012
Branden Dawson,1309,181,1013,566,317,177,3456,9,0,219,1004,566,21.2,Yes,2012
Jabari Brown,1052,103,696,307,385,301,2164,355,137,136,341,170,24,Yes,2012
Jordan Clarkson,1433,249,1075,473,487,392,2952,295,95,254,780,378,27.8,Yes,2012
David Rivers,411,59,377,160,138,81,2195,46,10,56,331,150,12.7,Yes,2012
Khem Birch,611,55,392,208,292,195,1755,0,0,82,392,208,17.6,Yes,2012
Deonte Burton,2102,515,1479,649,826,620,4393,546,184,280,933,465,25.3,Yes,2012
Cameron Bairstow,1239,102,808,418,559,401,2787,6,2,157,802,416,23.3,Yes,2012
Joe Thomas,332,37,271,151,99,30,1550,0,0,70,271,151,12.3,Yes,2012
James Michael McAdoo,1232,111,1044,467,524,298,2696,9,0,173,1035,467,25.5,Yes,2012
Jordan Williams,1501,126,1249,504,469,350,3389,477,143,253,772,361,25.6,Yes,2012
Anthony Johnson,1020,61,779,334,238,196,2009,412,156,122,367,178,25.1,Yes,2012
Pat Connaughton,1465,257,1145,515,215,167,4484,695,268,135,450,247,16.9,Yes,2012
Jerian Grant,1739,690,1276,556,567,448,4337,519,179,266,757,377,23.1,Yes,2012
Markel Brown,1655,308,1255,551,555,407,4088,421,146,239,834,405,22.2,Yes,2012
Eric Moreland,640,116,445,238,294,156,2227,24,8,161,421,230,16.6,Yes,2012
Joe Young,2304,351,1718,778,519,460,4333,739,288,221,979,490,25.3,Yes,2012
Tim Frazier,1543,641,1214,508,585,453,4132,239,74,355,975,434,24,Yes,2012
John Johnson,422,81,344,137,107,81,1309,187,67,78,157,70,18.9,Yes,2012
Lamar Patterson,1410,427,1097,477,394,285,3628,463,171,244,634,306,22.5,Yes,2012
Bryce Cotton,1975,384,1452,611,581,487,4314,736,266,193,716,345,22.7,Yes,2012
Javonte Green,1911,141,1350,701,739,485,3378,101,24,245,1249,677,29,Yes,2012
Derrick Williams,816,80,477,250,372,277,2056,112,39,141,365,211,21.1,Yes,2012
Langston Galloway,1991,296,1501,657,407,334,4720,806,343,156,695,314,21,Yes,2012
Josh Davis,1305,176,1033,475,562,344,3675,30,11,229,1003,464,21.6,Yes,2012
James Johnson,240,14,178,94,91,52,813,0,0,79,178,94,19.2,Yes,2012
Kevin Lynch,0,0,1,0,0,0,7,1,0,0,0,0,7.7,Yes,2012
Torrey Craig,2128,236,1808,747,502,337,4061,899,297,347,909,450,29.5,Yes,2012
Jack Foley,6,1,11,1,4,3,43,9,1,5,2,0,22,Yes,2012
Malcolm Miller,920,68,685,326,134,98,1766,404,170,74,281,156,24.2,Yes,2012
Chasson Randle,2375,354,1775,760,684,551,4791,787,304,324,988,456,25.9,Yes,2012
Dwight Powell,1465,240,1110,515,557,402,3569,114,33,283,996,482,23.8,Yes,2012
Anthony Brown,1562,231,1211,518,410,308,4200,541,218,228,670,300,20.1,Yes,2012
Josh Huestis,1019,113,870,392,277,169,3376,207,66,125,663,326,17,Yes,2012
Willie Green,888,125,645,337,294,198,2282,65,16,136,580,321,20.8,Yes,2012
Rakeem Christmas,1046,86,731,409,335,228,3126,1,0,162,730,409,17.4,Yes,2012
Michael Gbinije,1177,310,900,409,313,200,3061,411,159,194,489,250,21.1,Yes,2012
Jordan McRae,1521,209,1190,496,455,350,3088,522,179,225,668,317,27.8,Yes,2012
Jarnell Stokes,1129,129,776,411,489,307,2587,3,0,180,773,411,24.2,Yes,2012
Josh Richardson,1252,246,1005,458,314,238,3842,308,98,209,697,360,19,Yes,2012
Kevin Lynch,4,0,7,2,1,0,75,0,0,3,7,2,7.4,Yes,2012
Brandon Williams,186,8,133,77,60,32,761,3,0,31,130,77,12.4,Yes,2012
Julian Washburn,1526,274,1360,592,319,223,4448,349,119,213,1011,473,21.3,Yes,2012
Kyle Anderson,865,355,670,303,303,223,2242,96,36,183,574,267,22.2,Yes,2012
Norman Powell,1376,214,1090,503,347,259,3555,354,111,180,736,392,20.3,Yes,2012
Travis Wear,1052,85,843,425,228,182,2845,50,20,115,793,405,18.8,Yes,2012
David Wear,888,96,748,354,163,120,2832,142,60,120,606,294,16.8,Yes,2012
Darrun Hilliard,1511,248,1125,491,428,320,3537,569,209,206,556,282,22.4,Yes,2012
Treveon Graham,1882,199,1431,618,645,446,3558,565,200,191,866,418,26.8,Yes,2012
Briante Weber,862,378,695,296,299,230,2965,146,40,186,549,256,17,Yes,2012
Jarell Eddie,1182,139,995,383,276,224,3176,526,192,183,469,191,21.7,Yes,2012
Malcolm Brogdon,1809,335,1399,601,482,422,4157,507,185,207,892,416,25.3,Yes,2012
Joe Harris,1698,254,1276,568,414,299,4084,646,263,213,630,305,23.6,Yes,2012
C.J. Wilcox,1880,214,1478,640,356,299,3735,773,301,178,705,339,24.1,Yes,2012
Mike Brown,1309,235,1065,446,421,304,3396,335,113,226,730,333,21.7,Yes,2012
Shayne Whittington,1119,81,807,416,367,279,2574,48,8,150,759,408,22.9,Yes,2012
Marcus Thornton,2178,308,1649,709,551,435,4328,809,325,324,840,384,28.7,Yes,2012
Frank Kaminsky,1458,188,1013,529,389,297,2943,279,103,121,734,426,25.5,Yes,2012
Duje Dukan,298,37,248,106,64,42,970,134,44,36,114,62,18.6,Yes,2012
Larry Nance,1386,172,978,510,428,330,3631,117,36,193,861,474,22.8,Yes,2012
Michael Lyons,1527,214,1201,549,383,287,3482,448,142,228,753,407,26.7,No,2012
Mike Fitzgerald,804,90,551,261,200,162,2389,305,120,115,246,141,18.3,No,2012
Taylor Broekhuis,828,149,606,303,266,170,2743,180,52,176,426,251,19.1,No,2012
Todd Fletcher,822,366,644,292,145,118,3441,334,120,172,310,172,14.8,No,2012
Taylor Stewart,352,120,296,128,137,79,1505,54,17,104,242,111,18.3,No,2012
Kamryn Williams,554,157,465,204,159,105,1807,127,41,127,338,163,20.6,No,2012
Justin Hammonds,530,111,361,196,205,118,1758,50,20,110,311,176,18.1,No,2012
Kyle Green,240,69,201,76,52,41,744,134,47,49,67,29,20.7,No,2012
Max Yon,828,164,648,280,232,174,2206,289,94,154,359,186,23.1,No,2012
Chris Carter,36,17,30,8,35,20,232,10,0,19,20,8,16.5,No,2012
DeLovell Earls,291,121,262,108,111,58,1207,64,17,100,198,91,19.1,No,2012
Chase Kammerer,74,32,59,25,42,22,373,11,2,25,48,23,15.5,No,2012
Colt Barnhill,19,5,23,6,12,6,89,5,1,3,18,5,20.7,No,2012
Shawn Hempsey,85,70,96,33,31,13,743,38,6,45,58,27,12.4,No,2012
Marek Olesinski,750,121,578,265,134,97,2234,326,123,103,252,142,18.6,No,2012
Adam Brakeville,19,4,14,7,7,5,138,0,0,6,14,7,9.9,No,2012
Brian Davidson,0,0,0,0,0,0,1,0,0,1,0,0,58.2,No,2012
Scott Stucky,4,0,7,2,0,0,15,4,0,0,3,2,27.4,No,2012
Zeke Marshall,1265,97,857,470,518,323,3213,8,2,196,849,468,20.6,No,2012
Nikola Cvetinovic,1158,197,964,452,365,235,3065,61,19,232,903,433,22.9,No,2012
Alex Abreu,833,450,622,258,239,189,2530,319,128,245,303,130,19.8,No,2012
Quincy Diggs,1003,222,781,338,315,215,2830,316,112,246,465,226,21.5,No,2012
Brian Walsh,532,94,430,176,122,92,1731,231,88,64,199,88,16,No,2012
Nick Harney,781,77,606,298,238,159,1686,101,26,151,505,272,26.3,No,2012
Demetrius Treadwell,1101,143,875,424,454,252,2554,13,1,194,862,423,25.7,No,2012
Chauncey Gilliam,1119,105,886,404,247,192,2843,323,119,130,563,285,21,No,2012
Brett McClanahan,713,130,667,247,78,58,2290,465,161,108,202,86,18.2,No,2012
Adedeji Ibitayo,598,68,453,192,209,138,1508,219,76,89,234,116,22,No,2012
Josh Egner,49,3,50,19,20,11,193,3,0,14,47,19,19.6,No,2012
C.J. Oldham,11,4,12,5,0,0,53,3,1,5,9,4,16.4,No,2012
Kyle Petersen,8,0,10,2,5,4,33,6,0,2,4,2,22.3,No,2012
Michael Green,1,1,4,0,2,1,18,3,0,0,1,0,13.9,No,2012
Luke Avsec,0,2,1,0,0,0,17,1,0,3,0,0,11.9,No,2012
Casey Cantey,1276,131,1047,415,566,375,2837,265,71,295,782,344,28.7,No,2012
Demarquelle Tabb,1178,120,915,443,501,292,3004,7,0,194,908,443,22.5,No,2012
Jeremy Crutcher,1130,462,988,368,415,265,3563,361,129,322,627,239,21.3,No,2012
Brandon Ellis,773,77,690,275,179,124,2077,304,99,154,386,176,22.7,No,2012
Jeremy Ingram,122,15,128,44,17,10,263,67,24,19,61,20,29.4,No,2012
Green Hill,523,178,406,158,244,182,1896,89,25,145,317,133,17.9,No,2012
Jerome Hunter,345,44,296,139,110,66,1810,3,1,98,293,138,12.3,No,2012
Brandon Allen,81,12,76,29,22,12,245,36,11,13,40,18,20.3,No,2012
Eddie Hardy,43,10,44,15,3,2,180,39,11,10,5,4,15.4,No,2012
Marcus Lee,123,55,89,39,49,36,655,25,9,69,64,30,12.7,No,2012
Diamon Alexander,94,14,112,31,29,17,397,63,15,22,49,16,18.1,No,2012
Reginald Martin,40,6,42,16,12,8,290,1,0,25,41,16,12.4,No,2012
Jose Long,220,57,212,72,113,57,1255,74,19,45,138,53,12.7,No,2012
Justin Banks,329,17,235,134,81,61,1299,2,0,75,233,134,13.6,No,2012
Anthony Lanier,29,4,30,11,10,7,143,0,0,8,30,11,15,No,2012
Devin Colman,3,0,1,1,0,0,3,1,1,1,0,0,33.3,No,2012
Cameron Moore,1060,80,858,425,299,181,2704,97,29,138,761,396,22.8,No,2012
Jordan Swing,1011,207,811,339,251,197,2724,408,136,165,403,203,20.2,No,2012
Preston Purifoy,679,69,508,210,172,144,2086,307,115,89,201,95,16.7,No,2012
Ovie Soko,1115,124,806,379,523,338,2891,80,19,210,726,360,23,No,2012
Quincy Taylor,926,295,794,324,171,118,3348,397,160,259,397,164,17.7,No,2012
Jekore Tyler,192,40,184,70,59,38,479,48,14,62,136,56,30.5,No,2012
Robert Williams,709,135,580,243,212,147,2717,220,76,157,360,167,15.1,No,2012
K.C. Whitaker,84,18,103,23,23,18,330,82,20,17,21,3,21.8,No,2012
Herb Harrison,22,3,17,10,2,2,90,0,0,7,17,10,15.2,No,2012
Alexander Scotland-Williamson,29,5,12,7,23,15,211,0,0,21,12,7,10.4,No,2012
Beas Hamga,16,3,13,7,4,2,139,0,0,5,13,7,7.7,No,2012
Tramaine Butler,1088,191,984,376,433,226,2847,374,110,217,610,266,26.6,No,2012
Ivory White,744,152,665,269,152,96,2891,335,110,113,330,159,15.8,No,2012
Phillip Crawford,577,25,448,233,176,110,1120,5,1,93,443,232,28.4,No,2012
Kenderek Washington,507,42,409,177,145,93,1246,171,60,81,238,117,22.7,No,2012
Ryan Watts,433,78,442,148,126,86,1408,180,51,136,262,97,23,No,2012
Jeffery Middlebrooks,414,311,350,104,207,145,2326,220,61,201,130,43,14.3,No,2012
Stephawn Brown,307,63,301,125,65,30,1520,93,27,89,208,98,14.1,No,2012
Luther Page,660,89,502,227,381,206,2624,3,0,205,499,227,16.8,No,2012
Joshua Mason,75,25,90,30,33,15,391,11,0,45,79,30,19.7,No,2012
Jonathan Jefferson,66,10,86,21,36,22,407,27,2,23,59,19,15.8,No,2012
Anthony Price,32,26,35,12,13,5,234,14,3,21,21,9,13.5,No,2012
Quintarius Hutchinson,17,3,18,7,12,3,101,6,0,12,12,7,17.7,No,2012
Trevor Releford,1873,395,1319,638,537,437,4367,446,160,303,873,478,23.1,No,2012
Trevor Lacey,1197,295,971,404,293,218,3199,468,171,202,503,233,22,No,2012
Levi Randolph,1336,243,1043,455,411,307,4139,360,119,177,683,336,18.7,No,2012
Nick Jacobs,1057,22,895,454,229,149,2691,1,0,149,894,454,22.7,No,2012
Rodney Cooper,1122,161,988,401,245,182,3514,443,138,182,545,263,20,No,2012
Andrew Steele,399,128,301,124,176,126,1775,90,25,101,211,99,14.3,No,2012
Charles Hankerson Jr.,539,157,485,183,161,93,2066,240,80,108,245,103,19,No,2012
Carl Engstrom,108,16,90,43,37,22,773,0,0,45,90,43,10.6,No,2012
Moussa Gueye,219,17,162,79,91,61,1209,0,0,136,162,79,15.1,No,2012
Ben Eblen,154,151,186,66,48,18,1433,32,4,87,154,62,10.8,No,2012
Keon Blackledge,4,4,7,2,0,0,32,5,0,1,2,2,13.7,No,2012
Gerardo Suero,689,100,479,220,265,220,1015,81,29,134,398,191,37.5,No,2012
Mike Black,1542,383,1190,508,470,346,3831,460,180,340,730,328,24.5,No,2012
Logan Aronhalt,1320,110,1138,445,245,198,3122,623,232,191,515,213,24.4,No,2012
Jayson Guerrier,351,34,287,121,63,44,1118,172,65,43,115,56,17.1,No,2012
Luke Devlin,605,84,529,230,139,92,2389,182,53,90,347,177,15.5,No,2012
Blake Metcalf,471,86,372,207,170,57,2536,2,0,124,370,207,12.2,No,2012
Jacob Iati,655,116,501,201,124,100,2029,382,153,88,119,48,17.2,No,2012
Ralph Watts,171,80,156,58,61,34,969,63,21,60,93,37,13.5,No,2012
John Puk,548,62,471,217,162,114,2845,0,0,145,471,217,13.3,No,2012
Sam Rowley,1194,166,888,453,379,288,3202,6,0,268,882,453,23.1,No,2012
Tanner Gibson,19,8,14,6,9,6,122,5,1,2,9,5,8.6,No,2012
Peter Hooley,1519,337,1157,464,511,410,3905,555,181,257,602,283,22.8,No,2012
Kendrick McDonald,614,90,561,219,199,143,1611,112,33,137,449,186,23.7,No,2012
Twann Oakley,456,46,372,145,124,91,1315,221,75,71,151,70,19.9,No,2012
Xavian Rimmer,710,129,525,211,231,187,2311,274,101,145,251,110,16.5,No,2012
Ian Francis,751,86,613,273,346,205,2720,5,0,193,608,273,17.1,No,2012
KeDorian Sullivan,174,11,140,68,62,37,633,4,1,27,136,67,15.9,No,2012
Anthony Nieves,547,86,481,181,194,127,1363,163,58,151,318,123,26.7,No,2012
JaMichael Hawkins,787,80,698,256,166,134,2058,400,141,129,298,115,22.7,No,2012
Michael Starks,378,19,302,145,169,88,1904,0,0,86,302,145,11.9,No,2012
Chris Brand,69,8,64,27,12,9,198,13,6,18,51,21,22.7,No,2012
Martrevious Sanders,71,41,69,30,15,11,289,2,0,31,67,30,19,No,2012
Jarvis Moore,58,30,58,23,8,7,280,10,5,35,48,18,17.8,No,2012
Marquis Baker,415,45,378,127,138,99,891,220,62,64,158,65,28.5,No,2012
Tyson Tufono,14,4,16,5,0,0,81,13,4,6,3,1,13.9,No,2012
Devon Francois,5,0,4,2,0,0,46,2,1,5,2,1,10,No,2012
Darien Johnson,0,1,0,0,0,0,1,0,0,0,0,0,0,No,2012
Charles Hinkle,756,85,584,230,226,187,1659,293,109,108,291,121,26.7,No,2012
Troy Brewer,822,101,716,285,135,107,2337,417,145,96,299,140,20.5,No,2012
Daniel Munoz,799,371,710,258,244,191,3332,270,92,226,440,166,17.9,No,2012
Blake Jolivette,446,128,442,168,108,77,1678,78,33,133,364,135,21,No,2012
Tony Wroblicky,881,132,657,363,242,155,2565,0,0,177,657,363,21.5,No,2012
Riley Grafft,293,38,224,116,84,55,1110,21,6,65,203,110,16.2,No,2012
Simon McCormack,376,125,310,153,114,70,1683,0,0,114,310,153,15.7,No,2012
John Schoof,1154,230,909,390,185,147,4062,553,227,187,356,163,17.6,No,2012
Mike Bersch,203,32,226,72,9,6,772,182,53,34,44,19,19.5,No,2012
Daniel Fisher,64,17,59,25,23,14,430,2,0,26,57,25,12.6,No,2012
Wayne Simon,26,14,28,10,16,5,218,6,1,15,22,9,13,No,2012
Joe Hill,95,18,93,32,0,0,366,85,31,16,8,1,16.3,No,2012
Kyle Kager,218,39,172,79,60,44,755,53,16,56,119,63,20,No,2012
Warren Flood,1,0,5,0,2,1,15,0,0,2,5,0,30.3,No,2012
Jordan Borucki,9,0,8,4,2,1,18,0,0,1,8,4,31.1,No,2012
Omar Carter,1721,187,1440,617,438,313,3583,494,174,235,946,443,25.9,No,2012
Andre Williamson,813,87,561,304,314,196,2580,19,9,157,542,295,16.9,No,2012
Jamaal Trice,492,52,407,155,150,104,1490,205,78,97,202,77,19.6,No,2012
Michael Neal,704,259,597,226,250,170,2169,241,82,229,356,144,22,No,2012
Tab Hamilton,913,94,865,329,150,109,2593,435,146,116,430,183,20.4,No,2012
Isaac Butts,847,95,605,365,197,117,2508,0,0,203,605,365,18,No,2012
Nathan Healy,816,110,624,298,182,138,2396,222,82,125,402,216,17.6,No,2012
G.J. Vilarino,163,41,142,54,80,48,645,31,7,46,111,47,17.8,No,2012
Rodney Milium,104,12,86,32,22,14,235,69,26,11,17,6,23.2,No,2012
Mitch Woods,113,110,110,39,55,27,956,34,8,74,76,31,11.1,No,2012
Petey Hausley,245,7,183,96,93,53,676,0,0,44,183,96,20.2,No,2012
Brian Okam,35,3,30,11,27,13,246,0,0,15,30,11,11.8,No,2012
Trent Lockett,1181,219,844,408,451,317,3341,140,48,263,704,360,21.7,No,2012
Kyle Cain,878,78,761,368,192,133,2299,32,9,153,729,359,22.7,No,2012
Jonathan Gilling,998,272,784,323,138,94,3579,638,258,184,146,65,15.2,No,2012
Chris Colvin,441,228,420,147,206,110,1849,127,37,201,293,110,20.5,No,2012
Jordan Bachynski,968,33,632,354,424,260,2670,0,0,158,632,354,19.6,No,2012
Keala King,500,142,404,178,185,118,1410,94,26,147,310,152,24,No,2012
Chanse Creekmur,226,27,194,73,28,21,1055,168,59,33,26,14,12.6,No,2012
Ruslan Pateev,344,53,270,143,98,58,1292,0,0,89,270,143,17.2,No,2012
David Whitmore,4,1,3,1,2,2,28,1,0,0,2,1,7.7,No,2012
Pierre Newton,3,1,2,1,0,0,10,2,1,0,0,0,11.1,No,2012
Max Heller,7,20,14,2,3,2,162,5,1,14,9,1,9.4,No,2012
Kyle Fogg,1341,302,983,404,441,340,3829,478,193,226,505,211,19.4,No,2012
Jesse Perry,678,72,494,237,266,186,1806,65,18,93,429,219,20.9,No,2012
Josiah Turner,197,70,151,63,102,64,721,31,7,60,120,56,19.3,No,2012
Brendon Lavender,438,94,348,142,65,46,1568,263,108,63,85,34,14.8,No,2012
Jordin Mayes,464,129,421,161,96,64,1664,222,78,97,199,83,17.7,No,2012
Angelo Chol,455,27,355,184,142,87,1649,0,0,113,355,184,17.2,No,2012
Kevin Parrom,755,204,557,259,196,141,2257,253,96,116,304,163,17.6,No,2012
Kyryl Natyazhko,154,18,143,61,37,26,859,15,6,44,128,55,12.4,No,2012
Max Wiepking,16,0,8,5,5,2,36,7,4,1,1,1,16.4,No,2012
Alex Jacobson,60,6,51,26,13,7,391,1,1,24,50,25,10.8,No,2012
Sidiki Johnson,44,2,50,17,31,10,172,0,0,13,50,17,22.9,No,2012
Robert Arvizu,2,0,0,0,2,2,10,0,0,3,0,0,20.6,No,2012
Quinton Crawford,0,1,3,0,0,0,15,3,0,0,0,0,10.4,No,2012
Drew Mellon,1,3,8,0,2,1,46,3,0,1,5,0,11.2,No,2012
Dondre Wise,2,7,0,0,2,2,36,0,0,2,0,0,4.3,No,2012
D'Andre Williams,650,231,548,221,197,150,2006,160,58,141,388,163,20.7,No,2012
Daylon Guy,594,126,498,190,178,134,1722,247,80,85,251,110,20.6,No,2012
Will Neighbour,1054,97,788,354,340,257,2458,240,89,214,548,265,24.1,No,2012
Courtney Jackson,682,83,585,282,234,110,2403,30,8,153,555,274,18.7,No,2012
Michael Javes,341,28,339,134,168,71,1202,7,2,85,332,132,21.5,No,2012
Ben Dillard,801,119,584,223,307,253,2555,288,102,111,296,121,17,No,2012
Tramar Sutherland,176,28,142,56,100,60,709,19,4,30,123,52,16.5,No,2012
Taggart Lockhart,227,49,199,77,79,49,966,86,24,41,113,53,14.8,No,2012
Eric Lawton,69,13,62,22,28,22,286,21,3,24,41,19,18.5,No,2012
Marlon Louzeiro,170,13,135,68,57,31,638,5,3,32,130,65,16.1,No,2012
Reggie Fondren,48,12,53,17,11,10,219,18,4,8,35,13,16.1,No,2012
Ted Crass,7,0,9,3,2,0,34,6,1,1,3,2,16.1,No,2012
Savalance Townsend,1357,259,1077,429,530,378,3888,343,121,319,734,308,23.8,No,2012
Daniel Broughton,988,78,884,379,315,197,2543,89,33,224,795,346,25.5,No,2012
Lazabian Jackson,651,146,600,219,137,95,1838,366,118,120,234,101,21.8,No,2012
Rontrell Bailey,86,28,63,28,39,25,505,18,5,30,45,23,11.5,No,2012
Lavoris Weathers,122,9,126,43,105,36,604,1,0,37,125,43,18.3,No,2012
Austin Allen,56,2,50,19,33,18,211,1,0,11,49,19,19,No,2012
Jamar Harris,48,5,46,22,21,4,350,1,0,20,45,22,11.3,No,2012
Kyle Jones,56,20,66,18,8,3,383,62,17,21,4,1,12.3,No,2012
Jaylon Floyd,170,14,138,67,65,34,1085,9,2,60,129,65,10.9,No,2012
Derrius Nelson,19,6,16,6,4,3,98,13,4,7,3,2,13.3,No,2012
Demetrious Smith,17,5,9,5,6,5,192,3,2,15,6,3,7.2,No,2012
Edward Buford,6,2,3,2,4,2,26,0,0,3,3,2,15.9,No,2012
Marcel Mosley,1019,221,804,320,314,245,2664,368,134,259,436,186,23.8,No,2012
Marcus Hooten,644,88,581,220,208,141,1690,184,63,108,397,157,24.4,No,2012
Malcoln Kirkland,620,31,449,241,211,138,1757,0,0,125,449,241,20,No,2012
Trey Finn,1165,210,894,360,349,261,3845,491,184,162,403,176,16.4,No,2012
Brandon Peterson,1098,134,811,380,514,335,3676,14,3,228,797,377,18,No,2012
Edward Townsel,1177,240,1027,392,299,217,3366,496,176,247,531,216,21.8,No,2012
Darion Griswold,119,3,82,50,35,19,348,1,0,13,81,50,17,No,2012
Rakeem Dickerson,400,179,298,110,210,153,1708,88,27,116,210,83,15.6,No,2012
Adam Sterrenberg,276,48,219,83,112,75,952,108,35,44,111,48,17.2,No,2012
Johnny Zuppardo,129,9,118,50,16,11,527,50,18,34,68,32,15.3,No,2012
Bryce Clark,104,11,114,39,37,23,356,33,3,26,81,36,22.5,No,2012
Kinley Ogbonnaya-Branch,58,5,48,16,16,12,158,41,14,11,7,2,22,No,2012
B.J. Young,958,178,752,357,240,169,1673,231,75,138,521,282,29.3,No,2012
Mardracus Wade,797,153,569,235,253,198,2662,341,129,121,228,106,14.9,No,2012
Rickey Scott,532,163,487,195,204,117,1628,112,25,94,375,170,20.4,No,2012
Julysses Nobles,1136,376,928,360,435,298,3286,343,118,283,585,242,21.5,No,2012
Rashad Madden,1106,369,782,336,390,314,2997,353,120,246,429,216,19.5,No,2012
Devonta Abron,623,50,440,204,351,215,1732,1,0,102,439,204,21.1,No,2012
Hunter Mickelson,442,45,414,192,82,56,1397,12,2,77,402,190,18.7,No,2012
Marvell Waithe,224,30,177,77,75,51,738,67,19,37,110,58,16.9,No,2012
Michael Sanchez,380,44,295,123,209,133,1574,3,1,108,292,122,15.6,No,2012
Marshawn Powell,1283,120,1011,497,383,247,2482,145,42,173,866,455,27.1,No,2012
Brandon Mitchell,38,7,44,17,11,4,142,6,0,6,38,17,19.1,No,2012
Kikko Haydar,230,64,192,71,42,30,952,153,58,32,39,13,12.4,No,2012
Matt Thompson,3,1,4,1,0,0,7,3,1,0,1,0,28.1,No,2012
Ella Ellis,1585,159,1129,479,532,434,2952,510,193,206,619,286,27.6,No,2012
Julian Simmons,1255,58,1140,419,242,188,2568,614,229,151,526,190,28.3,No,2012
Josh Herbeck,777,99,708,266,64,48,2144,521,197,101,187,69,20,No,2012
Maxwell Lenox,290,175,218,102,123,76,1180,43,10,126,175,92,17.5,No,2012
Jordan Springer,297,55,225,110,119,77,1475,0,0,95,225,110,13.1,No,2012
Andrew Stire,221,33,154,89,74,43,890,0,0,55,154,89,14,No,2012
Milton Washington,161,57,115,58,58,41,473,8,4,57,107,54,21.5,No,2012
Jason Pancoe,191,100,184,65,28,21,857,115,40,56,69,25,15.1,No,2012
Whit Thornton,24,27,26,9,13,6,315,2,0,31,24,9,10.3,No,2012
Jalen Harris,22,15,24,6,10,6,113,11,4,17,13,2,20.9,No,2012
Josh Johnson,37,4,34,17,14,3,229,0,0,18,34,17,13.1,No,2012
Brian Hornstein,40,2,47,19,8,2,180,1,0,11,46,19,17.8,No,2012
Cartavious Kincade,68,19,57,23,27,19,256,15,3,17,42,20,17.3,No,2012
Chris Gramling,8,0,16,3,1,0,52,14,2,2,2,1,18.3,No,2012
Sean Billerman,14,3,12,4,7,4,36,9,2,0,3,2,21.5,No,2012
Pat Harris,5,2,9,1,3,3,32,6,0,0,3,1,16.7,No,2012
Matt Walker,2,0,3,1,0,0,4,0,0,2,3,1,64.4,No,2012
Michael Felton,0,0,0,0,0,0,1,0,0,0,0,0,0,No,2012
Frankie Sullivan,1556,287,1268,497,431,334,3755,713,228,243,555,269,23.2,No,2012
Kenny Gabriel,756,53,663,283,156,105,1963,271,85,133,392,198,22.9,No,2012
Chris Denson,1190,156,873,401,527,341,2496,171,47,129,702,354,25.9,No,2012
Rob Chubb,759,63,675,315,214,129,2191,1,0,178,674,315,22.7,No,2012
Varez Ward,398,160,326,118,213,139,1292,105,23,122,221,95,21.7,No,2012
Josh Wallace,439,302,395,148,203,132,2429,43,11,155,352,137,13.7,No,2012
Allen Payne,734,135,635,266,231,163,2765,154,39,193,481,227,17.5,No,2012
Josh Langford,481,40,399,189,129,78,1396,74,25,108,325,164,20.5,No,2012
Adrian Forbes,172,8,136,65,73,42,860,0,0,47,136,65,13.1,No,2012
Willy Kouassi,368,14,282,144,168,80,1576,0,0,102,282,144,15,No,2012
Noel Johnson,367,50,395,131,34,21,1350,250,84,83,145,47,18.5,No,2012
Jake Drum,25,3,14,7,14,10,92,3,1,8,11,6,15.5,No,2012
Tony Neysmith,84,68,91,36,40,12,771,6,0,70,85,36,11.9,No,2012
Cedrick McAfee,0,0,6,0,0,0,19,3,0,1,3,0,19.5,No,2012
T.J. Rice,0,0,3,0,0,0,5,1,0,0,2,0,31.7,No,2012
Dylan Spencer,3,0,5,1,2,0,17,5,1,3,0,0,27.6,No,2012
TyShwan Edmondson,1017,142,909,373,181,133,2333,384,138,169,525,235,24.7,No,2012
Josh Terry,746,127,597,282,263,180,1989,17,2,130,580,280,21.2,No,2012
Melvin Baker,615,54,494,240,171,120,1494,51,15,120,443,225,23.1,No,2012
John Fraley,956,68,612,355,406,246,2833,0,0,167,612,355,17.2,No,2012
Jerome Clyburn,255,113,199,75,116,89,998,49,16,84,150,59,16.9,No,2012
Will Triggs,1139,154,779,412,519,315,2964,3,0,197,776,412,20.5,No,2012
Herdie Lawrence,171,75,166,54,60,39,715,103,24,102,63,30,20.7,No,2012
Justin Blake,451,83,388,144,88,57,1353,313,106,59,75,38,18.1,No,2012
Chris Freeman,612,46,439,246,177,120,1740,1,0,117,438,246,18.3,No,2012
Anthony Campbell,1362,158,992,455,341,271,3150,507,181,222,485,274,22,No,2012
Alton Williams,55,5,39,18,5,4,133,33,15,1,6,3,15.8,No,2012
Thomas Greer,64,21,47,18,35,20,339,20,8,29,27,10,13.6,No,2012
Matt Hasse,47,29,30,14,26,17,266,2,2,17,28,12,11.1,No,2012
Kevin Covington,1,1,1,0,2,1,17,0,0,3,1,0,14.5,No,2012
Joe Harms,8,0,4,2,8,4,37,1,0,3,3,2,14.6,No,2012
Jarrod Jones,1623,105,1314,622,535,366,3587,47,13,229,1267,609,27.3,No,2012
Jesse Berry,1257,181,999,377,379,279,3089,661,224,233,338,153,23.9,No,2012
Randy Davis,929,446,637,240,380,313,3073,399,136,222,238,104,18.3,No,2012
Chris Bond,1050,143,785,392,365,245,3105,79,21,205,706,371,19.5,No,2012
Tyler Koch,267,69,240,94,58,27,1211,155,52,70,85,42,14.8,No,2012
Tyrae Robinson,298,150,234,96,139,91,1080,46,15,113,188,81,20.6,No,2012
Jauwan Scaife,1326,187,1076,403,405,317,3369,579,203,198,497,200,23.1,No,2012
Aaron Adeoye,376,46,329,145,127,80,1610,25,6,113,304,139,16.1,No,2012
Matt Kamieniecki,431,71,300,156,228,118,1649,3,1,96,297,155,16.2,No,2012
Zach Fields,145,11,127,64,32,17,604,0,0,48,127,64,16.4,No,2012
Pierre Sneed,269,78,278,97,104,70,1633,27,5,102,251,92,14.3,No,2012
Zeke Chapman,15,1,22,5,2,2,83,20,3,4,2,2,17.6,No,2012
Perry Jones,862,78,659,344,239,162,2030,43,12,125,616,332,22.4,No,2012
Brady Heslip,1140,102,829,359,147,121,3015,689,301,42,140,58,15.8,No,2012
A.J. Walton,778,452,676,271,259,169,3413,201,67,298,475,204,16.2,No,2012
Deuce Bello,555,78,428,194,222,128,1739,135,39,142,293,155,19.4,No,2012
Gary Franklin,513,185,483,163,101,68,2105,362,119,116,121,44,15.6,No,2012
Fred Ellis,214,52,192,68,76,59,967,68,19,70,124,49,15.4,No,2012
Jacob Neubert,14,2,20,6,4,2,59,2,0,5,18,6,22.9,No,2012
Kerron Johnson,1388,515,848,405,682,511,3205,209,67,326,639,338,23.4,No,2012
Drew Hanlen,874,423,640,257,220,171,2957,465,189,190,175,68,15.6,No,2012
Scott Saunders,1030,35,701,360,452,310,2023,0,0,170,701,360,28.8,No,2012
Mick Hedgepeth,1191,62,765,413,522,356,2673,29,9,180,736,404,22.5,No,2012
J.J. Mann,1509,272,1212,524,265,227,3570,644,234,184,568,290,21.6,No,2012
Blake Jenkins,918,110,602,337,336,213,2381,99,31,156,503,306,19.5,No,2012
Adam Barnes,166,48,118,61,57,37,665,15,7,37,103,54,13.7,No,2012
Brandon Baker,373,99,339,144,59,36,1600,180,49,73,159,95,13.7,No,2012
Trevor Noack,693,51,592,265,122,84,1852,243,79,97,349,186,20.3,No,2012
Reece Chamberlain,789,454,559,251,304,211,2787,211,76,219,348,175,17.1,No,2012
Chad Lang,287,1,220,121,94,45,626,0,0,61,220,121,26.2,No,2012
Spencer Turner,158,33,143,53,12,7,463,128,45,20,15,8,18.8,No,2012
Holden Mobley,77,40,56,23,29,19,683,33,12,35,23,11,7.9,No,2012
Seth Cavera,0,1,1,0,1,0,20,1,0,0,0,0,3.7,No,2012
Kevin Dukes,1159,264,982,376,171,131,3712,745,276,181,237,100,17.5,No,2012
Adrien Coleman,1027,151,768,392,424,224,2279,73,19,187,695,373,25.9,No,2012
Garrius Holloman,747,118,638,320,161,94,1916,46,13,126,592,307,23.3,No,2012
Anthony Breeze,922,53,642,336,416,249,2192,1,1,147,641,335,23.3,No,2012
Ricky Johnson,1161,295,959,322,467,379,3574,464,138,242,495,184,20.6,No,2012
Stanley Elliott,631,125,557,225,247,154,2705,117,27,136,440,198,15.6,No,2012
Javoris Bryant,745,95,642,274,280,197,2618,5,0,131,637,274,18.1,No,2012
Paul Scotland,363,97,310,110,123,91,1033,156,52,83,154,58,22.1,No,2012
Alex Smith,277,28,196,121,68,35,929,1,0,52,195,121,15.2,No,2012
Marc Mack,155,15,184,63,54,28,852,7,1,54,177,62,15.8,No,2012
Mikel Trapp,833,105,745,278,137,95,2874,536,182,140,209,96,17.8,No,2012
Raymoan McAfee,44,2,47,19,17,6,284,1,0,16,46,19,13.3,No,2012
David Baroum,0,0,3,0,0,0,6,0,0,1,3,0,34.8,No,2012
Brandon Stewart,292,28,240,80,141,106,709,100,26,60,140,54,28,No,2012
Ben Dickinson,610,104,548,239,182,121,1504,57,11,126,491,228,26.6,No,2012
Robert Mansell,526,62,462,169,207,151,1476,123,37,112,339,132,24.8,No,2012
Jimmy Gray,812,291,779,285,101,79,3205,506,163,241,273,122,17.9,No,2012
Chris Longoria,251,56,233,82,81,63,859,96,24,66,137,58,21.1,No,2012
Omar Richards,141,11,121,57,48,24,574,6,3,45,115,54,17.8,No,2012
Javon Ralling,231,29,209,85,103,61,1028,1,0,68,208,85,17,No,2012
Taylor Johnston,368,44,326,124,60,40,1707,213,80,87,113,44,13.8,No,2012
Alex Ogundadegbe,234,31,216,91,85,52,1244,2,0,60,214,91,13.6,No,2012
Jabrille Williams,92,9,86,39,14,6,589,31,8,28,55,31,11,No,2012
Carlyle Francis,33,8,30,10,16,12,143,12,1,21,18,9,22.2,No,2012
Byron Brown,8,3,10,3,4,2,44,5,0,2,5,3,17.1,No,2012
Mike Horn,26,17,53,9,12,5,676,29,3,10,24,6,5.3,No,2012
K.J. Brown,82,18,76,22,42,25,338,42,13,29,34,9,19.9,No,2012
Chris Rice,18,7,26,4,11,7,172,18,3,13,8,1,13.6,No,2012
Anthony Drmic,1942,244,1463,634,529,399,4117,786,275,223,677,359,24.5,No,2012
Derrick Marks,1912,370,1417,669,580,458,3538,293,116,332,1124,553,30.6,No,2012
Kenny Buckner,393,29,275,169,97,55,1133,1,0,57,274,169,17.5,No,2012
Thomas Bropleh,715,84,567,238,175,125,2038,302,114,91,265,124,18.9,No,2012
Ryan Watkins,1070,72,745,409,346,251,2651,3,1,122,742,408,20.2,No,2012
Westly Perryman,409,133,343,145,143,83,1633,109,36,84,234,109,15.5,No,2012
Drew Wiley,315,36,273,106,32,21,959,213,82,43,60,24,17.7,No,2012
Jeff Elorriaga,792,177,607,255,78,61,3111,518,221,70,89,34,12,No,2012
Tre Nichols,252,49,242,87,68,53,671,99,25,44,143,62,24.2,No,2012
Igor Hadziomerovic,511,219,456,184,161,100,2365,140,43,150,316,141,15.5,No,2012
Joe Hanstad,145,42,118,47,33,25,727,82,26,30,36,21,12.1,No,2012
Jarrell Crayton,33,2,21,12,18,9,128,1,0,8,20,12,15.4,No,2012
Matt Humphrey,648,97,605,214,165,95,1941,377,125,107,228,89,21.6,No,2012
Dennis Clifford,889,118,669,336,320,209,2934,31,8,212,638,328,19.4,No,2012
Lonnie Jackson,960,214,751,293,186,145,3203,598,229,167,153,64,17.2,No,2012
Jordan Daniels,650,181,562,227,116,97,1987,258,99,135,304,128,21.7,No,2012
Patrick Heckmann,903,197,632,290,281,214,2691,320,109,194,312,181,19.9,No,2012
Gabriel Moton,167,63,152,61,34,19,958,83,26,58,69,35,13,No,2012
Kyle Caudill,277,45,200,99,111,78,858,10,1,81,190,98,20.3,No,2012
John Cahill,114,20,79,35,19,15,735,64,29,15,15,6,7.7,No,2012
Eddie Odio,351,70,288,131,92,57,1856,109,32,75,179,99,12.3,No,2012
Danny Rubin,176,26,159,58,15,10,832,128,50,27,31,8,12.7,No,2012
Deirunas Visockas,99,19,80,33,20,16,335,50,17,24,30,16,17.1,No,2012
Ryan Kilcullen,2,0,0,0,2,2,9,0,0,1,0,0,12.1,No,2012
Salah Abdo,0,0,0,0,2,0,11,0,0,0,0,0,4.8,No,2012
John Cain Carney,17,5,22,8,3,0,240,4,1,8,18,7,7.3,No,2012
Peter Rehnquist,12,2,14,6,0,0,41,2,0,4,12,6,23,No,2012
Darryl Partin,1304,109,1111,445,336,249,2708,492,165,242,619,280,30.2,No,2012
D.J. Irving,1456,469,1146,458,475,370,4126,472,170,287,674,288,21.5,No,2012
Dom Morris,1139,94,856,439,312,220,3410,114,41,182,742,398,18.6,No,2012
Patrick Hazel,426,43,297,163,195,100,1880,0,0,101,297,163,13.8,No,2012
Matt Griffin,591,208,481,175,125,106,2684,363,135,126,118,40,12.9,No,2012
Travis Robinson,592,91,520,202,102,66,2269,344,122,107,176,80,15.9,No,2012
Malik Thomas,838,152,739,312,195,129,2610,267,85,160,472,227,20.2,No,2012
Jeff Pelage,319,20,268,126,154,67,1594,1,0,111,267,126,13.2,No,2012
Zach Chionuma,179,6,199,66,38,19,576,105,28,27,94,38,22.7,No,2012
Mike Terry,71,14,88,28,24,11,495,28,4,21,60,24,13,No,2012
James Kennedy,31,4,35,15,7,1,241,2,0,15,33,15,11.9,No,2012
Chris Kurz,2,1,9,1,1,0,53,0,0,5,9,1,14.5,No,2012
Mat Piotrowski,42,8,57,17,5,4,281,23,4,12,34,13,13.6,No,2012
A'uston Calhoun,1337,64,1166,529,324,240,2855,133,39,191,1033,490,27.9,No,2012
Scott Thomas,1261,317,1064,450,320,210,3634,469,151,239,595,299,21.7,No,2012
Jordon Crawford,1212,473,1101,455,240,180,3343,392,122,337,709,333,24.5,No,2012
Torian Oglesby,266,10,181,119,70,28,969,0,0,43,181,119,13.9,No,2012
Craig Sealey,321,25,297,125,128,68,1068,13,3,70,284,122,21,No,2012
Cameron Black,590,86,516,266,121,58,2690,0,0,118,516,266,13.4,No,2012
Jehvon Clarke,888,261,854,328,179,134,2423,313,98,227,541,230,25.2,No,2012
Luke Kraus,338,112,330,105,94,69,1663,207,59,72,123,46,14.2,No,2012
Chauncey Orr,305,63,233,104,83,65,1108,90,32,58,143,72,15.9,No,2012
Anthony Henderson,736,123,630,261,167,104,2451,304,110,83,326,151,17,No,2012
James Erger,87,32,101,32,18,10,677,63,13,26,38,19,10.6,No,2012
Antonio Ferrell,2,0,2,1,0,0,8,0,0,0,2,1,13.1,No,2012
Damarkeo Lyshe,62,14,59,19,20,13,241,36,11,11,23,8,17.1,No,2012
Taylor Brown,903,97,727,322,278,216,2105,148,43,155,579,279,26.8,No,2012
Walt Lemon,1721,367,1422,628,502,361,3935,324,104,404,1098,524,27.6,No,2012
Dyricus Simms-Edwards,1255,337,1084,429,378,274,3680,399,123,254,685,306,21.7,No,2012
Jordan Prosser,684,37,566,279,213,126,2598,0,0,113,566,279,15.8,No,2012
Jake Eastman,571,208,536,199,157,106,2846,244,67,110,292,132,13.3,No,2012
Shayok M. Shayok,430,38,371,175,143,68,1684,38,12,109,333,163,16.8,No,2012
Anthony Thompson,161,9,138,65,60,31,834,0,0,38,138,65,12.4,No,2012
Jalen Crawford,217,44,240,83,19,12,879,123,39,46,117,44,17.5,No,2012
Charonn Woods,27,9,29,7,16,11,276,15,2,8,14,5,8.5,No,2012
Milos Knezevic,92,8,83,31,19,13,333,57,17,24,26,14,18.5,No,2012
Donivine Stewart,796,367,673,283,218,141,2861,261,89,150,412,194,16.3,No,2012
Devon Hodges,0,1,1,0,0,0,21,0,0,3,1,0,9.9,No,2012
Noah Hartsock,1191,158,847,461,282,230,3331,99,39,123,748,422,16.1,No,2012
Charles Abouo,912,164,697,302,306,222,2527,244,86,151,453,216,19.1,No,2012
Matt Carlino,1620,525,1397,557,359,266,3604,666,240,307,731,317,25.4,No,2012
Brock Zylstra,607,147,487,209,129,87,2100,288,102,93,199,107,14.7,No,2012
Anson Winder,808,170,582,267,248,174,2126,283,100,91,299,167,17.8,No,2012
Nate Austin,529,100,388,205,178,106,2780,49,13,99,339,192,9.7,No,2012
Craig Cusick,247,148,207,78,61,40,1277,130,51,55,77,27,10.9,No,2012
Stephen Rogers,256,35,193,84,63,51,613,107,37,36,86,47,20.3,No,2012
Damarcus Harrison,784,134,744,276,173,128,2468,334,104,130,410,172,20.9,No,2012
Josh Sharp,250,63,168,93,90,59,1379,17,5,45,151,88,8.9,No,2012
Nick Martineau,44,34,49,15,10,7,289,22,7,16,27,8,11.8,No,2012
Chris Collinsworth,165,32,153,58,78,42,716,42,7,43,111,51,16.1,No,2012
Sean McGonagill,1618,522,1363,538,387,293,4110,683,249,327,680,289,23.8,No,2012
Matt Sullivan,1033,206,842,333,270,202,3262,455,165,157,387,168,18.5,No,2012
Andrew McCarthy,683,54,523,279,202,121,1890,18,4,102,505,275,20.4,No,2012
Stephen Albrecht,514,98,485,177,74,48,1418,299,112,83,186,65,23.3,No,2012
Jean Herbert-Harris,269,37,234,96,28,22,771,147,55,64,87,41,21.8,No,2012
Dockery Walker,568,35,459,234,202,99,1493,5,1,114,454,233,23.1,No,2012
Tyler Ponticelli,256,122,177,95,104,66,1634,1,0,114,176,95,11.1,No,2012
Tellef Lundevall,42,10,58,15,6,4,230,30,8,7,28,7,15.9,No,2012
Christian Gore,174,43,135,46,85,59,760,65,23,41,70,23,15.2,No,2012
Josh Biber,41,13,37,13,32,15,253,3,0,11,34,13,13.2,No,2012
Jon Schmidt,41,15,56,17,14,7,297,0,0,14,56,17,13.8,No,2012
Longi Yiljep,45,10,41,15,20,11,306,16,4,20,25,11,12.3,No,2012
Patrick Donnelly,4,1,11,2,0,0,37,8,0,2,3,2,18.9,No,2012
Alex Francis,2085,172,1457,791,815,490,4141,53,13,457,1404,778,28.9,No,2012
Frankie Dobbs,1232,505,920,355,416,331,3744,549,191,269,371,164,19.3,No,2012
Corey Maynard,1050,379,854,370,224,172,3406,417,138,211,437,232,17.9,No,2012
Raphael Jordan,561,116,535,196,148,100,2033,213,69,139,322,127,19.5,No,2012
Ben Altit,149,14,156,61,22,15,587,48,12,51,108,49,19.5,No,2012
Claybrin McMath,278,35,304,114,41,23,1252,122,27,60,182,87,16.3,No,2012
Daniel Calandrillo,142,31,149,54,17,11,686,79,23,17,70,31,13.3,No,2012
Vlad Kondratyev,616,34,524,255,125,83,1921,79,23,123,445,232,19.5,No,2012
Erick Smith,101,12,118,39,29,14,491,35,9,36,83,30,18.3,No,2012
Troy Robinson,32,19,42,12,11,7,306,15,1,18,27,11,11.2,No,2012
Jordan Harris,27,5,29,10,12,4,105,10,3,13,19,7,23.7,No,2012
Alex Herzing,2,0,2,1,1,0,16,0,0,1,2,1,11.2,No,2012
Patrick Matthews,0,1,1,0,0,0,11,0,0,0,1,0,4.8,No,2012
Cameron Ayers,1526,220,1205,530,319,265,3985,488,201,144,717,329,20.7,No,2012
Joe Willman,1162,154,1013,504,188,153,3232,10,1,152,1003,503,21.2,No,2012
Bryson Johnson,1384,200,1022,401,319,259,3690,812,323,137,210,78,19.3,No,2012
Bryan Cohen,1102,313,1003,370,320,225,3829,400,137,288,603,233,19.9,No,2012
Brian Fitzpatrick,530,49,373,206,152,111,1589,16,7,98,357,199,18.7,No,2012
Ben Brackney,342,28,268,109,59,52,1065,163,72,40,105,37,17.3,No,2012
Steven Kaspar,532,413,442,181,252,144,2610,90,26,205,352,155,16.1,No,2012
Ryan Hill,250,166,209,77,130,84,1729,38,12,126,171,65,12.6,No,2012
Joshea Singleton,223,26,184,71,100,65,670,58,16,59,126,55,22.6,No,2012
Enoch Andoh,186,4,154,67,75,52,679,0,0,63,154,67,19.3,No,2012
Colin Klebon,101,11,89,38,37,24,327,2,1,20,87,37,20.8,No,2012
Cory Starkey,179,46,150,74,50,31,828,0,0,52,150,74,14.8,No,2012
Probese Leo,14,1,14,6,7,2,114,0,0,8,14,6,11.8,No,2012
Mitchell Watt,1061,160,796,415,323,220,2495,34,11,224,762,404,24.3,No,2012
Javon McCrea,2004,249,1386,798,653,407,3473,4,1,309,1382,797,29.4,No,2012
Zach Filzen,1155,103,946,394,122,97,2733,671,270,140,275,124,21,No,2012
Titus Robinson,681,79,447,220,355,234,2006,19,7,195,428,213,19.9,No,2012
Dave Barnett,469,112,431,180,104,52,1985,176,57,126,255,123,15.3,No,2012
Tony Watson II,609,204,450,185,125,107,2057,333,132,110,117,53,15.4,No,2012
Jarod Oldham,562,409,497,182,234,156,2558,168,42,235,329,140,16.6,No,2012
Auraum Nuiriankh,325,98,313,101,102,74,1525,186,49,104,127,52,15.7,No,2012
Cameron Downing,245,30,134,88,103,69,638,0,0,58,134,88,19.6,No,2012
Corey Raley-Ross,85,33,93,33,30,16,398,19,3,41,74,30,19,No,2012
Xavier Ford,533,42,428,190,217,134,1474,56,19,113,372,171,21.9,No,2012
Raphell Thomas-Edwards,59,14,56,19,18,11,388,33,10,32,23,9,13,No,2012
Richie Sebuharara,24,16,20,7,4,4,183,14,6,10,6,1,9.1,No,2012
Andrew Smith,1147,97,773,409,435,293,2968,112,36,133,661,373,19.6,No,2012
Khyle Marshall,1373,52,1055,572,437,227,3001,19,2,123,1036,570,24.4,No,2012
Chrishawn Hopkins,748,197,627,246,241,181,2309,227,75,189,400,171,21.6,No,2012
Ronald Nored,835,497,646,251,449,285,4111,183,48,329,463,203,15.4,No,2012
Roosevelt Jones,1533,464,1297,589,595,354,4422,4,1,322,1293,588,22.2,No,2012
Chase Stigall,421,94,454,139,51,33,1858,369,110,86,85,29,15.9,No,2012
Kameron Woods,804,148,623,289,329,214,3315,65,12,188,558,277,15.4,No,2012
Erik Fromm,455,20,428,163,117,73,1547,196,56,77,232,107,19.1,No,2012
Jackson Aldridge,213,63,203,63,92,63,912,94,24,78,109,39,18.6,No,2012
Andy Smeathers,185,18,183,58,32,26,490,145,43,34,38,15,25.4,No,2012
Garrett Butcher,166,19,188,67,35,20,857,43,12,29,145,55,14.7,No,2012
Alex Barlow,596,274,497,194,132,105,2931,290,103,146,207,91,12.7,No,2012
Elliott Kampen,6,1,6,1,4,3,72,5,1,3,1,0,7.9,No,2012
Emerson Kampen,4,6,7,2,0,0,81,1,0,5,6,2,7.8,No,2012
David Hanson,1267,166,1127,467,276,179,3324,480,154,138,647,313,22.5,No,2012
Amaurys Fermin,325,119,308,117,79,54,976,114,37,75,194,80,23.7,No,2012
Will Taylor,475,33,374,188,147,99,1217,2,0,76,372,188,22.7,No,2012
Chris Eversley,1218,143,1037,444,348,244,2761,290,86,139,747,358,27.1,No,2012
Dylan Royer,612,59,478,201,47,41,1722,380,169,56,98,32,18.1,No,2012
Drake U'u,428,132,400,143,181,109,1701,151,33,105,249,110,19.4,No,2012
Will Donahue,474,81,341,170,206,133,1696,7,1,110,334,169,17.5,No,2012
Jamal Johnson,444,300,390,134,186,129,2372,144,47,145,246,87,14.7,No,2012
Kyle Odister,764,128,691,266,75,56,2059,454,176,97,237,90,21.7,No,2012
Maliik Love,511,210,445,188,203,120,2567,49,15,133,396,173,14.6,No,2012
Matt Titchenal,88,8,91,32,18,9,300,45,15,13,46,17,20.6,No,2012
Jordan Lewis,343,72,300,138,73,51,1655,53,16,73,247,122,12.9,No,2012
Stephon Carter,1628,330,1348,571,660,451,3622,159,35,358,1189,536,27.8,No,2012
Issiah Grayson,869,307,596,276,262,209,2071,248,108,212,348,168,23.2,No,2012
Zach Lamb,424,70,344,156,94,70,1021,111,42,81,233,114,23.7,No,2012
Donald Johnson,484,43,387,183,101,77,1502,105,41,103,282,142,17.9,No,2012
Tyrone White,537,99,471,188,76,53,1611,294,108,103,177,80,19.4,No,2012
Mo Hughley,234,57,165,80,119,74,879,2,0,62,163,80,16.7,No,2012
Adam Young,460,80,448,162,125,85,1689,172,51,83,276,111,17.4,No,2012
Rashad Savage,342,34,265,135,124,72,1538,0,0,66,265,135,12.6,No,2012
Robert Hayes,130,12,93,39,43,27,228,62,25,15,31,14,28.3,No,2012
Andre Jackson,57,0,53,26,11,5,116,0,0,8,53,26,29.5,No,2012
Ivan Matip,40,5,48,14,14,7,231,27,5,10,21,9,14,No,2012
Kwai Pearson,13,3,10,5,4,2,58,1,1,6,9,4,15.9,No,2012
Kregg Jones,157,5,124,65,63,27,690,0,0,40,124,65,14.6,No,2012
D.J. Seeley,1147,194,846,373,344,260,2276,343,141,189,503,232,26.2,No,2012
Kwame Vaughn,1775,342,1246,556,640,508,3767,438,155,315,808,401,25,No,2012
Isiah Umipig,1797,311,1411,582,345,285,3789,887,348,272,524,234,24.9,No,2012
Omondi Amoke,564,54,418,209,263,146,1675,8,0,95,410,209,18.8,No,2012
Orane Chin,1041,170,812,371,322,220,2986,225,79,214,587,292,20.6,No,2012
Perry Webster,341,255,272,104,123,84,1494,130,49,98,142,55,14.4,No,2012
Andre Hardy,582,47,455,207,273,168,1645,0,0,125,455,207,21.6,No,2012
Sedric Martin,141,14,112,58,39,25,481,0,0,39,112,58,17.5,No,2012
Orlando Brown,175,28,126,56,60,43,705,53,20,49,73,36,14.5,No,2012
John Underwood,39,1,32,14,24,11,221,0,0,18,32,14,13.3,No,2012
Bernard Webb,16,0,11,8,1,0,33,0,0,5,11,8,24.1,No,2012
Chris Collins,120,41,107,41,74,38,602,5,0,40,102,41,15.5,No,2012
Cameron Glover,6,1,3,1,5,3,13,3,1,0,0,0,19.9,No,2012
Conway James,0,0,0,0,0,0,0,0,0,0,0,0,0,No,2012
Jordan Knox,43,19,34,16,7,3,201,21,8,8,13,8,11.4,No,2012
Stephan Hicks,1959,137,1338,651,737,599,3938,185,58,227,1153,593,24.1,No,2012
Josh Greene,1549,360,1167,455,472,411,3594,590,228,240,577,227,22.1,No,2012
Vinnie McGhee,1024,358,991,350,160,120,2946,607,204,227,384,146,21.1,No,2012
Stephen Maxwell,1748,67,1199,635,657,478,3704,0,0,219,1199,635,23.3,No,2012
Aqeel Quinn,772,172,683,250,203,154,2274,342,118,145,341,132,21,No,2012
John Hayward-Mayhew,151,8,137,48,68,47,610,20,8,38,117,40,16.5,No,2012
Ari Feldman,98,10,83,37,18,14,351,21,10,11,62,27,14,No,2012
Allan Guei,250,118,253,90,65,48,972,48,22,65,205,68,17,No,2012
Michael Lizarraga,369,46,289,136,155,97,1332,1,0,94,288,136,16.5,No,2012
Frankie Eteuati,97,18,89,38,40,18,538,15,3,59,74,35,15,No,2012
Davon Potts,44,8,42,17,8,8,165,15,2,6,27,15,15.1,No,2012
Allen Jiles IV,98,21,80,39,44,20,486,2,0,39,78,39,14.1,No,2012
Thomas Jacobs,378,35,289,142,128,90,1493,18,4,64,271,138,14.7,No,2012
Jordan Mitchell,28,3,21,9,17,10,297,0,0,19,21,9,7.8,No,2012
Justin Yeargin,2,2,3,1,0,0,7,0,0,0,3,1,20.6,No,2012
Ishmael Godfrey,0,2,0,0,0,0,9,0,0,0,0,0,0,No,2012
Lonnie Watson,40,11,42,14,7,5,217,24,7,5,18,7,10.9,No,2012
Josh Ritchart,1333,116,1003,473,224,153,3014,568,234,168,435,239,22.9,No,2012
