Name,Points,Assists,FGA,FG,FTAs,FTs,Minutes,3s attempts,3s,turnovers,2s attempts,2s,usage,year,Appear_In_NBA
Grant Parker,478,47,334,160,156,104,1227.0,138,54,71.0,196,106,23.4,2010,0.0
Mike McLain,177,58,157,66,67,30,875.0,60,15,75.0,97,51,18.1,2010,0.0
Avery Merriex,103,46,91,38,28,18,802.0,22,9,42.0,69,29,10.9,2010,0.0
Sammy Schafer,87,27,64,29,43,26,384.0,14,3,22.0,50,26,16.6,2010,0.0
Saj El-Amin,9,2,12,3,5,3,50.0,2,0,2.0,10,3,19.9,2010,0.0
Jimmy Conyers,618,101,456,214,221,159,1981.0,105,31,152.0,351,183,18.2,2010,0.0
Chris McKnight,969,111,678,330,394,266,2449.0,121,43,154.0,557,287,21.7,2010,0.0
Ronnie Steward,57,31,60,24,10,3,300.0,20,6,24.0,40,18,15.1,2010,0.0
Tim Carroll,21,12,23,10,4,1,136.0,6,0,8.0,17,10,11.3,2010,0.0
Steve Swiech,25,1,21,12,6,1,44.0,0,0,2.0,21,12,30.3,2010,0.0
Alex Sullivan,3,1,1,1,4,1,12.0,0,0,2.0,1,1,20.6,2010,0.0
Evan Hilton,900,146,801,286,399,243,2554.0,292,85,238.0,509,201,23.1,2010,0.0
Alfred Frayer,7,0,4,2,6,3,51.0,0,0,6.0,4,2,11.6,2010,0.0
Royce Hamilton,43,7,56,16,19,9,263.0,16,2,14.0,40,14,11.9,2010,0.0
Antonio Adams,2,0,4,1,0,0,24.0,3,0,5.0,1,1,17.2,2010,0.0
Pierre Andrews,1,0,1,0,3,1,29.0,0,0,3.0,1,0,8.6,2010,0.0
Elijah Millsap,1114,122,918,387,461,290,2362.0,172,50,263.0,746,337,29.9,2010,1.0
Howard Crawford,809,32,580,287,322,224,2021.0,34,11,121.0,546,276,22.0,2010,0.0
George Drake,539,100,539,192,147,108,1992.0,203,47,111.0,336,145,18.4,2010,0.0
Menji Mundadi,590,37,464,185,141,102,1314.0,318,118,67.0,146,67,23.6,2010,0.0
Byron Walker,233,18,213,97,60,38,717.0,2,1,48.0,211,96,22.2,2010,0.0
Sekani Milligen,112,10,119,36,22,16,406.0,85,24,19.0,34,12,18.2,2010,0.0
Jadarren Mumpfield,8,14,8,3,2,1,100.0,5,1,11.0,3,2,9.9,2010,0.0
Jevon Freeman,6,25,4,0,13,6,178.0,0,0,27.0,4,0,10.8,2010,0.0
Derrick Johnson,2,1,2,1,0,0,18.0,0,0,1.0,2,1,8.3,2010,0.0
Mikhail Torrance,940,327,691,313,283,244,2256.0,224,70,185.0,467,243,24.1,2010,0.0
Anthony Brock,288,101,259,93,55,39,1146.0,164,63,69.0,95,30,15.4,2010,0.0
Greg Cage,17,2,17,7,5,2,59.0,7,1,5.0,10,6,18.4,2010,0.0
Will Harris,923,86,799,345,200,137,2254.0,275,96,167.0,524,249,23.7,2010,0.0
Scotty McRae,308,26,273,95,144,106,1001.0,50,12,82.0,223,83,21.6,2010,0.0
Fran Urli,164,14,107,53,78,55,556.0,5,3,29.0,102,50,16.0,2010,0.0
Mike Johnson,206,139,199,75,81,47,1049.0,46,9,91.0,153,66,15.9,2010,0.0
Brett Gifford,249,39,208,110,48,29,1787.0,1,0,109.0,207,110,9.7,2010,0.0
Louis Barraza,92,14,90,29,13,11,239.0,72,23,23.0,18,6,25.2,2010,0.0
Jonathan Boyd,636,61,558,211,102,81,1641.0,349,133,112.0,209,78,21.5,2010,0.0
JaMarkus Holt,422,21,409,162,189,98,1126.0,15,0,110.0,394,162,28.6,2010,0.0
Brandon Rogers,247,44,207,79,101,70,880.0,60,19,90.0,147,60,19.3,2010,0.0
Corey Anthony,77,12,87,29,26,12,407.0,34,7,29.0,53,22,15.3,2010,0.0
Derrick Blackwell,118,59,115,36,46,28,521.0,53,18,97.0,62,18,19.7,2010,0.0
Gifford Blakely,153,10,146,63,53,27,733.0,0,0,42.0,146,63,18.8,2010,0.0
Jeff Holton,1,1,0,0,2,1,4.0,0,0,2.0,0,0,40.0,2010,0.0
Kellen Brand,1411,186,1028,478,390,300,3364.0,400,155,228.0,628,323,21.1,2010,0.0
Josh Hunter,522,84,351,178,274,165,1585.0,7,1,120.0,344,177,18.7,2010,0.0
Ryann Abraham,703,241,521,229,189,137,2006.0,272,108,198.0,249,121,20.3,2010,0.0
Tyler Webb,288,44,209,108,73,49,1227.0,61,23,76.0,148,85,13.0,2010,0.0
A.J. Highsmith,132,24,111,45,11,8,391.0,96,34,30.0,15,11,18.5,2010,0.0
Derek Glasser,1028,551,781,292,352,295,3955.0,410,149,265.0,371,143,17.5,2010,0.0
Eric Boateng,494,43,313,203,183,88,1592.0,1,0,126.0,312,203,18.8,2010,0.0
Jerren Shipp,662,123,546,223,169,122,2717.0,285,94,108.0,261,129,15.3,2010,0.0
Taylor Rohde,79,7,60,29,38,20,339.0,11,1,13.0,49,28,15.3,2010,0.0
Nic Wise,1285,394,951,398,392,329,3267.0,405,160,248.0,546,238,22.2,2010,0.0
D.J. Shumpert,2,3,3,0,4,2,32.0,0,0,6.0,3,0,17.6,2010,0.0
Ricky Davison,162,23,118,49,35,28,414.0,70,36,27.0,48,13,20.4,2010,0.0
Kelson Stewart,140,21,122,44,43,35,502.0,39,17,16.0,83,27,16.4,2010,0.0
Wayne Burton,208,12,185,90,79,28,744.0,0,0,57.0,185,90,19.6,2010,0.0
Lionel Foster,87,121,54,22,60,40,728.0,17,3,67.0,37,19,10.7,2010,0.0
Nikola Cicic,27,11,36,8,8,6,105.0,31,5,9.0,5,3,24.2,2010,0.0
Terrance Calvin,979,300,824,318,444,334,2884.0,46,9,288.0,778,309,21.1,2010,0.0
Lebaron Weathers,562,32,550,217,129,83,1368.0,163,45,95.0,387,172,26.0,2010,0.0
Tavaris Washington,524,113,353,202,194,115,1687.0,34,5,193.0,319,197,18.9,2010,0.0
Tyree Glass,632,69,553,211,341,193,1940.0,79,17,180.0,474,194,24.3,2010,0.0
George Davis,554,30,493,222,188,103,1919.0,18,7,109.0,475,215,16.7,2010,0.0
Stephan Collins,22,4,21,9,5,2,188.0,6,2,12.0,15,7,9.4,2010,0.0
Hugh Barnett,69,5,63,26,32,17,228.0,0,0,30.0,63,26,26.6,2010,0.0
Antoni Lasker,9,2,9,2,7,4,94.0,4,1,10.0,5,1,10.6,2010,0.0
JeJuan Brown,434,57,370,163,144,95,1436.0,33,13,92.0,337,150,21.1,2010,0.0
Justin Butler,38,7,27,10,25,17,161.0,7,1,6.0,20,9,14.1,2010,0.0
Michael Lance,287,45,241,104,41,33,911.0,119,46,52.0,122,58,17.7,2010,0.0
Mike Washington,1065,73,782,392,415,259,2325.0,97,22,164.0,685,370,23.7,2010,0.0
Courtney Fortson,753,275,632,251,288,195,1551.0,180,56,220.0,452,195,30.5,2010,1.0
Stef Welsh,808,230,772,273,186,122,2515.0,453,140,206.0,319,133,20.5,2010,0.0
Stephen Cox,13,10,10,2,14,9,169.0,0,0,4.0,10,2,5.9,2010,0.0
Cody Lay,2,0,2,1,0,0,2.0,1,0,0.0,1,1,48.5,2010,0.0
Cleveland Richard,978,232,860,365,228,165,3003.0,256,83,228.0,604,282,23.3,2010,0.0
Josh Miller,826,336,742,283,259,182,2812.0,261,78,251.0,481,205,20.6,2010,0.0
Marcus Nelson,525,280,446,207,202,97,2762.0,61,14,223.0,385,193,16.0,2010,0.0
Tyrell Thompson,291,29,250,109,83,60,790.0,51,13,88.0,199,96,26.1,2010,0.0
Eric Zastoupil,146,19,120,53,51,39,689.0,13,1,39.0,107,52,13.0,2010,0.0
Jon Sizemore,104,41,106,47,15,9,539.0,4,1,41.0,102,46,16.1,2010,0.0
Joe Clark,0,0,1,0,0,0,7.0,0,0,1.0,1,0,15.1,2010,0.0
DeWayne Reed,1428,477,1223,460,492,324,3780.0,575,184,367.0,648,276,24.3,2010,0.0
Lucas Hargrove,946,192,737,350,263,167,2664.0,249,79,198.0,488,271,19.8,2010,0.0
Tay Waller,834,85,648,279,112,89,1844.0,484,187,71.0,164,92,20.3,2010,0.0
Brendon Knox,358,22,210,139,165,80,940.0,1,0,71.0,209,139,18.5,2010,0.0
Johnnie Lett,118,20,105,49,55,20,690.0,2,0,32.0,103,49,11.4,2010,0.0
Larry Williams Jr,61,4,55,21,12,5,197.0,44,14,9.0,11,7,17.5,2010,0.0
Wes Channels,1700,312,1343,556,515,362,3737.0,587,226,291.0,756,330,26.1,2010,0.0
Duran Roberson,290,21,238,112,95,58,931.0,34,8,62.0,204,104,18.9,2010,0.0
Chris Reaves,52,3,42,21,16,8,165.0,10,2,6.0,32,19,17.2,2010,0.0
Ernest Fields,404,36,266,143,170,114,1394.0,12,4,82.0,254,139,14.2,2010,0.0
Chris Wood,2,0,2,1,0,0,3.0,0,0,0.0,2,1,34.0,2010,0.0
Terrence Watson,268,36,209,94,135,80,892.0,0,0,71.0,209,94,20.8,2010,0.0
Brawley Chisholm,170,55,161,55,40,34,688.0,89,26,45.0,72,29,18.0,2010,0.0
Myron Green,75,18,74,21,37,27,394.0,22,6,21.0,52,15,15.6,2010,0.0
Zach Harrison,0,0,0,0,0,0,2.0,0,0,0.0,0,0,0.0,2010,0.0
Will Hauser,0,0,0,0,0,0,2.0,0,0,0.0,0,0,0.0,2010,0.0
Ekpe Udoh,867,154,726,343,259,168,2806.0,45,13,151.0,681,330,18.3,2010,1.0
Tweety Carter,1437,474,1158,485,260,193,3973.0,713,274,218.0,445,211,20.4,2010,0.0
Josh Lomers,580,23,341,226,206,128,1742.0,0,0,141.0,341,226,17.7,2010,0.0
Givon Crump,7,1,16,2,2,1,43.0,12,2,2.0,4,0,22.2,2010,0.0
Oscar Griffin,6,4,3,1,6,4,27.0,1,0,3.0,2,1,16.5,2010,0.0
Keaton Belcher,856,91,734,306,101,77,2047.0,485,167,114.0,249,139,21.0,2010,0.0
Jonny Rice,84,11,67,28,11,10,211.0,51,18,22.0,16,10,25.7,2010,0.0
Jarrell Thomas,287,50,252,98,62,42,994.0,152,49,64.0,100,49,16.3,2010,0.0
Tyrel Adams,126,12,130,48,53,30,790.0,2,0,44.0,128,48,13.6,2010,0.0
Antroine Williford,33,5,36,13,18,7,262.0,0,0,5.0,36,13,10.2,2010,0.0
Kene Anusionwu,73,2,57,29,29,15,351.0,0,0,11.0,57,29,6.7,2010,0.0
Rashad Bailey,8,0,5,3,0,0,7.0,4,2,0.0,1,1,38.7,2010,0.0
Umur Peten,77,7,52,30,17,12,368.0,18,5,19.0,34,25,11.5,2010,0.0
Ike Okoye,850,71,646,355,208,140,2109.0,4,0,132.0,642,355,20.4,2010,0.0
Kurt Cunningham,729,123,509,302,195,124,1764.0,5,1,165.0,504,301,22.2,2010,0.0
Tyler Young,12,1,7,3,8,6,24.0,0,0,1.0,7,3,23.7,2010,0.0
Nate Larsen,3,4,10,1,2,1,34.0,4,0,5.0,6,1,20.8,2010,0.0
Tyler Roche,457,92,386,164,64,41,1722.0,241,88,66.0,145,76,14.1,2010,0.0
Corey Lowe,1815,411,1539,612,428,278,3829.0,882,313,403.0,657,299,29.6,2010,0.0
Carlos Strong,1038,149,830,354,216,151,2774.0,447,179,136.0,383,175,18.9,2010,0.0
Tyler Morris,896,254,723,284,235,188,2758.0,366,140,193.0,357,144,21.2,2010,0.0
Valdas Sirutis,157,39,159,52,70,38,1242.0,66,15,47.0,93,37,10.7,2010,0.0
Brendan Sullivan,35,6,42,12,2,1,301.0,22,10,13.0,20,2,9.5,2010,0.0
Tunde Agboola,13,1,15,6,3,0,78.0,2,1,2.0,13,5,11.5,2010,0.0
Sherrod Smith,54,19,62,14,42,24,396.0,20,2,18.0,42,12,14.1,2010,0.0
Michael Schulze,3,2,6,1,3,1,26.0,2,0,4.0,4,1,22.0,2010,0.0
Otis Polk,714,61,517,270,284,174,2379.0,0,0,162.0,517,270,18.8,2010,0.0
Erik Marschall,797,92,613,318,244,155,2471.0,24,6,156.0,589,312,19.5,2010,0.0
Marc Larson,392,40,296,137,163,118,1780.0,0,0,101.0,296,137,14.9,2010,0.0
Darion Goins,137,24,163,58,13,6,540.0,71,15,49.0,92,43,20.0,2010,0.0
Matt Karaffa,9,2,8,3,6,3,25.0,3,0,1.0,5,3,17.0,2010,0.0
Chris Roberts,597,113,459,200,187,127,1845.0,196,70,99.0,263,130,18.6,2010,0.0
Sam Singh,367,56,256,135,134,97,1562.0,0,0,112.0,256,135,11.3,2010,0.0
Eddren McCain,236,145,216,83,78,49,1162.0,83,21,96.0,133,62,14.2,2010,0.0
Ryan Phillips,13,2,11,6,2,0,51.0,4,1,3.0,7,5,23.7,2010,0.0
Ned Goertzen,0,0,0,0,0,0,0.0,0,0,0.0,0,0,0,2010,0.0
Jonathan Tavernari,1519,182,1332,561,166,132,3200.0,698,265,164.0,634,296,24.8,2010,0.0
Michael Loyd Jr,248,76,176,88,67,45,788.0,66,27,72.0,110,61,17.6,2010,0.0
Chris Miles,555,115,437,216,220,123,1986.0,0,0,116.0,437,216,17.2,2010,0.0
Lamont Morgan Jr,169,97,119,60,41,26,772.0,47,23,63.0,72,37,13.3,2010,0.0
Matt Mullery,1134,201,763,421,400,267,2745.0,82,25,213.0,681,396,23.6,2010,0.0
Steve Gruber,184,71,122,43,102,82,754.0,39,16,67.0,83,27,17.9,2010,0.0
Marques Coleman,8,3,8,3,2,2,55.0,0,0,2.0,8,3,10.8,2010,0.0
Stefan Kaluz,21,1,22,8,9,5,65.0,0,0,1.0,22,8,22.9,2010,0.0
Patrick Behan,925,62,809,368,263,174,2299.0,66,15,191.0,743,353,25.7,2010,0.0
Zach Evans,78,15,81,30,36,16,411.0,7,2,25.0,74,28,15.3,2010,0.0
Matt Fiery,10,2,4,2,4,4,22.0,3,2,2.0,1,0,19.0,2010,0.0
D.J. Rowe,3,0,2,1,0,0,19.0,2,1,0.0,0,0,5.5,2010,0.0
Rodney Pierce,1358,302,1215,478,342,251,3186.0,436,151,255.0,779,327,24.0,2010,0.0
Calvin Betts,974,152,787,333,303,216,2959.0,290,92,168.0,497,241,18.4,2010,0.0
Sean Smiley,631,76,585,206,111,87,1473.0,388,132,96.0,197,74,24.4,2010,0.0
Max Boudreau,704,53,566,268,235,168,1783.0,2,0,133.0,564,268,20.7,2010,0.0
John Boyer,350,244,295,102,104,72,1857.0,226,74,104.0,69,28,11.4,2010,0.0
Kambi Laleye,85,28,93,36,36,13,586.0,1,0,48.0,92,36,12.1,2010,0.0
Gordon Hayward,992,125,634,298,340,280,2284.0,314,116,138.0,320,182,22.3,2010,1.0
Willie Veasley,877,113,647,322,246,154,3143.0,234,79,174.0,413,243,16.5,2010,0.0
Avery Jukes,246,13,190,84,87,53,819.0,66,25,31.0,124,59,16.5,2010,0.0
Nick Rodgers,12,3,9,4,0,0,46.0,8,4,4.0,1,0,14.9,2010,0.0
Lorenzo Keeler,1157,164,970,342,363,313,2575.0,500,160,182.0,470,182,26.6,2010,0.0
Charles Anderson,262,31,264,92,43,25,1340.0,157,53,41.0,107,39,12.6,2010,0.0
Ryan Darling,45,8,38,20,8,5,369.0,0,0,14.0,38,20,7.6,2010,0.0
Gerard Anderson,651,138,448,231,281,182,1750.0,35,7,173.0,413,224,23.2,2010,0.0
Bryce Webster,254,15,175,98,78,58,988.0,0,0,47.0,175,98,13.4,2010,0.0
Ray Miller,176,10,117,72,60,32,656.0,0,0,36.0,117,72,15.7,2010,0.0
Jamel McGuire,18,15,19,6,10,6,118.0,2,0,17.0,17,6,17.4,2010,0.0
Robbie Robinson,13,6,16,6,0,0,45.0,8,1,4.0,8,5,22.4,2010,0.0
Papa Guisse,120,17,105,44,46,32,826.0,2,0,27.0,103,44,10.8,2010,0.0
Frank Granados,3,0,9,1,0,0,27.0,6,1,0.0,3,0,16.8,2010,0.0
Kenny Daniels,765,96,494,262,266,201,1477.0,120,40,168.0,374,222,24.9,2010,0.0
Willie Galick,992,105,650,332,468,315,2641.0,40,13,244.0,610,319,20.8,2010,0.0
Mark Hill,511,212,426,149,191,140,1750.0,225,73,172.0,201,76,18.7,2010,0.0
Therin Taylor,193,26,155,60,105,71,717.0,21,2,63.0,134,58,17.4,2010,0.0
Kevin Menner,99,6,92,37,47,25,255.0,2,0,23.0,90,37,25.0,2010,0.0
Vincent Cordell,177,18,148,64,49,34,693.0,49,15,36.0,99,49,14.0,2010,0.0
Tony Osunsanmi,65,12,50,23,28,19,661.0,0,0,24.0,50,23,6.2,2010,0.0
Darrell Tripp,3,0,1,0,4,3,12.0,0,0,0.0,1,0,11.2,2010,0.0
Dominic Calegari,1106,143,798,383,282,210,2273.0,331,130,153.0,467,253,24.7,2010,0.0
Jacob Ranger,20,1,19,8,11,4,102.0,3,0,9.0,16,8,16.6,2010,0.0
DeAndre Medlock,10,1,10,2,18,6,73.0,0,0,11.0,10,2,20.6,2010,0.0
Michael Hunter,1308,298,1020,432,261,208,3436.0,608,236,286.0,412,196,22.3,2010,0.0
Zack Atkinson,241,12,221,103,57,35,884.0,0,0,47.0,221,103,17.9,2010,0.0
Brandon Scott,6,0,7,2,2,2,38.0,4,0,2.0,3,2,13.7,2010,0.0
Rashaad Ubah,0,0,1,0,0,0,9.0,0,0,0.0,1,0,6.1,2010,0.0
Kyle Austin,907,83,736,323,322,215,1841.0,138,46,126.0,598,277,29.9,2010,0.0
Larry Gurganious,372,92,296,131,185,108,1370.0,11,2,116.0,285,129,19.6,2010,0.0
Sean Cunningham,653,257,630,220,221,144,2724.0,220,69,225.0,410,151,16.6,2010,0.0
Brandon Dowdy,341,52,344,125,40,27,1217.0,197,64,44.0,147,61,16.9,2010,0.0
Dwight Gordon,137,39,139,54,39,22,529.0,25,7,24.0,114,47,18.2,2010,0.0
Rudy Meo,188,28,143,60,43,34,465.0,85,34,41.0,58,26,24.9,2010,0.0
Bryson Hampton,134,8,121,59,26,16,651.0,0,0,19.0,121,59,12.6,2010,0.0
Jesse LoBue,193,17,165,69,19,15,574.0,90,40,27.0,75,29,19.8,2010,0.0
Jalonni Diggs,269,125,279,100,31,22,1431.0,150,47,84.0,129,53,13.1,2010,0.0
Niko Brooks,5,5,6,2,4,1,42.0,4,0,5.0,2,2,16.3,2010,0.0
Colin Chadwick,2,0,3,1,0,0,9.0,0,0,0.0,3,1,17.7,2010,0.0
Idris Ibn Idris,0,0,0,0,0,0,3.0,0,0,0.0,0,0,0.0,2010,0.0
James Powell,1195,222,989,390,234,194,2897.0,577,221,217.0,412,169,23.8,2010,0.0
Sam Phippen,139,13,107,51,41,23,546.0,36,14,32.0,71,37,15.4,2010,0.0
Chris Brew,44,12,37,17,21,10,130.0,1,0,8.0,36,17,22.0,2010,0.0
Paul Roemer,232,140,195,72,80,53,1428.0,113,35,106.0,82,37,12.1,2010,0.0
Jacob Mercer,4,0,1,1,2,2,7.0,0,0,1.0,1,1,21.9,2010,0.0
Jerome Randle,1835,524,1311,595,446,393,3997.0,622,252,368.0,689,343,24.5,2010,0.0
Patrick Christopher,1700,235,1421,639,316,258,4129.0,480,164,205.0,941,475,23.1,2010,1.0
Jamal Boykin,958,102,724,396,199,156,2349.0,24,10,112.0,700,386,20.2,2010,0.0
Theo Robertson,1315,259,950,455,319,251,3843.0,350,154,219.0,600,301,18.8,2010,0.0
Max Zhang,104,5,59,38,56,28,353.0,0,0,17.0,59,38,14.8,2010,0.0
Nikola Knezevic,196,109,178,59,84,56,1172.0,98,22,87.0,80,37,13.3,2010,0.0
Jonathan Rodriguez,2153,286,1490,712,860,653,3968.0,245,76,346.0,1245,636,28.4,2010,0.0
Miles Taylor,422,43,283,158,156,101,1099.0,19,5,63.0,264,153,18.7,2010,0.0
Kyle Vejraska,900,78,741,336,218,159,2175.0,197,69,174.0,544,267,23.6,2010,0.0
William Kossangue,294,47,255,107,81,48,939.0,85,32,44.0,170,75,17.7,2010,0.0
Ricky Krainiak,41,3,40,14,5,4,156.0,31,9,8.0,9,5,16.5,2010,0.0
Chris Reynolds,137,15,119,49,60,39,437.0,4,0,46.0,115,49,22.4,2010,0.0
Frank Turner,1769,616,1442,631,645,431,4567.0,247,76,468.0,1195,555,24.1,2010,0.0
Rishawn Johnson,252,26,204,95,110,62,900.0,1,0,84.0,203,95,19.0,2010,0.0
Bob Bevilacqua,51,12,51,15,9,8,246.0,41,13,10.0,10,2,13.5,2010,0.0
Jerrald Bonham,508,72,390,188,193,127,2433.0,18,5,108.0,372,183,16.6,2010,0.0
David Swartz,77,10,74,30,12,5,246.0,34,12,20.0,40,18,20.0,2010,0.0
Joe Seymore,1001,147,925,351,148,110,3152.0,562,189,163.0,363,162,19.2,2010,0.0
Ross Pentland,39,16,39,13,11,8,254.0,15,5,13.0,24,8,12.1,2010,0.0
Jonathan Tull,17,4,15,2,21,13,101.0,2,0,11.0,13,2,19.1,2010,0.0
Nick Gerrity,0,0,1,0,0,0,8.0,0,0,2.0,1,0,20.2,2010,0.0
Drew Speraw,67,16,53,24,14,5,239.0,36,14,18.0,17,10,16.7,2010,0.0
Nik Garcia,4,1,10,2,1,0,27.0,4,0,1.0,6,2,22.2,2010,0.0
Ben O'Donnell,5,4,5,2,0,0,31.0,3,1,4.0,2,1,14.8,2010,0.0
Robbie Harman,1058,256,857,344,184,137,3234.0,594,233,236.0,263,111,22.6,2010,0.0
Jordan Bitzer,1158,189,929,361,286,240,3223.0,542,196,168.0,387,165,23.6,2010,0.0
Marko Spica,608,36,405,195,311,218,1433.0,3,0,210.0,402,195,29.2,2010,0.0
Chris Kellermann,941,77,767,321,209,147,2270.0,445,152,178.0,322,169,23.2,2010,0.0
Joe Estrada,3,0,1,1,0,0,4.0,1,1,0.0,0,0,13.0,2010,0.0
Tyler DeNike,0,0,0,0,0,0,1.0,0,0,0.0,0,0,0.0,2010,0.0
Billy Blackmon,128,24,115,56,40,16,858.0,2,0,25.0,113,56,8.6,2010,0.0
Quinton Goods,226,34,199,98,54,29,944.0,4,1,75.0,195,97,15.8,2010,0.0
Patrick Shaughnessy,31,1,20,12,12,7,103.0,0,0,9.0,20,12,16.6,2010,0.0
Sean Sweeney,4,0,13,2,0,0,20.0,2,0,5.0,11,2,44.4,2010,0.0
Dijuan Harris,656,474,450,190,321,225,2910.0,139,51,181.0,311,139,13.2,2010,0.0
Ian Andersen,735,63,672,236,88,68,2140.0,576,195,73.0,96,41,19.2,2010,0.0
RaShad Coleman,315,72,305,124,48,30,969.0,161,37,64.0,144,87,20.1,2010,0.0
Trevin Parks,16,4,11,6,7,4,26.0,1,0,5.0,10,6,35.9,2010,0.0
Kyle Church,18,4,17,5,6,5,56.0,13,3,6.0,4,2,21.1,2010,0.0
Ty Patterson,645,107,527,218,135,86,1672.0,343,123,79.0,184,95,19.2,2010,0.0
Ridge McKeither,253,24,178,95,92,57,471.0,19,6,72.0,159,89,30.2,2010,0.0
Dante Harvey,71,8,80,27,28,13,305.0,29,4,28.0,51,23,19.1,2010,0.0
Kabangu Tshinga Kasamba,266,38,264,96,59,45,1019.0,111,29,71.0,153,67,16.9,2010,0.0
Damian Windham,110,21,91,39,55,32,458.0,0,0,43.0,91,39,16.8,2010,0.0
Marquis Young,165,12,127,69,46,27,431.0,0,0,38.0,127,69,20.2,2010,0.0
Brandan Smith,127,57,123,41,53,34,666.0,37,11,56.0,86,30,14.6,2010,0.0
Alex Roberts,14,1,15,5,6,2,64.0,9,2,4.0,6,3,16.4,2010,0.0
Lance Stephenson,419,84,368,162,119,79,960.0,73,16,81.0,295,146,26.2,2010,1.0
Deonta Vaughn,1885,511,1539,608,447,356,4270.0,913,313,357.0,626,295,21.1,2010,0.0
Steve Toyloy,239,35,169,94,101,51,1059.0,0,0,60.0,169,94,12.1,2010,0.0
Joe Wolfinger,355,11,298,133,75,47,867.0,120,42,58.0,178,91,25.3,2010,0.0
Tom Fitzpatrick,3,0,2,0,4,3,8.0,0,0,0.0,2,0,28.0,2010,0.0
Zach Beach,0,0,2,0,0,0,1.0,2,0,2.0,0,0,0,2010,0.0
Trevor Booker,1725,224,1228,687,526,328,3806.0,71,23,260.0,1157,664,23.3,2010,1.0
David Potter,637,148,601,224,129,91,2208.0,290,98,157.0,311,126,17.0,2010,0.0
Karolis Petrukonis,21,7,26,10,8,1,125.0,0,0,17.0,26,10,15.0,2010,0.0
Nigel Ajere,72,6,66,27,22,18,190.0,0,0,16.0,66,27,25.6,2010,0.0
Lance James,43,7,29,12,21,17,106.0,7,2,9.0,22,10,23.8,2010,0.0
Joseph Harris,1444,188,1056,592,426,257,3806.0,12,3,250.0,1044,589,19.3,2010,0.0
Mario Edwards,700,167,581,249,141,97,1910.0,276,105,150.0,305,144,20.2,2010,0.0
Logan Johnson,782,312,638,270,248,177,2897.0,210,65,221.0,428,205,16.7,2010,0.0
Marcus Macellari,2,1,3,0,2,2,23.0,0,0,2.0,3,0,12.8,2010,0.0
Kyle Roemer,1640,135,1325,557,326,259,3517.0,689,267,271.0,636,290,26.1,2010,0.0
Ben Johnson,743,101,594,255,263,196,2166.0,108,37,162.0,486,218,21.7,2010,0.0
Brett Marfurt,51,8,61,16,15,9,232.0,44,10,16.0,17,6,19.6,2010,0.0
Patrick Liengueu,1,2,3,0,2,1,22.0,1,0,1.0,2,0,11.6,2010,0.0
Tony White Jr,1499,347,1118,465,382,316,3867.0,662,253,293.0,456,212,21.2,2010,0.0
Casaan Breeden,459,60,390,170,78,58,1368.0,182,61,101.0,208,109,19.6,2010,0.0
Rashad Wright,16,2,11,5,13,6,172.0,0,0,7.0,11,5,7.2,2010,0.0
Travis Busch,297,36,256,108,98,69,954.0,37,12,58.0,219,96,19.6,2010,0.0
Mame Bocar Ba,127,9,93,43,65,41,569.0,0,0,38.0,93,43,14.9,2010,0.0
Mike Annese,51,7,33,12,27,20,116.0,16,7,14.0,17,5,27.0,2010,0.0
Harvey Perry,163,45,174,52,58,37,650.0,74,22,56.0,100,30,19.0,2010,0.0
Arin Dunn,78,23,81,27,20,13,531.0,37,11,25.0,44,16,13.5,2010,0.0
Johnny Del Bene,5,0,4,2,0,0,14.0,2,1,0.0,2,1,14.8,2010,0.0
Dwight Thorne II,750,160,571,247,196,159,2468.0,274,97,150.0,297,150,18.5,2010,0.0
Casey Crawford,267,31,224,95,40,30,741.0,126,47,30.0,98,48,20.1,2010,0.0
Niko Scott,855,168,675,271,248,175,2604.0,367,138,182.0,308,133,20.1,2010,0.0
Patrick Foley,625,178,491,210,199,164,1584.0,131,41,130.0,360,169,24.2,2010,0.0
Kevin Bulger,435,211,457,167,112,80,2233.0,96,21,150.0,361,146,15.8,2010,0.0
Issa Mase,22,4,18,7,12,6,80.0,6,2,12.0,12,5,23.6,2010,0.0
Tom Piscina,2,0,1,1,0,0,1.0,0,0,0.0,1,1,52.9,2010,0.0
Sandeep Dhaliwal,0,0,0,0,0,0,1.0,0,0,0.0,0,0,0.0,2010,0.0
Jerome Dyson,1630,333,1342,523,611,449,3436.0,424,135,312.0,918,388,29.0,2010,1.0
Stanley Robinson,1231,131,1007,488,280,181,3307.0,211,74,210.0,796,414,20.4,2010,0.0
Gavin Edwards,631,47,393,233,224,165,1839.0,1,0,110.0,392,233,15.8,2010,0.0
Ater Majok,59,4,59,25,22,9,383.0,0,0,21.0,59,25,11.6,2010,0.0
Darius Smith,19,6,12,5,15,8,85.0,2,1,9.0,10,4,16.2,2010,0.0
Alex Hornat,0,0,0,0,0,0,7.0,0,0,1.0,0,0,12.2,2010,0.0
Kareem Brown,281,37,281,96,42,32,767.0,177,57,55.0,104,39,24.0,2010,0.0
Sam Coleman,405,17,353,151,142,102,1234.0,6,1,64.0,347,150,21.8,2010,0.0
Lenny Young,303,64,292,109,82,48,891.0,101,37,82.0,191,72,27.5,2010,0.0
Quinston Reggins,130,47,117,35,69,48,602.0,41,12,48.0,76,23,17.0,2010,0.0
Edward Hayden,288,18,291,129,39,26,1222.0,18,4,57.0,273,125,16.6,2010,0.0
George Jackson,67,29,79,21,26,19,356.0,27,6,43.0,52,15,19.5,2010,0.0
Jonathan Landry,25,1,25,10,4,1,70.0,9,4,0.0,16,6,19.9,2010,0.0
Ryan Wittman,2028,221,1520,696,307,259,4140.0,874,377,201.0,646,319,23.3,2010,0.0
Jeff Foote,957,182,640,367,370,223,2305.0,0,0,177.0,640,367,22.4,2010,1.0
Louis Dale,1452,470,1037,478,397,332,3102.0,409,164,305.0,628,314,25.6,2010,0.0
Jon Jaques,242,29,180,83,34,28,638.0,111,48,33.0,69,35,19.2,2010,0.0
Geoff Reeves,583,91,456,210,53,45,1867.0,270,118,89.0,186,92,14.4,2010,0.0
Alex Tyler,616,82,480,237,198,142,1896.0,1,0,123.0,479,237,20.1,2010,0.0
Andre Wilkins,73,5,71,30,23,13,304.0,2,0,24.0,69,30,17.4,2010,0.0
Pete Reynolds,57,12,41,24,19,9,265.0,5,0,18.0,36,24,9.9,2010,0.0
Cavel Witter,809,217,593,234,298,246,1927.0,274,95,194.0,319,139,25.0,2010,0.0
P'Allen Stinnett,1024,171,796,350,295,222,2215.0,329,102,198.0,467,248,26.5,2010,0.0
Chad Millard,259,52,218,85,87,54,1341.0,117,35,62.0,101,50,12.4,2010,0.0
Robby Pride,461,113,408,168,107,79,1699.0,158,46,120.0,250,122,18.9,2010,0.0
Josh Riddle,111,33,141,46,24,16,627.0,28,3,34.0,113,43,17.8,2010,0.0
Marlon Sanders,334,130,319,126,130,73,1491.0,51,9,128.0,268,117,19.5,2010,0.0
Herve Kouna,65,7,60,25,25,15,326.0,1,0,37.0,59,25,17.3,2010,0.0
Josef Brown,6,0,6,3,4,0,31.0,0,0,1.0,6,3,15.5,2010,0.0
Jarrett Mathis,27,2,21,8,18,11,170.0,0,0,8.0,21,8,10.1,2010,0.0
Garrett Brown,3,1,2,0,4,3,16.0,1,0,2.0,1,0,19.9,2010,0.0
Will Archambault,1065,170,928,383,183,113,2777.0,535,186,160.0,393,197,20.4,2010,0.0
Steve Rossiter,577,153,397,212,226,146,2286.0,26,7,122.0,371,205,14.5,2010,0.0
Bryant Barr,733,84,654,240,97,68,1996.0,505,185,75.0,149,55,18.2,2010,0.0
Dan Nelms,63,30,61,26,29,8,450.0,8,3,16.0,53,23,7.4,2010,0.0
Aaron Bond,22,4,18,8,0,0,41.0,10,6,4.0,8,2,24.4,2010,0.0
Rob Lowery,413,192,364,132,109,74,1063.0,208,75,119.0,156,57,25.4,2010,0.0
Mickey Perry,426,101,390,152,86,50,1341.0,223,72,82.0,167,80,19.5,2010,0.0
Kurt Huelsman,611,79,476,226,277,159,2912.0,0,0,184.0,476,226,14.2,2010,0.0
London Warren,532,451,441,188,265,151,2598.0,15,5,288.0,426,183,17.1,2010,0.0
Luke Hendrick,5,1,6,1,4,3,26.0,2,0,1.0,4,1,17.4,2010,0.0
Dan Fox,7,1,4,2,8,3,45.0,0,0,3.0,4,2,12.6,2010,0.0
Marcus Neal,857,160,769,303,163,116,2750.0,365,135,210.0,404,168,23.2,2010,0.0
Frisco Sandidge,883,125,670,325,327,217,2741.0,81,16,175.0,589,309,21.5,2010,0.0
Kris Douse,152,16,152,60,53,23,653.0,26,9,69.0,126,51,22.6,2010,0.0
Sheridan Price,2,0,5,0,2,2,34.0,0,0,0.0,5,0,9.9,2010,0.0
Nate Rohnert,1307,357,889,428,528,379,3499.0,238,72,274.0,651,356,27.2,2010,0.0
Tom Chott,1,0,1,0,2,1,10.0,1,0,1.0,0,0,17.1,2010,0.0
Kyle Chynoweth,0,0,0,0,0,0,4.0,0,0,0.0,0,0,0.0,2010,0.0
Will Walker,1361,188,1246,496,251,174,3361.0,571,195,131.0,675,301,24.4,2010,0.0
Mac Koshwal,1019,124,784,409,355,199,2629.0,8,2,206.0,776,407,22.4,2010,0.0
Ryan Siggins,39,5,34,13,4,3,140.0,26,10,2.0,8,3,14.5,2010,0.0
Kene Obi,31,1,25,9,22,13,127.0,0,0,6.0,25,9,16.5,2010,0.0
Xavier Keeling,548,93,364,170,259,177,1401.0,84,31,125.0,280,139,23.6,2010,0.0
Woody Payne,609,310,499,217,247,154,2677.0,67,21,233.0,432,196,16.8,2010,0.0
Eulis Stephens,566,85,522,212,184,114,2038.0,123,28,110.0,399,184,19.3,2010,0.0
Eugene Blue,213,13,153,88,72,37,773.0,0,0,64.0,153,88,16.8,2010,0.0
Lamar Lee,137,31,132,46,18,14,462.0,96,31,21.0,36,15,19.2,2010,0.0
Curtis Eatmon,78,43,61,26,40,23,465.0,18,3,50.0,43,23,18.5,2010,0.0
Jordan Fee,30,21,19,8,16,11,242.0,3,3,19.0,16,5,10.0,2010,0.0
Josh Young,1789,263,1312,546,563,442,4002.0,706,255,226.0,606,291,24.0,2010,0.0
Adam Templeton,901,121,712,307,152,113,3097.0,444,174,140.0,268,133,16.4,2010,0.0
Craig Stanley,413,187,283,135,169,128,1425.0,47,15,132.0,236,120,21.7,2010,0.0
Bill Eaddy,541,72,396,166,244,175,697.0,90,34,27.0,306,132,13.7,2010,0.0
Jamie Harris,781,248,695,271,219,169,2642.0,213,70,171.0,482,201,20.3,2010,0.0
Evan Neisler,485,28,394,179,189,127,1724.0,3,0,141.0,391,179,18.1,2010,0.0
Leon Spencer,295,23,218,110,119,75,799.0,0,0,56.0,218,110,21.1,2010,0.0
Kevin Phillip,91,6,85,43,12,5,413.0,0,0,14.0,85,43,13.0,2010,0.0
Shannon Givens,73,18,64,28,13,6,253.0,24,11,13.0,40,17,16.9,2010,0.0
Kenny Tribbett,188,8,147,67,75,54,837.0,0,0,76.0,147,67,13.0,2010,0.0
Bill Lally,0,1,9,0,0,0,19.0,6,0,2.0,3,0,23.3,2010,0.0
Jon Scheyer,2077,440,1442,586,706,608,4759.0,780,297,211.0,662,289,20.5,2010,0.0
Brian Zoubek,562,73,379,225,184,112,1670.0,0,0,130.0,379,225,17.5,2010,0.0
Jordan Davidson,18,6,13,4,14,8,101.0,5,2,8.0,8,2,13.3,2010,0.0
Jason Duty,540,117,447,171,94,75,2297.0,345,123,76.0,102,48,11.8,2010,0.0
Lucas Newton,15,7,10,4,6,4,87.0,8,3,9.0,2,1,11.9,2010,0.0
Oliver Lewinson,30,5,39,12,13,6,293.0,1,0,24.0,38,12,11.6,2010,0.0
Chase Robinson,20,4,25,7,2,2,97.0,14,4,5.0,11,3,15.6,2010,0.0
Salim Fauras,0,0,1,0,0,0,1.0,0,0,1.0,1,0,97.3,2010,0.0
Chris Turner,139,32,161,49,41,20,514.0,61,21,38.0,100,28,21.3,2010,0.0
Greyson Sargent,39,4,33,12,6,6,120.0,23,9,6.0,10,3,14.7,2010,0.0
Jocolby Davis,88,78,75,34,38,18,647.0,12,2,69.0,63,32,12.2,2010,0.0
Bruce Grimm,37,20,41,8,23,16,178.0,26,5,17.0,15,3,18.9,2010,0.0
Jordan Edwards,0,0,0,0,0,0,5.0,0,0,0.0,0,0,0.0,2010,0.0
T.J. Marion,477,190,368,169,213,139,1704.0,3,0,144.0,365,169,19.2,2010,0.0
Ousmane Cisse,753,118,578,309,243,135,2833.0,0,0,186.0,578,309,16.3,2010,0.0
Edin Suljic,303,51,269,124,73,55,1050.0,0,0,72.0,269,124,19.1,2010,0.0
Jay Smith,159,12,157,55,15,12,443.0,125,37,19.0,32,18,22.1,2010,0.0
Dewayne Wright Jr,134,41,120,44,47,32,451.0,42,14,38.0,78,30,21.3,2010,0.0
Romain Martin,1158,82,965,404,182,151,2375.0,518,199,161.0,447,205,27.0,2010,0.0
Josh Taylor,1058,136,821,381,157,109,2575.0,488,187,142.0,333,194,23.2,2010,0.0
Papa Oppong,600,79,460,222,88,61,1519.0,224,95,57.0,236,127,20.6,2010,0.0
Dayvon Ellis,262,117,216,97,35,30,971.0,107,38,63.0,109,59,17.1,2010,0.0
Robin Mestdagh,117,46,122,41,7,4,695.0,100,31,36.0,22,10,13.0,2010,0.0
Mike Lewis,107,33,101,37,20,12,314.0,61,21,21.0,40,16,23.3,2010,0.0
Antonio Gilkey,27,8,20,10,14,7,83.0,0,0,6.0,20,10,21.9,2010,0.0
Cordaro Ellis,8,2,5,4,0,0,52.0,0,0,4.0,5,4,9.6,2010,0.0
Carlos Medlock,1574,400,1126,448,578,465,3542.0,602,213,406.0,524,235,26.4,2010,0.0
Justin Dobbins,1078,95,771,419,402,240,2724.0,1,0,189.0,770,419,20.8,2010,0.0
L.J. Frazier,214,77,205,64,61,40,958.0,134,46,61.0,71,18,9.2,2010,0.0
Mark Dunn,485,40,381,184,118,89,1525.0,76,28,70.0,305,156,16.8,2010,0.0
Benny Valentine,744,190,671,259,175,123,1685.0,303,103,152.0,368,156,27.9,2010,0.0
Abebe Demissie,63,19,48,19,39,22,162.0,17,3,14.0,31,16,24.4,2010,0.0
Matthew Brunell,221,43,210,81,69,41,1262.0,51,18,96.0,159,63,14.0,2010,0.0
Gary Gibson,333,150,293,111,101,71,1693.0,146,40,110.0,147,71,14.0,2010,0.0
Alden Gibbs,59,13,66,19,36,19,378.0,9,2,14.0,57,17,12.6,2010,0.0
Sean Fischer,0,0,1,0,0,0,0.0,0,0,0.0,1,0,0,2010,0.0
Adam Constantine,734,51,483,290,282,154,2328.0,2,0,136.0,481,290,17.3,2010,0.0
T.J. Douglas,587,71,502,200,30,24,2158.0,431,163,51.0,71,37,13.5,2010,0.0
Devan Carter,662,134,664,257,169,100,2376.0,174,48,196.0,490,209,19.7,2010,0.0
Jon Ogolo,63,16,85,26,2,0,345.0,49,11,15.0,36,15,10.2,2010,0.0
Bryan Bouchie,349,25,264,136,124,65,810.0,40,12,57.0,224,124,24.8,2010,0.0
Monie Hudson,40,6,37,14,7,5,167.0,24,7,4.0,13,7,14.1,2010,0.0
Trevor Gregory,21,2,25,7,12,6,84.0,1,1,8.0,24,6,25.1,2010,0.0
Derek Johnson,2,0,2,1,0,0,4.0,0,0,0.0,2,1,26.5,2010,0.0
Mike Evanovich,732,143,580,243,102,81,1887.0,413,165,99.0,167,78,17.0,2010,0.0
Shimeek Johnson,71,12,80,30,12,3,333.0,34,8,13.0,46,22,14.7,2010,0.0
Jamal Turner,47,48,70,17,29,11,743.0,5,2,43.0,65,15,8.0,2010,0.0
Greg Martin,2,0,3,1,0,0,9.0,0,0,3.0,3,1,33.1,2010,0.0
Sean Grzeck,22,6,28,8,2,1,115.0,23,5,6.0,5,3,0.0,2010,0.0
Jimmy O'Sullivan,5,3,8,2,0,0,51.0,6,1,5.0,2,1,14.2,2010,0.0
Sean Baptiste,1519,102,1192,518,465,333,3302.0,432,150,173.0,760,368,24.7,2010,0.0
Alvin Mofunanya,602,61,474,215,276,168,1767.0,13,4,211.0,461,211,27.0,2010,0.0
Anaclet Mulumba Mbayi,34,7,29,11,18,11,308.0,5,1,15.0,24,10,8.7,2010,0.0
DeJuan Pursley,163,20,145,70,61,23,814.0,0,0,65.0,145,70,14.8,2010,0.0
Brandon Bryant,591,69,537,192,155,115,1665.0,298,92,107.0,239,100,20.2,2010,0.0
David Buchanon,224,69,181,76,46,33,726.0,98,39,72.0,83,37,21.3,2010,0.0
Sanchez Hughley,484,49,413,170,145,98,1296.0,128,46,100.0,285,124,22.9,2010,0.0
Marlon Bright,527,56,469,213,136,85,2048.0,64,16,124.0,405,197,16.3,2010,0.0
J.C. Otero,259,26,212,104,53,31,684.0,79,20,26.0,133,84,19.4,2010,0.0
Antoine Watson,176,56,166,57,53,40,519.0,83,22,51.0,83,35,23.0,2010,0.0
Cedric Essola,379,44,323,139,157,101,1433.0,9,0,92.0,314,139,16.2,2010,0.0
Martavis Key,47,9,53,19,8,4,189.0,21,5,7.0,32,14,16.7,2010,0.0
Nick Taylor,129,141,149,35,93,49,1342.0,67,10,72.0,82,25,10.6,2010,0.0
Nehemiah Crowder,2,0,0,0,2,2,17.0,0,0,0.0,0,0,2.8,2010,0.0
Dante Jennings,2,0,3,1,0,0,10.0,0,0,0.0,3,1,14.8,2010,0.0
Marcus Crawford,10,0,7,5,1,0,57.0,1,0,7.0,6,5,4.9,2010,0.0
Solomon Alabi,704,28,506,270,220,164,1692.0,1,0,128.0,505,270,21.9,2010,1.0
Ryan Reid,624,85,477,236,250,151,2539.0,1,1,206.0,476,235,15.9,2010,1.0
Jordan Demercy,228,90,204,84,69,43,1285.0,67,17,106.0,137,67,13.4,2010,0.0
Brian Hoff,63,7,52,23,12,7,152.0,27,10,5.0,25,13,20.8,2010,0.0
Dan Werner,873,268,788,314,160,121,3293.0,407,124,193.0,381,190,12.2,2010,0.0
Ray Shipman,223,32,181,85,68,47,871.0,38,6,41.0,143,79,13.8,2010,0.0
Rod Tishman,4,4,4,1,2,2,16.0,1,0,0.0,3,1,15.5,2010,0.0
Hudson Fricke,4,2,2,0,4,4,22.0,1,0,1.0,1,0,10.0,2010,0.0
Herb Tanner,247,109,284,87,101,47,1515.0,116,26,99.0,168,61,14.6,2010,0.0
Brennen Melvin,32,17,41,9,12,9,210.0,24,5,14.0,17,4,13.5,2010,0.0
Matt Beck,9,3,7,3,0,0,142.0,7,3,3.0,0,0,2.9,2010,0.0
Nick Checovich,0,1,8,0,0,0,27.0,7,0,0.0,1,0,13.9,2010,0.0
Kyle Kesses,0,0,0,0,0,0,5.0,0,0,0.0,0,0,0.0,2010,0.0
Paul George,974,151,716,320,264,212,2138.0,308,122,173.0,408,198,24.6,2010,1.0
Sylvester Seay,1152,107,924,408,332,229,2396.0,334,107,186.0,590,301,27.6,2010,0.0
Brandon Sperling,192,101,173,58,102,67,1196.0,54,9,85.0,119,49,13.3,2010,0.0
Brandon Webster,107,5,82,44,38,19,423.0,0,0,35.0,82,44,16.4,2010,0.0
Taylor Kelly,3,1,14,1,0,0,34.0,11,1,1.0,3,0,22.8,2010,0.0
Chris Picardi,2,1,6,1,0,0,10.0,1,0,0.0,5,1,30.5,2010,0.0
Zach Greene,0,0,5,0,0,0,10.0,4,0,0.0,1,0,25.5,2010,0.0
C.J. Hailey,504,58,421,186,120,95,1083.0,96,37,93.0,325,149,25.0,2010,0.0
Anton Silver,406,54,356,145,91,55,829.0,180,61,87.0,176,84,28.7,2010,0.0
Grayson Flittner,1223,313,966,371,269,218,2927.0,696,263,189.0,270,108,19.3,2010,0.0
Auryn MacMillan,734,56,550,303,234,128,2241.0,0,0,141.0,550,303,20.8,2010,0.0
Matt Maden,42,5,40,18,11,6,208.0,0,0,20.0,40,18,16.9,2010,0.0
Louis Birdsong,597,84,486,239,152,106,2347.0,39,13,109.0,447,226,13.0,2010,0.0
Jimmy Nolan,8,3,9,3,0,0,26.0,7,2,3.0,2,1,51.4,2010,0.0
Damian Hollis,1196,141,920,417,303,248,2614.0,305,114,230.0,615,303,25.0,2010,0.0
Hermann Opoku,200,6,117,70,96,60,835.0,0,0,50.0,117,70,12.7,2010,0.0
Jeff Alston,0,0,1,0,0,0,5.0,1,0,0.0,0,0,9.7,2010,0.0
Jp Cotton,0,0,0,0,0,0,3.0,0,0,0.0,0,0,0.0,2010,0.0
Greg Monroe,942,207,635,345,359,243,2122.0,33,9,189.0,602,336,24.7,2010,1.0
Stephen Stepka,2,0,2,1,0,0,9.0,0,0,0.0,2,1,11.6,2010,0.0
Antonio Hanson,818,124,703,283,79,65,2034.0,471,187,150.0,232,96,21.2,2010,0.0
Colby Wohlleb,330,21,260,108,41,31,911.0,205,83,38.0,55,25,16.8,2010,0.0
Antoine Johnson,549,182,482,214,194,98,1731.0,73,23,163.0,409,191,20.4,2010,0.0
Johntavious Rucker,190,79,176,73,78,38,876.0,28,6,74.0,148,67,15.3,2010,0.0
Tyler Troupe,512,61,495,203,100,66,1598.0,138,40,139.0,357,163,20.8,2010,0.0
Sandy Perry,225,13,207,95,49,33,732.0,12,2,35.0,195,93,17.5,2010,0.0
Krzysztof Janiszewski,116,9,122,52,36,12,481.0,1,0,41.0,121,52,17.6,2010,0.0
Jeb Brannen,11,9,16,4,7,3,169.0,4,0,10.0,12,4,8.4,2010,0.0
Alex Coxworth,4,0,3,1,2,1,5.0,3,1,0.0,0,0,38.1,2010,0.0
Joe Dukes,828,257,719,313,219,158,1992.0,142,44,169.0,577,269,27.3,2010,0.0
Trae Goldston,1041,148,954,365,142,115,2792.0,531,196,172.0,423,169,22.4,2010,0.0
Trey Hampton,583,70,457,213,206,141,2173.0,40,16,155.0,417,197,19.2,2010,0.0
Xavier Hansbro,469,40,512,196,67,41,1375.0,144,36,85.0,368,160,24.8,2010,0.0
Ousman Krubally,380,30,254,142,172,96,1319.0,0,0,86.0,254,142,17.5,2010,0.0
Kevin Lott,298,43,269,99,93,61,1366.0,127,39,66.0,142,60,14.7,2010,0.0
Gani Lawal,1167,43,814,446,498,275,2403.0,3,0,211.0,811,446,24.8,2010,1.0
Derrick Favors,448,37,293,179,143,90,989.0,1,0,90.0,292,179,21.8,2010,1.0
Zach Peacock,1009,109,804,384,262,193,2660.0,144,48,182.0,660,336,21.0,2010,0.0
D'Andre Bell,582,163,505,214,164,121,2349.0,101,33,171.0,404,181,15.9,2010,0.0
Brad Sheehan,97,19,102,41,22,15,510.0,5,0,22.0,97,41,12.4,2010,0.0
Sam Shew,6,2,4,1,7,4,25.0,1,0,4.0,3,1,21.6,2010,0.0
Ricky McPhee,822,125,722,273,116,88,2464.0,526,188,161.0,196,85,17.7,2010,0.0
Albert Jackson,398,41,327,163,136,72,1877.0,0,0,167.0,327,163,14.3,2010,0.0
Tyler Whatley,398,39,350,158,130,82,1590.0,5,0,81.0,345,158,15.5,2010,0.0
Matt Bouldin,1683,444,1217,564,469,368,4225.0,492,187,281.0,725,377,20.5,2010,0.0
Bol Kong,138,18,105,48,26,18,389.0,57,24,15.0,48,24,17.1,2010,0.0
Will Foster,103,8,87,47,42,9,472.0,0,0,35.0,87,47,15.2,2010,0.0
Andy Poling,11,0,5,4,13,3,23.0,0,0,2.0,5,4,28.8,2010,0.0
Chris Pontarolo-Maag,5,4,7,2,2,1,35.0,3,0,2.0,4,2,14.4,2010,0.0
Ariece Perkins,554,156,439,185,185,129,1533.0,145,55,111.0,294,130,20.9,2010,0.0
George Akpele,271,20,242,121,92,29,1232.0,0,0,83.0,242,121,15.6,2010,0.0
Kevin Loyd,170,106,166,62,38,28,1107.0,65,18,72.0,101,44,11.6,2010,0.0
Torez Young,80,15,80,25,38,26,295.0,19,4,44.0,61,21,24.2,2010,0.0
Terdarin Bryson,56,17,53,18,19,15,319.0,17,5,24.0,36,13,13.5,2010,0.0
Greg Dillon,48,8,51,18,11,7,103.0,16,5,15.0,35,13,34.7,2010,0.0
Maurice Wilkerson,28,5,21,12,4,3,144.0,1,1,9.0,20,11,11.1,2010,0.0
Jameel Forbes,22,4,26,10,5,2,90.0,1,0,15.0,25,10,24.2,2010,0.0
Demarcus Blunt,10,3,12,3,6,4,48.0,0,0,5.0,12,3,20.8,2010,0.0
Philip Duckett,0,0,1,0,0,0,5.0,1,0,0.0,0,0,10.0,2010,0.0
David Thomas,0,0,1,0,0,0,2.0,0,0,0.0,1,0,25.1,2010,0.0
Troy Cotton,1251,116,972,410,192,159,3366.0,655,272,127.0,317,138,19.0,2010,0.0
Randy Berry,728,78,444,225,367,278,2921.0,3,0,142.0,441,225,14.3,2010,0.0
Cordero Barkley,317,89,264,103,128,88,1617.0,84,23,81.0,180,80,14.5,2010,0.0
Pat Nelson,161,29,152,64,67,33,1339.0,1,0,70.0,151,64,10.1,2010,0.0
Jon Anderson,3,3,3,1,0,0,29.0,2,1,1.0,1,0,7.3,2010,0.0
Vincent Simpson,1337,280,1248,469,272,177,3246.0,697,222,341.0,551,247,28.8,2010,0.0
Michael Freeman,1241,79,810,441,503,357,3339.0,21,2,316.0,789,439,20.8,2010,0.0
John Ntoko,120,27,125,43,34,19,753.0,66,15,39.0,59,28,10.4,2010,0.0
Jordan Brooks,170,168,205,53,86,47,1147.0,87,17,110.0,118,36,10.6,2010,0.0
Antwyne Hines,3,0,4,1,2,1,15.0,0,0,1.0,4,1,25.1,2010,0.0
Joel Barkers,250,20,208,90,123,69,620.0,1,1,45.0,207,89,26.9,2010,0.0
David Bookman,76,9,65,27,36,22,228.0,3,0,19.0,62,27,23.9,2010,0.0
Zack Zeglinski,9,6,11,3,6,3,41.0,3,0,2.0,8,3,20.7,2010,0.0
Jeremy Lin,1483,406,1052,506,495,363,3354.0,324,108,331.0,728,398,27.7,2010,1.0
Pat Magnarelli,341,29,244,139,88,63,912.0,0,0,45.0,244,139,18.6,2010,0.0
Doug Miller,244,24,194,110,54,24,1027.0,0,0,45.0,194,110,13.6,2010,0.0
Max Kenyi,202,22,175,65,72,50,769.0,67,22,51.0,108,43,18.3,2010,0.0
Spencer deMars,4,1,2,0,8,4,18.0,0,0,1.0,2,0,19.6,2010,0.0
Dan McGeary,433,77,426,141,58,44,1657.0,343,107,81.0,83,34,18.8,2010,0.0
Peter Edelson,0,0,1,0,0,0,7.0,1,0,0.0,0,0,7.4,2010,0.0
Roderick Flemings,1052,137,816,369,388,270,2390.0,164,44,158.0,652,325,24.0,2010,0.0
Petras Balocka,469,93,381,156,231,144,1262.0,58,13,130.0,323,143,22.8,2010,0.0
Adhar Mayen,394,80,369,152,64,46,1526.0,146,44,100.0,223,108,16.8,2010,0.0
Dwain Williams,613,107,483,180,161,137,1575.0,292,116,82.0,191,64,25.6,2010,0.0
Jeremy Lay,194,54,174,52,78,62,558.0,104,28,45.0,70,24,22.8,2010,0.0
Paul Campbell,249,57,178,105,84,39,1108.0,0,0,54.0,178,105,12.4,2010,0.0
Leroy Lutu,80,16,78,34,26,10,292.0,13,2,25.0,65,32,18.7,2010,0.0
Ji Xiang,38,4,22,9,36,20,112.0,2,0,5.0,20,9,18.8,2010,0.0
Beau Albrechtson,4,1,4,2,0,0,15.0,1,0,2.0,3,2,27.6,2010,0.0
Rykin Enos,3,3,4,0,4,3,15.0,3,0,2.0,1,0,26.2,2010,0.0
Eugene Harris,1411,263,1200,476,222,176,3689.0,777,283,206.0,423,193,20.2,2010,0.0
Cruz Daniels,678,63,488,286,162,105,2510.0,2,1,152.0,486,285,14.1,2010,0.0
David Singleton,333,206,297,128,136,74,1376.0,17,3,167.0,280,125,18.7,2010,0.0
Jourdan Morris,339,22,293,142,79,45,891.0,32,10,70.0,261,132,21.8,2010,0.0
Cornelius Vines,594,125,584,185,145,92,1744.0,423,132,97.0,161,53,20.7,2010,0.0
Miklos Szabo,299,20,269,130,63,33,952.0,23,6,68.0,246,124,18.5,2010,0.0
Eric Meister,562,65,468,241,151,80,2374.0,0,0,115.0,468,241,14.6,2010,0.0
Adam May,322,68,254,88,150,112,1102.0,115,34,67.0,139,54,18.4,2010,0.0
Aubrey Coleman,1516,167,1229,523,547,409,2342.0,209,61,160.0,1020,462,33.8,2010,0.0
Kelvin Lewis,1536,130,1234,504,323,263,3478.0,706,265,105.0,528,239,20.4,2010,0.0
Sean Coleman,148,10,137,54,15,10,584.0,84,30,18.0,53,24,13.3,2010,0.0
Kahmell Broughton,20,2,12,8,6,4,141.0,0,0,3.0,12,8,6.0,2010,0.0
Jamon Wilson,2,0,1,1,0,0,7.0,0,0,0.0,1,1,6.9,2010,0.0
Curtis White,703,201,574,221,152,119,2725.0,398,142,174.0,176,79,15.9,2010,0.0
Paul Kirkpatrick,676,68,490,261,304,154,2618.0,0,0,212.0,490,261,16.9,2010,0.0
Adam Walker,408,100,406,158,165,87,1850.0,22,5,139.0,384,153,19.9,2010,0.0
Kandi Mukole,560,62,483,196,234,119,2123.0,165,49,175.0,318,147,20.4,2010,0.0
C.J. Prince,144,13,143,43,25,19,475.0,118,39,26.0,25,4,19.1,2010,0.0
Tyreak Johnson,29,12,43,9,15,10,126.0,14,1,17.0,29,8,27.4,2010,0.0
Yannick Braimbridge,47,36,60,17,13,7,443.0,28,6,43.0,32,11,12.3,2010,0.0
Nate Cooper,73,15,63,23,60,27,769.0,0,0,39.0,63,23,3.3,2010,0.0
Amorrow Morgan,1221,265,968,427,437,303,3290.0,200,64,313.0,768,363,25.5,2010,0.0
Demetrius Monroe,628,63,469,267,131,94,2218.0,0,0,82.0,469,267,15.3,2010,0.0
Austin Kilpatrick,708,151,665,227,102,71,2282.0,512,183,135.0,153,44,20.4,2010,0.0
Chron Tatum,508,23,378,204,148,95,1523.0,20,5,71.0,358,199,18.8,2010,0.0
Donnie Carson,542,104,546,206,161,111,2025.0,73,19,108.0,473,187,20.3,2010,0.0
Rolando Little,85,8,69,32,39,21,393.0,0,0,21.0,69,32,14.9,2010,0.0
Todd Starks,29,5,18,10,6,5,67.0,8,4,7.0,10,6,22.4,2010,0.0
Mac Hopson,1062,390,786,347,379,270,2396.0,242,98,217.0,544,249,26.9,2010,0.0
Kashif Watson,651,147,475,216,306,211,1838.0,36,8,130.0,439,208,23.1,2010,0.0
Steffan Johnson,1250,436,1030,430,260,180,3287.0,554,210,302.0,476,220,19.1,2010,0.0
Marvin Jefferson,576,33,421,234,195,108,1490.0,0,0,104.0,421,234,19.7,2010,0.0
Luciano de Souza,485,36,377,156,86,66,1288.0,288,107,52.0,89,49,19.5,2010,0.0
Marcus Lawrence,148,157,149,55,42,21,1136.0,61,17,73.0,88,38,14.4,2010,0.0
Travis Blackstock,18,2,21,8,4,1,57.0,4,1,1.0,17,7,28.0,2010,0.0
Jeremy Buttell,622,53,516,228,146,97,2098.0,212,69,94.0,304,159,17.3,2010,0.0
Chris Buchanan,158,15,145,53,43,27,539.0,86,25,34.0,59,28,20.0,2010,0.0
Spencer Stewart,517,420,503,160,142,109,2666.0,264,88,262.0,239,72,16.0,2010,0.0
Kris Harris,107,26,123,42,42,17,452.0,27,6,29.0,96,36,21.7,2010,0.0
Austin Hood,15,0,13,5,5,3,41.0,6,2,2.0,7,3,21.8,2010,0.0
Arthur Wiley,0,0,3,0,0,0,15.0,2,0,1.0,1,0,13.7,2010,0.0
Osiris Eldridge,1838,271,1547,631,397,298,4099.0,758,278,270.0,789,353,25.6,2010,0.0
Dinma Odiakosa,982,85,654,385,410,212,2807.0,0,0,179.0,654,385,21.1,2010,0.0
Lloyd Phillips,659,249,537,210,187,139,2086.0,271,100,158.0,266,110,19.0,2010,0.0
Dominique Keller,358,27,310,152,59,35,827.0,57,19,56.0,253,133,25.4,2010,0.0
Richard Semrau,68,12,56,26,25,15,368.0,5,1,26.0,51,25,13.8,2010,0.0
Bubba Chisholm,11,4,20,4,2,1,34.0,17,2,2.0,3,2,35.8,2010,0.0
Harry Marshall,1051,275,789,341,394,296,3003.0,248,73,207.0,541,268,22.1,2010,0.0
Rashad Reed,668,150,594,215,159,120,2058.0,347,118,149.0,247,97,21.8,2010,0.0
Josh Crawford,238,19,211,93,55,41,821.0,35,11,61.0,176,82,19.8,2010,0.0
Brant Leitnaker,141,21,116,47,70,47,693.0,2,0,42.0,114,47,15.1,2010,0.0
Devan Dumes,542,73,451,171,155,110,1287.0,256,90,139.0,195,81,26.7,2010,0.0
Tijan Jobe,15,0,16,7,4,1,211.0,0,0,13.0,16,7,7.5,2010,0.0
Brett Finkelmeier,10,6,10,4,2,2,194.0,2,0,11.0,8,4,5.9,2010,0.0
Steven Gambles,3,0,5,1,4,1,26.0,1,0,2.0,4,1,17.7,2010,0.0
Jonathan Huffman,429,29,364,149,84,54,1233.0,205,77,69.0,159,72,22.2,2010,0.0
Milan Prodanovic,823,149,773,272,147,114,3173.0,496,165,158.0,277,107,16.5,2010,0.0
Craig Brackins,1539,153,1285,572,449,326,3052.0,236,69,196.0,1049,503,29.1,2010,1.0
Marquis Gilstrap,476,45,372,162,163,109,1029.0,114,43,87.0,258,119,25.6,2010,0.0
Lucca Staiger,420,73,350,140,23,18,1219.0,305,122,77.0,45,18,18.9,2010,0.0
Charles Boozer,139,19,118,43,51,33,447.0,73,20,19.0,45,23,18.8,2010,0.0
Alex Dorr,11,1,7,4,4,3,40.0,1,0,2.0,6,4,13.4,2010,0.0
L.A. Pomlee,7,1,5,3,5,1,32.0,0,0,2.0,5,3,14.4,2010,0.0
Anthony Tucker,276,40,236,94,32,20,646.0,185,68,45.0,51,26,26.8,2010,1.0
Devan Bawinkel,291,44,268,97,10,6,1362.0,252,91,28.0,16,6,12.9,2010,0.0
John Lickliter,39,15,40,12,6,5,175.0,35,10,11.0,5,2,17.1,2010,0.0
Nick Neari,1,2,1,0,2,1,11.0,0,0,1.0,1,0,14.9,2010,0.0
Deilvez Yearby,718,52,592,266,283,173,1531.0,36,13,149.0,556,253,32.9,2010,0.0
Antwone Snead,160,34,113,57,74,46,646.0,1,0,39.0,112,57,14.7,2010,0.0
Aaron Richie,200,21,164,66,61,39,713.0,88,29,38.0,76,37,12.6,2010,0.0
Seve Beech,5,5,3,2,0,0,18.0,2,1,2.0,1,1,12.7,2010,0.0
Ethan Peabody,1,2,2,0,2,1,27.0,0,0,1.0,2,0,7.4,2010,0.0
Alan Arnett,0,0,1,0,0,0,6.0,1,0,1.0,0,0,16.9,2010,0.0
Robert Glenn,1131,98,700,414,402,298,1867.0,31,5,184.0,669,409,30.9,2010,0.0
Jon Avery,1014,103,672,431,279,151,2740.0,7,1,139.0,665,430,18.5,2010,0.0
Billy Pettiford,709,327,587,265,228,163,3371.0,47,16,271.0,540,249,15.4,2010,0.0
Zach Litteral,0,0,0,0,0,0,3.0,0,0,0.0,0,0,0.0,2010,0.0
Garrison Johnson,1251,111,1071,408,419,309,3065.0,378,126,183.0,693,282,30.0,2010,0.0
Kyle Swanier,20,2,19,4,12,8,67.0,14,4,9.0,5,0,22.5,2010,0.0
Jazmonn Major,10,0,14,3,9,2,48.0,9,2,5.0,5,1,24.5,2010,0.0
Trenton Marshall,460,62,370,154,120,95,817.0,155,57,52.0,215,97,29.7,2010,0.0
Amadou Mbodji,540,52,421,225,143,88,1954.0,8,2,116.0,413,223,13.7,2010,0.0
John Barnes,202,72,193,65,55,37,810.0,115,35,70.0,78,30,18.0,2010,0.0
Samir Rolley,6,6,13,3,0,0,56.0,2,0,5.0,11,3,16.3,2010,0.0
Lehmon Colbert,1460,210,1138,532,448,295,3444.0,306,101,243.0,832,431,24.4,2010,0.0
Will Alston,186,10,171,65,99,56,696.0,0,0,55.0,171,65,18.8,2010,0.0
Chris Edwards,176,54,186,62,43,28,769.0,77,24,69.0,109,38,16.7,2010,0.0
Szymon Lukasiak,236,11,214,103,69,30,876.0,1,0,84.0,213,103,16.6,2010,0.0
Josh Sparks,12,4,9,3,8,6,63.0,0,0,7.0,9,3,15.1,2010,0.0
Jimmy McMurrin,5,0,3,2,0,0,7.0,2,1,0.0,1,1,20.6,2010,0.0
Brian Gilbert,104,17,112,40,9,6,434.0,75,18,25.0,37,22,20.6,2010,0.0
Pierre Curtis,1237,463,842,376,529,421,4137.0,186,64,335.0,656,312,16.4,2010,0.0
Matt Parker,142,17,143,48,22,16,544.0,93,30,31.0,50,18,17.5,2010,0.0
Dazzmond Thornton,410,18,303,168,117,74,1138.0,0,0,113.0,303,168,21.0,2010,0.0
Alvin Brown,11,0,10,3,10,5,52.0,0,0,2.0,10,3,16.4,2010,0.0
Ryan Knight,0,1,2,0,0,0,17.0,2,0,2.0,0,0,12.2,2010,0.0
Hunter Tatum,0,0,0,0,0,0,3.0,0,0,0.0,0,0,0.0,2010,0.0
Denis Clemente,1543,425,1370,547,331,245,3642.0,600,204,259.0,770,343,22.7,2010,0.0
Luis Colon,317,50,288,131,117,55,1459.0,0,0,69.0,288,131,13.9,2010,0.0
Chris Merriewether,66,49,59,17,45,31,773.0,11,1,59.0,48,16,8.0,2010,0.0
Sherron Collins,1888,552,1476,656,426,344,4071.0,615,232,331.0,861,424,24.8,2010,1.0
Xavier Henry,483,53,354,162,115,90,990.0,165,69,69.0,189,93,23.4,2010,1.0
Cole Aldrich,1038,72,681,391,351,256,2330.0,0,0,133.0,681,391,21.0,2010,1.0
C.J. Henry,40,4,24,14,2,1,73.0,21,11,2.0,3,3,17.9,2010,0.0
Chase Buford,12,2,16,4,7,4,59.0,7,0,4.0,9,4,15.8,2010,0.0
Kurtis Woods,717,86,689,250,140,89,1888.0,378,128,136.0,311,122,23.8,2010,0.0
Jon-Michael Nickerson,795,130,749,322,181,115,2371.0,139,36,151.0,610,286,22.3,2010,0.0
Jonathan Whipple,383,57,395,155,90,52,2181.0,88,21,95.0,307,134,12.6,2010,0.0
Zadrian Gibson,152,13,121,64,43,23,695.0,4,1,40.0,117,63,13.1,2010,0.0
Cortez Irby,14,7,34,5,2,2,98.0,28,2,3.0,6,3,19.3,2010,0.0
Junior Ajayi,19,3,21,6,8,5,112.0,9,2,9.0,12,4,73.9,2010,0.0
James McRae,2,1,1,0,4,2,3.0,0,0,0.0,1,0,48.2,2010,0.0
Chris Singletary,1236,325,904,426,519,330,2847.0,166,54,276.0,738,372,26.6,2010,0.0
Tyree Evans,620,22,582,213,93,70,1621.0,358,124,64.0,224,89,21.7,2010,0.0
Anthony Simpson,544,44,449,214,147,89,1635.0,69,27,67.0,380,187,18.2,2010,0.0
Mike McKee,614,106,516,190,128,91,1919.0,406,143,86.0,110,47,17.2,2010,0.0
Frank Henery-Ala,153,22,129,52,46,35,843.0,44,14,18.0,85,38,10.2,2010,0.0
Brandon Parks,321,23,261,138,97,45,1118.0,1,0,63.0,260,138,16.5,2010,0.0
Ian Pinckney,15,3,14,5,9,5,59.0,3,0,1.0,11,5,16.5,2010,0.0
Greg Avila,7,0,4,3,5,1,14.0,0,0,4.0,4,3,37.4,2010,0.0
Alex Grimsley,13,3,10,4,10,4,103.0,1,1,11.0,9,3,12.7,2010,0.0
Cameron Joyce,1,2,0,0,3,1,18.0,0,0,2.0,0,0,9.6,2010,0.0
John Wall,616,241,438,202,232,175,1288.0,114,37,149.0,324,165,25.7,2010,1.0
DeMarcus Cousins,575,38,369,206,268,162,893.0,6,1,78.0,363,205,30.5,2010,1.0
Patrick Patterson,1564,146,1054,617,417,306,3295.0,73,24,159.0,981,593,21.3,2010,1.0
Eric Bledsoe,419,107,312,144,123,82,1122.0,128,49,112.0,184,95,20.4,2010,1.0
Daniel Orton,129,15,91,48,63,33,502.0,2,0,38.0,89,48,15.0,2010,1.0
Ramon Harris,358,107,256,122,156,94,1720.0,81,20,136.0,175,102,13.5,2010,0.0
Perry Stevenson,602,97,405,234,192,131,2355.0,11,3,156.0,394,231,13.9,2010,0.0
Mark Krebs,12,3,22,4,2,0,72.0,20,4,3.0,2,0,17.4,2010,0.0
Rodney Green,1914,390,1520,706,592,422,3905.0,271,80,412.0,1249,626,28.4,2010,0.0
Yves Mekongo Mbala,1016,169,756,327,420,290,3187.0,217,72,243.0,539,255,18.4,2010,0.0
Kimmani Barrett,1070,126,742,351,383,290,2752.0,228,78,175.0,514,273,19.0,2010,0.0
Parrish Grant,72,44,57,23,26,15,438.0,38,11,32.0,19,12,11.1,2010,0.0
Terrell Williams,158,36,139,63,75,32,762.0,2,0,63.0,137,63,14.9,2010,0.0
Jeff Kari,763,200,570,228,269,200,2260.0,295,107,165.0,275,121,19.4,2010,0.0
Michael Gruner,659,226,523,213,217,162,2482.0,228,71,158.0,295,142,16.1,2010,0.0
Marek Koltun,131,4,103,51,65,29,657.0,0,0,54.0,103,51,14.5,2010,0.0
Alex Orchowski,42,9,21,13,20,14,219.0,5,2,13.0,16,11,10.0,2010,0.0
Justin Nabors,780,86,563,292,257,178,1662.0,53,18,162.0,510,274,25.3,2010,0.0
Lawrence Nwevo,385,21,340,157,150,71,1147.0,1,0,81.0,339,157,21.0,2010,0.0
Reggie Mathis,130,22,118,40,51,38,364.0,54,12,23.0,64,28,21.7,2010,0.0
Donte Lopez,36,13,45,12,13,9,170.0,24,3,10.0,21,9,17.2,2010,0.0
E.B. Davis,32,5,40,13,6,2,128.0,15,4,6.0,25,9,19.2,2010,0.0
Justin Carter,4,2,3,2,0,0,18.0,0,0,1.0,3,2,10.6,2010,0.0
Ashton Hall,297,55,229,99,107,78,915.0,69,21,47.0,160,78,0.0,2010,0.0
Marquis Hall,1514,566,1307,491,427,317,3900.0,599,215,306.0,708,276,25.2,2010,0.0
Zahir Carrington,1260,107,933,455,550,350,2960.0,1,0,264.0,932,455,26.7,2010,0.0
Dave Buchberger,507,95,408,168,115,93,2004.0,208,78,68.0,200,90,13.8,2010,0.0
Matt Shamis,120,48,124,44,31,22,633.0,36,10,53.0,88,34,17.7,2010,0.0
Ryan Peters,2,0,2,0,4,2,15.0,0,0,2.0,2,0,19.7,2010,0.0
Kyle Ohman,1141,206,880,357,300,227,2809.0,520,200,202.0,360,157,22.5,2010,0.0
Johnny Stephene,170,60,118,52,76,53,636.0,38,13,64.0,80,39,17.6,2010,0.0
Bill Weaver,59,9,57,27,15,5,324.0,0,0,17.0,57,27,12.8,2010,0.0
Tyler Baker,281,46,212,89,73,61,787.0,116,42,53.0,96,47,18.9,2010,0.0
Johnny Lee,171,154,161,50,63,42,1061.0,107,29,94.0,54,21,13.5,2010,0.0
Jerry Macon,4,0,3,2,0,0,9.0,1,0,4.0,2,2,37.1,2010,0.0
Stephan Gilling,1125,103,990,382,96,65,3094.0,757,296,127.0,233,86,17.5,2010,0.0
Arturas Lazdauskas,263,93,202,106,82,47,1296.0,16,4,83.0,186,102,13.1,2010,0.0
Jesse Woodard,200,62,205,67,53,36,800.0,111,30,64.0,94,37,14.6,2010,0.0
Jaytornah Wisseh,1693,537,1351,538,641,513,3876.0,336,104,381.0,1015,434,27.6,2010,0.0
Corey Wright Jr,44,23,35,14,22,14,233.0,8,2,29.0,27,12,15.7,2010,0.0
Miguel Bocachica,10,1,10,3,2,2,35.0,6,2,2.0,4,1,18.2,2010,0.0
Dana Smith,1128,153,839,408,389,256,2202.0,178,56,188.0,661,352,25.5,2010,0.0
Kevin Swecker,774,165,679,260,120,97,2250.0,413,157,87.0,266,103,16.1,2010,0.0
Billy Robinson Jr,532,43,462,219,128,84,1571.0,64,10,105.0,398,209,17.7,2010,0.0
E.J. Dawson,243,199,242,87,83,48,1478.0,57,21,130.0,185,66,12.7,2010,0.0
Ian Persaud,22,1,21,9,0,0,53.0,9,4,4.0,12,5,21.7,2010,0.0
Tyren Johnson,884,176,732,331,237,164,2558.0,188,58,207.0,544,273,23.6,2010,0.0
Lamar Roberson,354,78,327,134,90,60,1102.0,93,26,91.0,234,108,20.1,2010,0.0
Willie Lago,275,137,304,96,91,49,1392.0,143,34,130.0,161,62,16.5,2010,0.0
Corey Bloom,163,20,166,48,54,36,614.0,127,31,23.0,39,17,17.0,2010,0.0
Brandon Dison,87,15,77,36,20,15,394.0,0,0,18.0,77,36,7.4,2010,0.0
Robert Vaughn,0,1,2,0,0,0,3.0,2,0,0.0,0,0,34.5,2010,0.0
Dynile Forbes,688,52,508,207,222,171,1574.0,283,103,84.0,225,104,19.4,2010,0.0
Tony Hooper,1592,339,1331,539,394,278,3582.0,693,236,424.0,638,303,23.9,2010,0.0
Colby Carr,122,35,109,47,37,27,428.0,5,1,40.0,104,46,19.4,2010,0.0
Jarvis Hill,581,90,511,193,185,127,1897.0,204,68,155.0,307,125,19.5,2010,0.0
Warren Fuselier,83,36,90,33,25,14,423.0,6,3,44.0,84,30,17.2,2010,0.0
Kenneth Averette,316,158,255,98,118,89,1398.0,93,31,116.0,162,67,16.9,2010,0.0
Rory Burt,52,0,41,18,26,16,245.0,1,0,13.0,40,18,13.5,2010,0.0
Robert Nelson,2,0,1,0,2,2,17.0,1,0,2.0,0,0,11.6,2010,0.0
Tasmin Mitchell,1989,292,1639,762,481,354,4692.0,322,111,286.0,1317,651,23.1,2010,0.0
Chris Beattie,25,4,24,8,3,2,93.0,17,7,3.0,7,1,15.9,2010,0.0
Alex Farrer,153,59,149,50,52,35,797.0,73,18,50.0,76,32,14.1,2010,0.0
Taylor Jacobsen,0,0,1,0,0,0,5.0,0,0,0.0,1,0,10.4,2010,0.0
Kyle Gibson,1677,234,1236,508,575,444,3571.0,582,217,255.0,654,291,27.3,2010,0.0
Magnum Rolle,1023,75,813,409,322,204,2643.0,3,1,182.0,810,408,20.8,2010,1.0
Jamel Guyton,799,138,673,272,150,120,2170.0,372,135,121.0,301,137,19.1,2010,0.0
David Jackson,547,51,475,202,164,109,2217.0,108,34,98.0,367,168,13.6,2010,0.0
Anson Bartlett,64,16,47,19,38,26,345.0,1,0,18.0,46,19,12.0,2010,0.0
Yonas Berhe,39,30,50,18,5,2,373.0,9,1,27.0,41,17,8.9,2010,0.0
Shawn Oliverson,49,4,40,22,16,5,383.0,0,0,17.0,40,22,6.8,2010,0.0
Samardo Samuels,942,74,618,339,383,264,1897.0,1,0,161.0,617,339,26.2,2010,1.0
Edgar Sosa,1363,392,1098,458,359,247,3270.0,562,200,274.0,536,258,23.1,2010,0.0
Jerry Smith,1203,233,876,398,270,197,3266.0,540,210,188.0,336,188,18.8,2010,1.0
Reginald Delk,851,118,694,313,105,54,2567.0,444,171,95.0,250,142,15.9,2010,0.0
Chris Brickley,17,8,16,7,4,1,67.0,9,2,4.0,7,5,15.9,2010,0.0
Marcus Thomas,359,24,332,121,43,29,969.0,241,88,49.0,91,33,21.5,2010,0.0
Aric Van Weelden,203,94,175,68,61,39,1468.0,94,28,68.0,81,40,9.7,2010,0.0
Tom Neary,3,0,2,0,8,3,24.0,0,0,1.0,2,0,14.8,2010,0.0
Kevin Muldowney,0,1,0,0,0,0,8.0,0,0,0.0,0,0,0.0,2010,0.0
Given Kalipinde,98,22,85,34,33,16,303.0,42,14,16.0,43,20,18.7,2010,0.0
Brad Sweezy,124,28,135,49,72,26,1075.0,5,0,70.0,130,49,10.7,2010,0.0
Brett Harvey,1208,374,901,333,426,368,3541.0,489,174,217.0,412,159,20.4,2010,0.0
Jawaan Wright,340,41,231,117,183,106,1351.0,1,0,72.0,230,117,14.6,2010,0.0
Garrett Kelly,30,7,28,10,7,4,162.0,18,6,13.0,10,4,15.4,2010,0.0
Junior Bernal,1034,358,912,395,447,235,3420.0,41,9,289.0,871,386,20.3,2010,0.0
Jerrell Boswell,20,6,22,6,5,5,40.0,19,3,1.0,3,3,32.8,2010,0.0
Rico Pickett,684,126,623,260,146,96,1526.0,201,68,122.0,422,192,31.0,2010,0.0
Darryl Crawford,1431,218,1153,482,550,394,3287.0,248,73,208.0,905,409,26.5,2010,0.0
Antoine Pearson,1123,276,834,338,485,338,3158.0,307,109,245.0,527,229,20.3,2010,0.0
Brandon Adams,457,47,341,148,231,160,1670.0,2,1,88.0,339,147,16.0,2010,0.0
Patrick Bouli,473,221,425,157,112,81,2863.0,250,78,152.0,175,79,9.7,2010,0.0
Victor Jackson,3,8,12,1,2,0,55.0,5,1,2.0,7,0,14.2,2010,0.0
Daye Kaba,260,49,240,94,61,40,798.0,94,32,54.0,146,62,22.3,2010,0.0
Javon Parris,269,73,280,95,110,61,1246.0,75,18,114.0,205,77,18.4,2010,0.0
Mike Taylor,101,17,102,34,15,12,504.0,57,21,23.0,45,13,13.7,2010,1.0
Lazar Hayward,1859,122,1476,667,451,356,3648.0,473,169,230.0,1003,498,27.2,2010,1.0
Maurice Acker,805,378,674,258,215,165,2883.0,325,124,184.0,349,134,17.3,2010,0.0
David Cubillan,642,225,537,211,98,74,2680.0,382,146,96.0,155,65,12.8,2010,0.0
Tyler Wilkerson,1038,66,730,384,355,249,2321.0,72,21,154.0,658,363,23.9,2010,0.0
Hassan Whiteside,447,10,319,167,187,110,889.0,5,3,64.0,314,164,25.8,2010,1.0
Chris Lutz,1059,238,852,338,187,143,3265.0,601,240,184.0,251,98,16.7,2010,0.0
Antonio Haymon,156,32,119,56,55,39,441.0,17,5,19.0,102,51,18.1,2010,0.0
Darryl Merthie,651,271,653,211,226,148,2281.0,309,81,202.0,344,130,20.8,2010,0.0
Camden Miller,114,18,100,39,19,13,350.0,61,23,28.0,39,16,19.3,2010,0.0
Robbie Jackson,375,28,257,127,190,121,1079.0,1,0,86.0,256,127,23.9,2010,0.0
Shawn Grant,236,18,219,82,45,34,650.0,109,38,31.0,110,44,22.4,2010,0.0
Matt Spadafora,707,143,672,259,207,130,3044.0,173,59,93.0,499,200,15.3,2010,0.0
Jake Wasko,74,22,73,31,27,12,582.0,0,0,26.0,73,31,10.3,2010,0.0
Neal Pitt,666,37,524,241,265,163,1509.0,75,21,131.0,449,220,22.0,2010,0.0
Sean Berry,171,7,145,60,90,51,507.0,0,0,49.0,145,60,24.0,2010,0.0
James Cotton,56,8,34,15,41,26,265.0,2,0,17.0,32,15,13.6,2010,1.0
Roland Dunston,33,3,26,13,2,1,82.0,13,6,7.0,13,7,21.2,2010,0.0
Jamal Edwards,0,1,1,0,0,0,8.0,0,0,2.0,1,0,19.2,2010,0.0
Greivis Vasquez,2171,772,1769,751,530,439,4568.0,699,230,450.0,1070,521,26.0,2010,1.0
Landon Milbourne,1104,74,893,426,272,210,2883.0,117,42,164.0,776,384,19.9,2010,0.0
Eric Hayes,1201,513,914,409,215,187,3868.0,484,196,258.0,430,213,15.8,2010,0.0
Jin Soo Choi,41,2,51,14,11,8,180.0,23,5,14.0,28,9,19.0,2010,0.0
David Pearman,7,1,16,3,1,1,45.0,11,0,1.0,5,3,18.8,2010,0.0
Steve Goins,4,0,3,1,4,2,16.0,0,0,3.0,3,1,24.0,2010,0.0
Ricky Harris,1960,215,1534,643,533,398,3460.0,795,276,281.0,739,367,28.2,2010,0.0
David Gibbs,159,88,180,58,29,18,939.0,88,25,43.0,92,33,12.3,2010,0.0
Lex Mongo,0,2,5,0,0,0,19.0,3,0,2.0,2,0,17.8,2010,0.0
Will Morning,186,14,144,78,73,30,515.0,1,0,35.0,143,78,20.6,2010,0.0
Elbryan Neal,220,36,188,82,96,55,778.0,7,1,93.0,181,81,18.0,2010,0.0
Jamarcus Little,27,3,36,12,9,3,179.0,0,0,15.0,36,12,14.8,2010,0.0
Atakan Yurttas,10,1,5,1,12,8,30.0,1,0,1.0,4,1,19.3,2010,0.0
Elliot Williams,754,151,515,234,302,217,1696.0,200,69,129.0,315,165,23.6,2010,1.0
Roburt Sallie,566,90,410,177,131,93,1597.0,272,119,54.0,138,58,16.6,2010,0.0
Doneal Mack,1191,148,995,411,197,130,2876.0,655,239,100.0,340,172,20.2,2010,0.0
Willie Kemp,795,331,732,269,162,95,2861.0,456,162,154.0,276,107,16.4,2010,0.0
Pierre Henderson-Niles,206,6,184,89,65,28,863.0,0,0,50.0,184,89,15.4,2010,0.0
Aaron Jacques,5,1,5,1,4,3,16.0,0,0,0.0,5,1,22.2,2010,0.0
James Harvey Jr,3,0,3,1,2,0,7.0,1,1,0.0,2,0,29.1,2010,0.0
Tyler Foster,2,0,2,1,0,0,12.0,1,0,0.0,1,1,8.6,2010,0.0
James Florence,2286,436,1918,744,768,556,3948.0,819,242,345.0,1099,502,32.2,2010,0.0
Daniel Emerson,1201,144,796,403,496,353,3088.0,110,42,261.0,686,361,20.4,2010,0.0
E.J. Kusnyer,759,40,656,244,90,68,1821.0,548,203,55.0,108,41,18.6,2010,0.0
Ridas Pulkauninkas,46,7,45,15,12,8,200.0,34,8,8.0,11,7,14.2,2010,0.0
Michael Jenkins,17,0,19,6,7,5,42.0,0,0,2.0,19,6,28.0,2010,0.0
Tevin Swann,15,8,9,4,10,7,72.0,0,0,5.0,9,4,12.6,2010,0.0
Brendan Walker,80,49,79,24,31,21,668.0,46,11,56.0,33,13,10.2,2010,0.0
James Dews,1090,166,958,399,154,122,3179.0,489,170,106.0,469,229,18.4,2010,0.0
Dwayne Collins,1245,109,820,463,567,319,2973.0,0,0,222.0,820,463,23.3,2010,0.0
Cyrus McGowan,278,32,223,95,111,72,1045.0,52,16,82.0,171,79,17.1,2010,0.0
Kenny Hayes,989,188,752,333,274,218,2409.0,272,105,164.0,480,228,25.0,2010,0.0
Adam Fletcher,381,54,317,155,129,71,1809.0,1,0,113.0,316,155,16.4,2010,0.0
Rodney Haddix,252,44,218,82,72,54,934.0,111,34,68.0,107,48,18.4,2010,0.0
Kramer Soderberg,133,44,116,42,45,30,610.0,66,19,40.0,50,23,14.8,2010,0.0
Michael Aluise,0,0,3,0,0,0,3.0,1,0,1.0,2,0,76.5,2010,0.0
Raymar Morgan,1597,186,1126,594,571,384,3534.0,87,25,283.0,1039,569,24.0,2010,0.0
Isaiah Dahlman,157,35,118,54,51,36,580.0,39,13,29.0,79,41,17.1,2010,0.0
Jon Crandell,4,2,3,1,2,2,34.0,0,0,1.0,3,1,7.3,2010,0.0
Dion Sims,0,0,1,0,0,0,1.0,0,0,0.0,1,0,50.4,2010,0.0
Manny Harris,1668,366,1283,521,585,484,3329.0,447,142,313.0,836,379,30.6,2010,1.0
DeShawn Sims,1584,96,1388,633,333,228,3312.0,305,90,169.0,1083,543,28.1,2010,0.0
Zack Gibson,448,35,359,174,111,76,1233.0,94,24,67.0,265,150,21.0,2010,0.0
Ben Cronin,11,0,7,3,8,5,26.0,0,0,2.0,7,3,27.3,2010,0.0
Eric Puls,13,0,9,5,0,0,26.0,5,3,1.0,4,2,21.3,2010,0.0
Montarrio Haddock,731,75,560,269,214,161,1517.0,85,32,128.0,475,237,26.9,2010,0.0
Desmond Yates,1775,56,1291,714,328,257,3517.0,221,90,184.0,1070,624,25.0,2010,0.0
Calvin O'Neil,691,161,545,236,276,198,2853.0,75,21,132.0,470,215,14.8,2010,0.0
Rod Emmanuel,194,40,176,69,58,35,666.0,66,21,47.0,110,48,19.6,2010,0.0
Theryn Hudson,614,36,429,260,170,94,1814.0,0,0,114.0,429,260,19.0,2010,0.0
John David Little,25,3,15,9,7,3,46.0,6,4,3.0,9,5,24.1,2010,0.0
Demario Williams,84,29,103,30,26,18,427.0,26,6,35.0,77,24,18.1,2010,0.0
David Murray,21,2,23,9,4,3,53.0,3,0,2.0,20,9,26.4,2010,0.0
Matt Joines,5,1,2,1,2,2,7.0,1,1,0.0,1,0,21.9,2010,0.0
Ricky Franklin,1291,332,1150,433,334,232,3820.0,554,193,258.0,596,240,20.7,2010,0.0
James Eayrs,773,95,632,261,190,158,1651.0,278,93,105.0,354,168,25.5,2010,0.0
Jason Averkamp,322,36,224,97,135,104,1090.0,91,24,44.0,133,73,15.5,2010,0.0
Deonte Roberts,547,156,414,200,233,145,1832.0,4,2,179.0,410,198,19.3,2010,0.0
Riley Walker,32,6,34,13,9,4,141.0,9,2,8.0,25,11,16.8,2010,0.0
Michael Tyler,11,1,10,4,6,2,38.0,6,1,0.0,4,3,17.3,2010,0.0
Burleigh Porte,15,3,12,6,9,3,108.0,0,0,4.0,12,6,9.5,2010,0.0
Lawrence Westbrook,1199,216,933,408,301,243,2692.0,369,140,234.0,564,268,25.4,2010,0.0
Damian Johnson,924,184,719,355,279,179,2739.0,124,35,147.0,595,320,19.0,2010,0.0
Devron Bostick,200,42,181,77,35,24,565.0,76,22,41.0,105,55,22.1,2010,0.0
Jarvis Varnado,1403,89,930,548,514,306,3594.0,4,1,191.0,926,547,18.9,2010,1.0
Barry Stewart,1602,293,1289,489,463,344,4431.0,779,280,215.0,510,209,19.2,2010,0.0
Phil Turner,625,131,529,204,162,122,2112.0,294,95,115.0,235,109,17.0,2010,0.0
Julius Cheeks,670,128,573,214,174,130,1702.0,321,112,132.0,252,102,22.7,2010,0.0
Shannon Behling,699,56,665,265,122,78,1924.0,283,91,111.0,382,174,21.2,2010,0.0
Joshua Mack,414,124,366,137,69,57,1003.0,232,83,100.0,134,54,25.2,2010,0.0
Michael Mayo,36,2,36,12,4,3,92.0,27,9,3.0,9,3,21.9,2010,0.0
Terrico White,955,124,814,349,197,134,2032.0,354,123,100.0,460,226,23.9,2010,1.0
DeAundre Cranston,217,29,175,82,63,37,1083.0,55,16,47.0,120,66,11.1,2010,0.0
DeAngelo Riley,26,8,18,10,9,6,104.0,0,0,6.0,18,10,13.1,2010,0.0
Michael Halford,0,0,1,0,0,0,6.0,1,0,0.0,0,0,8.0,2010,0.0
Alex Bazzell,98,49,77,32,27,22,583.0,43,12,21.0,34,20,9.8,2010,0.0
Daniel Brady,20,10,19,9,6,2,227.0,0,0,14.0,19,9,3.4,2010,0.0
Patrick Inyard,1,0,1,0,2,1,17.0,0,0,0.0,1,0,16.4,2010,0.0
Justin Fuehrmeyer,507,329,408,151,172,135,2553.0,217,70,149.0,191,81,13.3,2010,0.0
Ryan Jehle,208,29,157,78,63,39,900.0,53,13,50.0,104,65,14.2,2010,0.0
Cardell McFarland,224,43,170,72,80,62,726.0,65,18,66.0,105,54,20.5,2010,0.0
J.T. Tiller,940,332,776,338,292,219,2723.0,174,45,208.0,602,293,19.9,2010,0.0
Zaire Taylor,881,348,724,297,265,178,3219.0,312,109,183.0,412,188,14.9,2010,0.0
Keith Ramsey,354,79,247,145,102,54,1432.0,27,10,82.0,220,135,12.5,2010,0.0
Whitney Coleman,1203,293,1070,436,214,170,3894.0,459,161,294.0,611,275,23.4,2010,0.0
Justin Sofman,281,27,233,93,26,22,781.0,193,73,34.0,40,20,18.3,2010,0.0
George Barbour,127,13,117,46,72,35,425.0,0,0,27.0,117,46,22.3,2010,0.0
Kevin Schafer,18,7,23,4,11,8,138.0,15,2,12.0,8,2,15.3,2010,0.0
Yaniv Simpson,397,40,338,136,29,25,940.0,248,100,64.0,90,36,24.0,2010,0.0
Marquis Navarre,454,163,359,155,142,105,1676.0,114,39,109.0,245,116,19.2,2010,0.0
Will Bynum,564,129,454,205,234,146,1691.0,39,8,123.0,415,197,21.3,2010,1.0
Austin Brown,161,27,155,57,51,27,391.0,78,20,34.0,77,37,16.1,2010,0.0
Cameron Henderson,70,12,67,28,21,14,305.0,0,0,25.0,67,28,17.0,2010,0.0
Bryan Louff,31,25,35,10,9,6,207.0,10,5,16.0,25,5,14.9,2010,0.0
Michel Swita,2,0,1,0,2,2,9.0,0,0,0.0,1,0,12.1,2010,0.0
Ryan Staudacher,838,140,661,296,44,36,2977.0,473,210,74.0,188,86,13.7,2010,0.0
Jack McGillis,630,114,552,222,180,118,2221.0,212,68,127.0,340,154,18.7,2010,0.0
Rasason Young,140,12,127,56,5,1,385.0,65,27,22.0,62,29,21.8,2010,0.0
Michael Taylor,398,108,294,128,72,58,1659.0,211,84,81.0,83,44,13.7,2010,0.0
Vassy Banny,65,22,54,22,37,19,419.0,8,2,39.0,46,20,14.7,2010,0.0
Justin Roper,2,0,2,1,0,0,3.0,0,0,0.0,2,1,36.9,2010,0.0
Ryan Nelson,0,0,0,0,0,0,7.0,0,0,1.0,0,0,7.9,2010,0.0
Maze Stallworth,1414,140,1111,447,306,237,3593.0,736,283,169.0,375,164,19.5,2010,0.0
Steve Peterson,330,58,281,118,82,61,1185.0,105,33,72.0,176,85,17.1,2010,0.0
Brandon Shingles,283,255,223,102,106,72,1598.0,25,7,145.0,198,95,13.3,2010,0.0
Les Simmons,193,12,154,67,70,51,553.0,31,8,55.0,123,59,20.7,2010,0.0
Jamel Marshall,21,0,16,8,6,5,65.0,0,0,5.0,16,8,18.3,2010,0.0
David Terrell,5,1,7,2,2,1,25.0,0,0,2.0,7,2,19.9,2010,0.0
Jason Beharie,4,0,7,2,2,0,47.0,0,0,0.0,7,2,8.5,2010,0.0
Corey Clemens,4,0,3,1,2,1,9.0,2,1,0.0,1,0,21.9,2010,0.0
John Lamb,205,33,185,61,34,28,740.0,170,55,35.0,15,6,12.5,2010,0.0
Reggie Holmes,2048,76,1608,613,657,514,3659.0,865,308,191.0,743,305,28.4,2010,0.0
Troy Smith,416,71,361,145,138,97,1302.0,109,29,66.0,252,116,18.5,2010,0.0
Joe Davis,827,94,738,294,204,152,1882.0,324,87,141.0,414,207,27.6,2010,0.0
Sean Thomas,201,118,184,66,93,62,1020.0,27,7,89.0,157,59,13.9,2010,0.0
Danny Smith,95,96,97,34,51,24,618.0,16,3,58.0,81,31,13.6,2010,0.0
John Long,27,2,24,12,13,3,221.0,0,0,4.0,24,12,7.2,2010,1.0
Buford Foote,20,0,17,7,12,6,119.0,0,0,7.0,17,7,12.4,2010,0.0
Jeremy Goode,1706,594,1322,549,733,484,4276.0,387,124,381.0,935,425,25.9,2010,0.0
Kelly Beidler,1041,165,878,378,278,188,2997.0,286,97,204.0,592,281,21.2,2010,0.0
Will Holland,829,91,770,282,152,103,2491.0,470,162,138.0,300,120,20.1,2010,0.0
Pierre Brown,174,33,149,65,36,23,631.0,47,21,56.0,102,44,18.1,2010,0.0
Mike Harvey,8,0,5,3,3,1,18.0,2,1,1.0,3,2,21.2,2010,0.0
Danero Thomas,1277,195,1089,460,321,226,3179.0,394,131,225.0,695,329,24.0,2010,0.0
Tony Easley,923,72,572,373,274,177,2385.0,0,0,131.0,572,373,18.9,2010,0.0
Georges Fotso,67,7,60,26,32,15,559.0,0,0,28.0,60,26,9.1,2010,0.0
Jeremy Wilson,155,8,104,60,50,35,516.0,0,0,44.0,104,60,16.4,2010,0.0
T.J. Topercer,204,35,186,66,60,43,980.0,98,29,69.0,88,37,15.1,2010,0.0
Alex Newsome,41,1,27,16,15,9,155.0,0,0,13.0,27,16,14.8,2010,0.0
Scott Brooks,56,9,63,20,35,15,371.0,6,1,27.0,57,19,16.1,2010,1.0
Pete Banos,0,0,0,0,0,0,5.0,0,0,0.0,0,0,0.0,2010,0.0
Sek Henry,872,256,719,296,284,185,3113.0,302,95,208.0,417,201,18.3,2010,0.0
Quincy Hankins-Cole,104,11,78,35,78,34,250.0,0,0,21.0,78,35,29.3,2010,0.0
Myles Holley,75,8,72,31,24,13,202.0,4,0,13.0,68,31,25.7,2010,0.0
Ben Nelson,25,3,17,5,25,15,113.0,0,0,9.0,17,5,18.2,2010,0.0
Matt Shaw,478,38,371,162,136,102,1188.0,135,52,42.0,236,110,21.4,2010,0.0
Darris Santee,311,13,222,124,117,63,887.0,0,0,50.0,222,124,19.2,2010,0.0
Steve Jones,75,19,70,27,21,13,526.0,30,8,16.0,40,19,9.6,2010,1.0
Luke Babbitt,1316,119,927,445,393,351,2370.0,178,75,146.0,749,370,26.8,2010,1.0
Armon Johnson,1441,445,1168,546,372,279,3299.0,242,70,276.0,926,476,22.9,2010,1.0
Brandon Fields,1271,234,1037,432,373,263,3104.0,448,144,181.0,589,288,21.3,2010,0.0
Joey Shaw,740,93,561,246,214,169,2001.0,230,79,112.0,331,167,17.8,2010,0.0
Ray Kraemer,333,38,239,108,46,35,1144.0,183,82,36.0,56,26,11.8,2010,0.0
Keith Olson,17,3,17,8,4,1,91.0,0,0,2.0,17,8,11.3,2010,0.0
Radar Onguetou,446,51,388,158,160,103,2163.0,112,27,81.0,276,131,13.0,2010,0.0
Russell Graham,183,154,181,58,96,58,1063.0,52,9,71.0,129,49,14.6,2010,0.0
Colbey Santos,393,123,402,136,66,34,2019.0,286,87,79.0,116,49,15.7,2010,0.0
Jahmar Young,1479,233,1091,496,399,331,2710.0,421,156,193.0,670,340,27.2,2010,0.0
Jonathan Gibson,1541,237,1215,530,293,222,3213.0,650,259,216.0,565,271,22.9,2010,1.0
Kelly Merker,30,4,28,10,12,10,212.0,1,0,8.0,27,10,9.3,2010,0.0
Tray Britt,22,4,15,6,21,9,76.0,1,1,8.0,14,5,21.7,2010,0.0
Darington Hobson,555,160,439,193,199,130,1175.0,108,39,104.0,331,154,26.9,2010,1.0
Roman Martinez,1159,201,888,397,223,160,3353.0,507,205,134.0,381,192,17.8,2010,0.0
Billy Humphrey,1104,201,826,346,274,227,2823.0,482,185,173.0,344,161,19.8,2010,0.0
Jaroslav Tyrna,454,65,353,167,166,96,1842.0,73,24,147.0,280,143,16.7,2010,0.0
Ejike Hart,179,25,159,63,92,53,1016.0,0,0,69.0,159,63,14.7,2010,0.0
Destin Damachoua,117,18,131,45,24,17,553.0,57,10,35.0,74,35,20.1,2010,0.0
Obi Ikeakor,86,3,66,33,26,18,351.0,5,2,25.0,61,31,20.2,2010,0.0
Tyrone Lewis,1839,224,1556,589,507,373,3974.0,854,288,222.0,702,301,23.3,2010,0.0
Bilal Benn,965,211,849,355,259,182,2647.0,252,73,199.0,597,282,20.2,2010,0.0
Rob Garrison,769,205,657,259,211,169,2348.0,274,82,161.0,383,177,19.0,2010,0.0
Demetrius Williamson,666,55,624,230,157,87,2057.0,381,119,81.0,243,111,17.2,2010,0.0
Austin Cooley,217,30,237,79,39,20,759.0,138,39,42.0,99,40,18.0,2010,0.0
Chris Armstrong,5,0,10,2,0,0,18.0,8,1,1.0,2,1,35.2,2010,0.0
Chris Iles,362,167,315,111,108,86,1333.0,151,54,107.0,164,57,19.6,2010,0.0
Dominic Friend,468,158,435,160,137,96,2278.0,197,52,167.0,238,108,15.7,2010,0.0
Maurice Foster,106,3,88,44,29,17,204.0,5,1,22.0,83,43,33.1,2010,0.0
Cameron McCallum,66,15,60,27,25,12,359.0,0,0,24.0,60,27,14.3,2010,0.0
Phillip Ward,37,4,39,18,4,1,146.0,0,0,8.0,39,18,18.3,2010,0.0
Drejon Scott,72,19,89,24,13,8,292.0,61,16,20.0,28,8,19.6,2010,0.0
Nick Lopez,70,15,53,24,33,20,352.0,11,2,29.0,42,22,13.8,2010,0.0
Dan Stonkus,371,41,283,134,201,103,2572.0,2,0,156.0,281,134,7.0,2010,0.0
Matt Darnell,15,1,19,5,7,3,87.0,6,2,7.0,13,3,16.7,2010,0.0
Robert Fitzsimmons,2,0,2,0,2,2,21.0,2,0,3.0,0,0,14.1,2010,0.0
Michael Deloach,1796,302,1408,672,537,361,3244.0,292,91,343.0,1116,581,29.0,2010,0.0
Joseph Dorsett-Jeffreys,421,12,332,167,143,87,1140.0,0,0,103.0,332,167,20.9,2010,0.0
Christian Morris,106,0,79,38,50,30,238.0,0,0,31.0,79,38,26.8,2010,0.0
Isaac Nixon,52,8,48,19,11,5,233.0,21,9,28.0,27,10,16.6,2010,0.0
Antoine Perry,36,38,66,14,12,5,484.0,15,3,53.0,51,11,12.3,2010,0.0
Sean Smith,905,188,756,296,160,116,2711.0,488,197,153.0,268,99,17.0,2010,0.0
Sean Hobbs,4,0,5,1,4,2,42.0,0,0,4.0,5,1,13.9,2010,0.0
Tavarus Alston,923,288,808,331,272,176,2127.0,297,85,238.0,511,246,26.3,2010,0.0
Dwane Joshua,564,58,478,181,156,107,1267.0,275,95,125.0,203,86,25.6,2010,0.0
James Porter,212,29,210,84,121,44,1135.0,0,0,85.0,210,84,15.9,2010,0.0
Ben Stywall,1245,146,907,439,549,350,3792.0,75,17,247.0,832,422,20.0,2010,0.0
Mikko Koivisto,1178,190,936,365,216,185,3088.0,705,263,147.0,231,102,18.4,2010,0.0
Kendall Toney,861,140,803,308,71,43,2547.0,573,202,136.0,230,106,19.1,2010,0.0
Pete Brown,348,37,311,133,129,82,1729.0,1,0,92.0,310,133,13.6,2010,0.0
Montel Smith,150,58,140,43,80,56,693.0,47,8,62.0,93,35,13.5,2010,0.0
DeAngelo Jackson,92,3,94,40,25,12,489.0,0,0,26.0,94,40,9.1,2010,0.0
Mike Hardiman,16,2,20,6,8,1,78.0,10,3,4.0,10,3,20.4,2010,0.0
Dennis Horner,872,118,631,295,251,196,2602.0,240,86,118.0,391,209,19.1,2010,1.0
Farnold Degand,340,159,268,113,127,78,1411.0,102,36,115.0,166,77,16.3,2010,0.0
Kaycee Obi-Gwacham,0,0,1,0,0,0,3.0,0,0,0.0,1,0,17.2,2010,0.0
Johnny Wolf,862,275,683,278,214,171,2643.0,378,135,155.0,305,143,17.6,2010,0.0
Dominique Lacey,644,66,540,237,196,124,1766.0,139,46,194.0,401,191,23.1,2010,0.0
Montez Downey,596,47,552,195,127,97,1558.0,355,109,107.0,197,86,22.6,2010,0.0
Will Ohuaregbe,112,15,104,46,53,20,487.0,1,0,37.0,103,46,16.7,2010,0.0
Darion Jeralds,164,122,130,55,52,34,1154.0,46,20,99.0,84,35,8.4,2010,0.0
Jeremy Basnight,46,5,42,15,7,5,114.0,35,11,7.0,7,4,22.5,2010,0.0
Daniel Mercer,84,13,65,40,20,4,529.0,0,0,10.0,65,40,7.8,2010,0.0
Josh Sheets,199,48,209,67,29,18,1019.0,142,47,39.0,67,20,12.9,2010,0.0
Deon Thompson,1414,114,1171,579,390,256,3246.0,2,0,202.0,1169,579,22.1,2010,0.0
William Graves,513,62,454,173,83,65,1284.0,277,102,67.0,177,71,19.7,2010,0.0
Ed Davis,562,44,383,210,228,142,1357.0,0,0,86.0,383,210,19.2,2010,1.0
Marcus Ginyard,874,275,734,313,285,198,3362.0,163,50,215.0,571,263,15.0,2010,0.0
Terrence Petree,6,1,4,3,2,0,19.0,0,0,2.0,4,3,16.7,2010,0.0
Thomas Thornton,6,1,6,2,2,0,27.0,5,2,3.0,1,0,16.9,2010,0.0
Marc Campbell,33,26,27,10,10,7,164.0,18,6,30.0,9,4,17.5,2010,0.0
James Gallagher,0,2,1,0,1,0,21.0,0,0,0.0,1,0,3.2,2010,0.0
Josh Vaughan,484,148,400,161,103,74,1541.0,228,88,85.0,172,73,17.4,2010,0.0
Sam Sussenguth,186,21,115,72,50,41,812.0,2,1,34.0,113,71,10.6,2010,0.0
Austin Pennick,140,70,133,53,62,32,704.0,9,2,42.0,124,51,14.5,2010,0.0
Dejuan Flowers,195,11,132,70,84,55,731.0,0,0,43.0,132,70,14.8,2010,0.0
Eni Cuka,597,74,503,196,132,104,1504.0,284,101,153.0,219,95,26.6,2010,0.0
Stan Januska,765,158,724,262,190,126,2471.0,364,115,162.0,360,147,20.8,2010,0.0
Germaine Sparkes,608,209,632,214,233,130,3034.0,165,50,243.0,467,164,16.7,2010,0.0
Zack Riggins,166,10,136,66,55,27,650.0,13,7,36.0,123,59,14.7,2010,0.0
Stephen O'Reilly,3,0,5,1,0,0,17.0,3,1,4.0,2,0,28.7,2010,0.0
Eric Tramiel,745,43,472,265,321,201,1557.0,46,14,103.0,426,251,23.7,2010,0.0
Richard Thomas,278,42,257,104,78,50,992.0,88,20,76.0,169,84,19.5,2010,0.0
Cameron Spencer,73,20,56,27,36,19,565.0,0,0,32.0,56,27,8.8,2010,0.0
Antwone Matlock,6,0,15,2,0,0,58.0,13,2,3.0,2,0,12.0,2010,0.0
Matt Janning,1836,352,1522,639,442,335,4597.0,645,223,311.0,877,416,26.0,2010,0.0
Manny Adako,1209,97,960,519,227,169,3410.0,7,2,190.0,953,517,21.8,2010,0.0
Nkem Ojougboh,1039,127,749,374,430,287,3532.0,13,4,222.0,736,370,17.9,2010,0.0
Baptiste Bataille,385,140,304,95,191,145,1518.0,177,50,107.0,127,45,18.4,2010,0.0
Brian McDonald,15,3,14,6,0,0,95.0,10,3,4.0,4,3,10.2,2010,0.0
Nick Larson,401,111,354,138,91,70,2054.0,175,55,126.0,179,83,15.1,2010,0.0
Reid Wallace,63,6,54,26,3,2,255.0,25,9,13.0,29,17,14.0,2010,0.0
Casey Ommen,2,0,3,1,0,0,3.0,0,0,0.0,3,1,52.1,2010,0.0
Mike Trinh,0,0,0,0,0,0,2.0,0,0,0.0,0,0,0.0,2010,0.0
Will Figures,1144,196,779,329,414,349,2509.0,316,137,207.0,463,192,25.0,2010,0.0
Yahosh Bonner,288,125,200,69,149,107,1487.0,130,43,77.0,70,26,11.7,2010,0.0
Ben Jenkins,6,0,5,3,2,0,10.0,0,0,2.0,5,3,41.2,2010,0.0
Sean Kowal,609,46,462,249,212,110,1744.0,1,1,84.0,461,248,20.6,2010,0.0
Michael Fakuade,166,18,129,59,90,45,571.0,11,3,38.0,118,56,19.8,2010,0.0
Najul Ervin,215,58,187,94,85,27,1205.0,6,0,89.0,181,94,13.1,2010,0.0
Ante Dzepina,133,11,103,49,69,35,479.0,1,0,32.0,102,49,15.3,2010,0.0
Justin Peaster,1,0,1,0,2,1,2.0,0,0,0.0,1,0,46.8,2010,0.0
Adam Koch,1186,180,744,347,569,446,3105.0,164,46,226.0,580,301,23.0,2010,0.0
Jordan Eglseder,1066,63,806,439,238,173,2014.0,54,15,134.0,752,424,30.2,2010,0.0
Ali Farokhmanesh,667,93,546,215,105,85,2052.0,405,152,67.0,141,63,18.6,2010,0.0
Adam Rodenberg,77,4,67,31,26,13,346.0,11,2,32.0,56,29,18.0,2010,0.0
Brian Haak,63,37,54,19,19,14,436.0,38,11,18.0,16,8,10.8,2010,0.0
Damon Jones,989,50,864,357,156,121,1956.0,420,154,121.0,444,203,26.1,2010,1.0
Michael McConathy,621,397,549,170,242,194,2401.0,267,87,340.0,282,83,15.4,2010,0.0
Aramie Brooks,172,20,158,70,73,32,540.0,1,0,40.0,157,70,15.7,2010,0.0
John Conine,0,0,5,0,0,0,34.0,2,0,3.0,3,0,4.5,2010,0.0
Jeremy Nash,545,177,468,180,155,120,2381.0,229,65,93.0,239,115,15.4,2010,0.0
Luke Harangody,2476,210,1968,936,719,562,3769.0,129,42,231.0,1839,894,34.7,2010,1.0
Tory Jackson,1231,694,1081,440,409,248,4506.0,319,103,333.0,762,337,17.7,2010,0.0
Jonathan Peoples,390,144,335,138,76,56,1625.0,154,58,97.0,181,80,14.3,2010,0.0
Tim Andree,18,2,14,8,4,2,53.0,0,0,3.0,14,8,18.5,2010,0.0
Johnathon Jones,1678,819,1362,569,482,394,4883.0,402,146,433.0,960,423,20.9,2010,0.0
Derick Nelson,1528,190,1180,517,610,405,3637.0,258,89,306.0,922,428,24.3,2010,0.0
John Kast,18,5,15,7,6,3,72.0,5,1,13.0,10,6,21.4,2010,0.0
Jay Thames,4,0,5,1,2,1,77.0,2,1,3.0,3,0,5.5,2010,0.0
Evan Turner,1517,414,1073,539,508,385,3314.0,149,54,352.0,924,485,30.8,2010,1.0
Jeremie Simmons,379,108,304,122,81,60,1144.0,202,75,59.0,102,47,19.6,2010,0.0
Kyle Madsen,143,15,108,58,35,27,772.0,0,0,39.0,108,58,11.5,2010,0.0
P.J. Hill,206,99,142,58,83,60,960.0,80,30,69.0,62,28,13.5,2010,0.0
Nikola Kecman,35,2,30,15,5,3,81.0,15,2,2.0,15,13,23.1,2010,0.0
Zisis Sarikopoulos,48,5,34,18,24,12,219.0,0,0,17.0,34,18,14.7,2010,0.0
Mark Titus,9,3,6,2,4,3,48.0,6,2,0.0,0,0,10.7,2010,0.0
Danny Peters,6,1,15,3,0,0,49.0,2,0,9.0,13,3,12.4,2010,0.0
Armon Bassett,1199,310,910,366,342,281,2943.0,470,186,183.0,440,180,22.1,2010,0.0
Kenneth van Kempen,529,61,528,227,107,68,2395.0,25,7,153.0,503,220,15.8,2010,0.0
Steven Coleman,426,105,315,143,125,91,1106.0,137,49,99.0,178,94,22.5,2010,0.0
Obi Muonelo,1378,229,1129,468,301,197,3281.0,634,245,231.0,495,223,23.0,2010,0.0
Garrett Thomas,0,0,2,0,0,0,9.0,0,0,1.0,2,0,17.0,2010,0.0
Tommy Mason-Griffin,438,154,369,147,91,74,1107.0,165,70,87.0,204,77,23.0,2010,0.0
Tony Crocker,1351,224,1083,457,322,239,3804.0,540,198,241.0,543,259,19.9,2010,0.0
Willie Warren,868,199,606,278,273,215,1806.0,277,97,160.0,329,181,24.8,2010,1.0
Tiny Gallon,310,24,223,122,89,62,720.0,17,4,70.0,206,118,23.7,2010,0.0
Ryan Wright,299,11,208,106,151,87,1264.0,1,0,74.0,207,106,14.3,2010,0.0
Beau Gerber,26,2,22,10,10,6,112.0,0,0,11.0,22,10,17.3,2010,0.0
Gerald Lee,1624,162,1187,619,500,370,3735.0,40,16,230.0,1147,603,24.6,2010,0.0
Marsharee Neely,588,103,548,225,103,62,1677.0,222,76,98.0,326,149,21.8,2010,0.0
Marquel DeLancey,68,69,59,24,40,20,485.0,1,0,47.0,58,24,13.3,2010,0.0
Kevin Ford,714,66,506,274,266,166,1935.0,7,0,125.0,499,274,19.5,2010,0.0
Michael Fletcher,32,2,46,11,0,0,131.0,40,10,9.0,6,1,21.0,2010,0.0
Joe Moore,8,4,17,3,3,1,65.0,7,1,9.0,10,2,21.3,2010,0.0
Seth Tarver,981,215,798,371,297,187,3301.0,182,52,180.0,616,319,18.4,2010,0.0
Roeland Schaftenaar,905,211,713,327,272,192,2842.0,198,59,170.0,515,268,19.8,2010,0.0
Josh Tarver,733,304,708,270,222,146,3109.0,221,47,228.0,487,223,17.7,2010,0.0
Calvin Hampton,173,12,168,72,42,29,762.0,1,0,50.0,167,72,16.5,2010,0.0
Chris Richard,2,1,3,1,0,0,17.0,2,0,1.0,1,1,12.8,2010,1.0
David Sturner,5,4,10,2,2,0,43.0,7,1,2.0,3,1,17.3,2010,0.0
Tajuan Porter,1803,259,1499,584,333,290,4021.0,896,345,311.0,603,239,24.8,2010,0.0
Michael Dunigan,496,19,332,173,251,150,1144.0,1,0,82.0,331,173,23.3,2010,0.0
Lekendric Longmire,597,44,515,231,158,102,1589.0,94,33,75.0,421,198,21.0,2010,0.0
John Elorriaga,6,1,5,2,2,1,22.0,2,1,1.0,3,1,15.7,2010,0.0
Michael Nunnally,495,36,364,199,193,97,1459.0,1,0,91.0,363,199,21.5,2010,0.0
Joe Ford,541,244,361,214,206,113,2377.0,0,0,159.0,361,214,13.7,2010,0.0
Lavar Neufville,262,137,234,88,108,66,1132.0,72,20,91.0,162,68,17.8,2010,0.0
Royal Edwards,34,2,34,12,0,0,75.0,27,10,4.0,7,2,31.1,2010,0.0
Everson Lacerda,3,0,9,1,2,1,14.0,0,0,1.0,9,1,42.9,2010,0.0
Nick Peterson,0,0,0,0,1,0,6.0,0,0,0.0,0,0,4.3,2010,0.0
Andrew Ott,127,8,86,46,62,35,497.0,1,0,30.0,85,46,16.9,2010,0.0
Adam Highberger,14,2,18,5,1,0,66.0,15,4,4.0,3,1,20.7,2010,0.0
Justin Reilly,273,35,223,96,95,65,857.0,58,16,62.0,165,80,19.1,2010,0.0
Malcolm Washington,11,7,13,2,12,7,76.0,4,0,6.0,9,2,17.5,2010,0.0
Drew Godwin,7,1,16,3,0,0,65.0,11,1,3.0,5,2,15.7,2010,0.0
Conor Sullivan,6,1,7,1,4,3,34.0,6,1,3.0,1,0,18.8,2010,0.0
Sean Mullan,5,0,10,2,3,1,30.0,4,0,2.0,6,2,24.1,2010,0.0
Tommy Eggleston,0,1,3,0,0,0,18.0,3,0,2.0,0,0,15.0,2010,0.0
Zach Kimber,0,0,0,0,0,0,1.0,0,0,0.0,0,0,0.0,2010,0.0
Andy Shannon,22,3,28,10,2,2,221.0,0,0,8.0,28,10,8.3,2010,0.0
Jermaine Dixon,569,128,509,210,151,103,1600.0,176,46,73.0,333,164,20.9,2010,0.0
Tim Frye,17,3,16,6,0,0,35.0,12,5,6.0,4,1,31.3,2010,0.0
Dominic Waters,1215,313,843,388,319,271,2565.0,393,168,249.0,450,220,27.0,2010,0.0
Jamie Jones,1095,64,851,467,240,161,2612.0,0,0,154.0,851,467,22.4,2010,0.0
Julius Thomas,825,147,507,336,316,153,2367.0,1,0,146.0,506,336,16.8,2010,0.0
Austonn Lazoff,7,2,6,1,6,5,15.0,2,0,2.0,4,1,36.0,2010,0.0
Kenton Bansemer,0,0,0,0,0,0,15.0,0,0,0.0,0,0,0.0,2010,0.0
Steve Christensen,0,0,1,0,0,0,6.0,0,0,1.0,1,0,16.6,2010,0.0
T.J. Campbell,791,331,539,250,173,152,2032.0,291,139,180.0,248,111,20.8,2010,0.0
Robin Smeulders,1036,90,784,379,364,270,2490.0,44,8,160.0,740,371,23.6,2010,0.0
Nik Raivio,1130,170,938,405,302,210,2357.0,329,110,177.0,609,295,28.1,2010,0.0
Ethan Niedermeyer,518,94,451,179,86,62,2090.0,265,98,136.0,186,81,15.8,2010,0.0
Taishi Ito,391,227,361,113,140,103,2145.0,210,62,146.0,151,51,13.9,2010,0.0
Cody Mivshek,7,1,7,3,0,0,21.0,2,1,0.0,5,2,17.7,2010,0.0
Darnell Hugee,788,46,553,281,375,217,1503.0,34,9,112.0,519,272,27.9,2010,0.0
Dorian McDaniel,637,35,646,254,80,51,1928.0,241,78,88.0,405,176,17.2,2010,0.0
Alex Richman,192,20,164,64,12,8,529.0,150,56,32.0,14,8,15.6,2010,0.0
Tarrence Garrison,151,17,160,64,41,23,736.0,1,0,49.0,159,64,15.4,2010,0.0
Grady Green,42,0,42,18,10,2,112.0,12,4,11.0,30,14,25.5,2010,0.0
Phillip Gates,28,2,24,10,5,3,68.0,16,5,5.0,8,5,22.8,2010,0.0
Zach Finley,642,94,524,266,191,110,1951.0,0,0,192.0,524,266,22.7,2010,0.0
Marcus Schroeder,563,295,509,191,135,104,3416.0,236,77,161.0,273,114,12.9,2010,0.0
Pawel Buczak,378,121,310,150,98,59,1429.0,51,19,120.0,259,131,19.9,2010,0.0
Nick Lake,211,24,169,72,38,29,734.0,107,38,40.0,62,34,18.5,2010,0.0
Jamine Peterson,726,40,600,280,203,115,1204.0,149,51,75.0,451,229,29.6,2010,0.0
Sharaud Curry,1606,462,1275,530,388,339,3929.0,563,207,302.0,712,323,21.0,2010,0.0
Brian McKenzie,769,158,688,277,118,73,2608.0,410,142,154.0,278,135,13.0,2010,0.0
Kyle Wright,134,19,137,45,28,20,491.0,87,24,20.0,50,21,13.1,2010,0.0
Johnnie Lacy,41,14,51,14,14,11,179.0,22,2,9.0,29,12,16.3,2010,0.0
Russell Permenter,67,1,57,21,39,24,245.0,1,1,17.0,56,20,18.5,2010,0.0
Keaton Grant,1031,247,852,329,268,196,3410.0,504,177,207.0,348,152,17.6,2010,0.0
Chris Kramer,850,337,643,303,289,205,3704.0,136,39,200.0,507,264,13.4,2010,0.0
Mark Wohlford,40,9,28,13,11,6,197.0,16,8,7.0,12,5,10.9,2010,0.0
Stevie Loveless,2,2,5,1,0,0,15.0,0,0,2.0,5,1,24.3,2010,0.0
Kyle Coleman,0,2,1,0,2,0,12.0,1,0,0.0,0,0,8.5,2010,0.0
James Feldeine,1320,211,1141,483,313,239,2954.0,334,115,214.0,807,368,28.3,2010,0.0
Jeremy Baker,413,55,285,131,179,134,1252.0,58,17,71.0,227,114,17.1,2010,0.0
Jonathan Cruz,205,28,175,89,47,27,812.0,3,0,52.0,172,89,15.8,2010,0.0
Dave Johnson,121,61,100,38,41,32,529.0,44,13,43.0,56,25,14.8,2010,1.0
Evann Baker,299,74,217,96,111,91,831.0,33,16,68.0,184,80,12.4,2010,0.0
Steve Robinson,46,32,48,12,37,19,327.0,13,3,21.0,35,9,13.1,2010,0.0
Ryan Bogdan,2,3,13,0,2,2,43.0,10,0,0.0,3,0,15.6,2010,0.0
Eric Coggins,49,3,33,19,25,11,251.0,0,0,8.0,33,19,10.5,2010,0.0
Artsiom Parakhouski,1195,70,804,451,483,290,2109.0,17,3,147.0,787,448,26.4,2010,0.0
Joey Lynch-Flohr,1267,128,932,472,448,322,3273.0,4,1,227.0,928,471,20.7,2010,0.0
Lazar Trifunovic,1057,163,926,432,279,184,2523.0,26,9,261.0,900,423,25.9,2010,0.0
Amir Johnson,1229,604,1055,410,386,258,4143.0,447,151,398.0,608,259,18.4,2010,1.0
Philip Martin,377,111,308,146,141,68,1789.0,63,17,125.0,245,129,13.1,2010,0.0
Cole Wilder,93,37,84,23,42,31,413.0,56,16,41.0,28,7,17.5,2010,0.0
Keith Cothran,1287,251,1092,492,324,210,3153.0,299,93,187.0,793,399,22.2,2010,0.0
Lamonte Ulmer,1082,124,834,420,322,229,3129.0,57,13,140.0,777,407,18.0,2010,0.0
Lawrence Ghoram,814,120,699,298,281,178,2426.0,110,40,183.0,589,258,20.4,2010,0.0
A.J. Holland,40,37,48,12,14,9,315.0,26,7,28.0,22,5,13.2,2010,0.0
David Gonzalvez,1727,283,1326,590,438,310,4409.0,619,237,254.0,707,353,22.2,2010,0.0
Ryan Butler,872,237,701,301,145,104,3230.0,456,166,208.0,245,135,16.0,2010,0.0
Ryan Thompson,1879,393,1331,627,610,477,4531.0,415,148,305.0,916,479,21.1,2010,0.0
Carl Johnson,28,8,26,10,8,6,140.0,7,2,13.0,19,8,15.4,2010,0.0
Jermaine Jackson,92,22,74,35,38,22,589.0,2,0,45.0,72,35,11.6,2010,1.0
Robbie Myers,56,14,62,21,20,13,322.0,2,1,22.0,60,20,14.6,2010,0.0
Mezie Nwigwe,827,233,699,284,283,202,2673.0,179,57,225.0,520,227,19.7,2010,0.0
Dallas Green,497,53,337,178,196,140,1683.0,1,1,106.0,336,177,15.7,2010,0.0
Josiah Whitehead,279,32,183,97,120,85,987.0,2,0,68.0,181,97,16.3,2010,0.0
Jimmy Langhurst,781,195,556,241,169,142,2137.0,387,157,120.0,169,84,17.4,2010,0.0
Brad Piehl,52,6,56,23,8,6,259.0,3,0,23.0,53,23,16.1,2010,0.0
Khalif Foster,38,5,35,11,16,11,135.0,19,5,15.0,16,6,19.3,2010,0.0
Hamady N'Diaye,718,48,495,267,311,184,2744.0,2,0,169.0,493,267,15.0,2010,0.0
Muhamed Hasani,6,1,5,2,2,1,38.0,4,1,2.0,1,1,10.5,2010,0.0
Tomasz Kokosinski,0,0,3,0,2,0,14.0,1,0,1.0,2,0,17.8,2010,0.0
Justin Eller,762,45,637,271,318,211,2168.0,44,9,133.0,593,262,22.3,2010,0.0
Antonio Flaggs,441,76,357,133,121,96,1392.0,205,79,67.0,152,54,18.5,2010,0.0
Domineek Daniel,222,35,217,86,52,34,588.0,55,16,69.0,162,70,27.0,2010,0.0
Michael Selling,204,20,214,87,39,24,699.0,35,6,49.0,179,81,21.1,2010,0.0
Mike Marcial,144,180,121,46,47,33,1257.0,53,19,85.0,68,27,9.7,2010,0.0
Jonathan Malloy,133,42,135,45,43,29,686.0,42,14,69.0,93,31,17.6,2010,0.0
Jared Stigall,132,83,136,41,28,19,873.0,93,31,46.0,43,10,12.0,2010,0.0
Dani Lopez,18,0,20,8,4,2,78.0,0,0,10.0,20,8,21.0,2010,0.0
David Norris,11,2,14,5,0,0,42.0,4,1,1.0,10,4,18.4,2010,0.0
Brad Johnstin,5,1,6,2,0,0,23.0,5,1,2.0,1,1,17.9,2010,0.0
Corey Hassan,1472,238,1259,508,244,185,3197.0,719,271,224.0,540,237,25.2,2010,0.0
Ryan Litke,1182,164,1001,412,126,88,2647.0,688,270,220.0,313,142,23.6,2010,0.0
Chauncey Hardy,1247,340,976,446,221,181,3088.0,424,174,254.0,552,272,21.1,2010,0.0
Liam Potter,463,37,341,182,188,99,1522.0,0,0,135.0,341,182,18.6,2010,0.0
Josh Marshall,67,2,72,31,11,3,210.0,12,2,6.0,60,29,19.2,2010,0.0
Devin Sweetney,1529,184,1169,495,578,454,3601.0,317,85,340.0,852,410,30.8,2010,0.0
Cedric Latimer,339,53,283,120,71,47,1052.0,139,52,78.0,144,68,22.0,2010,0.0
Kurt Hoffman,336,69,242,127,129,80,1963.0,6,2,114.0,236,125,12.3,2010,0.0
Austin Fowler,22,6,31,9,2,2,131.0,8,2,3.0,23,7,14.2,2010,0.0
Chris McFarland,75,46,62,22,40,27,608.0,16,4,54.0,46,18,11.8,2010,0.0
Ron Johnson,2,0,1,1,2,0,13.0,0,0,3.0,1,1,20.3,2010,1.0
Aaron DeVane,0,1,1,0,0,0,15.0,1,0,1.0,0,0,7.1,2010,0.0
Darrin Govens,1360,323,1214,469,245,178,3714.0,679,244,218.0,535,225,22.2,2010,0.0
Garrett Williamson,912,416,647,290,438,310,3729.0,97,22,251.0,550,268,16.0,2010,0.0
Temi Adebayo,2,1,2,0,4,2,31.0,0,0,2.0,2,0,9.8,2010,0.0
C.J. Brown,4,2,6,2,0,0,25.0,0,0,4.0,6,2,20.6,2010,0.0
Willie Reed,682,33,476,273,272,136,1657.0,0,0,97.0,476,273,25.4,2010,1.0
Femi John,69,9,71,24,16,13,290.0,29,8,19.0,42,16,18.6,2010,0.0
Darrin Young,5,0,1,1,3,3,23.0,0,0,1.0,1,1,8.2,2010,0.0
Jeff Reid,2,0,4,1,0,0,23.0,1,0,1.0,3,1,12.0,2010,0.0
Omar Samhan,1848,142,1357,737,528,374,3505.0,10,0,220.0,1347,737,26.1,2010,0.0
Ben Allen,545,114,460,205,89,65,1715.0,191,70,111.0,269,135,19.3,2010,0.0
Wayne Hunter,721,97,643,250,229,141,2244.0,251,80,137.0,392,170,19.7,2010,0.0
Jordan Costner,199,32,180,62,82,48,1264.0,87,27,77.0,93,35,11.7,2010,0.0
Jamin Shumate,11,0,9,5,4,1,85.0,0,0,10.0,9,5,12.4,2010,0.0
Kabeya Kabongo,6,4,15,3,5,0,92.0,1,0,6.0,14,3,13.2,2010,0.0
Corey Allmond,979,156,773,338,140,108,1944.0,484,195,101.0,289,143,23.4,2010,0.0
Ashton Mitchell,1101,566,780,339,429,316,2995.0,321,107,336.0,459,232,21.8,2010,0.0
Preston Brown,588,62,459,207,182,120,1352.0,138,54,77.0,321,153,22.3,2010,0.0
Marco Cooper,64,7,46,27,19,10,301.0,0,0,10.0,46,27,10.9,2010,0.0
Arthur Zulu,55,7,50,25,10,5,264.0,0,0,15.0,50,25,12.8,2010,0.0
Trevon Charles,21,8,24,8,3,3,108.0,9,2,4.0,15,6,13.2,2010,0.0
Trey Montgomery,1030,241,724,353,342,236,3047.0,266,88,233.0,458,265,23.8,2010,0.0
Bryan Friday,972,161,729,356,303,199,2691.0,196,61,200.0,533,295,27.6,2010,0.0
Peter Carroll,2,0,3,1,0,0,15.0,0,0,3.0,3,1,22.5,2010,0.0
Kelvin Davis,531,80,464,188,117,69,1542.0,281,86,115.0,183,102,21.7,2010,0.0
Tyrone Shelley,664,54,568,234,192,132,1381.0,221,64,127.0,347,170,26.8,2010,0.0
Jason Deutchman,5,1,4,1,4,3,26.0,1,0,0.0,3,1,18.4,2010,0.0
Bryan Horton,9,5,14,3,10,3,74.0,2,0,5.0,12,3,16.2,2010,0.0
Ben Kneller,1,0,2,0,2,1,3.0,0,0,0.0,2,0,51.0,2010,0.0
Roberto Mafra,432,21,346,172,118,88,1063.0,0,0,69.0,346,172,24.4,2010,0.0
De'Jon Jackson,880,248,779,310,249,185,3199.0,237,75,180.0,542,235,21.8,2010,0.0
Patrick McCollum,113,42,133,37,46,30,363.0,48,9,62.0,85,28,32.7,2010,0.0
Clinton Houston,138,13,108,45,72,48,722.0,2,0,37.0,106,45,15.9,2010,0.0
Rafael Crescencio,12,3,21,4,5,4,109.0,0,0,14.0,21,4,18.8,2010,0.0
Dior Lowhorn,2003,72,1552,764,581,406,3582.0,201,69,239.0,1351,695,29.6,2010,0.0
Dontae Bryant,242,205,222,82,98,51,1591.0,83,27,116.0,139,55,12.5,2010,0.0
Blake Wallace,412,57,353,144,77,57,1414.0,185,67,49.0,168,77,16.7,2010,0.0
Peter Smith,97,29,77,29,24,17,323.0,63,22,13.0,14,7,16.5,2010,0.0
Chioke Walker,8,0,6,3,2,2,20.0,1,0,2.0,5,3,22.8,2010,0.0
Robert Owens,534,57,432,171,81,67,1474.0,314,125,63.0,118,46,18.2,2010,0.0
Mac Peterson,480,94,362,142,117,98,1748.0,259,98,63.0,103,44,13.8,2010,0.0
Chris Oakes,933,81,677,374,294,185,2606.0,0,0,147.0,677,374,18.6,2010,0.0
C.J. Webster,969,172,760,386,307,197,2464.0,2,0,157.0,758,386,21.5,2010,0.0
Anthony Dixon,14,1,14,6,8,2,70.0,1,0,3.0,13,6,15.0,2010,0.0
Jerelle Wilson,18,2,14,7,7,2,89.0,5,2,6.0,9,5,13.6,2010,0.0
Troy Alexander,52,42,45,14,34,20,438.0,14,4,50.0,31,10,13.1,2010,0.0
Tracy Rankins,525,84,453,170,167,121,1389.0,195,64,107.0,258,106,24.3,2010,0.0
Patrick Hardy,602,158,533,209,158,110,2508.0,218,74,174.0,315,135,16.4,2010,0.0
Darius Baugh,67,8,76,23,12,9,214.0,31,12,18.0,45,11,24.9,2010,0.0
Marius Chawa,71,5,61,26,33,17,310.0,10,2,17.0,51,24,16.1,2010,0.0
Rod Mitchell,182,38,182,67,87,48,921.0,5,0,100.0,177,67,16.0,2010,0.0
Glen Izevbigie,68,7,67,27,34,14,412.0,0,0,38.0,67,27,15.5,2010,0.0
Andrew Anderson,36,10,50,12,17,9,235.0,19,3,14.0,31,9,16.4,2010,0.0
Devin Stowers,67,10,64,26,25,15,455.0,0,0,38.0,64,26,15.3,2010,0.0
Mark St. Fort,2,0,1,0,4,2,29.0,0,0,3.0,1,0,10.5,2010,0.0
Robert Mitchell,1157,116,1005,431,260,200,2481.0,272,95,150.0,733,336,20.4,2010,0.0
Eugene Harvey,1560,576,1188,535,570,445,4072.0,174,45,372.0,1014,490,21.4,2010,0.0
John Garcia,613,46,433,263,180,87,2101.0,0,0,92.0,433,263,12.5,2010,0.0
Melvyn Oliver,13,3,11,5,7,3,40.0,0,0,3.0,11,5,20.2,2010,0.0
Matt Cajuste,18,1,13,8,4,1,65.0,1,1,4.0,12,7,11.5,2010,0.0
Alex Franklin,1730,150,1074,609,783,512,3814.0,1,0,276.0,1073,609,22.6,2010,0.0
Edwin Ubiles,1939,273,1582,787,390,262,4131.0,292,103,276.0,1290,684,24.2,2010,1.0
Ronald Moore,1070,823,1094,391,264,172,4452.0,382,116,321.0,712,275,16.9,2010,0.0
Denzel Yard,15,2,12,5,4,3,43.0,5,2,8.0,7,3,24.5,2010,0.0
Just-in'Love Smith,7,1,5,2,3,2,13.0,1,1,1.0,4,1,27.5,2010,0.0
Bryan Sherrer,474,104,335,146,154,138,1566.0,122,44,81.0,213,102,16.0,2010,0.0
LaShun Watson,367,98,333,141,103,60,1202.0,68,25,80.0,265,116,19.7,2010,0.0
Charles Tabet,113,7,92,40,59,33,636.0,0,0,30.0,92,40,10.6,2010,0.0
Philip Tabet,150,12,110,54,69,42,846.0,2,0,43.0,108,54,10.8,2010,0.0
Rob Phillips,22,3,33,9,0,0,139.0,13,4,8.0,20,5,15.0,2010,0.0
Jason Flagler,1437,129,1144,610,257,200,3709.0,48,17,193.0,1096,593,20.9,2010,0.0
Arsenio Williams,291,20,208,109,122,73,717.0,3,0,46.0,205,109,21.3,2010,0.0
Brandon Smalls,290,36,287,102,60,44,800.0,142,42,39.0,145,60,21.3,2010,0.0
Devin McBride,62,3,53,22,20,12,134.0,16,6,6.0,37,16,33.6,2010,0.0
Louis Brown,2,1,3,0,4,2,14.0,0,0,1.0,3,0,0,2010,0.0
Devan Downey,2304,567,2003,833,573,445,4322.0,570,193,382.0,1433,640,31.6,2010,0.0
Brandis Raley-Ross,853,137,728,294,170,118,2810.0,396,147,136.0,332,147,16.4,2010,0.0
Dominique Archie,1013,102,748,384,275,183,2933.0,180,62,169.0,568,322,18.4,2010,0.0
Evaldas Baniulis,528,78,450,178,67,41,1875.0,330,131,92.0,120,47,14.6,2010,0.0
Robert Wilder,13,11,12,4,7,3,225.0,7,2,14.0,5,2,8.4,2010,0.0
Garrett Callahan,1449,245,1112,453,403,341,3571.0,551,202,247.0,561,251,22.1,2010,0.0
Kai Williams,1423,146,1074,509,379,276,3874.0,389,129,206.0,685,380,17.5,2010,0.0
Anthony Cordova,763,93,654,322,229,115,2009.0,9,4,170.0,645,318,25.4,2010,0.0
Michael Palarca,277,192,273,92,100,68,1595.0,87,25,123.0,186,67,15.8,2010,0.0
Mark Engen,182,9,173,64,80,49,597.0,22,5,43.0,151,59,24.8,2010,0.0
James Rader,25,1,16,7,8,7,52.0,10,4,4.0,6,3,22.7,2010,0.0
Mackenzie Casey,248,104,233,88,70,49,1131.0,104,23,95.0,129,65,21.0,2010,0.0
Josh Cassaday,99,26,75,33,48,28,418.0,19,5,33.0,56,28,15.2,2010,0.0
Nick Selken,2,0,0,0,2,2,2.0,0,0,0.0,0,0,23.6,2010,0.0
Dominique Jones,1797,328,1339,592,615,453,3470.0,495,160,249.0,844,432,29.8,2010,1.0
Chris Howard,920,485,764,305,372,246,3668.0,222,64,260.0,542,241,16.6,2010,0.0
Mike Mercer,958,174,928,387,190,117,2414.0,270,67,160.0,658,320,24.1,2010,0.0
Ryan Kardok,18,8,19,6,4,2,167.0,12,4,7.0,7,2,8.7,2010,0.0
Alex Rivas,135,4,100,53,51,29,632.0,0,0,43.0,100,53,14.1,2010,0.0
Jordan Dumars,6,0,8,2,0,0,27.0,8,2,0.0,0,0,15.5,2010,0.0
Sam Pearson,323,139,275,108,155,96,1232.0,57,11,133.0,218,97,19.6,2010,0.0
JaJuan Maxwell,499,64,419,172,181,124,1492.0,98,31,109.0,321,141,19.5,2010,0.0
LaMont Russell,274,77,188,104,107,66,1466.0,1,0,86.0,187,104,11.1,2010,0.0
Eric McCrary,63,11,47,23,13,10,204.0,18,7,15.0,29,16,17.0,2010,0.0
KaJuan Watson,37,4,27,13,12,10,115.0,2,1,9.0,25,12,18.5,2010,0.0
Israel Kirk,78,12,73,32,33,14,580.0,1,0,23.0,72,32,10.0,2010,0.0
Patrick Sullivan,1283,187,929,522,366,238,2965.0,5,1,265.0,924,521,24.7,2010,0.0
Damon Forest,420,22,337,142,116,82,808.0,168,54,54.0,169,88,30.9,2010,0.0
Robert Tibbs,323,52,199,101,145,103,995.0,53,18,73.0,146,83,17.6,2010,0.0
Stephen Burches,36,23,34,13,13,9,236.0,9,1,28.0,25,12,14.8,2010,0.0
Joe Wong,0,0,1,0,0,0,4.0,0,0,1.0,1,0,25.7,2010,0.0
Dwight Lewis,1460,199,1263,522,370,267,4069.0,443,149,262.0,820,373,22.0,2010,0.0
Michael Gerrity,624,242,531,214,244,165,1995.0,108,31,162.0,423,183,20.4,2010,0.0
Kasey Cunningham,45,4,35,18,19,9,215.0,0,0,17.0,35,18,13.7,2010,0.0
Percy Miller,5,1,4,2,3,1,19.0,1,0,2.0,3,2,23.1,2010,0.0
Ryan Wetherell,17,11,22,6,6,3,111.0,7,2,7.0,15,4,15.9,2010,0.0
Tony Freeman,990,299,829,327,203,141,2960.0,517,195,245.0,312,132,19.4,2010,0.0
Nick Evans,188,7,159,75,53,38,682.0,0,0,63.0,159,75,19.1,2010,0.0
Caleb Long,3,1,2,1,0,0,10.0,2,1,2.0,0,0,21.0,2010,0.0
Aaron Moise,0,0,0,0,2,0,7.0,0,0,0.0,0,0,7.1,2010,0.0
Derek Williams,894,219,706,303,294,219,2099.0,215,69,154.0,491,234,25.3,2010,0.0
Mouhammad Faye,650,74,570,233,183,116,1749.0,216,68,137.0,354,165,23.9,2010,0.0
Ryan Barbre,15,2,15,5,0,0,35.0,13,5,3.0,2,0,27.9,2010,0.0
Buchi Awaji,265,43,215,94,46,34,808.0,110,43,35.0,105,51,17.8,2010,0.0
Andre Stephens,585,31,467,220,251,145,2190.0,0,0,103.0,467,220,16.1,2010,0.0
Gustavo Lino,51,1,41,18,21,15,265.0,0,0,5.0,41,18,11.3,2010,0.0
Daryl Arnold,131,6,115,48,40,22,425.0,42,13,35.0,73,35,38.6,2010,0.0
Bryson Brewer,22,8,19,8,3,3,147.0,8,3,11.0,11,5,11.0,2010,0.0
Davis Baker,1260,104,1021,464,268,227,2791.0,285,105,191.0,736,359,23.8,2010,0.0
Scott Friel,78,60,71,30,27,16,509.0,11,2,74.0,60,28,15.9,2010,0.0
Drew Allen,93,28,94,31,14,11,572.0,73,20,34.0,21,11,12.6,2010,0.0
Byron Byrd,32,3,40,13,4,3,75.0,12,3,4.0,28,10,37.7,2010,0.0
Jazz Williams,621,48,630,221,88,56,1746.0,361,123,84.0,269,98,22.9,2010,0.0
Doug Scott,686,121,588,251,295,161,2643.0,99,23,190.0,489,228,19.8,2010,0.0
Tony McGilveary,120,5,122,44,32,17,337.0,48,15,25.0,74,29,23.5,2010,0.0
Nick Walls,104,111,111,35,55,33,624.0,14,1,80.0,97,34,17.0,2010,0.0
Bobby Lee,88,5,99,34,14,9,212.0,56,11,15.0,43,23,27.8,2010,0.0
Norm Nixon Jr,151,69,169,58,28,17,695.0,59,18,54.0,110,40,17.5,2010,0.0
Horace Dixon,19,0,22,9,1,1,107.0,0,0,11.0,22,9,14.5,2010,0.0
McCall Wollman,14,3,38,6,2,2,135.0,13,0,12.0,25,6,11.2,2010,0.0
Desean Miles,0,1,4,0,0,0,19.0,3,0,2.0,1,0,15.4,2010,0.0
Chris Matthews,879,176,794,300,87,66,2463.0,602,213,144.0,192,87,19.7,2010,0.0
Jonathan Hall,747,197,595,303,211,129,1937.0,46,12,163.0,549,291,22.4,2010,0.0
Malcom Eleby,467,240,402,145,253,167,1821.0,63,10,219.0,339,135,21.2,2010,0.0
Lewis Leonard,8,0,15,3,8,2,32.0,5,0,3.0,10,3,34.2,2010,0.0
Joe Bucher,0,0,1,0,0,0,2.0,0,0,0.0,1,0,25.1,2010,0.0
John Schitchtel,0,0,0,0,0,0,2.0,0,0,0.0,0,0,0.0,2010,0.0
Kayode Ayeni,685,86,592,243,211,143,2054.0,195,56,189.0,397,187,23.0,2010,0.0
Herman Wrice,246,15,205,101,98,44,1194.0,2,0,78.0,203,101,14.3,2010,0.0
Nigel Byam,188,18,153,77,54,33,645.0,5,1,48.0,148,76,18.1,2010,0.0
Anthony Mason Jr,1059,187,960,393,210,153,2888.0,369,120,193.0,591,273,22.4,2010,0.0
Rob Thomas,242,4,190,96,87,48,576.0,6,2,29.0,184,94,22.5,2010,0.0
John Taubeneck,1,1,7,0,2,1,9.0,4,0,1.0,3,0,50.8,2010,0.0
Landry Fields,1393,210,1078,499,432,292,3041.0,301,103,197.0,777,396,24.9,2010,1.0
Drew Shiller,512,167,407,160,84,75,1901.0,299,117,101.0,108,43,14.7,2010,0.0
Emmanuel Igbinosa,97,9,79,36,18,10,244.0,45,15,17.0,34,21,22.0,2010,0.0
Da'Veed Dildy,77,35,82,30,30,14,463.0,22,3,41.0,60,27,15.2,2010,0.0
Matei Daian,34,2,29,14,13,6,234.0,1,0,9.0,28,14,9.7,2010,0.0
Peter Abraham,10,1,7,4,1,0,28.0,4,2,1.0,3,2,15.5,2010,0.0
Chris Ebersole,2,2,2,1,0,0,12.0,0,0,1.0,2,1,12.8,2010,0.0
Tavita Pritchard,0,0,0,0,0,0,2.0,0,0,0.0,0,0,0.0,2010,0.0
Walt Harris,456,70,403,157,104,84,1307.0,158,58,57.0,245,99,20.8,2010,0.0
Orren Tims,325,22,304,127,98,65,940.0,42,6,91.0,262,121,25.2,2010,0.0
Will Reinke,116,25,112,52,14,11,385.0,1,1,31.0,111,51,20.8,2010,0.0
Eric Bell,360,382,352,121,121,79,2398.0,110,39,162.0,242,82,12.8,2010,0.0
Austin Falke,50,16,57,21,2,1,194.0,23,7,11.0,34,14,19.1,2010,0.0
Lionell Holmes,17,0,10,5,4,3,21.0,7,4,2.0,3,1,35.3,2010,0.0
Aaron Patterson,0,1,3,0,0,0,5.0,1,0,1.0,2,0,42.7,2010,0.0
A.J. Smith,1313,270,1093,419,404,308,3198.0,490,167,379.0,603,252,26.9,2010,0.0
Mark Lohuis,604,106,592,201,63,51,2539.0,447,151,105.0,145,50,14.7,2010,0.0
Olivier Dupiton,110,18,90,39,58,32,744.0,0,0,59.0,90,39,11.9,2010,0.0
Sheldon Oliver,516,45,428,180,253,156,1926.0,2,0,108.0,426,180,17.0,2010,0.0
Shawn Bowen,71,27,89,25,18,9,537.0,44,12,34.0,45,13,12.3,2010,0.0
Tim Lang,514,45,400,170,188,126,1745.0,141,48,104.0,259,122,17.6,2010,0.0
Phil Bassan,2,0,1,0,4,2,3.0,1,0,0.0,0,0,49.8,2010,0.0
Muhammad El-Amin,971,93,812,339,235,190,1710.0,283,103,135.0,529,236,31.2,2010,0.0
Desmond Adedeji,196,10,162,82,81,32,544.0,0,0,46.0,162,82,22.0,2010,0.0
Eddie Castellanos,236,190,254,93,92,43,1673.0,28,7,170.0,226,86,9.8,2010,0.0
Andrew Goba,80,14,96,32,38,16,1035.0,0,0,57.0,96,32,8.1,2010,0.0
Patrick Dame,3,2,0,0,4,3,8.0,0,0,1.0,0,0,18.4,2010,0.0
Wes Johnson,1293,150,1017,462,311,239,2937.0,373,130,200.0,644,332,24.3,2010,0.0
Andy Rautins,1121,347,908,360,156,119,3096.0,754,282,221.0,154,78,18.2,2010,1.0
Arinze Onuaku,1232,73,833,540,385,152,3058.0,0,0,182.0,833,540,18.8,2010,1.0
Luis Guzman,361,224,332,132,102,58,2098.0,130,39,135.0,202,93,12.3,2010,0.0
Carmel Bouchman,2,0,2,0,2,2,12.0,0,0,1.0,2,0,18.1,2010,0.0
Rafael Deleon,2,2,6,1,2,0,31.0,0,0,3.0,6,1,19.5,2010,0.0
Marquis Weddle,1304,111,1186,458,187,148,2653.0,704,240,174.0,482,218,26.0,2010,0.0
M.J. Brown,244,101,252,85,85,60,972.0,58,14,75.0,194,71,18.0,2010,0.0
Terrance Coleman,131,21,130,44,53,33,499.0,36,10,31.0,94,34,17.8,2010,0.0
Delrico Lane,257,187,177,78,106,70,1191.0,89,31,108.0,88,47,13.4,2010,0.0
Cataurius Taylor,65,59,70,23,28,14,535.0,22,5,43.0,48,18,11.2,2010,0.0
Dominique Mpondo,70,8,64,26,29,18,425.0,0,0,23.0,64,26,11.3,2010,0.0
Josh Sain,375,47,342,132,84,52,750.0,161,59,80.0,181,73,32.0,2010,0.0
Jeremiah Crutcher,368,232,336,126,71,48,1576.0,208,68,132.0,128,58,15.6,2010,0.0
Darius Cox,668,93,529,277,151,99,1943.0,57,15,107.0,472,262,17.7,2010,0.0
Lonnie Funderburke,148,13,111,51,78,46,830.0,0,0,51.0,111,51,11.8,2010,0.0
Martell Buie,111,31,83,33,38,27,333.0,47,18,33.0,36,15,20.0,2010,0.0
Erick Peguero,57,9,61,21,30,15,192.0,14,0,22.0,47,21,25.2,2010,0.0
Hamilton Nash,32,4,37,14,6,4,270.0,0,0,12.0,37,14,9.6,2010,0.0
Marcus Cowan,28,2,15,9,17,10,190.0,0,0,8.0,15,9,8.1,2010,0.0
Greg Holley,15,3,25,5,1,0,70.0,16,5,7.0,9,0,23.1,2010,0.0
Frank Davis,1118,198,854,356,195,155,3010.0,615,251,158.0,239,105,18.2,2010,0.0
Elijah Cunningham-Muhammad,382,143,297,125,105,88,1027.0,107,44,100.0,190,81,21.8,2010,0.0
Wayne Chism,1608,155,1274,588,452,301,3375.0,405,131,215.0,869,457,24.6,2010,0.0
J.P. Prince,953,313,727,367,325,194,2611.0,111,25,233.0,616,342,19.6,2010,0.0
Bobby Maze,752,273,654,275,189,144,2184.0,207,58,137.0,447,217,19.6,2010,0.0
Tyler Smith,1680,391,1260,598,580,425,3490.0,203,59,257.0,1057,539,25.8,2010,0.0
Quinn Cannington,14,4,10,5,2,2,38.0,3,2,1.0,7,3,16.3,2010,0.0
Kevin Palmer,1230,182,883,393,433,339,2040.0,333,105,250.0,550,288,32.1,2010,0.0
Shamar Coombs,325,94,283,100,99,74,1056.0,163,51,114.0,120,49,20.5,2010,0.0
LaMarr Drake,205,120,184,69,62,42,940.0,85,25,105.0,99,44,16.6,2010,0.0
Marcus Hammonds,167,45,145,63,39,21,865.0,54,20,60.0,91,43,12.7,2010,0.0
Filip Toncinic,365,79,353,130,126,78,1426.0,93,27,92.0,260,103,17.2,2010,0.0
Jacob Warnell,4,0,3,1,2,2,15.0,1,0,2.0,2,1,19.1,2010,0.0
Donald Sloan,1522,370,1214,519,503,368,3860.0,345,116,259.0,869,403,24.4,2010,1.0
Bryan Davis,1066,143,744,380,501,305,2815.0,2,1,251.0,742,379,22.5,2010,0.0
Derrick Roland,547,133,478,199,147,99,1938.0,189,50,122.0,289,149,20.1,2010,0.0
Chris Chapman,4,2,3,2,0,0,20.0,0,0,0.0,3,2,4.2,2010,0.0
Shawn Schepel,4,1,7,1,6,2,24.0,0,0,2.0,7,1,21.2,2010,0.0
Marquez Haynes,1377,303,978,456,464,344,2871.0,333,121,255.0,645,335,25.8,2010,0.0
Brandon Long,1277,131,1143,417,282,220,3210.0,694,223,174.0,449,194,22.4,2010,0.0
Dwight Gentry II,242,69,172,73,97,73,761.0,74,23,49.0,98,50,16.8,2010,0.0
Tommy Moffitt,718,92,595,285,151,98,2137.0,145,50,108.0,450,235,18.0,2010,0.0
J.D. Davis,158,20,134,64,54,30,780.0,3,0,45.0,131,64,12.6,2010,0.0
Trey Parker,202,27,119,74,90,54,1098.0,0,0,40.0,119,74,7.7,2010,0.0
Ishmael Awange,57,5,40,21,33,15,401.0,0,0,36.0,40,21,10.9,2010,0.0
Jon Miller,19,1,19,6,8,6,77.0,9,1,6.0,10,5,18.0,2010,0.0
Hungo Makor,0,0,3,0,1,0,7.0,1,0,0.0,2,0,23.7,2010,0.0
Zvonko Buljan,759,121,596,284,194,138,1721.0,176,53,196.0,420,231,27.6,2010,0.0
Edvinas Ruzgas,652,47,479,221,120,91,1980.0,318,119,50.0,161,102,15.6,2010,0.0
Keion Mitchem,535,121,483,186,77,59,1888.0,279,104,114.0,204,82,14.3,2010,0.0
Logan Lancon,20,4,32,7,6,4,152.0,18,2,4.0,14,5,14.3,2010,0.0
Torey Woods,2,1,3,1,0,0,5.0,2,0,1.0,1,1,42.6,2010,0.0
Derrick Caracter,810,51,558,314,282,177,1553.0,16,5,170.0,542,309,27.2,2010,1.0
Myron Strong,402,159,374,157,91,56,1420.0,118,32,108.0,256,125,16.5,2010,0.0
Marcus Ruppel,8,1,4,3,0,0,16.0,2,2,0.0,2,1,12.5,2010,0.0
Yaw Mensa,1,0,1,0,6,1,15.0,0,0,1.0,1,0,16.2,2010,0.0
Luis Valera,452,19,330,168,178,116,1246.0,2,0,83.0,328,168,20.7,2010,0.0
Manny Hendrix,123,23,116,38,48,32,439.0,38,15,26.0,78,23,19.6,2010,0.0
ChaRunn Jones,82,25,87,28,2,2,371.0,81,24,21.0,6,4,15.3,2010,0.0
Rakeem Couch,24,5,13,7,16,10,178.0,0,0,11.0,13,7,9.3,2010,0.0
Jacob Trader,30,1,26,12,9,5,207.0,1,1,7.0,25,11,10.0,2010,0.0
Rico Seagears,15,4,26,6,5,2,164.0,11,1,11.0,15,5,12.5,2010,0.0
Morris Smith IV,800,89,723,283,123,89,2150.0,402,145,122.0,321,138,22.7,2010,0.0
Omar Johnson,729,231,560,225,255,187,2069.0,241,92,167.0,319,133,20.5,2010,0.0
Terry Fields,342,49,263,133,102,71,1057.0,19,5,61.0,244,128,18.1,2010,0.0
Demarco Stepter,413,12,338,165,103,73,1000.0,52,10,63.0,286,155,22.8,2010,0.0
Leslie Jackson,110,25,114,45,20,13,591.0,27,7,23.0,87,38,12.0,2010,0.0
Richie Frohlich,87,1,59,35,35,17,289.0,1,0,16.0,58,35,15.9,2010,0.0
Chip Ivany,6,3,12,3,2,0,33.0,5,0,8.0,7,3,32.7,2010,0.0
DeAndre Hall,984,143,824,393,291,177,2016.0,67,21,189.0,757,372,27.4,2010,0.0
Junior Treasure,438,87,341,136,146,113,834.0,176,53,101.0,165,83,30.4,2010,0.0
Onyekawtuke Abiakam,170,15,149,74,47,22,820.0,0,0,40.0,149,74,11.0,2010,0.0
Ricky Boyles,333,16,239,138,90,57,940.0,1,0,76.0,238,138,18.0,2010,0.0
Marc Ellis,105,17,74,38,41,21,460.0,27,8,29.0,47,30,11.7,2010,0.0
Jason West,59,8,50,21,13,8,152.0,24,9,16.0,26,12,23.5,2010,0.0
TeAllen Price,11,0,13,4,9,3,63.0,0,0,6.0,13,4,23.4,2010,0.0
John Rybak,687,117,544,223,132,105,1898.0,389,136,83.0,155,87,15.6,2010,0.0
Emanuel Bidias a Moute,315,56,252,123,124,69,969.0,3,0,90.0,249,123,19.1,2010,0.0
Roshun Jackson,96,22,130,38,28,17,401.0,31,3,33.0,99,35,19.3,2010,0.0
Nick Okorie,692,108,560,230,220,163,1612.0,184,69,114.0,376,161,22.4,2010,0.0
Darko Cohadarevic,330,52,308,136,78,57,1026.0,12,1,81.0,296,135,18.7,2010,0.0
Theron Jenkins,90,15,81,34,32,21,284.0,9,1,24.0,72,33,20.1,2010,0.0
Corbin Ray,27,4,21,11,2,2,103.0,6,3,6.0,15,8,0.0,2010,0.0
Damion James,1917,163,1473,705,631,404,4156.0,283,103,259.0,1190,602,23.7,2010,1.0
Avery Bradley,396,71,368,159,66,36,1003.0,112,42,52.0,256,117,20.4,2010,1.0
Dexter Pittman,882,38,541,337,346,208,1629.0,0,0,143.0,541,337,25.2,2010,1.0
Justin Mason,866,378,757,321,264,151,3936.0,218,73,196.0,539,248,13.5,2010,0.0
Jordan Dressler,196,21,158,83,50,29,778.0,1,1,50.0,157,82,17.1,2010,0.0
Ian Salter,138,10,115,53,58,32,955.0,0,0,42.0,115,53,11.9,2010,0.0
Kevin Rohner,8,2,6,3,1,0,23.0,5,2,0.0,1,1,16.1,2010,0.0
Drew Rodriguez,0,1,2,0,0,0,12.0,0,0,0.0,2,0,10.4,2010,0.0
Josh Thornton,1002,105,873,348,117,80,2229.0,578,226,134.0,295,122,24.5,2010,0.0
Calvin Lee,485,55,429,191,131,96,1392.0,22,7,84.0,407,184,21.4,2010,0.0
Jarrel Smith,588,53,476,207,184,137,1596.0,112,37,77.0,364,170,21.5,2010,0.0
David Brewster,209,22,212,70,55,35,727.0,116,34,46.0,96,36,19.9,2010,0.0
Jimmy Smith,7,3,12,2,3,2,50.0,6,1,5.0,6,1,20.5,2010,0.0
Brandon Hazzard,1255,128,999,431,245,184,2491.0,509,209,138.0,490,222,25.2,2010,0.0
Michael Vogler,897,473,655,307,261,200,2742.0,202,83,214.0,453,224,17.2,2010,0.0
Richard Delk,1118,229,938,437,188,104,3405.0,409,140,213.0,529,297,15.9,2010,0.0
Yamene Coleman,546,21,443,233,161,80,1870.0,0,0,91.0,443,233,17.0,2010,0.0
Antywan Jones,434,86,375,177,78,44,1418.0,103,36,99.0,272,141,18.0,2010,0.0
Trayce Macon,271,33,225,86,96,56,768.0,126,43,62.0,99,43,20.7,2010,0.0
Kyle Greenwood,0,0,3,0,0,0,30.0,0,0,2.0,3,0,8.4,2010,0.0
Kevin Sims,1339,412,986,387,499,401,3737.0,429,164,288.0,557,223,20.6,2010,0.0
Asim McQueen,599,66,512,221,218,150,2295.0,20,7,148.0,492,214,17.3,2010,0.0
Eric Vianney,377,126,325,125,86,57,1422.0,202,70,95.0,123,55,16.9,2010,0.0
Terrance Beasley,45,6,56,17,19,10,190.0,9,1,15.0,47,16,22.0,2010,0.0
Jon Andersen,21,2,25,10,2,1,133.0,0,0,8.0,25,10,13.3,2010,0.0
Jerome Jordan,1508,113,964,547,595,414,3214.0,0,0,268.0,964,547,24.2,2010,1.0
Ben Uzoh,1951,425,1448,657,593,464,4549.0,496,173,334.0,952,484,23.2,2010,1.0
Bishop Wheatley,471,103,370,163,208,143,2617.0,17,2,137.0,353,161,11.9,2010,0.0
Michael Roll,1005,253,845,369,84,61,2979.0,501,209,140.0,344,160,18.5,2010,0.0
Nikola Dragovic,754,91,634,253,156,128,2044.0,376,120,109.0,258,133,20.9,2010,0.0
Mustafa Abdul-Hamid,74,27,63,29,9,4,297.0,37,12,22.0,26,17,15.6,2010,0.0
James Keefe,245,33,213,96,78,35,1309.0,53,18,64.0,160,78,12.3,2010,0.0
Spencer Soo,5,0,6,1,2,2,14.0,2,1,1.0,4,0,29.6,2010,0.0
Jared Quayle,892,275,672,294,214,176,2169.0,316,128,120.0,356,166,21.9,2010,0.0
Jaxon Myaer,180,47,139,61,35,26,633.0,80,32,59.0,59,29,17.0,2010,0.0
Modou Niang,88,12,57,32,42,24,353.0,0,0,33.0,57,32,16.0,2010,0.0
Jourdain Scoubes,418,45,376,138,88,63,1343.0,222,79,53.0,154,59,20.0,2010,0.0
Tyray Petty,383,75,315,135,94,65,1388.0,128,48,95.0,187,87,15.5,2010,0.0
Corey Claitt,429,83,376,161,118,81,1168.0,100,26,126.0,276,135,29.0,2010,0.0
Aaron England,158,21,131,54,24,23,491.0,69,27,25.0,62,27,18.3,2010,0.0
Eric Dearden,142,40,129,49,41,32,537.0,38,12,45.0,91,37,19.3,2010,0.0
Nick Jenson,22,2,30,10,6,2,157.0,0,0,8.0,30,10,13.9,2010,0.0
Jason Holm,0,2,5,0,0,0,48.0,0,0,2.0,5,0,8.3,2010,0.0
Lafayette Yarbray,0,0,0,0,1,0,3.0,0,0,1.0,0,0,26.4,2010,0.0
Luka Drca,784,362,582,233,276,224,2774.0,288,94,262.0,294,139,19.4,2010,0.0
Kim Tillie,466,58,349,167,155,125,1532.0,30,7,102.0,319,160,18.5,2010,0.0
Matt Read,104,15,83,40,29,20,378.0,9,4,27.0,74,36,15.5,2010,0.0
Tre Smith,12,8,12,4,4,1,55.0,8,3,4.0,4,1,17.4,2010,0.0
Ricky Shoff,5,0,5,2,0,0,16.0,4,1,1.0,1,1,19.9,2010,0.0
Austin Robison,0,0,0,0,0,0,2.0,0,0,0.0,0,0,0.0,2010,0.0
Brandon McPherson,1180,316,860,404,273,214,3129.0,388,158,203.0,472,246,19.7,2010,0.0
Milos Milosevic,20,5,17,8,6,4,96.0,1,0,9.0,16,8,15.4,2010,0.0
Jermaine Beal,1255,421,923,381,405,322,3604.0,471,171,197.0,452,210,18.7,2010,0.0
A.J. Ogilvy,1467,106,901,495,640,470,2459.0,29,7,227.0,872,488,28.9,2010,0.0
Marqus Blakely,1875,301,1179,673,876,525,3675.0,26,4,331.0,1153,669,26.1,2010,1.0
Maurice Joseph,953,90,752,293,246,203,2302.0,452,164,117.0,300,129,22.1,2010,0.0
Nick Vier,628,321,475,181,253,185,2649.0,229,81,260.0,246,100,15.2,2010,0.0
Scottie Reynolds,2222,482,1573,652,775,631,4340.0,770,287,396.0,803,365,26.8,2010,0.0
Taylor King,423,32,349,146,71,48,939.0,224,83,50.0,125,63,21.5,2010,0.0
Reggie Redding,681,258,597,241,223,148,2900.0,180,51,162.0,417,190,14.4,2010,0.0
Jason Colenda,2,2,1,0,3,2,38.0,0,0,4.0,1,0,16.5,2010,0.0
Larry Sanders,1044,51,798,415,364,210,2376.0,16,4,155.0,782,411,23.5,2010,1.0
T.J. Gwynn,523,100,348,181,220,149,1695.0,35,12,109.0,313,169,17.2,2010,0.0
Jay Gavin,490,60,382,148,145,106,1046.0,233,88,88.0,149,60,26.5,2010,0.0
Kirill Pishchalnikov,301,44,236,112,125,77,1297.0,0,0,85.0,236,112,16.2,2010,0.0
Terrance Saintil,117,10,102,51,34,15,445.0,0,0,25.0,102,51,17.1,2010,0.0
Adam Lonon,328,322,262,119,134,83,1995.0,50,7,213.0,212,112,10.9,2010,0.0
Hunter Houston,211,24,224,81,27,11,636.0,136,38,29.0,88,43,17.2,2010,0.0
Carl Josey,113,23,141,44,25,12,725.0,69,13,63.0,72,31,10.5,2010,0.0
Aaron Blosser,10,0,8,4,0,0,19.0,4,2,3.0,4,2,23.8,2010,0.0
Lewis Witcher,264,11,230,112,82,40,1341.0,0,0,45.0,230,112,11.9,2010,0.0
Sylven Landesberg,930,155,719,316,323,259,1825.0,111,39,138.0,608,277,28.3,2010,0.0
Jerome Meyinsse,299,15,183,104,134,91,1127.0,0,0,36.0,183,104,13.0,2010,0.0
Calvin Baker,919,304,884,323,213,160,2817.0,371,113,235.0,513,210,21.4,2010,0.0
Solomon Tat,106,23,89,36,52,34,427.0,5,0,29.0,84,36,16.3,2010,0.0
Tom Jonke,0,0,1,0,0,0,12.0,1,0,2.0,0,0,13.6,2010,0.0
Thomas Kody,0,1,2,0,0,0,8.0,0,0,1.0,2,0,20.4,2010,0.0
Michael Orock,466,36,344,188,191,90,1509.0,0,0,110.0,344,188,19.1,2010,0.0
Doug Elwell,319,132,318,110,29,20,1468.0,237,79,80.0,81,31,14.3,2010,0.0
Ryan Conrad,127,30,122,38,37,30,345.0,78,21,34.0,44,17,25.8,2010,0.0
Garrett Constance,20,1,23,6,7,5,98.0,16,3,3.0,7,3,15.3,2010,0.0
Phillip Roth,0,0,2,0,0,0,11.0,0,0,3.0,2,0,23.3,2010,0.0
Al-Farouq Aminu,892,87,657,313,351,241,1869.0,105,25,180.0,552,288,27.5,2010,1.0
Ishmael Smith,1114,612,1078,458,273,132,3667.0,219,66,350.0,859,392,20.6,2010,0.0
L.D. Williams,1005,158,809,373,319,200,3332.0,206,59,196.0,603,314,16.8,2010,0.0
Chas McFarland,755,62,556,268,331,216,2120.0,19,3,168.0,537,265,18.9,2010,0.0
David Weaver,304,29,215,116,104,66,1368.0,14,6,69.0,201,110,11.6,2010,0.0
Phaethon Bolton,0,0,0,0,0,0,2.0,0,0,0.0,0,0,0.0,2010,0.0
Kyle Fowler,0,0,1,0,0,0,2.0,0,0,1.0,1,0,47.0,2010,0.0
Nikola Koprivica,533,142,417,179,156,106,2066.0,211,69,117.0,206,110,16.8,2010,0.0
John Allen,7,6,11,3,0,0,43.0,7,1,2.0,4,2,15.4,2010,0.0
Austin Bragg,0,0,0,0,0,0,3.0,0,0,0.0,0,0,0.0,2010,0.0
Quincy Pondexter,1786,230,1297,652,557,428,3715.0,165,54,258.0,1132,598,24.4,2010,1.0
Tyreese Breshers,103,1,81,35,63,33,335.0,0,0,20.0,81,35,18.2,2010,0.0
Steve Panos,890,46,602,322,344,246,2084.0,2,0,165.0,600,322,23.7,2010,0.0
Franklin Session,317,83,274,122,111,56,948.0,74,17,81.0,200,105,21.5,2010,0.0
Nick Hansen,546,107,437,170,71,64,1799.0,373,142,68.0,64,28,15.6,2010,0.0
Matt Washington,45,1,32,17,19,11,116.0,1,0,7.0,31,17,20.7,2010,0.0
Josh Noble,19,12,22,7,5,3,100.0,8,2,7.0,14,5,15.7,2010,0.0
Da'Sean Butler,2095,280,1654,741,557,408,4491.0,581,205,252.0,1073,536,24.6,2010,1.0
Devin Ebanks,775,176,596,276,292,215,2217.0,70,8,142.0,526,268,19.8,2010,1.0
Wellington Smith,696,132,593,259,180,106,2519.0,228,72,131.0,365,187,16.3,2010,0.0
Cam Payne,9,3,11,2,8,5,52.0,3,0,6.0,8,2,20.1,2010,0.0
Bryan Lowther,0,0,1,0,0,0,1.0,0,0,0.0,1,0,50.6,2010,0.0
Brandon Giles,1424,157,1284,537,274,195,3035.0,431,155,222.0,853,382,27.9,2010,0.0
Jake Robinson,1287,122,997,409,239,191,2755.0,727,278,139.0,270,131,22.6,2010,0.0
Brigham Waginger,810,398,729,278,160,89,3668.0,500,165,232.0,229,113,14.0,2010,0.0
Kendall Russell,233,33,160,81,94,70,882.0,4,1,55.0,156,80,14.1,2010,0.0
Adrian Gailliard,289,18,215,107,121,74,954.0,1,1,75.0,214,106,17.4,2010,0.0
Antoine Childs,52,3,26,19,17,10,88.0,5,4,6.0,21,15,21.7,2010,0.0
David Nurse,764,166,613,231,181,142,2652.0,445,160,141.0,168,71,17.5,2010,0.0
Quenton Kirby,392,91,369,144,145,95,1352.0,37,9,130.0,332,135,23.9,2010,0.0
James Granstra,280,35,210,100,147,80,1502.0,0,0,65.0,210,100,12.8,2010,0.0
Jeremy Felton,51,6,54,22,9,7,97.0,0,0,7.0,54,22,37.7,2010,0.0
A.J. Slaughter,1581,332,1255,528,402,315,3550.0,562,210,248.0,693,318,25.3,2010,0.0
Jeremy Evans,1065,72,668,427,291,199,3150.0,33,12,136.0,635,415,16.1,2010,1.0
Anthony Sally,253,179,188,65,146,105,1507.0,64,18,169.0,124,47,14.5,2010,0.0
Nesho Milosevic,661,41,565,257,254,143,959.0,32,4,199.0,533,253,20.8,2010,0.0
Jameson Tipping,48,11,54,16,11,6,218.0,34,10,9.0,20,6,16.2,2010,0.0
David Kool,2122,272,1519,643,680,605,4002.0,653,231,282.0,866,412,29.9,2010,0.0
Martelle McLemore,587,76,528,205,136,88,1734.0,263,89,106.0,265,116,20.3,2010,0.0
Donald Lawson,472,39,355,180,202,112,1997.0,0,0,131.0,355,180,16.1,2010,0.0
Clevin Hannah,766,295,535,243,185,152,1929.0,309,128,153.0,226,115,20.6,2010,0.0
Kenny Manigault,26,17,17,7,21,12,115.0,1,0,9.0,16,7,16.5,2010,0.0
Bryce Mayes,7,0,7,2,4,2,23.0,6,1,1.0,1,1,22.7,2010,0.0
Mason Felter,3,1,5,1,2,1,31.0,1,0,4.0,4,1,16.9,2010,0.0
David Schneider,1491,368,1270,432,434,349,3985.0,862,278,196.0,408,154,23.3,2010,0.0
Danny Sumner,1146,106,997,424,292,163,2864.0,414,135,160.0,583,289,23.2,2010,0.0
Sean McCurdy,353,248,311,107,135,93,1803.0,145,46,155.0,166,61,15.5,2010,0.0
Steven Hess,251,55,167,101,80,49,979.0,3,0,87.0,164,101,17.1,2010,0.0
Matt McFadden,74,23,77,31,11,2,355.0,39,10,32.0,38,21,37.3,2010,0.0
Mantoris Robinson,755,137,617,247,338,221,3069.0,180,40,206.0,437,207,16.5,2010,0.0
Andy Buechert,285,25,261,112,135,61,1240.0,2,0,81.0,259,112,16.7,2010,0.0
Chris Malcolm,140,14,125,54,59,31,618.0,1,1,42.0,124,53,16.2,2010,0.0
Chad Dewitt,32,7,39,12,2,2,102.0,21,6,8.0,18,6,23.9,2010,0.0
Raymond Davis,104,27,114,40,18,8,397.0,65,16,34.0,49,24,20.5,2010,0.0
Trevon Hughes,1339,277,1058,415,464,334,3438.0,487,175,222.0,571,240,24.7,2010,0.0
Jason Bohannon,1170,211,858,365,269,228,3749.0,559,212,130.0,299,153,16.8,2010,0.0
Junior Salters,1196,198,1055,402,176,128,3271.0,703,264,191.0,352,138,19.0,2010,0.0
Corey Godzinski,670,104,569,247,129,90,2243.0,289,86,86.0,280,161,17.0,2010,0.0
Todd Brown,1469,226,1259,516,333,240,3900.0,503,197,171.0,756,319,22.8,2010,0.0
Cory Cooperwood,610,51,452,218,230,164,1558.0,36,10,86.0,416,208,23.1,2010,0.0
Ronnie Thomas,429,47,379,166,91,55,1713.0,134,42,93.0,245,124,16.5,2010,0.0
Scott Grote,542,144,402,177,198,142,1747.0,142,46,152.0,260,131,17.6,2010,0.0
Paul Darkwa,28,1,28,11,14,6,131.0,0,0,11.0,28,11,19.1,2010,0.0
Darian Cartharn,27,13,27,9,4,4,170.0,15,5,13.0,12,4,13.5,2010,0.0
John David Gardner,258,109,208,90,74,56,949.0,63,22,65.0,145,68,18.4,2010,0.0
Ryan Dermody,506,69,453,165,128,82,2047.0,302,94,93.0,151,71,12.4,2010,0.0
Boubacar Sylla,79,2,68,28,41,23,313.0,0,0,25.0,68,28,17.5,2010,0.0
Thomas Manzano,56,11,48,20,24,14,141.0,21,2,6.0,27,18,22.5,2010,0.0
Jordan Crawford,1009,170,806,367,217,166,1905.0,284,109,143.0,522,258,27.4,2010,1.0
Jason Love,888,66,570,316,374,256,2474.0,0,0,146.0,570,316,19.2,2010,0.0
Alex Zampier,1144,196,924,367,337,275,2527.0,422,135,233.0,502,232,32.2,2010,0.0
Michael Sands,458,48,314,150,217,157,1264.0,8,1,90.0,306,149,22.5,2010,0.0
Jordan Gibson,368,54,289,134,124,93,1183.0,24,7,66.0,265,127,17.9,2010,0.0
Paul Nelson,327,23,236,119,143,89,1276.0,0,0,63.0,236,119,15.6,2010,0.0
DeAndre Mays,749,207,686,251,247,175,1898.0,204,72,168.0,482,179,25.8,2010,0.0
Sulskis Vytas,919,169,701,290,303,213,2261.0,350,126,147.0,351,164,22.2,2010,0.0
Kelvin Bright,659,100,551,233,260,159,1687.0,127,34,113.0,424,199,23.5,2010,0.0
Sirlester Martin,586,55,558,244,121,76,1614.0,86,22,91.0,472,222,22.1,2010,0.0
Vance Cooksey,454,198,355,133,185,139,1721.0,148,49,147.0,207,84,17.4,2010,0.0
Dallas Blocker,185,50,150,77,56,30,769.0,4,1,42.0,146,76,14.4,2010,0.0
Eddie D'Haiti,70,13,59,24,38,22,319.0,1,0,29.0,58,24,16.9,2010,0.0
Zack Rebillot,111,14,77,41,44,29,531.0,2,0,27.0,75,41,11.9,2010,0.0
Tom Parks,145,14,130,50,10,6,519.0,103,39,35.0,27,11,16.4,2010,0.0
Andy Timko,0,1,3,0,0,0,9.0,1,0,2.0,2,0,28.2,2010,0.0
Tom Fow,641,51,486,219,103,83,1361.0,288,120,46.0,198,99,25.3,2011,0.0
Derek Brooks,432,56,302,148,110,83,1023.0,129,53,61.0,173,95,24.1,2011,0.0
Evan Washington,973,327,745,340,411,248,3969.0,126,45,252.0,619,295,18.1,2011,0.0
Jamil Bailey,2,0,2,1,0,0,6.0,1,0,0.0,1,1,19.6,2011,0.0
Myles Jerrett,2,0,1,1,0,0,3.0,0,0,0.0,1,1,19.6,2011,0.0
Steve McNees,981,318,856,303,224,154,3505.0,638,221,178.0,218,82,16.8,2011,0.0
Darryl Roberts,962,185,707,301,237,210,3085.0,374,150,140.0,333,151,16.1,2011,0.0
Brett Mcknight,1142,112,981,417,296,212,2150.0,293,96,152.0,688,321,30.6,2011,0.0
Mike Bardo,187,35,147,73,89,41,1429.0,0,0,51.0,147,73,8.7,2011,0.0
Dakotah Euton,16,1,20,4,6,4,67.0,13,4,0.0,7,0,17.8,2011,0.0
Cornelius Hester,1325,154,1332,484,194,149,3145.0,694,208,177.0,638,276,24.3,2011,0.0
Bo Amusa,490,36,390,184,166,109,1204.0,30,13,59.0,360,171,20.5,2011,0.0
Desmond Jackson,463,115,555,161,91,47,1991.0,351,94,131.0,204,67,17.0,2011,0.0
Jonathan Inman,646,60,425,227,336,192,1890.0,1,0,118.0,424,227,17.3,2011,0.0
Jabari Deshields,167,113,179,51,90,53,949.0,44,12,135.0,135,39,15.6,2011,0.0
Reggie Porter,145,51,126,43,53,43,573.0,55,16,75.0,71,27,19.5,2011,0.0
Chris Burks,0,0,0,0,0,0,5.0,0,0,0.0,0,0,0.0,2011,0.0
Jamarr Sanders,1072,195,924,381,166,127,2789.0,488,183,191.0,436,198,23.4,2011,0.0
Aaron Johnson,992,664,696,299,434,326,3975.0,221,68,355.0,475,231,16.6,2011,0.0
Mike Jones,21,2,24,8,2,1,69.0,12,4,9.0,12,4,25.9,2011,0.0
Tramayne Moorer,646,34,445,211,301,212,1336.0,42,12,102.0,403,199,25.8,2011,0.0
Christopher Duncan,360,40,335,134,139,83,1120.0,54,9,82.0,281,125,21.6,2011,0.0
Robert Sanders,266,36,230,95,132,64,993.0,36,12,86.0,194,83,19.1,2011,0.0
Kaylim Noel,83,8,59,29,25,13,208.0,28,12,14.0,31,17,20.5,2011,0.0
Ivan Johnson,75,17,96,20,46,30,301.0,35,5,22.0,61,15,23.4,2011,1.0
Patrick Davis,61,1,61,26,12,8,193.0,2,1,20.0,59,25,22.6,2011,0.0
Dwayne Harvey,57,47,45,14,41,23,312.0,15,6,34.0,30,8,15.9,2011,0.0
Jordan Jefferson,25,1,19,12,6,1,86.0,2,0,8.0,17,12,17.4,2011,0.0
Adrian Spellman,11,0,10,5,5,1,31.0,0,0,1.0,10,5,21.7,2011,0.0
Charvez Davis,505,74,468,175,42,30,1618.0,338,125,67.0,130,50,17.6,2011,0.0
Senario Hillman,1032,234,999,409,208,146,2933.0,261,68,243.0,738,341,23.4,2011,0.0
Kendall Durant,21,3,17,6,6,6,74.0,8,3,7.0,9,3,18.7,2011,0.0
Justin Luquire,8,1,7,4,2,0,36.0,1,0,1.0,6,4,12.8,2011,0.0
Hunter Jeffery,3,2,8,1,0,0,21.0,8,1,0.0,0,0,19.6,2011,0.0
Tim Ambrose,1582,308,1303,584,382,288,3083.0,338,126,329.0,965,458,30.9,2011,0.0
Billy Allen,193,49,187,60,39,34,948.0,141,39,37.0,46,21,13.2,2011,0.0
Jake Lindfors,102,7,118,39,22,14,439.0,48,10,30.0,70,29,18.9,2011,0.0
Derrek Tartt,57,27,51,19,22,13,347.0,19,6,36.0,32,13,14.6,2011,0.0
Russell Moore,2,3,5,1,0,0,39.0,0,0,1.0,5,1,8.5,2011,0.0
Theo Hatcher,0,0,0,0,0,0,1.0,0,0,0.0,0,0,0.0,2011,0.0
Marquiz Baker,444,31,382,128,168,131,793.0,163,57,65.0,219,71,29.8,2011,0.0
Jamar Ragland,228,27,218,85,76,43,696.0,53,15,63.0,165,70,20.6,2011,0.0
Willis Brownlee,168,28,138,56,73,46,536.0,29,10,46.0,109,46,18.3,2011,0.0
Korey Sanders,124,12,126,54,43,16,510.0,3,0,18.0,123,54,14.5,2011,0.0
Alex Savannah,239,78,234,80,130,70,1095.0,42,9,107.0,192,71,17.5,2011,0.0
Keith Searcy,280,65,301,104,108,69,1012.0,22,3,135.0,279,101,22.0,2011,0.0
Shaunvanta Ingram,205,25,221,74,65,44,598.0,68,13,67.0,153,61,24.3,2011,0.0
Tony Eackles,245,29,182,70,134,89,645.0,41,16,77.0,141,54,22.8,2011,0.0
Michael Martin,62,9,49,23,38,16,565.0,0,0,25.0,49,23,7.4,2011,0.0
Jeremy Richards,0,0,1,0,2,0,4.0,1,0,0.0,0,0,21.9,2011,0.0
Vlad Moldoveanu,1098,117,812,354,337,275,2145.0,321,115,129.0,491,239,31.9,2011,0.0
Nick Hendra,773,275,657,271,199,126,2777.0,314,105,211.0,343,166,18.8,2011,0.0
Steve Luptak,195,117,182,63,46,31,1353.0,117,38,74.0,65,25,11.4,2011,0.0
Donald Sims,2185,346,1477,641,611,545,4058.0,883,358,291.0,594,283,25.5,2011,0.0
Jeremi Booth,772,85,676,267,139,98,2144.0,416,140,95.0,260,127,19.6,2011,0.0
Marcus Wright,397,120,345,143,98,69,1291.0,134,42,146.0,211,101,20.8,2011,0.0
J.R. Archer,18,2,17,5,6,5,71.0,12,3,5.0,5,2,17.7,2011,0.0
Griffin Shaw,8,1,8,2,2,2,43.0,7,2,3.0,1,0,14.0,2011,0.0
Jacob Lail,9,1,12,3,6,3,76.0,0,0,9.0,12,3,15.9,2011,0.0
Josh Nirenberg,16,2,18,7,5,2,64.0,0,0,7.0,18,7,21.7,2011,0.0
Ty Abbott,1330,234,1138,454,213,149,4019.0,757,273,199.0,381,181,20.3,2011,0.0
Rihards Kuksiks,1175,192,933,395,132,105,3310.0,696,280,134.0,237,115,19.4,2011,0.0
Jamelle McMillan,627,321,545,225,91,54,2713.0,330,123,153.0,215,102,15.4,2011,0.0
Brandon Dunson,158,23,134,55,48,31,150.0,52,17,12.0,82,38,18.4,2011,0.0
Jamelle Horne,829,118,687,303,169,112,2965.0,291,111,139.0,396,192,16.0,2011,0.0
Solomon Bozeman,1473,374,941,376,661,549,3578.0,470,172,288.0,471,204,26.3,2011,0.0
Alex Garcia-Mendoza,658,68,493,218,229,176,1796.0,116,46,90.0,377,172,20.2,2011,0.0
Matt Mouzy,966,107,818,336,80,67,2436.0,590,227,123.0,228,109,21.0,2011,0.0
Eric Kibi,129,19,112,48,66,33,484.0,1,0,34.0,111,48,19.4,2011,0.0
Montrell Thornton,217,19,153,85,74,47,816.0,0,0,39.0,153,85,14.6,2011,0.0
Derrick Bails,437,20,399,173,164,91,1206.0,3,0,107.0,396,173,25.1,2011,0.0
Reggie Sonnier,13,5,19,6,0,0,36.0,7,1,2.0,12,5,30.8,2011,0.0
Allen Smith,685,203,618,217,166,113,2472.0,397,138,161.0,221,79,17.2,2011,0.0
Gavin Montgomery,571,69,481,207,153,94,1693.0,159,63,148.0,322,144,18.6,2011,0.0
Ricky Parks,367,51,377,124,83,45,1231.0,250,74,95.0,127,50,20.2,2011,0.0
Dominic Moore,103,22,94,31,46,28,498.0,38,13,45.0,56,18,16.4,2011,0.0
Keith Ross,8,1,13,3,3,1,44.0,7,1,2.0,6,2,19.2,2011,0.0
Antonio Ootesey,52,14,69,15,29,12,321.0,42,10,24.0,27,5,12.3,2011,0.0
Shamus Ferguson,0,1,0,0,0,0,8.0,0,0,0.0,0,0,0.0,2011,0.0
Donald Boone,747,117,652,268,162,127,1915.0,263,84,123.0,389,184,23.0,2011,0.0
Rashad Allison,572,247,421,172,229,185,1878.0,134,43,124.0,287,129,17.8,2011,0.0
Jeremy Thomas,369,53,207,134,179,101,1384.0,1,0,67.0,206,134,13.3,2011,0.0
Daniel Bryant,523,101,473,182,110,71,1052.0,262,88,93.0,211,94,30.1,2011,0.0
Chano Rashiduddin,11,3,13,4,13,3,76.0,0,0,5.0,13,4,18.3,2011,0.0
Delvon Johnson,440,29,314,171,170,98,1612.0,0,0,77.0,314,171,14.8,2011,0.0
Marcus Britt,394,126,328,140,65,57,1841.0,155,57,81.0,173,83,11.8,2011,0.0
Jemal Farmer,241,33,200,86,75,53,742.0,43,16,52.0,157,70,19.1,2011,0.0
Jeremy Hence,690,92,523,253,210,131,1857.0,164,53,130.0,359,200,21.4,2011,0.0
Mitch McDonald,157,127,136,57,64,42,862.0,7,1,104.0,129,56,16.1,2011,0.0
Nathan Hedgecock,198,36,180,69,36,24,646.0,101,36,46.0,79,33,17.9,2011,0.0
Chris Welker,67,11,62,25,5,4,319.0,42,13,20.0,20,12,13.4,2011,0.0
Alex Godette,32,9,27,10,15,8,103.0,11,4,4.0,16,6,18.8,2011,0.0
C.J. McElrath,28,8,30,11,3,1,143.0,19,5,18.0,11,6,17.6,2011,0.0
Zach Ricketts,0,0,0,0,0,0,2.0,0,0,0.0,0,0,0.0,2011,0.0
Eric Wilde,0,0,0,0,0,0,2.0,0,0,0.0,0,0,0.0,2011,0.0
Caleb Brown,718,391,627,228,272,194,2764.0,208,68,223.0,419,160,17.7,2011,0.0
Tyrone Caldwell,401,216,276,129,147,106,1488.0,95,37,133.0,181,92,16.2,2011,0.0
Marcel Williams,283,60,213,111,124,61,1463.0,0,0,86.0,213,111,12.3,2011,0.0
Malik Perry,723,86,535,267,344,189,2921.0,1,0,204.0,534,267,16.9,2011,0.0
Maurice Hubbard,158,38,183,74,39,10,884.0,0,0,58.0,183,74,16.2,2011,0.0
Franklin Henderson,2,0,1,1,1,0,6.0,0,0,1.0,1,1,22.0,2011,0.0
Adrian Tucker,2,1,3,1,2,0,10.0,2,0,2.0,1,1,31.8,2011,0.0
LaceDarius Dunn,2285,175,1664,724,537,449,3961.0,985,388,307.0,679,336,29.7,2011,0.0
Stargell Love,52,34,61,22,6,4,287.0,19,4,34.0,42,18,17.4,2011,0.0
Nolan Dennis,90,16,72,31,42,21,336.0,27,7,31.0,45,24,18.5,2011,0.0
Levi Norwood,1,0,0,0,2,1,2.0,0,0,0.0,0,0,24.3,2011,0.0
Jordan Campbell,725,191,544,247,130,82,2292.0,373,149,140.0,171,98,15.8,2011,0.0
Jon House,732,201,554,269,269,160,2669.0,107,34,178.0,447,235,14.8,2011,0.0
Alexander Starling,925,79,698,332,369,250,2998.0,51,11,180.0,647,321,19.1,2011,0.0
Albert Abrahams,379,26,304,157,114,65,914.0,0,0,64.0,304,157,25.0,2011,0.0
Aric Miller,154,35,129,56,66,35,662.0,23,7,44.0,106,49,16.7,2011,0.0
Dion Hudson,0,2,1,0,0,0,6.0,0,0,0.0,1,0,9.0,2011,0.0
Moussa Camara,814,60,707,261,193,143,2449.0,428,149,115.0,279,112,20.5,2011,0.0
Greer Wright,800,185,611,258,284,209,1801.0,237,75,213.0,374,183,29.0,2011,0.0
Mahamoud Jabbi,500,54,425,204,80,59,1927.0,89,33,61.0,336,171,14.9,2011,0.0
Chretien Lukusa,640,170,635,227,227,130,3065.0,215,56,177.0,420,171,16.5,2011,0.0
Preston Pena,3,0,5,1,1,1,19.0,1,0,1.0,4,1,18.7,2011,0.0
La'Shard Anderson,1022,367,865,343,341,258,2885.0,266,78,249.0,599,265,22.0,2011,0.0
Robert Arnold,796,102,632,270,237,164,1819.0,281,92,126.0,351,178,23.7,2011,0.0
Daequon Montreal,702,68,548,261,234,167,1712.0,49,13,89.0,499,248,21.6,2011,0.0
Paul Noonan,1092,192,807,342,234,197,2886.0,562,211,168.0,245,131,18.5,2011,0.0
Zack Moritz,252,21,206,104,81,44,760.0,0,0,43.0,206,104,19.0,2011,0.0
Sean Imadiyi,138,12,113,59,46,20,542.0,0,0,35.0,113,59,15.7,2011,0.0
Sam Hicks,9,1,4,4,2,1,14.0,0,0,1.0,4,4,21.5,2011,0.0
Justin Salzwedel,40,3,36,12,4,4,133.0,32,12,3.0,4,0,15.1,2011,0.0
G.A. Hill,0,2,0,0,2,0,10.0,0,0,0.0,0,0,4.8,2011,0.0
Reggie Jackson,1254,350,979,455,296,223,2775.0,345,121,203.0,634,334,24.8,2011,1.0
Joe Trapani,1679,171,1357,587,422,314,3465.0,523,191,220.0,834,396,25.9,2011,0.0
Corey Raji,1312,162,991,518,350,227,3228.0,161,49,122.0,830,469,20.3,2011,0.0
Biko Paris,783,391,633,260,211,151,2961.0,301,112,242.0,332,148,17.0,2011,0.0
Josh Southern,670,113,474,247,260,176,2189.0,0,0,127.0,474,247,16.9,2011,0.0
Dallas Elmore,232,45,187,78,82,63,1075.0,52,13,66.0,135,65,14.1,2011,0.0
Cortney Dunn,82,17,70,31,41,20,890.0,0,0,30.0,70,31,6.9,2011,0.0
Chris Kowalski,2,0,9,1,4,0,41.0,4,0,1.0,5,1,15.8,2011,0.0
Nick Mosakowski,5,2,20,2,0,0,38.0,8,1,2.0,12,1,30.1,2011,0.0
John Holland,2212,154,1667,723,633,511,4195.0,718,255,249.0,949,468,29.2,2011,1.0
Henry Gaskins,0,0,2,0,0,0,2.0,2,0,0.0,0,0,53.8,2011,0.0
Danny McElroy,197,11,216,89,37,18,799.0,17,1,71.0,199,88,19.9,2011,0.0
Joe Jakubowski,846,381,690,281,213,154,3418.0,337,130,241.0,353,151,16.2,2011,0.0
Mike Dabney,45,0,28,15,26,15,151.0,0,0,10.0,28,15,17.3,2011,0.0
Wiley Roberts,3,0,4,1,2,0,5.0,1,1,0.0,3,0,51.4,2011,0.0
Andrew Warren,1621,177,1228,514,436,368,3666.0,560,225,186.0,668,289,26.0,2011,0.0
Dodie Dunson,853,152,703,291,239,163,2706.0,317,108,130.0,386,183,19.1,2011,0.0
Aaron Ganson,0,0,1,0,0,0,2.0,1,0,0.0,0,0,26.6,2011,0.0
Jimmer Fredette,2599,515,1843,838,711,627,4119.0,752,296,350.0,1091,542,30.5,2011,1.0
Jackson Emery,1235,312,899,409,242,187,3434.0,601,230,132.0,298,179,16.5,2011,0.0
Logan Magnusson,89,28,77,33,24,13,497.0,28,10,21.0,49,23,10.7,2011,0.0
James Anderson,137,14,123,57,59,23,548.0,0,0,18.0,123,57,15.4,2011,1.0
Peter Sullivan,1361,162,963,412,504,395,3373.0,413,142,203.0,550,270,22.6,2011,0.0
Garrett Leffelman,535,63,445,193,92,74,1693.0,200,75,55.0,245,118,17.0,2011,0.0
Adrian Williams,814,127,659,254,191,146,2793.0,451,160,149.0,208,94,17.5,2011,0.0
Christopher Taylor,118,56,121,50,43,18,815.0,1,0,49.0,120,50,12.7,2011,0.0
Cecil Gresham,891,72,722,303,175,135,2068.0,384,150,101.0,338,153,24.0,2011,0.0
Matthew Lee,192,27,203,70,16,12,404.0,125,40,35.0,78,30,31.5,2011,0.0
Barry Latham,355,130,351,128,135,78,1958.0,86,21,106.0,265,107,13.3,2011,0.0
Papa Lo,58,15,66,28,10,2,548.0,0,0,29.0,66,28,9.6,2011,0.0
Michael Chroney,106,36,94,38,42,24,632.0,22,6,58.0,72,32,14.6,2011,0.0
G.W. Boon,940,88,813,311,206,158,2545.0,451,160,151.0,362,151,21.9,2011,0.0
Darryl Shazier,927,498,822,313,250,180,3889.0,361,121,220.0,461,192,15.7,2011,0.0
Stephen Tyree,433,161,268,145,199,127,1968.0,44,16,130.0,224,129,13.5,2011,0.0
Byron Mulkey,767,278,642,257,216,167,2172.0,241,86,180.0,401,171,21.1,2011,0.0
Jawaan Alston,438,83,331,183,156,72,1833.0,1,0,131.0,330,183,15.0,2011,0.0
Mike Clifford,33,2,24,14,9,5,71.0,0,0,5.0,24,14,23.4,2011,0.0
Shelvin Mack,1527,357,1228,515,372,281,3374.0,605,216,239.0,623,299,26.3,2011,1.0
Shawn Vanzant,546,154,446,177,175,125,2292.0,195,67,108.0,251,110,15.7,2011,0.0
Zach Hahn,590,127,514,193,58,50,1974.0,407,154,104.0,107,39,18.1,2011,0.0
Grant Leiendecker,80,14,86,24,15,12,267.0,74,20,18.0,12,4,23.7,2011,0.0
Alex Anglin,14,6,13,5,3,2,121.0,4,2,4.0,9,3,7.6,2011,0.0
Shawn Lewis,1283,188,1081,421,412,298,3012.0,430,143,243.0,651,278,28.0,2011,0.0
Ben Eisenhardt,11,2,12,3,7,4,82.0,7,1,0.0,5,2,10.3,2011,0.0
Ben Kelly,3,0,8,1,0,0,33.0,7,1,3.0,1,0,18.4,2011,0.0
Ryan Pembleton,2,0,2,0,4,2,70.0,0,0,1.0,2,0,3.9,2011,0.0
Donavan Bragg,1084,316,918,332,401,317,3329.0,316,103,288.0,602,229,20.5,2011,0.0
Reynaul Baker,102,41,95,39,36,23,479.0,4,1,23.0,91,38,13.7,2011,0.0
Cory Brown,309,25,273,117,94,70,1520.0,21,5,67.0,252,112,9.6,2011,0.0
James Albright,122,16,123,45,44,17,403.0,49,15,30.0,74,30,20.9,2011,0.0
De'Aundray Robinson,49,7,65,21,11,5,259.0,11,2,17.0,54,19,16.4,2011,0.0
Cody Kale,18,4,11,6,6,3,92.0,4,3,4.0,7,3,9.4,2011,0.0
Lance Bailey,0,1,1,0,0,0,1.0,0,0,0.0,1,0,48.6,2011,0.0
Devon Peltier,762,54,562,243,147,128,1678.0,358,148,79.0,204,95,21.5,2011,0.0
Jer'Vaughn Johnson,834,75,615,314,292,195,2134.0,50,11,170.0,565,303,21.9,2011,0.0
Roger Guardia,44,7,42,16,2,2,211.0,31,10,12.0,11,6,13.2,2011,0.0
Steve Jurich,44,6,42,15,18,7,219.0,25,7,12.0,17,8,14.5,2011,0.0
Lenny Daniel,863,36,583,308,424,247,1673.0,0,0,138.0,583,308,26.4,2011,0.0
Rashaun McLemore,689,82,549,235,255,166,1589.0,187,53,142.0,362,182,26.0,2011,0.0
Dathan Lyles,212,131,220,72,57,42,942.0,98,26,85.0,122,46,17.0,2011,0.0
Raymond Cody,330,62,302,110,95,74,1181.0,119,36,76.0,183,74,17.1,2011,0.0
Bryce Smith,17,1,15,5,2,2,44.0,14,5,0.0,1,0,27.8,2011,0.0
Aaron Henson,9,0,17,3,4,3,39.0,3,0,0.0,14,3,23.6,2011,0.0
Joe Harden,1345,159,1014,443,542,416,2898.0,161,43,232.0,853,400,27.1,2011,0.0
Mark Payne,1379,448,823,453,527,422,3718.0,151,51,262.0,672,402,19.6,2011,0.0
Todd Lowenthal,199,148,155,70,76,50,1698.0,21,9,79.0,134,61,8.1,2011,0.0
Darren Moore,936,125,622,291,358,267,2132.0,236,87,132.0,386,204,21.9,2011,0.0
Patrick Rembert,847,300,680,258,321,245,3007.0,242,86,177.0,438,172,17.4,2011,0.0
Pavol Losonsky,297,30,274,121,56,39,905.0,49,16,62.0,225,105,20.2,2011,0.0
Derrick Strings,342,40,324,119,39,32,978.0,193,72,42.0,131,47,20.7,2011,0.0
Peter Simek,102,5,103,43,32,16,434.0,3,0,22.0,100,43,16.2,2011,0.0
Emil Kim,77,18,67,28,30,19,444.0,7,2,29.0,60,26,12.6,2011,0.0
Jonas Lalehzadeh,30,8,31,11,7,4,122.0,12,4,6.0,19,7,17.2,2011,0.0
Javon Borum,683,157,552,214,175,142,1874.0,288,113,131.0,264,101,22.1,2011,0.0
Tyquan Brown,92,13,77,39,37,14,441.0,0,0,33.0,77,39,14.7,2011,0.0
Delonte Taylor,67,6,79,28,10,3,243.0,34,8,10.0,45,20,19.7,2011,0.0
Andy Saharan,14,1,23,5,1,0,100.0,16,4,2.0,7,1,13.0,2011,0.0
Jordan Weiner,405,101,330,129,59,44,1465.0,274,103,67.0,56,26,15.1,2011,0.0
Jon Pastorek,290,80,222,109,70,51,1343.0,55,21,95.0,167,88,13.8,2011,0.0
Justin Joyner,378,357,344,127,112,59,2804.0,198,65,180.0,146,62,9.3,2011,0.0
Will Brew,360,169,332,119,129,76,1875.0,155,46,162.0,177,73,15.6,2011,0.0
Troy Leaf,65,14,67,22,17,13,269.0,28,8,20.0,39,14,19.2,2011,0.0
Seth Kamphoefner,0,0,1,0,0,0,8.0,0,0,1.0,1,0,13.3,2011,0.0
Tony Williams,0,0,0,0,0,0,2.0,0,0,0.0,0,0,0.0,2011,0.0
Markhuri Sanders-Frison,429,52,306,175,129,77,1250.0,3,2,66.0,303,173,17.7,2011,0.0
Nigel Carter,56,4,50,19,22,10,237.0,24,8,11.0,26,11,15.4,2011,0.0
Junard Hartley,792,600,634,261,331,227,3536.0,140,43,342.0,494,218,16.7,2011,0.0
Preston Dodson,679,75,493,244,295,191,2175.0,1,0,120.0,492,244,16.8,2011,0.0
Martell Jackson,120,9,98,50,39,20,362.0,0,0,29.0,98,50,20.8,2011,0.0
Keishawn Mayes,311,33,291,115,112,66,1017.0,46,15,82.0,245,100,22.0,2011,0.0
Cole Dewey,22,3,23,7,10,6,83.0,14,2,7.0,9,5,22.2,2011,0.0
Anthony Dees,8,2,20,2,2,2,87.0,16,2,1.0,4,0,13.1,2011,0.0
Larry Awosanya,17,1,25,8,5,1,121.0,1,0,8.0,24,8,15.0,2011,0.0
Elton Frazier,1023,88,918,405,262,170,2885.0,176,43,181.0,742,362,21.3,2011,0.0
Greg Logins,1269,69,1053,477,235,179,2858.0,356,136,209.0,697,341,24.1,2011,0.0
Julius Coles,1212,173,1089,415,347,230,3206.0,448,152,242.0,641,263,23.4,2011,0.0
Robert Goldsberry,364,289,281,104,120,90,2235.0,196,66,187.0,85,38,11.8,2011,0.0
Tomas Vazquez-Simmons,657,90,525,238,179,120,3172.0,179,61,133.0,346,177,11.8,2011,0.0
Ashton Khan,15,8,12,5,8,5,58.0,1,0,6.0,11,5,18.9,2011,0.0
Rokas Gricius,36,0,24,10,17,10,107.0,14,6,3.0,10,4,16.7,2011,0.0
Maxx Nakwaasah,705,79,619,237,225,163,2106.0,233,68,154.0,386,169,22.7,2011,0.0
Jonathan Blount,197,21,156,63,73,54,583.0,52,17,42.0,104,46,20.0,2011,0.0
Leo Davis,214,71,208,72,42,26,887.0,122,44,79.0,86,28,17.3,2011,0.0
Travis Sims,126,33,134,42,43,25,579.0,61,17,59.0,73,25,18.4,2011,0.0
Roman Tubner,364,114,316,109,179,122,1341.0,96,24,133.0,220,85,21.2,2011,0.0
Andrew Rebol,74,10,57,23,41,28,334.0,1,0,26.0,56,23,15.4,2011,0.0
Baba Diallo,58,8,52,21,27,15,317.0,10,1,22.0,42,20,13.8,2011,0.0
Matt Nichenko,11,2,10,4,7,3,88.0,1,0,9.0,9,4,12.7,2011,0.0
Jeff Latin,6,1,3,1,8,4,20.0,0,0,4.0,3,1,27.1,2011,0.0
Brandon Joseph,4,1,2,1,2,2,19.0,1,0,1.0,1,1,10.4,2011,0.0
Patrick Elledge,0,0,0,0,0,0,0.0,0,0,1.0,0,0,0,2011,0.0
Imad Quhwash,663,166,458,188,372,250,1826.0,126,37,204.0,332,151,24.4,2011,0.0
Mike Pouncy,453,84,392,171,136,89,1148.0,71,22,81.0,321,149,22.5,2011,0.0
Tadre Sheppard,557,29,354,190,275,170,1503.0,18,7,75.0,336,183,18.7,2011,0.0
Carlos Dos Santos,295,37,255,119,106,57,1098.0,0,0,62.0,255,119,16.7,2011,0.0
T.K. Smith,104,17,113,35,11,10,359.0,88,24,19.0,25,11,18.7,2011,0.0
Jacquan McClinton,34,14,22,10,27,14,186.0,1,0,11.0,21,10,11.7,2011,0.0
Jeff Jackson,10,4,15,2,6,5,61.0,6,1,5.0,9,1,17.8,2011,0.0
Shemik Thompson,1327,483,1204,480,378,284,3838.0,288,83,347.0,916,397,24.9,2011,0.0
Chris Baskerville,224,21,159,89,80,46,768.0,0,0,48.0,159,89,16.5,2011,0.0
Markeys Deans,367,39,290,138,105,75,1026.0,48,16,53.0,242,122,20.2,2011,0.0
Vince Rosario,268,35,260,87,44,30,890.0,218,64,42.0,42,23,19.1,2011,0.0
Devan Bailey,159,153,187,65,34,20,1522.0,39,9,101.0,148,56,10.4,2011,0.0
Justin Alexander,4,1,3,1,2,2,20.0,0,0,1.0,3,1,12.4,2011,0.0
Tom Herzog,208,6,152,84,63,40,619.0,0,0,34.0,152,84,18.2,2011,0.0
A.J. Tyler,706,59,581,269,163,125,2089.0,144,43,100.0,437,226,18.9,2011,0.0
Dave Diakite,245,27,200,80,128,78,833.0,28,7,70.0,172,73,20.7,2011,0.0
Taylor Young,375,240,312,116,126,97,1742.0,152,46,105.0,160,70,14.1,2011,0.0
Dogukan Kuzucan,6,0,5,2,5,2,22.0,2,0,3.0,3,2,24.7,2011,0.0
Jalin Thomas,661,26,534,206,231,178,1676.0,210,71,84.0,324,135,22.6,2011,0.0
William McClure,197,25,191,76,95,45,1275.0,0,0,70.0,191,76,12.5,2011,0.0
Antonio Weary,324,102,274,115,142,78,1760.0,60,16,125.0,214,99,13.8,2011,0.0
Amir Rashid,219,104,251,75,94,58,1073.0,51,11,87.0,200,64,18.6,2011,0.0
Paris Paramore,8,4,10,3,0,0,51.0,5,2,4.0,5,1,14.3,2011,0.0
Nate VanArendonk,0,0,0,0,0,0,12.0,0,0,2.0,0,0,8.7,2011,0.0
Jamarco Warren,1968,336,1635,660,391,311,3915.0,917,337,321.0,718,323,26.5,2011,0.0
Kenny Mitchell,532,43,416,212,159,108,1308.0,8,0,95.0,408,212,22.0,2011,0.0
Johathan Brooks,221,35,208,95,38,30,718.0,1,1,44.0,207,94,18.3,2011,0.0
Zimmy Nwogbo,139,20,114,48,63,42,575.0,4,1,41.0,110,47,15.8,2011,0.0
Troy Pierce,49,7,36,17,22,15,275.0,0,0,11.0,36,17,10.2,2011,0.0
Joel Lamb,274,40,287,113,44,25,1056.0,71,23,59.0,216,90,15.5,2011,0.0
Stanley Honorat,37,13,48,14,4,2,184.0,25,7,12.0,23,7,16.5,2011,0.0
An'Juan Wilderness,795,146,604,300,326,179,2829.0,71,16,186.0,533,284,16.7,2011,0.0
Phil Jones,611,54,519,225,225,157,1901.0,22,4,88.0,497,221,18.7,2011,0.0
Gokhan Sirin,160,9,136,52,16,11,461.0,109,45,25.0,27,7,18.6,2011,0.0
Shamari Spears,1054,81,780,381,372,279,2448.0,38,13,172.0,742,368,22.9,2011,0.0
Charles Dewhurst,314,129,234,86,179,137,1614.0,16,5,125.0,218,81,13.5,2011,0.0
Ray Morgenstern,1,1,0,0,2,1,8.0,0,0,1.0,0,0,12.9,2011,0.0
DeAntre Jefferson,482,36,282,176,230,130,1277.0,1,0,115.0,281,176,19.2,2011,0.0
Troy Cage,174,35,177,58,58,37,531.0,77,21,51.0,100,37,23.5,2011,0.0
Jeremy Saffore,385,28,290,160,126,65,1409.0,1,0,88.0,289,160,14.9,2011,0.0
Josh Odem,295,68,235,96,69,56,889.0,131,47,65.0,104,49,18.1,2011,0.0
Carl Montgomery,1539,84,1135,601,581,333,3166.0,22,4,250.0,1113,597,24.5,2011,0.0
Jon Montgomery,531,96,546,178,111,83,1696.0,320,92,105.0,226,86,20.2,2011,0.0
Antonio Lofton,591,88,411,160,359,255,1725.0,58,16,187.0,353,144,21.0,2011,0.0
Hajji Martin,368,24,385,151,109,60,1514.0,35,6,61.0,350,145,15.3,2011,0.0
Victor Scott,323,69,330,110,60,34,1338.0,233,69,82.0,97,41,15.5,2011,0.0
Christian Wall,819,196,733,281,240,166,2498.0,292,91,175.0,441,190,19.3,2011,0.0
Jamill Harris,85,40,102,29,31,24,316.0,23,3,33.0,79,26,22.0,2011,0.0
Sean Montgomery,44,4,43,18,13,7,119.0,8,1,16.0,35,17,25.5,2011,0.0
Archie Seals,40,11,37,16,12,5,289.0,11,3,20.0,26,13,10.1,2011,0.0
Steve Martin,53,93,73,18,20,10,806.0,25,7,89.0,48,11,9.9,2011,0.0
Pawel Kielbasa,66,3,84,27,18,12,443.0,0,0,32.0,84,27,13.1,2011,0.0
Rashad Bishop,890,239,772,334,183,123,3291.0,306,99,163.0,466,235,17.2,2011,0.0
Ibrahima Thomas,619,39,502,234,228,127,1894.0,100,24,99.0,402,210,19.0,2011,0.0
Darnell Wilks,321,75,260,121,85,46,1194.0,94,33,88.0,166,88,16.6,2011,0.0
Anthony McClain,196,13,153,76,86,44,687.0,0,0,37.0,153,76,13.5,2011,0.0
Eddie Tyree,4,0,4,2,1,0,18.0,0,0,2.0,4,2,18.5,2011,0.0
Anthony McBride,0,1,2,0,0,0,12.0,1,0,0.0,1,0,8.7,2011,0.0
Cameron Wells,2049,485,1754,753,565,454,4463.0,314,89,307.0,1440,664,30.0,2011,0.0
Zach Urbanus,1321,353,1119,440,189,146,4529.0,705,295,229.0,414,145,17.5,2011,0.0
Austin Dahn,1125,176,1045,387,140,108,3607.0,682,243,233.0,363,144,19.2,2011,0.0
Bryan Streeter,585,74,496,245,212,94,2469.0,14,1,110.0,482,244,16.1,2011,0.0
Daniel Eykyn,250,42,212,79,75,59,1337.0,102,33,53.0,110,46,13.9,2011,0.0
Matt Clark,248,32,218,94,65,37,1198.0,75,23,57.0,143,71,12.0,2011,0.0
Morakinyo Williams,74,7,82,31,22,12,363.0,0,0,28.0,82,31,16.8,2011,0.0
Mike Dejworek,113,15,81,41,53,31,448.0,3,0,26.0,78,41,13.1,2011,0.0
John Reynolds,7,2,9,3,4,0,33.0,2,1,4.0,7,2,34.9,2011,0.0
Phillip Pandak,113,12,117,39,8,5,348.0,99,30,7.0,18,9,27.3,2011,0.0
Demontez Stitt,1365,419,1061,455,468,344,3513.0,335,111,318.0,726,344,22.0,2011,0.0
Jerai Grant,856,72,555,326,321,204,2269.0,0,0,129.0,555,326,18.7,2011,0.0
Cory Stanton,80,25,84,29,21,14,351.0,38,8,21.0,46,21,17.2,2011,0.0
Zavier Anderson,47,44,40,17,25,10,350.0,6,3,46.0,34,14,14.1,2011,0.0
Jonah Baize,6,2,5,2,0,0,40.0,2,2,6.0,3,0,12.9,2011,0.0
DeAndre Hopkins,0,1,2,0,0,0,10.0,0,0,2.0,2,0,21.0,2011,0.0
Norris Cole,1978,455,1555,677,587,485,4114.0,433,139,283.0,1122,538,26.8,2011,1.0
Josh McCoy,185,30,136,50,72,58,678.0,81,27,34.0,55,23,15.6,2011,0.0
Charlie Woods,118,18,114,40,20,14,519.0,72,24,16.0,42,16,14.0,2011,0.0
Darius Ware,5,0,3,1,4,3,17.0,0,0,3.0,3,1,24.1,2011,0.0
Keith Mackie,0,0,3,0,0,0,18.0,2,0,2.0,1,0,14.4,2011,0.0
Anthony Wells,34,16,31,15,6,3,289.0,3,1,13.0,28,14,8.5,2011,0.0
Chad Gray,1057,77,838,421,290,179,2054.0,120,36,146.0,718,385,27.8,2011,0.0
Desmond Holloway,480,45,323,162,173,132,832.0,68,24,63.0,255,138,28.1,2011,0.0
Mike Holmes,754,37,635,314,238,124,1764.0,4,2,82.0,631,312,23.9,2011,0.0
Joe Hoban,482,191,395,159,170,107,1778.0,174,57,162.0,221,102,18.6,2011,0.0
Andrew Goudelock,2571,424,2092,956,314,263,4588.0,958,396,311.0,1134,560,28.2,2011,1.0
Donavan Monroe,1382,262,1076,486,372,277,3653.0,375,133,221.0,701,353,20.5,2011,0.0
Jeremy Simmons,1029,107,701,415,309,198,2851.0,6,1,141.0,695,414,17.6,2011,0.0
Jordan Turok,9,1,15,3,0,0,41.0,11,3,3.0,4,0,22.3,2011,0.0
Garrett Campbell,4,0,6,2,0,0,51.0,2,0,2.0,4,2,7.9,2011,0.0
Andy Ogide,1241,71,889,489,378,253,2523.0,31,10,216.0,858,479,26.9,2011,0.0
Travis Franklin,895,116,536,275,565,345,2091.0,0,0,194.0,536,275,25.5,2011,0.0
Adam Nigon,644,163,523,220,117,80,2599.0,320,124,163.0,203,96,17.1,2011,0.0
Andre McFarland,726,77,615,245,118,92,2389.0,363,144,104.0,252,101,19.0,2011,0.0
Alec Burks,1291,165,855,423,495,398,2100.0,150,47,157.0,705,376,30.0,2011,1.0
Cory Higgins,2001,320,1397,653,691,570,4478.0,360,125,305.0,1037,528,24.2,2011,1.0
Levi Knutson,787,122,601,274,131,110,2371.0,328,129,90.0,273,145,16.8,2011,0.0
Marcus Relphorde,778,145,647,272,217,159,1969.0,207,75,156.0,440,197,23.5,2011,0.0
Javon Coney,52,12,57,19,14,8,370.0,29,6,11.0,28,13,11.1,2011,0.0
Trent Beckley,10,1,11,4,3,2,74.0,0,0,6.0,11,4,12.4,2011,0.0
Asenso Ampim,559,63,531,211,201,129,1648.0,36,8,142.0,495,203,24.1,2011,0.0
Max Craig,247,11,213,97,100,53,898.0,0,0,78.0,213,97,20.5,2011,0.0
Brian Grimes,369,52,376,136,151,97,1172.0,14,0,88.0,362,136,23.8,2011,0.0
Zack Crimmins,152,11,162,65,43,22,583.0,1,0,33.0,161,65,19.2,2011,0.0
Kemba Walker,1783,460,1350,578,640,501,3647.0,387,126,258.0,963,452,26.2,2011,1.0
Jamal Coombs-McDaniel,341,41,297,113,101,75,1061.0,143,40,45.0,154,73,18.5,2011,0.0
Charles Okwandu,153,26,148,70,30,13,907.0,0,0,59.0,148,70,12.3,2011,0.0
Donnell Beverly,156,110,131,53,49,36,820.0,31,14,69.0,100,39,13.6,2011,0.0
Vincent Goldsberry,852,285,733,296,305,241,3113.0,97,19,209.0,636,277,17.8,2011,0.0
Ceslovas Kucinskas,418,22,348,165,117,77,1685.0,35,11,78.0,313,154,15.0,2011,0.0
Branden Doughty,291,31,260,122,64,43,1194.0,11,4,63.0,249,118,15.0,2011,0.0
Osman Olol,5,1,8,2,2,1,26.0,1,0,3.0,7,2,22.7,2011,0.0
Mark Coury,295,67,255,126,72,43,1208.0,1,0,51.0,254,126,15.0,2011,0.0
Aaron Osgood,122,18,93,47,54,27,377.0,2,1,28.0,91,46,20.8,2011,0.0
Adam Wire,263,102,179,92,107,71,1417.0,21,8,85.0,158,84,11.4,2011,0.0
Manny Sahota,9,3,14,4,1,0,54.0,6,1,6.0,8,3,19.8,2011,0.0
Kenny Lawson Jr,1313,73,983,507,345,260,2799.0,103,39,159.0,880,468,24.5,2011,0.0
Darryl Ashford,418,96,341,145,113,76,1432.0,155,52,66.0,186,93,17.2,2011,0.0
Kaleb Korver,419,165,356,138,43,27,2277.0,297,116,105.0,59,22,11.2,2011,0.0
Wayne Runnels,262,48,191,97,96,65,892.0,8,3,60.0,183,94,17.8,2011,0.0
Casey Harriman,336,58,262,103,90,62,1476.0,191,68,53.0,71,35,12.6,2011,0.0
Clive Weeden,388,66,358,149,164,89,1862.0,4,1,102.0,354,148,16.1,2011,0.0
Gediminas Bertasius,138,15,126,47,59,40,531.0,24,4,48.0,102,43,20.1,2011,0.0
Ronnie Dixon,588,123,528,220,113,86,1765.0,183,62,128.0,345,158,22.9,2011,0.0
Mbiyimoh Ghogomu,70,16,85,29,30,12,538.0,6,0,30.0,79,29,12.9,2011,0.0
Kevin Mulquin,16,1,17,8,1,0,59.0,0,0,3.0,17,8,18.4,2011,0.0
James Herring,13,1,17,5,0,0,52.0,8,3,3.0,9,2,20.4,2011,0.0
Jenieri Cyrus,4,0,6,2,2,0,13.0,1,0,0.0,5,2,28.3,2011,0.0
Brendan Mckillop,831,254,715,271,98,73,2695.0,578,216,119.0,137,55,16.2,2011,0.0
Ben Allison,388,46,299,126,224,130,1285.0,33,6,117.0,266,120,20.0,2011,0.0
Devin Searcy,389,39,304,155,122,79,1604.0,0,0,87.0,304,155,14.2,2011,0.0
Logan Nourse,1,3,7,0,2,1,20.0,5,0,2.0,2,0,25.7,2011,0.0
Peter Zestermann,5,0,10,2,4,1,22.0,0,0,2.0,10,2,32.1,2011,0.0
Terron Stowe,206,9,158,76,86,53,642.0,1,1,41.0,157,75,21.3,2011,0.0
Trevor Welcher,478,206,410,172,138,102,2603.0,124,32,128.0,286,140,13.7,2011,0.0
Chad Wilson,218,35,225,75,26,15,963.0,165,53,43.0,60,22,16.6,2011,0.0
Alibaba Odd,112,13,85,37,38,30,292.0,17,8,23.0,68,29,24.6,2011,0.0
Brandon Baylor,64,9,65,24,6,4,321.0,35,12,11.0,30,12,14.0,2011,0.0
Justin May,3,0,8,1,0,0,25.0,4,1,2.0,4,0,22.8,2011,0.0
Christian Hurrington,2,0,3,1,0,0,23.0,0,0,1.0,3,1,9.9,2011,0.0
Jawan Carter,1784,382,1314,509,632,508,4260.0,741,258,306.0,573,251,25.4,2011,0.0
Alphonso Dawson,1307,136,1334,497,218,157,3483.0,542,156,196.0,792,341,23.8,2011,0.0
Brian Johnson,1017,510,811,327,322,228,3978.0,374,135,266.0,437,192,15.3,2011,0.0
D.J. Boney,532,101,464,156,167,127,2465.0,304,93,102.0,160,63,13.4,2011,0.0
Kaleb Clyburn,13,7,13,4,6,5,104.0,8,0,4.0,5,4,10.5,2011,0.0
Edwin Santiago,315,58,334,111,92,60,1208.0,133,33,103.0,201,78,21.5,2011,0.0
Billy Kidd,0,1,1,0,0,0,1.0,0,0,0.0,1,0,55.2,2011,0.0
Trevor Noonan,165,65,164,58,38,25,659.0,80,24,56.0,84,34,22.4,2011,0.0
Andrew Hooper,622,90,443,208,91,65,1671.0,320,141,97.0,123,67,23.4,2011,0.0
Kyle Lewis,609,159,494,203,137,107,2830.0,265,96,119.0,229,107,13.6,2011,0.0
Jimmy Drew,352,112,318,114,61,44,1350.0,232,80,75.0,86,34,15.0,2011,0.0
Mike Stovall,361,89,363,129,98,74,1123.0,118,29,91.0,245,100,23.2,2011,0.0
Devin Hill,272,31,310,110,83,31,1169.0,95,21,50.0,215,89,17.7,2011,0.0
Mario Stula,121,13,142,42,13,10,640.0,93,27,17.0,49,15,13.3,2011,0.0
John Hoskins,29,1,31,7,33,15,206.0,0,0,14.0,31,7,14.5,2011,0.0
Connor Clark,0,0,6,0,0,0,16.0,4,0,2.0,2,0,24.3,2011,0.0
Ryan Wedel,1512,254,1167,492,259,216,3857.0,793,312,191.0,374,180,21.5,2011,0.0
Frank Wiseler,180,108,159,58,51,39,891.0,68,25,65.0,91,33,15.8,2011,0.0
Gerald Colds,1049,262,1081,352,394,222,3371.0,441,123,221.0,640,229,22.7,2011,0.0
Yannick Formbor,81,14,57,30,34,21,468.0,0,0,22.0,57,30,9.8,2011,0.0
Ronald Colbert,3,3,6,1,1,1,17.0,3,0,4.0,3,1,31.8,2011,0.0
Nolan Smith,1911,406,1490,667,514,411,3842.0,451,166,292.0,1039,501,25.6,2011,1.0
Kyle Singler,2392,293,1879,814,643,497,4887.0,736,267,316.0,1143,547,24.7,2011,1.0
Kyrie Irving,192,47,104,55,71,64,303.0,39,18,27.0,65,37,26.4,2011,1.0
Casey Peters,0,0,0,0,0,0,25.0,0,0,1.0,0,0,2.0,2011,0.0
Damian Saunders,1511,281,1184,599,421,209,4073.0,342,104,251.0,842,495,19.3,2011,0.0
Rodrigo Peggau,88,7,73,32,44,22,381.0,13,2,31.0,60,30,15.9,2011,0.0
David Theis,102,13,99,34,36,23,445.0,44,11,36.0,55,23,16.4,2011,0.0
Jontae Sherrod,973,160,753,303,310,236,2357.0,366,131,215.0,387,172,25.2,2011,0.0
Jamar Abrams,1110,80,859,394,192,147,3043.0,450,175,171.0,409,219,19.2,2011,0.0
Brock Young,1232,612,955,354,532,430,3290.0,306,94,375.0,649,260,26.1,2011,0.0
Chad Wynn,563,23,432,232,158,99,1665.0,0,0,130.0,432,232,20.1,2011,0.0
Wakefield Ellison,70,13,80,24,20,13,371.0,36,9,20.0,44,15,15.3,2011,0.0
Evan Salzano,12,2,12,5,2,2,19.0,2,0,3.0,10,5,43.1,2011,0.0
Micah Williams,1180,99,922,399,347,253,2845.0,374,129,163.0,548,270,23.0,2011,0.0
Justin Tubbs,916,47,751,303,192,128,2417.0,526,182,115.0,225,121,20.9,2011,0.0
Curtis Wilkinson,53,4,27,20,28,13,225.0,0,0,11.0,27,20,11.8,2011,0.0
De'Shaud Johnson,27,14,25,10,6,5,158.0,6,2,10.0,19,8,12.1,2011,0.0
Curry McKinney,419,127,421,155,89,59,1463.0,156,50,101.0,265,105,20.7,2011,0.0
Shaun Pratl,418,71,316,161,143,91,995.0,16,5,71.0,300,156,24.5,2011,0.0
Tyler Laser,1087,228,858,370,209,182,2881.0,441,165,204.0,417,205,21.8,2011,0.0
Isaac Smith,54,22,42,15,27,23,334.0,5,1,24.0,37,14,12.8,2011,0.0
Matt Dorlack,83,20,62,31,49,21,688.0,0,0,48.0,62,31,10.8,2011,0.0
Levi Noel,19,3,23,5,10,7,148.0,6,2,10.0,17,3,13.8,2011,0.0
Spencer Perrin,646,142,494,254,164,113,1723.0,76,25,89.0,418,229,21.8,2011,0.0
Justin Stommes,1277,300,908,430,272,207,3521.0,504,210,207.0,404,220,20.0,2011,0.0
Willie Cruz,256,80,193,96,93,62,934.0,9,2,52.0,184,94,17.6,2011,0.0
Devin McDonald,317,70,266,102,82,61,1099.0,138,52,98.0,128,50,19.9,2011,0.0
Brandon Bowdry,1856,171,1474,668,694,458,3648.0,200,62,392.0,1274,606,30.6,2011,0.0
Jay Higgins,403,133,397,130,122,56,1848.0,283,87,102.0,114,43,15.5,2011,0.0
Adrian Burton,70,32,78,25,29,15,264.0,22,5,25.0,56,20,22.7,2011,0.0
Kenny Stewart,44,2,45,19,8,5,183.0,7,1,12.0,38,18,17.0,2011,0.0
William Cooper,248,85,242,102,74,35,1680.0,29,9,116.0,213,93,10.8,2011,0.0
Jake Fosdick,0,0,1,0,2,0,7.0,1,0,0.0,0,0,14.3,2011,0.0
Rashano McRae,21,6,19,6,23,9,175.0,0,0,11.0,19,6,11.9,2011,0.0
Morgan Hyslop,4,2,3,2,0,0,20.0,1,0,1.0,2,2,10.1,2011,0.0
Chris Long,1234,528,983,372,409,318,3694.0,501,172,237.0,482,200,19.6,2011,0.0
Terrance Birdette,385,92,325,133,109,71,1518.0,140,48,119.0,185,85,16.5,2011,0.0
Scott Grable,362,71,249,132,157,98,1540.0,2,0,97.0,247,132,13.8,2011,0.0
Daniel Watts,40,5,44,17,11,6,252.0,0,0,15.0,44,17,12.9,2011,0.0
Gary Pope,4,2,3,2,0,0,9.0,0,0,0.0,3,2,16.5,2011,0.0
David Meyer,2,0,3,1,0,0,10.0,0,0,0.0,3,1,15.0,2011,0.0
Clint Hopf,493,22,332,170,211,152,1580.0,2,1,82.0,330,169,17.5,2011,0.0
Pieter van Tongeren,596,27,449,248,177,100,2078.0,0,0,110.0,449,248,16.6,2011,0.0
Kavon Lacey,537,282,475,205,169,113,2585.0,48,14,188.0,427,191,15.4,2011,0.0
Taylor Gray,0,0,0,0,0,0,1.0,0,0,0.0,0,0,0.0,2011,0.0
Yorel Hawkins,1043,131,877,381,335,254,2923.0,102,27,154.0,775,354,21.8,2011,0.0
Warren Edney,541,39,472,201,133,96,1537.0,136,43,79.0,336,158,21.8,2011,0.0
Lyndon Jordan,418,96,361,147,82,53,1684.0,201,71,79.0,160,76,13.6,2011,0.0
Greg Nero,943,96,677,327,404,265,2307.0,69,24,174.0,608,303,22.6,2011,0.0
Kristian Petric,0,0,1,0,0,0,11.0,0,0,2.0,1,0,14.0,2011,0.0
Kamil Svrdlik,703,50,547,268,273,161,2348.0,29,6,193.0,518,262,19.5,2011,0.0
Terence Grier,877,144,783,344,306,148,2676.0,148,41,191.0,635,303,23.1,2011,0.0
John Galvin,625,59,473,225,255,173,2267.0,6,2,120.0,467,223,16.4,2011,0.0
Tyler Reynolds,74,19,106,28,15,6,387.0,60,12,12.0,46,16,16.2,2011,0.0
Nate Gibbs,68,2,46,17,41,34,252.0,0,0,15.0,46,17,16.0,2011,0.0
Larry Jackson,893,56,668,313,481,266,2951.0,6,1,167.0,662,312,18.4,2011,0.0
Rasheem Jenkins,379,144,344,118,107,75,1397.0,215,68,136.0,129,50,18.9,2011,0.0
Christopher Walker,334,50,288,121,118,72,1087.0,80,20,74.0,208,101,19.2,2011,0.0
Cecil Bent,218,13,197,90,84,38,653.0,0,0,66.0,197,90,22.5,2011,0.0
Brett Royster,914,45,631,335,393,244,3211.0,0,0,159.0,631,335,15.9,2011,0.0
DeMonte Simpson,109,9,86,42,47,25,399.0,0,0,24.0,86,42,16.3,2011,0.0
Darren Stewart,10,1,11,3,9,4,106.0,0,0,0.0,11,3,7.1,2011,0.0
Dylan O'Sullivan,4,1,2,1,3,2,23.0,0,0,3.0,2,1,14.0,2011,0.0
Anthony Banks,812,50,605,317,269,178,1722.0,2,0,114.0,603,317,23.9,2011,0.0
Reed Baker,1020,158,889,315,286,243,2260.0,449,147,209.0,440,168,25.8,2011,0.0
Marlon Rivera,192,161,176,56,170,80,953.0,5,0,114.0,171,56,18.9,2011,0.0
Tim Snyder,156,11,122,54,83,48,452.0,7,0,43.0,115,54,22.0,2011,0.0
Nick Goshay,24,3,20,8,8,5,81.0,8,3,6.0,12,5,17.9,2011,0.0
Charlie Lytle,55,27,79,21,10,8,406.0,36,5,40.0,43,16,14.8,2011,0.0
Chad Lutkenhaus,167,59,136,60,64,37,1206.0,37,10,59.0,99,50,8.8,2011,0.0
Jordan Negrin,5,2,5,2,3,1,28.0,1,0,4.0,4,2,18.1,2011,0.0
Eric Frederick,352,17,281,134,101,58,709.0,74,26,51.0,207,108,26.6,2011,0.0
Marvin Roberts,793,107,661,272,279,193,1712.0,208,56,165.0,453,216,27.7,2011,0.0
Phil Gary Jr,596,187,411,180,255,181,1709.0,161,55,141.0,250,125,19.5,2011,0.0
Alex Legion,277,37,276,103,38,25,739.0,142,46,46.0,134,57,24.1,2011,0.0
Tremayne Russell,620,150,464,206,265,171,1960.0,110,37,225.0,354,169,19.7,2011,0.0
Martavis Kee,18,11,29,8,2,0,149.0,14,2,11.0,15,6,13.3,2011,0.0
Stephon Weaver,278,56,275,96,55,47,1047.0,115,39,36.0,160,57,15.9,2011,0.0
Anthony Anderson Jr,7,2,10,2,4,1,51.0,8,2,2.0,2,0,13.5,2011,0.0
Chris Singleton,975,140,802,336,336,199,2761.0,315,104,227.0,487,232,21.4,2011,1.0
Derwin Kitchen,811,308,623,288,239,173,2595.0,184,62,192.0,439,226,17.8,2011,0.0
Andrew Rutledge,5,0,8,2,0,0,12.0,3,1,1.0,5,1,36.9,2011,0.0
A.J. Yawn,2,1,13,0,10,2,28.0,3,0,1.0,10,0,32.9,2011,0.0
Vernon Macklin,993,94,720,439,253,115,2502.0,1,0,151.0,719,439,20.7,2011,1.0
Chandler Parsons,1452,339,1105,527,401,245,3964.0,454,153,234.0,651,374,19.6,2011,1.0
Alex Tyus,1333,80,1048,560,317,207,3271.0,16,6,164.0,1032,554,21.5,2011,0.0
Kyle McClanahan,18,4,11,5,12,7,117.0,4,1,7.0,7,4,9.8,2011,0.0
Adam Allen,144,15,108,52,13,8,374.0,76,32,23.0,32,20,0,2011,0.0
Brenton Butler,1524,293,1373,486,420,320,3880.0,693,232,259.0,680,254,24.6,2011,0.0
Jacob Green,223,17,221,81,110,61,1137.0,0,0,62.0,221,81,14.5,2011,0.0
Bernard Gifford,6,0,3,2,0,0,6.0,2,2,0.0,1,0,24.7,2011,0.0
Matt Grayhack,3,0,6,1,2,1,18.0,0,0,0.0,6,1,19.1,2011,0.0
Khiry Gordon,14,4,18,7,1,0,105.0,0,0,9.0,18,7,12.3,2011,0.0
Tim Steed,278,49,205,104,97,54,642.0,35,16,57.0,170,88,24.0,2011,0.0
Nedeljko Golubovic,709,119,612,247,197,130,2841.0,287,85,143.0,325,162,15.4,2011,0.0
Bracken Funk,197,29,165,67,75,50,583.0,57,13,32.0,108,54,19.9,2011,0.0
Bennie Rhodes,79,6,66,28,29,20,184.0,20,3,11.0,46,25,24.7,2011,0.0
Amu Saaka,1163,130,877,397,364,271,2816.0,276,98,172.0,601,299,25.7,2011,0.0
Jordan Miller,1299,185,1117,424,373,291,3204.0,477,160,225.0,640,264,24.9,2011,0.0
Noah States,768,142,642,291,138,96,2327.0,238,90,163.0,404,201,19.9,2011,0.0
Darryl Evans,643,268,504,211,245,146,2618.0,228,75,183.0,276,136,16.2,2011,0.0
Justin Dehm,1050,266,857,344,177,148,3244.0,573,214,205.0,284,130,18.6,2011,0.0
Neil Duval,120,15,106,39,58,40,554.0,9,2,32.0,97,37,15.6,2011,0.0
Garrett Copeland,0,0,2,0,0,0,22.0,2,0,3.0,0,0,11.6,2011,0.0
Jonathan Moore,927,91,728,304,286,201,2240.0,334,118,147.0,394,186,24.3,2011,0.0
Joshua Henley,489,104,423,219,122,50,2139.0,5,1,128.0,418,218,15.2,2011,0.0
Luke Engelken,170,41,187,62,13,9,656.0,140,37,53.0,47,25,19.0,2011,0.0
Brian McNair,204,88,239,76,32,22,916.0,109,30,65.0,130,46,17.1,2011,0.0
Keith Manley,62,5,66,23,26,16,272.0,8,0,15.0,58,23,17.4,2011,0.0
Bryan Burrell,14,11,12,5,10,4,123.0,0,0,14.0,12,5,12.6,2011,0.0
Cameron Long,1416,356,1085,481,407,299,3826.0,400,155,258.0,685,326,23.5,2011,0.0
Isaiah Tate,427,66,384,151,97,61,1626.0,190,64,62.0,194,87,15.6,2011,0.0
Thomas Armistead,0,0,2,0,0,0,8.0,0,0,1.0,2,0,20.0,2011,0.0
Joseph Katuka,552,29,429,215,223,122,1519.0,0,0,118.0,429,215,21.8,2011,0.0
Chris Fitzgerald,40,2,42,12,8,7,93.0,35,9,3.0,7,3,27.0,2011,0.0
Daymon Warren,16,5,24,8,4,0,176.0,0,0,10.0,24,8,10.5,2011,0.0
Austin Freeman,1761,274,1285,640,356,294,4000.0,491,187,206.0,794,453,22.2,2011,0.0
Chris Wright,1369,442,1033,474,393,294,3448.0,373,127,260.0,660,347,22.8,2011,1.0
Julian Vaughn,639,125,474,249,218,138,2177.0,23,3,172.0,451,246,18.1,2011,0.0
Ryan Dougherty,2,0,4,1,0,0,22.0,0,0,4.0,4,1,19.0,2011,0.0
Rory Spencer,635,55,436,211,332,213,1692.0,0,0,155.0,436,211,23.1,2011,0.0
Zuri James,156,33,140,50,25,21,671.0,94,35,35.0,46,15,14.1,2011,0.0
Justin Taylor,9,0,5,2,12,5,82.0,0,0,5.0,5,2,9.7,2011,0.0
Austin Younker,3,0,0,0,4,3,1.0,0,0,0.0,0,0,96.0,2011,0.0
Dante Curry,393,50,366,126,73,47,1072.0,274,94,57.0,92,32,22.7,2011,0.0
Marques Johnson,291,177,286,116,70,46,1661.0,48,13,121.0,238,103,13.9,2011,1.0
Harold Doby,65,11,64,23,34,19,322.0,1,0,20.0,63,23,16.4,2011,0.0
Daniel Brown,0,0,1,0,0,0,2.0,0,0,0.0,1,0,26.4,2011,0.0
Iman Shumpert,1166,382,977,387,381,281,2877.0,364,111,280.0,613,276,23.9,2011,1.0
Maurice Miller,682,342,530,201,268,211,2279.0,225,69,232.0,305,132,18.6,2011,0.0
Lance Storrs,258,83,275,88,35,24,1275.0,181,58,74.0,94,30,13.6,2011,0.0
Kyle Speller,0,0,1,0,0,0,3.0,0,0,0.0,1,0,16.3,2011,0.0
Trey Thompkins III,1396,124,1141,535,339,247,2628.0,221,79,235.0,920,456,29.7,2011,0.0
Travis Leslie,1099,191,866,417,331,246,2345.0,57,19,180.0,809,398,26.2,2011,1.0
Jeremy Price,945,96,728,369,292,205,2559.0,5,2,228.0,723,367,21.7,2011,0.0
Steven Gray,1432,339,1109,493,309,236,3689.0,568,210,209.0,541,283,20.0,2011,0.0
Demetri Goodson,529,206,414,191,212,134,2123.0,64,13,145.0,350,178,15.7,2011,0.0
Donald Qualls,1103,185,944,347,262,208,2789.0,574,201,190.0,370,146,22.9,2011,0.0
Lance Feurtado,609,61,552,209,176,128,1571.0,181,63,104.0,371,146,23.6,2011,0.0
Rupert Rose,359,118,302,116,160,110,1231.0,66,17,72.0,236,99,18.3,2011,0.0
Chris Britt-Black,88,7,72,36,55,16,487.0,0,0,40.0,72,36,14.2,2011,0.0
Rydell Harris,85,22,83,30,49,25,476.0,5,0,47.0,78,30,16.1,2011,0.0
Brandon Wilson,34,2,29,12,21,9,74.0,6,1,11.0,23,11,33.8,2011,0.0
Rahmon Fletcher,1678,438,1338,633,352,262,3657.0,399,150,341.0,939,483,26.5,2011,0.0
Bryquis Perine,978,312,883,342,287,216,2905.0,249,78,200.0,634,264,22.0,2011,0.0
Seth Evans,284,73,238,88,63,51,1188.0,158,57,66.0,80,31,14.7,2011,0.0
Greg LeSage,96,14,77,34,39,28,517.0,0,0,30.0,77,34,12.6,2011,0.0
Derek Semenas,15,5,18,6,5,2,65.0,2,1,5.0,16,5,20.0,2011,0.0
Kwame Morgan,951,79,840,310,241,172,2208.0,448,159,104.0,392,151,24.9,2011,0.0
Charles Funches,646,75,460,202,328,232,1931.0,28,10,142.0,432,192,19.9,2011,0.0
Brandon Tunnell,628,303,456,189,309,219,2377.0,113,31,217.0,343,158,17.0,2011,0.0
Joe Zeglinski,2016,257,1820,690,352,243,4871.0,1140,393,223.0,680,297,25.1,2011,0.0
Morgan Sabia,1401,113,1226,499,227,161,3796.0,676,242,225.0,550,257,22.0,2011,0.0
Milton Burton,596,127,594,219,97,71,1949.0,289,87,95.0,305,132,20.3,2011,0.0
Anthony Minor,524,135,373,218,181,86,2052.0,9,2,142.0,364,216,15.7,2011,0.0
Ross Erickson,56,12,66,19,14,10,343.0,35,8,16.0,31,11,13.9,2011,0.0
Kevin Estes,284,40,233,122,56,39,1013.0,3,1,74.0,230,121,17.5,2011,0.0
Joe Nardi,12,4,26,5,0,0,109.0,22,2,2.0,4,3,13.9,2011,0.0
Ernest Rouse,11,2,9,2,8,6,47.0,5,1,3.0,4,1,18.5,2011,0.0
Bill Amis,898,82,693,361,230,169,2290.0,22,7,157.0,671,354,22.1,2011,0.0
Hiram Thompson,607,254,451,187,223,164,2289.0,185,69,203.0,266,118,17.4,2011,0.0
Douglas Kurtz,86,4,63,34,29,18,364.0,0,0,35.0,63,34,15.5,2011,0.0
Anthony Salter,7,3,9,3,0,0,31.0,5,1,6.0,4,2,24.6,2011,0.0
Dominick Brumfield,5,0,13,2,4,1,37.0,4,0,4.0,9,2,26.0,2011,0.0
Tehran Cox,340,190,343,111,132,94,1452.0,89,24,155.0,254,87,18.8,2011,0.0
Earnest Bridges,408,28,298,152,177,103,1476.0,5,1,102.0,293,151,16.2,2011,0.0
David Campbell,427,119,388,152,89,65,2025.0,191,58,109.0,197,94,13.3,2011,0.0
Adam Hall,3,2,5,1,3,1,21.0,2,0,0.0,3,1,14.7,2011,0.0
Moses Burgess,0,0,1,0,0,0,14.0,0,0,1.0,1,0,6.9,2011,0.0
Joe Stroman,4,0,6,2,0,0,19.0,1,0,0.0,5,2,15.0,2011,0.0
Charles Jenkins,2513,489,1856,847,788,639,4592.0,471,180,385.0,1385,667,28.4,2011,1.0
Greg Washington,667,71,619,284,155,99,2727.0,2,0,114.0,617,284,14.8,2011,0.0
Brad Kelleher,187,83,166,62,38,29,706.0,101,34,38.0,65,28,16.8,2011,0.0
Paul Bilbo,4,1,5,1,2,2,34.0,0,0,3.0,5,1,14.1,2011,0.0
Andrew Keister,945,98,723,376,306,186,2484.0,35,7,181.0,688,369,21.5,2011,0.0
Andrew Beinert,932,335,756,307,218,145,3309.0,425,173,276.0,331,134,17.6,2011,0.0
Steve Carver,4,0,4,2,0,0,15.0,0,0,0.0,4,2,13.7,2011,0.0
Andrew Gonzalez,1292,106,917,398,495,402,2197.0,270,94,214.0,647,304,28.7,2011,0.0
Michael Moss,488,261,471,179,122,85,1897.0,156,45,224.0,315,134,18.3,2011,0.0
Shawn Echols,261,81,234,91,77,48,1087.0,96,31,82.0,138,60,15.1,2011,0.0
Fred Hinnenkamp,288,34,282,111,58,39,1032.0,96,27,41.0,186,84,15.7,2011,0.0
Sammy Obetoh,166,15,168,61,118,42,520.0,14,2,56.0,154,59,24.4,2011,0.0
T.J. Berry,72,4,48,24,19,12,170.0,28,12,7.0,20,12,17.6,2011,0.0
Ben Daniels,92,13,97,32,11,7,359.0,69,21,24.0,28,11,16.3,2011,0.0
Aaron Hendrix,5,1,4,1,4,3,19.0,2,0,1.0,2,1,14.5,2011,0.0
Sam Ryan,4,1,5,2,0,0,30.0,0,0,5.0,5,2,15.6,2011,0.0
Maurice McNeil,652,30,489,243,276,166,1617.0,0,0,109.0,489,243,22.7,2011,0.0
Adam Brown,601,106,496,214,106,77,1545.0,240,96,87.0,256,118,20.7,2011,0.0
Zamal Nixon,848,283,664,275,281,216,2398.0,252,82,181.0,412,193,20.1,2011,0.0
Nick Haywood,82,22,90,23,33,21,454.0,60,15,22.0,30,8,14.3,2011,0.0
Trumaine Johnson,385,154,354,146,97,60,1532.0,104,33,139.0,250,113,22.0,2011,0.0
Cory Tellis,8,7,7,4,0,0,66.0,3,0,4.0,4,4,8.6,2011,0.0
Kyle Riley,755,216,699,275,201,124,2426.0,310,81,203.0,389,194,20.1,2011,0.0
Gary Lawrence,127,12,97,36,91,55,601.0,3,0,67.0,94,36,17.5,2011,0.0
David Naves,24,5,35,10,4,2,157.0,6,2,18.0,29,8,17.7,2011,0.0
Charles DeCosta,37,3,24,13,33,11,280.0,0,0,15.0,24,13,10.0,2011,0.0
Kendall Salley,15,4,10,3,14,9,89.0,0,0,8.0,10,3,14.0,2011,0.0
Bryce Fluellen,11,5,26,4,3,1,67.0,13,2,3.0,13,2,23.0,2011,0.0
Julian Washington,7,0,3,2,6,3,34.0,0,0,4.0,3,2,14.7,2011,0.0
Broderick Gilchrest,912,168,760,318,263,178,2311.0,309,98,187.0,451,220,25.7,2011,0.0
Deividas Busma,499,29,405,204,144,91,1464.0,0,0,92.0,405,204,20.5,2011,0.0
Phyllip Taylor,266,49,220,82,133,91,753.0,48,11,45.0,172,71,23.0,2011,0.0
Michael Lacey,216,32,179,77,84,56,916.0,31,6,53.0,148,71,15.6,2011,0.0
Kamil Gawrzydek,14,2,9,4,13,6,115.0,0,0,8.0,9,4,10.5,2011,0.0
Russell Wilkinson,4,1,8,2,0,0,16.0,1,0,0.0,7,2,26.1,2011,0.0
Jeff Ledbetter,496,87,367,154,83,66,1261.0,286,122,87.0,81,32,20.8,2011,0.0
Shawn Henderson,406,114,398,157,94,63,1375.0,90,29,81.0,308,128,20.1,2011,0.0
Luiz Toledo,491,33,335,194,167,103,1508.0,1,0,103.0,334,194,18.0,2011,0.0
Brandon Wiley,531,82,385,218,166,93,1788.0,8,2,115.0,377,216,18.1,2011,0.0
Paul Jorg,0,0,1,0,0,0,4.0,0,0,1.0,1,0,26.9,2011,0.0
Robo Kreps,1592,246,1287,532,365,298,3944.0,625,230,226.0,662,302,23.0,2011,0.0
Paul Carter,824,106,682,287,272,204,1989.0,148,46,167.0,534,241,25.4,2011,0.0
Brad Birton,287,59,267,125,57,36,1325.0,9,1,90.0,258,124,14.9,2011,0.0
Zavion Neely,522,88,483,188,163,121,1384.0,89,25,83.0,394,163,23.9,2011,0.0
K.C. Robbins,249,16,236,114,34,21,828.0,0,0,75.0,236,114,20.3,2011,0.0
Dipanjot Singh,129,27,107,45,25,19,458.0,56,20,29.0,51,25,16.6,2011,0.0
Shawn King,10,8,18,4,5,2,118.0,7,0,10.0,11,4,13.2,2011,0.0
Jimmy Harding,15,3,25,5,8,3,75.0,8,2,6.0,17,3,23.0,2011,0.0
Arman Rasul,7,0,5,3,2,1,28.0,0,0,2.0,5,3,14.6,2011,0.0
Austin Hill,527,94,431,197,151,111,1253.0,73,22,116.0,358,175,26.7,2011,0.0
Blake Mishler,239,14,198,96,69,47,758.0,0,0,47.0,198,96,20.3,2011,0.0
Alex Rubin,330,141,302,103,64,41,1936.0,235,83,64.0,67,20,10.8,2011,0.0
Justin Clark,140,52,158,50,27,16,845.0,103,24,42.0,55,26,13.6,2011,0.0
Kenyon Smith,10,10,8,4,2,1,100.0,5,1,4.0,3,3,7.2,2011,0.0
Matt Coates,0,1,0,0,0,0,6.0,0,0,1.0,0,0,8.7,2011,0.0
Demetri McCamey,1718,733,1404,597,405,288,4374.0,654,236,393.0,750,361,24.7,2011,0.0
Mike Tisdale,1243,100,926,495,281,224,3103.0,75,29,168.0,851,466,21.0,2011,0.0
Jereme Richmond,236,57,197,104,43,26,685.0,12,2,54.0,185,102,20.8,2011,0.0
Bill Cole,378,85,296,135,62,38,1627.0,190,70,45.0,106,65,11.4,2011,0.0
Aaron Carter,888,95,661,265,276,224,2523.0,371,134,155.0,290,131,20.1,2011,0.0
Jake Kelly,900,237,722,302,251,201,2732.0,263,95,231.0,459,207,24.2,2011,0.0
Isiah Martin,447,26,326,178,159,91,1555.0,1,0,71.0,325,178,17.0,2011,0.0
Logan Eitel,5,2,5,2,1,1,30.0,1,0,2.0,4,2,13.3,2011,0.0
Jeremiah Rivers,436,226,393,156,174,105,2629.0,77,19,199.0,316,137,13.5,2011,0.0
Rashon Dwight,837,295,720,270,292,219,2994.0,238,78,243.0,482,192,20.7,2011,0.0
Alejo Rodriguez,793,87,536,328,287,137,2545.0,0,0,145.0,536,328,15.0,2011,0.0
Aleksandar Kesic,0,0,6,0,0,0,18.0,2,0,0.0,4,0,16.4,2011,0.0
Diante Garrett,1364,611,1240,505,351,256,3952.0,330,98,362.0,910,407,22.9,2011,1.0
Darion Anderson,1563,327,1294,538,516,365,3650.0,405,122,358.0,889,416,23.5,2011,0.0
Jamie Vanderbeken,535,55,405,188,76,51,1432.0,255,108,54.0,150,80,17.5,2011,0.0
DeMarcus Phillips,20,4,23,8,7,4,77.0,6,0,4.0,17,8,19.3,2011,0.0
Jarryd Cole,708,40,466,277,243,152,2436.0,8,2,137.0,458,275,16.1,2011,0.0
Jordan Stoermer,32,9,28,11,5,3,115.0,23,7,5.0,5,4,15.5,2011,0.0
T.J. Sayre,2,2,1,1,0,0,8.0,0,0,1.0,1,1,12.6,2011,0.0
Ben Botts,1400,197,1067,468,266,227,3688.0,532,237,156.0,535,231,18.9,2011,0.0
Zach Plackemeier,928,362,755,298,197,161,3613.0,436,171,216.0,319,127,16.0,2011,0.0
Jeremy Mixon,578,98,497,202,158,121,1292.0,138,53,96.0,359,149,27.4,2011,0.0
Oleg Kovalov,161,14,123,49,51,36,437.0,71,27,36.0,52,22,21.6,2011,0.0
Terrance Williams,91,5,70,39,28,13,20.0,0,0,1.0,70,39,23.5,2011,0.0
Krste Ruiz,6,6,7,2,3,2,40.0,3,0,8.0,4,2,21.4,2011,0.0
LeRoy Nobles,1464,147,998,462,446,354,3479.0,468,186,189.0,530,276,21.7,2011,0.0
John Ashworth,457,323,414,152,93,71,3086.0,243,82,164.0,171,70,10.9,2011,0.0
Anthony Williams,46,1,35,19,13,8,201.0,0,0,6.0,35,19,12.7,2011,0.0
Nick DeSchepper,19,18,21,3,16,11,135.0,15,2,13.0,6,1,16.6,2011,0.0
David Mazanowski,0,0,3,0,2,0,18.0,2,0,1.0,1,0,14.6,2011,0.0
Tyrone Hanson,858,123,721,290,192,135,2099.0,354,143,142.0,367,147,23.0,2011,0.0
Grant Maxey,1761,221,1360,639,514,391,3449.0,279,92,300.0,1081,547,33.7,2011,0.0
De'Suan Dixon,718,143,650,255,287,167,2344.0,175,41,146.0,475,214,21.4,2011,0.0
Rod Melvin,470,330,396,147,199,145,2593.0,112,31,207.0,284,116,14.5,2011,0.0
Cason Burk,314,145,241,101,163,95,2182.0,57,17,105.0,184,84,10.0,2011,0.0
Gertavian Blake,116,7,98,51,60,14,645.0,0,0,69.0,98,51,15.4,2011,0.0
Chris Hyche,188,15,201,79,38,9,550.0,68,21,47.0,133,58,20.7,2011,0.0
Oliver Jefferson,46,7,40,22,6,2,253.0,0,0,23.0,40,22,12.7,2011,0.0
Donte Himes,0,0,0,0,0,0,2.0,0,0,0.0,0,0,0.0,2011,0.0
Nick Murphy,1498,228,1045,531,624,414,3406.0,74,22,254.0,971,509,24.1,2011,0.0
Jeremy Bynum,1158,137,1004,406,158,117,2865.0,584,229,142.0,420,177,21.4,2011,0.0
LeVentrice Gray,74,6,48,24,36,26,347.0,1,0,11.0,47,24,12.0,2011,0.0
Dominique Shellman,213,199,208,73,76,51,1179.0,56,16,132.0,152,57,16.6,2011,0.0
Brice Jenkins,59,18,60,20,18,10,357.0,25,9,16.0,35,11,12.9,2011,0.0
Sean Thurston,103,26,104,44,31,14,991.0,2,1,63.0,102,43,9.7,2011,0.0
DeAndre Bynum,119,28,130,39,72,32,681.0,39,9,31.0,91,30,14.8,2011,0.0
Latiq Agard,2,0,0,0,2,2,5.0,0,0,1.0,0,0,21.3,2011,0.0
Jonathan Merit,0,1,2,0,0,0,8.0,0,0,1.0,2,0,19.5,2011,0.0
Ayron Hardy,1233,254,906,487,273,200,3781.0,183,59,195.0,723,428,16.8,2011,0.0
Travis Cohn,906,146,738,339,169,134,2281.0,256,94,193.0,482,245,23.6,2011,0.0
Keion Palmer,82,2,56,31,36,20,216.0,0,0,17.0,56,31,20.4,2011,0.0
Chris Rozier,54,7,69,23,9,6,209.0,9,2,16.0,60,21,20.7,2011,0.0
A.J. Garden,0,0,1,0,0,0,5.0,0,0,0.0,1,0,9.8,2011,0.0
Denzel Bowles,1130,136,754,441,364,248,1953.0,0,0,203.0,754,441,29.9,2011,0.0
Ben Louis,366,183,345,141,82,51,1888.0,117,33,125.0,228,108,13.8,2011,0.0
Kevin McGaughey,6,0,4,2,2,1,10.0,3,1,0.0,1,1,25.6,2011,0.0
Andre Prince,2,2,1,0,2,2,14.0,1,0,1.0,0,0,10.9,2011,0.0
Jacob Pullen,2132,455,1600,653,684,527,3978.0,828,299,355.0,772,354,27.3,2011,1.0
Curtis Kelly,812,111,566,307,326,197,2008.0,2,1,200.0,564,306,22.8,2011,0.0
Devon Peterson,31,5,22,12,10,6,75.0,1,1,3.0,21,11,19.1,2011,0.0
Alex Potuzak,2,0,4,1,0,0,19.0,0,0,3.0,4,1,17.7,2011,0.0
Marcus Morris,1371,137,916,508,471,311,2611.0,123,44,172.0,793,464,24.5,2011,0.0
Markieff Morris,923,126,617,341,311,203,2105.0,94,38,172.0,523,303,21.8,2011,1.0
Tyrel Reed,829,163,591,256,175,141,2517.0,433,176,90.0,158,80,14.9,2011,0.0
Brady Morningstar,645,305,516,231,91,67,2779.0,281,116,124.0,235,115,12.0,2011,0.0
Josh Selby,206,56,193,72,37,28,530.0,94,34,53.0,99,38,24.4,2011,1.0
Mario Little,271,47,215,106,68,45,727.0,38,14,37.0,177,92,19.2,2011,0.0
LaDaris Green,503,77,436,203,90,60,1622.0,133,37,114.0,303,166,18.5,2011,0.0
Kelvin McConnell,1040,256,831,328,204,171,3437.0,553,213,249.0,278,115,15.1,2011,0.0
Matt Heramb,314,95,269,113,75,54,1408.0,93,34,107.0,176,79,14.7,2011,0.0
Artie Marine,129,21,125,38,53,31,505.0,71,22,29.0,54,16,16.9,2011,0.0
RJ Hall,0,0,1,0,0,0,10.0,0,0,1.0,1,0,10.3,2011,0.0
Mirza Medinic,12,3,16,5,5,2,87.0,0,0,7.0,16,5,20.0,2011,0.0
Rodriguez Sherman,1183,276,1009,424,347,235,3444.0,314,100,246.0,695,324,21.9,2011,0.0
DeAndre Nealy,13,2,13,5,6,3,85.0,0,0,4.0,13,5,11.6,2011,0.0
Jordan Wilds,1,0,0,0,2,1,10.0,0,0,0.0,0,0,4.7,2011,0.0
Dan Hartman,0,0,1,0,0,0,2.0,1,0,0.0,0,0,24.9,2011,0.0
Brandon Knight,657,159,513,217,171,136,1363.0,231,87,120.0,282,130,27.0,2011,1.0
DeAndre Liggins,576,212,477,194,196,126,2192.0,187,62,147.0,290,132,16.4,2011,1.0
Josh Harrellson,440,39,337,185,94,61,1486.0,29,9,60.0,308,176,15.0,2011,1.0
Jerrell Williams,1211,195,992,450,488,286,2933.0,96,25,339.0,896,425,25.0,2011,0.0
Ruben Guillandeaux,1168,317,998,404,255,194,3144.0,433,166,205.0,565,238,21.3,2011,0.0
Steve Weingarten,328,45,234,121,82,60,1103.0,74,26,56.0,160,95,14.2,2011,0.0
Greg Danish,8,4,14,2,5,3,32.0,10,1,3.0,4,1,22.1,2011,0.0
Jared Mintz,1245,171,821,428,466,377,2734.0,47,12,207.0,774,416,23.8,2011,0.0
Darion Benbow,412,58,364,161,134,87,1627.0,12,3,119.0,352,158,17.4,2011,0.0
Ben Wheeler,314,189,324,114,38,23,1612.0,197,63,132.0,127,51,15.2,2011,0.0
Jake Kreuser,12,1,18,5,5,2,111.0,0,0,10.0,18,5,14.5,2011,0.0
Andy Moore,22,8,29,7,8,5,100.0,21,3,10.0,8,4,22.1,2011,0.0
Kendrick Harris,622,170,494,197,256,175,1661.0,168,53,158.0,326,144,21.3,2011,0.0
Coy Custer,527,49,369,190,203,133,1527.0,44,14,96.0,325,176,16.3,2011,0.0
Tremell Adams,146,12,116,47,26,22,260.0,79,30,23.0,37,17,25.0,2011,0.0
Orlando Brazier,143,8,137,59,38,25,331.0,0,0,26.0,137,59,23.5,2011,0.0
Darius Harris,6,3,6,2,2,2,34.0,1,0,7.0,5,2,17.6,2011,0.0
Prentice Small,410,270,362,118,234,158,1757.0,73,16,148.0,289,102,18.0,2011,0.0
Rob Keefer,674,69,618,251,137,110,2058.0,160,62,125.0,458,189,20.1,2011,0.0
David Safstrom,50,6,36,18,25,14,374.0,0,0,27.0,36,18,9.8,2011,0.0
Kevin McCarthy,32,2,25,11,18,10,118.0,0,0,6.0,25,11,16.3,2011,0.0
Corey Huerta,0,0,1,0,0,0,2.0,1,0,0.0,0,0,24.4,2011,0.0
Bryant Reams,0,0,0,0,0,0,3.0,0,0,1.0,0,0,16.2,2011,0.0
Jeremy Anderson,417,37,357,133,37,30,1393.0,336,121,47.0,21,12,15.6,2011,0.0
Carter McMasters,136,17,139,52,33,24,662.0,25,8,38.0,114,44,14.7,2011,0.0
Garen Lafser,12,2,13,4,4,4,39.0,8,0,1.0,5,4,21.6,2011,0.0
James Spencer,40,32,34,13,23,9,491.0,17,5,32.0,17,8,8.0,2011,0.0
Asaad Woods,0,0,8,0,0,0,15.0,0,0,4.0,8,0,39.7,2011,0.0
Adnan Hodzic,2002,80,1363,799,576,403,3252.0,8,1,273.0,1355,798,28.2,2011,0.0
Josh Slater,1602,462,1148,487,672,484,3313.0,435,144,336.0,713,343,26.2,2011,0.0
Michael Teller,683,134,657,235,95,57,2452.0,464,156,83.0,193,79,14.5,2011,0.0
Milos Kleut,65,1,45,25,19,15,335.0,0,0,23.0,45,25,11.0,2011,0.0
Brett Staal,11,7,8,4,7,2,41.0,1,1,4.0,7,3,17.9,2011,0.0
Greg Plater,1029,166,875,336,173,128,2813.0,635,229,158.0,240,107,19.8,2011,0.0
Tristan Wilson,107,16,110,44,32,15,406.0,20,4,35.0,90,40,19.2,2011,0.0
Lin Chang,40,3,26,9,23,17,130.0,12,5,11.0,14,4,17.9,2011,0.0
Brandon Nevens,27,1,23,11,6,4,117.0,6,1,3.0,17,10,12.0,2011,0.0
Jerramy King,10,9,9,3,7,4,96.0,5,0,8.0,4,3,10.3,2011,0.0
David Hicks,1157,138,1032,393,302,224,3591.0,451,147,174.0,581,246,18.1,2011,0.0
Kyle Johnson,1433,102,1243,479,305,235,3393.0,666,240,188.0,577,239,22.2,2011,0.0
Joel Gierbolini,10,0,8,4,4,2,25.0,0,0,1.0,8,4,19.4,2011,0.0
Milos Nikolic,11,0,11,5,2,0,42.0,5,1,2.0,6,4,15.4,2011,0.0
Aaron Mitchell,680,214,543,245,229,167,1844.0,81,23,166.0,462,222,20.9,2011,0.0
Earl Gee II,198,104,158,64,71,54,680.0,47,16,76.0,111,48,17.9,2011,0.0
La'Ryan Gary,699,61,516,241,253,195,1837.0,91,22,136.0,425,219,22.3,2011,0.0
Travis Bureau,960,115,751,336,238,153,2759.0,388,135,147.0,363,201,18.5,2011,0.0
Randell Daigle,1075,256,920,364,155,120,2962.0,596,227,197.0,324,137,20.5,2011,0.0
Courtney Wallace,422,25,309,159,185,104,1431.0,2,0,100.0,307,159,17.3,2011,0.0
Colby Batiste,157,11,120,62,58,33,890.0,0,0,50.0,120,62,11.4,2011,0.0
Lawrence Gilbert,939,94,770,306,243,200,2546.0,362,127,174.0,408,179,21.9,2011,0.0
Tommie Sykes,668,51,389,196,430,276,1597.0,1,0,131.0,388,196,23.6,2011,0.0
Lonell Reeves,16,22,20,6,4,1,254.0,9,3,18.0,11,3,8.4,2011,0.0
Jamichael Goodin,5,4,4,2,2,1,37.0,0,0,3.0,4,2,11.5,2011,0.0
Dennis Harris,136,13,115,57,32,17,441.0,16,5,23.0,99,52,18.1,2011,0.0
DeAndre Brown,797,186,737,297,157,112,2063.0,287,91,181.0,450,206,23.9,2011,0.0
Tevin Hall,92,33,65,28,40,30,435.0,15,6,34.0,50,22,13.5,2011,0.0
Antwond Roshell,68,4,57,29,21,10,285.0,0,0,31.0,57,29,17.2,2011,0.0
C.J. Scott,43,7,29,16,15,9,117.0,4,2,13.0,25,14,21.0,2011,0.0
Darius Redding,100,22,83,38,37,19,427.0,14,5,27.0,69,33,14.8,2011,0.0
Justin Rake,13,1,14,5,0,0,49.0,9,3,3.0,5,2,17.2,2011,0.0
Preston Knowles,1023,233,931,366,121,93,2549.0,539,198,148.0,392,168,23.4,2011,0.0
Terrence Jennings,630,43,453,257,194,116,1610.0,0,0,79.0,453,257,19.7,2011,0.0
Geoff McCammon,815,59,659,280,148,112,1827.0,347,143,97.0,312,137,23.4,2011,0.0
Andy Polka,959,267,761,345,405,247,3854.0,80,22,223.0,681,323,16.1,2011,0.0
Courtney Stanley,414,266,350,142,189,109,2040.0,86,21,210.0,264,121,16.5,2011,0.0
Gabe Kindred,92,24,68,30,36,27,282.0,15,5,28.0,53,25,20.5,2011,0.0
Shaun Adams,39,6,35,10,21,15,122.0,16,4,8.0,19,6,22.5,2011,0.0
Ryan Sterling,74,11,80,25,14,10,225.0,48,14,19.0,32,11,24.5,2011,0.0
Vernon Teel,1139,353,847,367,552,376,2565.0,117,29,285.0,730,338,26.9,2011,0.0
Larry Davis,802,161,762,275,218,157,2363.0,271,95,130.0,491,180,21.5,2011,0.0
Griffin Reilly,4,3,19,2,1,0,80.0,13,0,4.0,6,2,14.7,2011,0.0
Brian Rudolph,894,527,715,281,395,289,3598.0,165,43,290.0,550,238,16.9,2011,0.0
Jamal Barney,1059,101,959,391,300,218,1969.0,217,59,205.0,742,332,34.1,2011,0.0
Josh Wiegand,37,5,28,15,12,6,246.0,3,1,8.0,25,14,8.5,2011,0.0
Paolo Ivis,11,0,15,4,5,3,92.0,0,0,1.0,15,4,10.2,2011,0.0
Troy Barnies,912,106,706,360,239,170,2722.0,69,22,184.0,637,338,19.3,2011,0.0
Terrance Mitchell,546,92,368,137,240,185,1344.0,250,87,111.0,118,50,23.2,2011,0.0
Sean McNally,898,116,750,330,297,207,3024.0,99,31,179.0,651,299,18.2,2011,0.0
Malachi Peay,312,97,247,108,147,91,1159.0,18,5,98.0,229,103,18.6,2011,0.0
Demetrius Jemison,592,94,519,235,171,121,2322.0,5,1,140.0,514,234,17.8,2011,0.0
Andrew Gabriel,575,99,572,233,231,109,2603.0,2,0,206.0,570,233,17.4,2011,0.0
Nick Walsh,281,55,281,94,34,28,919.0,194,65,67.0,87,29,20.2,2011,0.0
Robert Martina,46,7,46,17,14,11,173.0,7,1,8.0,39,16,18.5,2011,0.0
Menelik Watson,136,11,103,49,69,36,468.0,3,2,38.0,100,47,19.5,2011,0.0
Korey Bauer,480,31,423,177,166,103,1944.0,79,23,96.0,344,154,16.4,2011,0.0
Dejuan Goodwin,483,119,476,169,115,69,2071.0,213,76,154.0,263,93,17.3,2011,0.0
George Dallas,0,0,0,0,0,0,4.0,0,0,0.0,0,0,0.0,2011,0.0
Pat McDerby,7,2,4,1,6,5,14.0,2,0,1.0,2,1,29.1,2011,0.0
Jimmy Butler,1277,180,768,390,596,461,3134.0,94,36,110.0,674,354,19.0,2011,1.0
Dwight Buycks,521,189,438,194,115,79,1769.0,150,54,137.0,288,140,18.3,2011,1.0
Joe Fulce,226,25,187,92,35,31,715.0,33,11,23.0,154,81,16.5,2011,0.0
Robert Frozena,21,3,16,5,15,9,85.0,3,2,5.0,13,3,16.7,2011,0.0
Tirrell Baines,1238,81,888,468,432,301,2999.0,7,1,173.0,881,467,21.3,2011,0.0
Johnny Thomas,312,26,252,126,59,44,956.0,61,16,29.0,191,110,16.1,2011,0.0
Aundra Williams,63,1,37,22,35,19,297.0,0,0,4.0,37,22,9.6,2011,0.0
Johnny Higgins,57,36,37,10,44,35,264.0,11,2,24.0,26,8,15.3,2011,0.0
Orlando Allen,92,3,82,39,31,14,469.0,0,0,33.0,82,39,13.7,2011,0.0
Eladio Espinosa,76,14,70,29,36,18,576.0,12,0,33.0,58,29,10.9,2011,0.0
Xavier Humphrey,4,0,6,2,0,0,12.0,0,0,1.0,6,2,28.8,2011,0.0
Justin Howe,2,0,1,1,2,0,9.0,0,0,1.0,1,1,16.2,2011,0.0
Noah Fischer,21,2,23,6,7,3,58.0,17,6,2.0,6,0,23.8,2011,0.0
Justin Fry,789,122,675,301,241,176,2899.0,42,11,155.0,633,290,17.6,2011,0.0
Travis King,709,190,582,251,149,103,2431.0,267,104,170.0,315,147,17.3,2011,0.0
Laurence Jolicoeur,478,29,381,145,214,162,1561.0,95,26,93.0,286,119,18.9,2011,0.0
Bakari Smith,76,40,96,28,29,20,789.0,1,0,55.0,95,28,10.9,2011,0.0
Nick Groce,79,35,76,30,16,14,470.0,20,5,22.0,56,25,11.9,2011,0.0
Dishawn Bradshaw,285,42,246,94,75,57,776.0,139,40,39.0,107,54,19.9,2011,0.0
Kevin White,612,341,625,226,194,134,2211.0,119,26,244.0,506,200,21.9,2011,0.0
Lyvann Obame Obame,294,17,220,111,125,72,1032.0,0,0,71.0,220,111,16.7,2011,0.0
Joseph Swift,89,47,82,32,49,24,386.0,3,1,51.0,79,31,19.5,2011,0.0
Tim Burns,682,151,595,253,148,114,2412.0,201,62,141.0,394,191,16.9,2011,0.0
Diyaaldin Kelley,74,1,60,30,28,14,257.0,0,0,30.0,60,30,19.4,2011,0.0
Josh Bright,369,150,416,124,84,50,1856.0,225,71,137.0,191,53,16.2,2011,0.0
Mike Spence,9,1,10,3,10,3,50.0,0,0,5.0,10,3,19.0,2011,0.0
Robert Tucker,11,0,14,5,2,1,46.0,0,0,0.0,14,5,16.1,2011,0.0
Kevin Williams,2,2,3,1,2,0,19.0,0,0,2.0,3,1,15.1,2011,1.0
Cliff Tucker,782,169,671,303,150,96,2180.0,227,80,126.0,444,223,19.1,2011,0.0
Dino Gregory,509,46,433,200,148,108,2131.0,2,1,82.0,431,199,13.1,2011,0.0
Adrian Bowie,888,286,688,321,269,183,2605.0,190,63,188.0,498,258,18.5,2011,0.0
Cliff Palsson,89,25,66,30,22,17,324.0,29,12,19.0,37,18,13.9,2011,0.0
Ersin Levent,8,1,12,2,6,3,43.0,5,1,4.0,7,1,21.0,2011,0.0
Anthony Gurley,1530,114,1304,524,407,295,3020.0,555,187,244.0,749,337,27.9,2011,0.0
Gary Correia,293,234,305,89,80,50,2060.0,220,65,120.0,85,24,10.8,2011,0.0
Hashim Bailey,129,9,106,53,68,23,661.0,0,0,43.0,106,53,13.1,2011,0.0
Daryl Traynham,47,31,45,12,28,20,166.0,16,3,21.0,29,9,23.4,2011,0.0
Trey Lang,14,1,7,4,9,6,66.0,0,0,1.0,7,4,8.8,2011,0.0
Jordan Couture,2,1,2,0,3,2,9.0,1,0,0.0,1,0,18.6,2011,0.0
Diego Kapelan,1405,104,1231,456,233,198,3025.0,806,295,146.0,425,161,25.4,2011,0.0
Stephan Martin,933,163,782,320,213,170,2182.0,363,123,210.0,419,197,26.0,2011,0.0
P.J. Alawoya,839,92,668,352,235,134,2802.0,6,1,130.0,662,351,16.1,2011,0.0
C.J. Collins,621,321,600,204,181,130,2828.0,253,83,199.0,347,121,15.8,2011,0.0
Preston David,172,11,143,71,60,30,834.0,0,0,38.0,143,71,12.7,2011,0.0
Mari Kontae,40,3,37,14,12,11,220.0,11,1,6.0,26,13,11.1,2011,0.0
Will Coleman,497,21,312,198,168,101,1454.0,0,0,75.0,312,198,16.1,2011,0.0
Angel Garcia,130,3,95,43,33,27,216.0,45,17,13.0,50,26,28.9,2011,0.0
Brian Mills,1138,124,868,418,334,243,2927.0,199,59,216.0,669,359,22.1,2011,0.0
Jeff Smith,662,187,515,216,229,156,1692.0,214,74,173.0,301,142,23.4,2011,0.0
David O'Shaughnessey,21,9,29,6,16,7,135.0,23,2,8.0,6,4,16.4,2011,0.0
Ted Price,0,0,0,0,0,0,1.0,0,0,0.0,0,0,0.0,2011,0.0
Adrian Thomas,776,106,640,259,82,54,2455.0,522,204,113.0,118,55,16.4,2011,0.0
Nick Winbush,912,66,773,324,151,112,2526.0,419,152,98.0,354,172,20.6,2011,0.0
Antonio Ballard,638,102,469,228,210,144,2148.0,128,38,120.0,341,190,18.0,2011,0.0
Chris McHenry,280,64,253,96,42,30,816.0,159,58,63.0,94,38,20.2,2011,0.0
Sean Mock,3,0,8,1,2,1,37.0,2,0,2.0,6,1,16.1,2011,0.0
Kalin Lucas,1996,558,1575,670,637,507,4278.0,395,149,324.0,1180,521,26.1,2011,1.0
Durrell Summers,1314,103,1094,474,278,205,3171.0,433,161,201.0,661,313,22.8,2011,0.0
Delvon Roe,660,127,440,235,324,190,2248.0,0,0,130.0,440,235,16.2,2011,0.0
Mike Kebler,65,26,53,23,25,19,457.0,4,0,17.0,49,23,9.2,2011,0.0
Nick Giard,0,0,0,0,0,0,6.0,0,0,0.0,0,0,0.0,2011,0.0
Matt Heneveld,0,0,1,0,0,0,7.0,0,0,0.0,1,0,7.3,2011,0.0
Darius Morris,666,319,539,253,197,137,1996.0,103,23,154.0,436,230,22.3,2011,1.0
Darrick Ervin,0,0,0,0,0,0,3.0,0,0,0.0,0,0,0.0,2011,0.0
James Washington III,1183,311,819,331,426,340,3217.0,459,181,228.0,360,150,20.2,2011,0.0
Trevor Ottley,298,36,228,93,168,112,1131.0,0,0,99.0,228,93,18.3,2011,0.0
Rod Emanuel,112,45,116,41,24,18,538.0,38,12,31.0,78,29,14.8,2011,0.0
Kyle Hunt,78,2,58,28,35,22,223.0,3,0,17.0,55,28,20.7,2011,0.0
K.C. Anuna,13,0,9,5,2,2,18.0,3,1,1.0,6,4,31.0,2011,0.0
Cory Herald,2,0,3,1,0,0,5.0,1,0,1.0,2,1,40.2,2011,0.0
Tone Boyle,823,68,677,254,219,166,2195.0,418,149,93.0,259,105,20.3,2011,0.0
Lonnie Boga,254,36,205,88,87,46,868.0,90,32,46.0,115,56,17.3,2011,0.0
Jerard Ajami,138,58,147,42,58,33,1035.0,80,21,39.0,67,21,10.6,2011,0.0
Mitchell Carter,41,1,35,14,26,13,172.0,0,0,16.0,35,14,28.8,2011,0.0
Patrick Souter,57,24,56,20,24,14,274.0,10,3,18.0,46,17,16.0,2011,0.0
Blake Hoffarber,1265,266,955,420,182,146,3451.0,681,279,162.0,274,141,18.0,2011,0.0
Al Nolen,595,394,473,161,290,213,2485.0,194,60,174.0,279,101,16.3,2011,0.0
Dominique Dawson,0,0,4,0,0,0,23.0,0,0,2.0,4,0,13.4,2011,0.0
Ravern Johnson,1460,94,1166,522,208,156,3274.0,654,260,147.0,512,262,21.8,2011,0.0
Kodi Augustus,852,87,618,269,298,238,2120.0,227,76,191.0,391,193,22.8,2011,0.0
Riley Benock,382,142,306,124,45,32,2048.0,259,102,87.0,47,22,10.3,2011,0.0
John Riek,31,2,18,10,16,11,107.0,0,0,7.0,18,10,15.6,2011,0.0
Brandon Bolen,6,2,8,2,4,2,58.0,1,0,8.0,7,2,15.6,2011,0.0
Orlando Smith,333,36,260,126,146,81,1342.0,5,0,86.0,255,126,14.8,2011,0.0
Mark Holmes,90,4,112,34,16,9,348.0,34,13,10.0,78,21,17.7,2011,0.0
Darian Donald,224,24,215,76,70,43,815.0,109,29,51.0,106,47,17.8,2011,0.0
Ricky Lamb,94,16,102,34,20,13,357.0,56,13,31.0,46,21,19.4,2011,0.0
Jerome Harris,0,2,0,0,0,0,9.0,0,0,1.0,0,0,5.2,2011,0.0
Chris Warren,2021,452,1563,634,487,419,3812.0,900,334,281.0,663,300,25.9,2011,0.0
Zach Graham,1274,178,1001,423,375,292,3168.0,368,136,198.0,633,287,21.7,2011,0.0
Jay Couisnard,1082,168,851,365,423,273,2890.0,236,79,226.0,615,286,23.2,2011,0.0
Spencer Johnson,993,63,792,352,273,177,2951.0,324,112,120.0,468,240,17.6,2011,0.0
Bakari Lewis,785,209,678,258,234,179,2012.0,249,90,190.0,429,168,24.9,2011,0.0
Max Rockmann,144,29,126,46,51,35,658.0,56,17,38.0,70,29,14.8,2011,0.0
Jermaine Mallett,791,175,558,256,239,198,2263.0,221,81,141.0,337,175,19.4,2011,0.0
Will Creekmore,892,85,618,325,359,225,2116.0,45,17,138.0,573,308,23.8,2011,0.0
Adam Leonard,1577,323,1295,512,238,185,4546.0,953,368,205.0,342,144,19.2,2011,0.0
Nafis Ricks,594,234,461,187,291,205,1729.0,47,15,127.0,414,172,22.7,2011,0.0
Nick Valla,10,5,10,3,4,3,91.0,6,1,6.0,4,2,10.8,2011,0.0
Aaron Cooper,5,7,8,2,0,0,51.0,3,1,6.0,5,1,15.0,2011,0.0
Justin Safford,641,105,554,242,169,115,1717.0,102,42,117.0,452,200,21.3,2011,0.0
R.J. Rutledge,600,84,535,204,132,84,1877.0,324,108,95.0,211,96,19.8,2011,0.0
James Hett,553,492,513,200,156,99,3892.0,230,54,235.0,283,146,11.2,2011,0.0
Nick DelTufo,440,59,361,155,168,112,1823.0,76,18,130.0,285,137,16.8,2011,0.0
Matt Pritchett,7,1,14,3,2,1,51.0,6,0,3.0,8,3,18.9,2011,0.0
Erik Rush,1151,238,907,377,455,317,2986.0,267,80,234.0,640,297,24.9,2011,0.0
Bobby Howard,1366,142,1176,488,387,230,3252.0,516,160,212.0,660,328,25.6,2011,0.0
Danny Piepoli,757,84,632,247,114,93,2216.0,451,170,94.0,181,77,17.2,2011,0.0
Cody Anderson,290,22,231,114,56,38,1068.0,69,24,39.0,162,90,15.5,2011,0.0
Chris McCall,67,6,57,22,17,12,197.0,28,11,14.0,29,11,20.8,2011,0.0
Casey Trujeque,46,37,47,13,10,10,264.0,34,10,21.0,13,3,14.3,2011,0.0
Tor Anderson,9,2,10,3,1,0,53.0,9,3,2.0,1,0,12.2,2011,0.0
Brian Qvale,1050,75,704,415,345,220,2720.0,1,0,150.0,703,415,21.2,2011,0.0
Vaughn Autry,35,11,40,10,9,7,158.0,29,8,7.0,11,2,17.5,2011,0.0
Chase Adams,29,6,30,10,2,2,108.0,25,7,10.0,5,3,20.4,2011,0.0
Kenneth Faried,2009,117,1376,783,755,440,3964.0,12,3,304.0,1364,780,26.1,2011,1.0
Demonte Harper,1436,400,1270,515,358,252,3941.0,430,154,448.0,840,361,26.6,2011,0.0
Sam Goodman,426,105,335,161,133,84,1476.0,62,20,79.0,273,141,16.4,2011,0.0
Arthur McMillan,44,2,32,17,13,10,143.0,0,0,12.0,32,17,18.0,2011,0.0
Romaric Lasme,5,3,5,2,2,1,62.0,0,0,9.0,5,2,12.4,2011,0.0
Rodney Stokes,398,35,319,165,104,68,1415.0,0,0,72.0,319,165,14.3,2011,0.0
Tola Lawal,68,10,55,20,35,28,195.0,1,0,16.0,54,20,22.1,2011,0.0
Gene Johnson,89,7,85,38,17,13,505.0,1,0,15.0,84,38,10.0,2011,0.0
Adam Braswell,28,9,23,9,4,2,157.0,20,8,6.0,3,1,9.6,2011,0.0
Jake Lockhart,0,0,1,0,0,0,7.0,1,0,1.0,0,0,14.1,2011,0.0
Shawn Atupem,1121,108,858,451,372,219,2895.0,1,0,208.0,857,451,22.3,2011,0.0
David Golladay,163,40,160,61,53,40,713.0,8,1,52.0,152,60,17.8,2011,0.0
Jean Cajou,1036,181,844,325,321,263,3017.0,384,123,173.0,460,202,20.0,2011,0.0
Tayvon Jackson,178,29,149,57,93,64,1086.0,1,0,39.0,148,57,11.1,2011,0.0
Evan Cleveland,10,5,13,3,10,3,99.0,1,1,4.0,12,2,11.8,2011,0.0
B.J. Jenkins,1196,362,912,388,287,238,3310.0,502,182,248.0,410,206,20.3,2011,0.0
Isacc Miles,1222,430,910,398,370,270,3563.0,453,156,270.0,457,242,20.7,2011,0.0
Jeffery McClain,525,78,331,174,264,176,2142.0,3,1,124.0,328,173,14.0,2011,0.0
Picasso Simmons,10,1,13,4,0,0,21.0,8,2,4.0,5,2,41.8,2011,0.0
Jeff Reese,0,0,1,0,0,0,6.0,1,0,0.0,0,0,8.8,2011,0.0
O.J. Avworo,767,483,589,227,473,291,3557.0,118,22,316.0,471,205,17.1,2011,0.0
Mark Veazey,679,39,546,272,182,135,2107.0,0,0,123.0,546,272,17.7,2011,0.0
Romeo Garcia,516,142,455,172,162,114,2491.0,198,58,113.0,257,114,12.3,2011,0.0
Lance Jeter,622,279,494,220,175,125,1991.0,154,57,135.0,340,163,19.3,2011,0.0
Drake Beranek,133,30,111,47,28,23,563.0,51,16,32.0,60,31,15.0,2011,0.0
Kamyron Brown,281,168,218,87,127,86,1118.0,67,21,131.0,151,66,18.6,2011,0.0
Matt Karn,12,3,11,4,0,0,53.0,11,4,3.0,0,0,14.2,2011,0.0
Tre'Von Willis,1361,330,980,425,482,388,2844.0,386,123,230.0,594,302,26.1,2011,0.0
Derrick Jasper,517,266,408,195,180,91,2499.0,116,36,177.0,292,159,14.1,2011,0.0
Todd Hanni,4,0,7,2,0,0,24.0,3,0,1.0,4,2,17.2,2011,0.0
Mychal Martinez,4,1,8,2,1,0,26.0,1,0,4.0,7,2,24.6,2011,0.0
Tyler Norman,4,0,6,2,1,0,37.0,2,0,6.0,4,2,17.3,2011,0.0
Derrell Conner,143,48,146,54,29,13,385.0,72,22,39.0,74,32,25.5,2011,0.0
Illiwa Baldwin,40,4,29,16,13,8,146.0,0,0,10.0,29,16,15.3,2011,0.0
Adam Carp,25,3,19,6,20,13,110.0,1,0,5.0,18,6,13.8,2011,0.0
Marko Cukic,99,7,60,37,36,25,368.0,1,0,16.0,59,37,12.5,2011,0.0
Tyrone Conley,1304,173,1216,442,293,198,3520.0,680,222,215.0,536,220,24.3,2011,0.0
Dane DiLiegro,795,48,623,315,278,164,3057.0,3,1,200.0,620,314,17.7,2011,0.0
James Valladares,161,17,183,64,28,16,1028.0,67,17,31.0,116,47,12.2,2011,0.0
Kazadi Nyanguila,13,2,12,5,4,3,80.0,0,0,4.0,12,5,12.1,2011,0.0
Troy Gillenwater,1065,55,763,372,351,263,1813.0,163,58,133.0,600,314,30.8,2011,0.0
Gordo Castillo,657,79,490,216,74,64,2073.0,396,161,83.0,94,55,15.2,2011,0.0
Drew Herig,10,2,7,3,3,2,21.0,4,2,4.0,3,1,29.5,2011,0.0
Makhtar Diop,8,0,4,2,6,2,13.0,3,2,2.0,1,0,34.0,2011,0.0
Abdoulaye N'doye,9,1,6,3,8,3,93.0,0,0,4.0,6,3,7.3,2011,0.0
Dairese Gary,1458,564,904,412,715,537,3707.0,268,97,303.0,636,315,21.6,2011,0.0
Emmanuel Negedu,110,13,65,32,65,45,380.0,5,1,21.0,60,31,15.0,2011,0.0
Anthony Nelson,1215,647,896,339,635,451,4443.0,319,86,343.0,577,253,17.9,2011,0.0
Kevon Moore,399,70,358,132,172,101,1343.0,139,34,108.0,219,98,20.0,2011,0.0
Luuk Kortekaas,3,0,4,1,1,1,21.0,1,0,0.0,3,1,10.6,2011,0.0
Anatoly Bose,2050,210,1453,629,672,521,3763.0,722,271,312.0,731,358,31.9,2011,0.0
Kenny Franklin Jr,299,140,269,103,32,27,1456.0,183,66,78.0,86,37,13.7,2011,0.0
Kellan Carter,466,225,318,180,196,104,2800.0,5,2,138.0,313,178,10.7,2011,0.0
Justin Ayers,173,34,157,63,43,27,708.0,68,20,28.0,89,43,15.9,2011,0.0
Andy Roethle,0,0,0,0,0,0,1.0,0,0,1.0,0,0,55.1,2011,0.0
Jheryl Wilson,1359,277,1223,479,428,269,3676.0,409,132,346.0,814,347,24.1,2011,0.0
Dytanya Johnson,57,4,48,21,26,15,252.0,1,0,28.0,47,21,17.6,2011,0.0
Drew Onyebuchi,30,3,21,12,18,6,125.0,1,0,4.0,20,12,13.4,2011,0.0
Rob Hampton,907,166,710,305,352,237,2397.0,196,60,224.0,514,245,24.0,2011,0.0
Aleek Pauline,647,377,500,198,327,213,2957.0,103,38,290.0,397,160,16.1,2011,0.0
Timothy Zephyr,225,42,243,98,38,24,1140.0,28,5,58.0,215,93,13.3,2011,0.0
John Williams,1171,121,828,457,441,250,3217.0,22,7,171.0,806,450,17.6,2011,1.0
Toles Hartman,54,12,38,22,20,10,215.0,1,0,16.0,37,22,14.5,2011,0.0
Eric Stubbs,247,29,217,106,67,35,986.0,1,0,70.0,216,106,17.1,2011,0.0
Thomas Coleman,1285,149,810,489,533,307,3351.0,4,0,249.0,806,489,19.0,2011,0.0
Cristian Henry,48,4,38,21,15,6,147.0,0,0,14.0,38,21,19.8,2011,0.0
Thomas Cooper,12,0,14,3,9,5,37.0,6,1,4.0,8,2,29.6,2011,0.0
Brock Moorman,16,0,11,6,4,3,91.0,1,1,6.0,10,5,10.0,2011,0.0
C.J. Wilkerson,1023,131,710,302,441,333,2161.0,229,86,187.0,481,216,26.0,2011,0.0
Dijon Manns,231,13,200,99,49,33,808.0,0,0,85.0,200,99,19.3,2011,0.0
Marvin Fitzgerald,45,10,49,19,10,6,212.0,11,1,15.0,38,18,16.7,2011,0.0
Dwayne Sims,138,14,150,50,9,5,573.0,104,33,24.0,46,17,15.6,2011,0.0
Michael Glasker,318,269,348,101,108,76,1858.0,131,40,215.0,217,61,16.2,2011,0.0
Tim Hobbs,7,0,3,3,2,1,22.0,0,0,5.0,3,3,20.9,2011,0.0
P.J. Taylor,27,21,25,7,25,13,234.0,2,0,25.0,23,7,13.3,2011,0.0
Brandon Evans,779,93,570,232,324,240,1825.0,195,75,152.0,375,157,24.8,2011,0.0
Darrius Sellers,33,1,29,12,24,9,275.0,2,0,27.0,27,12,12.2,2011,0.0
Robby Dilmore,0,0,0,0,0,0,2.0,0,0,0.0,0,0,0.0,2011,0.0
Isaac Swindell,0,0,0,0,0,0,0.0,0,0,0.0,0,0,0,2011,0.0
Tracy Smith,1240,79,905,471,463,298,2422.0,0,0,140.0,905,471,26.8,2011,0.0
Javier Gonzalez,764,336,655,252,195,140,2567.0,350,120,265.0,305,132,20.3,2011,0.0
Enrico Kufuor,6,0,7,3,0,0,24.0,1,0,4.0,6,3,23.1,2011,0.0
Ben Amos,0,0,0,0,0,0,2.0,0,0,0.0,0,0,0.0,2011,0.0
Chad Tomko,1702,481,1505,590,320,266,3989.0,744,256,349.0,761,334,25.7,2011,0.0
Ahmad Grant,475,70,417,169,74,57,1537.0,214,80,78.0,203,89,17.9,2011,0.0
Darryl Felder,421,105,410,137,133,89,1718.0,194,58,90.0,216,79,16.2,2011,0.0
Matthew Wallace,90,15,101,31,10,9,303.0,74,19,29.0,27,12,22.2,2011,0.0
Keegan Pace,0,0,1,0,0,0,10.0,1,0,2.0,0,0,16.5,2011,0.0
Justin Knox,586,52,450,211,233,163,1958.0,2,1,118.0,448,210,16.9,2011,0.0
Daniel Bolick,6,2,4,1,4,4,19.0,1,0,1.0,3,1,16.7,2011,0.0
D.J. Johnston,4,1,8,2,0,0,21.0,1,0,1.0,7,2,19.7,2011,0.0
Van Hatchell,1,1,5,0,2,1,16.0,4,0,2.0,1,0,22.9,2011,0.0
Michael Tveidt,1221,135,983,474,215,164,2806.0,274,109,140.0,709,365,21.9,2011,0.0
Freddy Coleman,304,88,277,109,100,58,943.0,78,28,94.0,199,81,22.3,2011,0.0
Andy Nagel,56,8,47,22,23,12,318.0,2,0,14.0,45,22,11.3,2011,0.0
Derek Benter,289,40,228,96,109,78,1072.0,47,19,81.0,181,77,17.8,2011,0.0
Chris Clausen,274,42,222,87,76,51,976.0,143,49,52.0,79,38,16.9,2011,0.0
Brad Haugabrook,460,245,448,178,147,96,1914.0,38,8,164.0,410,170,18.9,2011,0.0
Kyle Groothuis,245,10,173,98,125,49,1149.0,0,0,49.0,173,98,11.0,2011,0.0
Josh White,1668,331,1177,499,571,485,4260.0,497,185,282.0,680,314,20.9,2011,0.0
George Odufuwa,941,138,637,346,395,249,2811.0,1,0,210.0,636,346,18.8,2011,0.0
Dominique Johnson,949,317,712,300,260,218,2644.0,333,131,203.0,379,169,20.3,2011,0.0
Shannon Shorter,488,149,351,157,216,164,1865.0,67,10,145.0,284,147,16.1,2011,0.0
Ben Knox,60,7,57,27,19,6,352.0,0,0,21.0,57,27,12.6,2011,0.0
Avery Redmond,7,1,2,1,8,5,27.0,0,0,3.0,2,1,16.6,2011,0.0
Jamie Egenti,5,0,4,1,5,3,17.0,0,0,1.0,4,1,22.0,2011,0.0
Chaisson Allen,1550,430,1239,513,476,344,4418.0,505,180,273.0,734,333,21.9,2011,0.0
Vinny Lima,180,25,158,63,40,30,757.0,65,24,43.0,93,39,16.1,2011,0.0
Ben Felix,12,0,23,5,4,2,113.0,0,0,3.0,23,5,13.8,2011,0.0
Eric Platt,740,122,542,228,171,121,1988.0,400,163,108.0,142,65,19.8,2011,0.0
Shane Johannsen,880,49,499,347,332,186,2260.0,0,0,111.0,499,347,18.2,2011,0.0
Austin Smith,228,24,150,91,73,45,636.0,1,1,50.0,149,90,19.3,2011,0.0
DeAngelo Jones,321,45,264,119,101,65,914.0,71,18,84.0,193,101,22.5,2011,0.0
Josh Lepley,380,30,249,140,172,100,1039.0,0,0,96.0,249,140,21.0,2011,0.0
Julian Olubuyi,125,181,114,42,69,36,1057.0,19,5,78.0,95,37,11.1,2011,0.0
Ify Umodu,3,2,1,1,2,1,11.0,0,0,1.0,1,1,14.2,2011,0.0
Devon Beitzel,1568,186,1044,499,397,335,3002.0,584,235,192.0,460,264,24.6,2011,0.0
Neal Kingman,904,137,709,304,255,179,2461.0,345,117,197.0,364,187,21.3,2011,0.0
Chris Kaba,692,89,495,210,235,178,1791.0,220,94,142.0,275,116,20.9,2011,0.0
Taylor Montgomery,656,60,553,216,321,204,2622.0,51,20,139.0,502,196,16.4,2011,0.0
Michael Bedford,6,2,5,2,2,1,52.0,4,1,1.0,1,1,6.8,2011,0.0
Kevin Hanes,6,0,3,2,2,2,11.0,0,0,0.0,3,2,18.3,2011,0.0
David Arnold,20,21,23,5,10,7,176.0,11,3,26.0,12,2,15.7,2011,0.0
Lee Hall,8,0,11,3,2,2,24.0,1,0,2.0,10,3,24.4,2011,0.0
Xavier Silas,1596,169,1192,491,567,446,3034.0,466,168,274.0,726,323,30.3,2011,1.0
Jeremy Landers,372,100,348,125,152,95,1455.0,96,27,121.0,252,98,18.2,2011,0.0
Michael Patton,509,96,507,171,90,63,1688.0,325,104,127.0,182,67,19.0,2011,0.0
Bryan Hall,184,151,165,78,67,26,1215.0,5,2,96.0,160,76,13.1,2011,0.0
Cameron Madlock,41,7,44,19,11,3,289.0,0,0,10.0,44,19,10.4,2011,0.0
Tre Edwards,4,2,2,2,0,0,12.0,0,0,2.0,2,2,16.6,2011,0.0
Kwadzo Ahelegbe,1329,342,1036,417,515,393,3567.0,300,102,291.0,736,315,25.5,2011,0.0
Lucas O'Rear,529,126,354,198,200,126,2255.0,31,7,97.0,323,191,14.1,2011,0.0
Kerwin Dunham,463,112,371,150,127,99,2564.0,196,64,68.0,175,86,11.3,2011,0.0
Will Pratt,956,67,663,332,391,250,1388.0,133,42,174.0,530,290,33.4,2011,0.0
Devon Baker,859,108,616,246,344,260,1568.0,284,107,134.0,332,139,26.4,2011,0.0
Dominic Knight,464,156,358,154,209,128,1643.0,80,28,152.0,278,126,19.4,2011,0.0
Logan McConathy,207,165,222,61,77,59,1442.0,110,26,170.0,112,35,11.0,2011,0.0
Charles Clark,270,38,238,102,117,47,839.0,58,19,64.0,180,83,19.6,2011,0.0
Michael Thompson,1689,528,1300,568,365,277,4633.0,675,276,240.0,625,292,21.5,2011,0.0
Mike Capocci,194,62,141,70,79,49,856.0,18,5,55.0,123,65,15.3,2011,0.0
Ivan Peljusic,171,62,166,70,41,19,674.0,41,12,53.0,125,58,21.2,2011,0.0
Jeff Ryan,335,104,262,128,117,67,1637.0,44,12,87.0,218,116,13.3,2011,0.0
Ben Hansbrough,1613,487,1100,496,458,358,4275.0,649,263,257.0,451,233,19.0,2011,1.0
Carleton Scott,557,108,426,205,93,79,1668.0,189,68,72.0,237,137,17.2,2011,0.0
Tyrone Nash,712,177,460,235,384,241,2345.0,3,1,117.0,457,234,17.0,2011,0.0
Tom Kopko,26,6,26,10,5,2,62.0,15,4,2.0,11,6,25.1,2011,0.0
Keith Benson,1903,94,1226,684,772,524,3616.0,29,11,183.0,1197,673,23.7,2011,1.0
Will Hudson,1023,77,611,390,363,243,3026.0,7,0,154.0,604,390,14.9,2011,0.0
Larry Wright,1106,187,899,360,250,209,2698.0,477,177,159.0,422,183,21.2,2011,1.0
Ilija Milutinovic,175,24,124,60,61,42,555.0,26,13,37.0,98,47,16.4,2011,0.0
Drew Maynard,409,55,337,156,81,41,1202.0,170,56,91.0,167,100,19.5,2011,0.0
Jon Diebler,1536,269,1109,473,263,216,4688.0,900,374,169.0,209,99,15.7,2011,0.0
David Lighty,1458,374,1125,516,453,285,4582.0,394,141,284.0,731,375,19.9,2011,0.0
Dallas Lauderdale,574,25,335,246,200,82,2425.0,0,0,115.0,335,246,12.4,2011,0.0
Eddie Days,1,1,7,0,2,1,24.0,3,0,0.0,4,0,17.7,2011,0.0
DeVaughn Washington,1061,75,765,381,459,298,2757.0,4,1,204.0,761,380,21.9,2011,0.0
Tommy Freeman,1071,134,723,315,219,182,3117.0,584,259,119.0,139,56,15.5,2011,0.0
Asown Sayles,151,35,156,55,47,30,956.0,50,11,37.0,106,44,11.0,2011,0.0
Adetunji Adedipe,41,3,31,19,16,3,223.0,0,0,14.0,31,19,12.1,2011,0.0
Marshall Moses,1020,71,757,413,279,190,2550.0,12,4,177.0,745,409,21.3,2011,0.0
Matt Pilgrim,862,84,660,342,289,145,2245.0,120,33,225.0,540,309,19.7,2011,0.0
Nick Sidorakis,216,66,208,78,24,16,1197.0,138,44,60.0,70,34,11.9,2011,0.0
Songo Adoki,0,0,0,0,0,0,0.0,0,0,0.0,0,0,0,2011,0.0
Cade Davis,1015,133,814,329,232,176,2947.0,531,181,119.0,283,148,18.6,2011,0.0
Kyle Hardrick,0,0,1,0,0,0,6.0,0,0,0.0,1,0,9.1,2011,0.0
Frank Hassell,1282,127,981,516,375,250,3183.0,2,0,194.0,979,516,22.1,2011,0.0
Ben Finney,1211,302,1008,415,421,258,3873.0,410,123,216.0,598,292,19.1,2011,0.0
Keyon Carter,836,93,753,331,160,108,2457.0,193,66,117.0,560,265,20.0,2011,0.0
Darius James,960,454,921,338,211,146,3789.0,417,138,246.0,504,200,17.4,2011,0.0
Josh Hicks,5,3,8,2,0,0,29.0,6,1,0.0,2,1,14.6,2011,0.0
Ken Holdman,428,124,323,158,129,84,2104.0,78,28,113.0,245,130,11.9,2011,0.0
Hunter McClinton,98,39,85,32,20,13,506.0,60,21,38.0,25,11,13.3,2011,0.0
Tim Morton,44,5,37,17,16,10,219.0,2,0,10.0,35,17,12.6,2011,0.0
Javier Nasarre,67,6,58,24,19,14,208.0,21,5,21.0,37,19,21.4,2011,0.0
Kyron Stokes,370,105,329,121,110,77,1634.0,184,51,89.0,145,70,14.4,2011,0.0
Alex Desir,9,1,7,2,4,4,14.0,5,1,2.0,2,1,39.5,2011,0.0
Calvin Haynes,1226,199,1060,427,332,240,3061.0,398,132,236.0,662,295,25.6,2011,0.0
Omari Johnson,764,89,685,286,180,108,2496.0,287,84,159.0,398,202,19.9,2011,1.0
Lathen Wallace,827,50,700,271,213,152,1978.0,386,133,124.0,314,138,25.1,2011,0.0
Daniel Deane,403,48,312,125,208,128,1532.0,93,25,139.0,219,100,20.2,2011,0.0
Joevan Catron,1167,215,875,393,518,350,3025.0,115,31,240.0,760,362,22.8,2011,0.0
Jay-R Strowbridge,787,160,684,261,172,133,2482.0,360,132,117.0,324,129,20.3,2011,0.0
Teondre Williams,403,48,358,151,92,56,1220.0,117,45,75.0,241,106,19.7,2011,0.0
Matt Losli,5,2,3,2,2,1,27.0,1,0,3.0,2,2,13.0,2011,0.0
Nicholas Fearn,8,8,12,2,9,4,146.0,2,0,6.0,10,2,7.7,2011,0.0
Sam Willard,1149,153,881,434,328,241,3170.0,114,40,178.0,767,394,23.8,2011,0.0
Demetrece Young,667,212,523,214,140,113,2157.0,331,126,103.0,192,88,17.8,2011,0.0
Nyika Williams,343,11,239,138,116,67,806.0,0,0,56.0,239,138,24.2,2011,0.0
Terrell Smith,803,254,678,278,252,174,3035.0,219,73,211.0,459,205,19.5,2011,0.0
Pat Eveland,451,64,419,156,85,59,1410.0,262,80,39.0,157,76,19.6,2011,0.0
Jose Rivera,172,54,140,55,17,13,711.0,123,49,28.0,17,6,13.9,2011,0.0
Chuck Coley,21,12,28,8,4,2,163.0,10,3,13.0,18,5,14.8,2011,0.0
Stephon Lamar,27,8,27,9,9,6,89.0,10,3,10.0,17,6,25.5,2011,0.0
Talor Battle,2213,517,1791,722,634,452,4799.0,930,317,301.0,861,405,29.9,2011,0.0
Jeff Brooks,882,159,741,358,183,113,2881.0,161,53,153.0,580,305,20.6,2011,0.0
DJ Jackson,984,101,737,325,317,250,3529.0,247,84,130.0,490,241,17.6,2011,0.0
Andrew Jones III,751,59,551,301,239,149,3309.0,0,0,155.0,551,301,13.8,2011,0.0
Steve Kirkpatrick,10,1,26,5,2,0,106.0,3,0,6.0,23,5,16.8,2011,0.0
Jack Eggleston,1248,219,972,456,328,255,3737.0,218,81,191.0,754,375,20.3,2011,0.0
Conor Turley,272,53,189,87,128,91,1044.0,25,7,77.0,164,80,17.2,2011,0.0
Andreas Schreiber,238,26,212,92,87,48,691.0,30,6,92.0,182,86,31.5,2011,0.0
Zack Gordon,33,5,34,11,13,8,154.0,14,3,10.0,20,8,17.9,2011,0.0
Darren Smith,285,55,279,95,56,38,1061.0,169,57,79.0,110,38,19.6,2011,0.0
Larry Loughery,16,2,14,5,15,6,78.0,0,0,6.0,14,5,23.9,2011,0.0
Casey James,0,0,0,0,0,0,4.0,0,0,0.0,0,0,0.0,2011,0.0
Mychel Thompson,1413,201,1366,487,325,247,3722.0,589,192,213.0,777,295,22.9,2011,1.0
Jonathan Dupre,442,28,458,175,73,53,1465.0,126,39,77.0,332,136,19.4,2011,0.0
Gus Clardy,149,24,115,62,42,25,963.0,2,0,25.0,113,62,8.2,2011,0.0
Denis Agre,65,8,58,28,17,9,385.0,0,0,15.0,58,28,10.4,2011,0.0
Tanner Kerry,56,6,53,17,31,22,352.0,0,0,16.0,53,17,12.0,2011,0.0
Brad Wanamaker,1090,454,815,356,431,311,3153.0,195,67,257.0,620,289,20.9,2011,1.0
Gilbert Brown,1046,234,775,359,314,234,2944.0,275,94,165.0,500,265,18.9,2011,0.0
Gary McGhee,538,33,367,214,215,110,1913.0,0,0,88.0,367,214,15.1,2011,0.0
Melvin Jones,724,130,591,244,105,83,1971.0,381,153,106.0,210,91,19.0,2011,0.0
Phillip Thomas,373,9,256,126,159,121,838.0,0,0,61.0,256,126,23.7,2011,0.0
Paul Guede,284,44,241,88,110,77,1220.0,112,31,69.0,129,57,14.8,2011,0.0
Phil Nelson,865,139,777,311,108,84,2414.0,466,159,125.0,311,152,19.2,2011,0.0
Dane Johnson,136,127,92,43,38,24,810.0,64,26,52.0,28,17,10.0,2011,0.0
Alonzo Brandon,98,7,116,35,6,3,377.0,93,25,11.0,23,10,17.2,2011,0.0
Terry Coleman,5,8,10,2,0,0,82.0,4,1,4.0,6,1,8.6,2011,0.0
Jared Stohl,1401,208,996,451,187,163,3418.0,754,336,146.0,242,115,19.0,2011,0.0
Luke Sikma,1048,253,773,412,297,212,3051.0,40,12,245.0,733,400,20.1,2011,0.0
Kramer Knutson,663,108,480,263,257,137,2691.0,2,0,124.0,478,263,14.2,2011,0.0
Jasonn Hannibal,266,15,237,110,91,46,985.0,0,0,96.0,237,110,20.2,2011,0.0
Trant Simpson,1639,463,1424,507,577,473,3731.0,450,152,425.0,974,355,26.2,2011,0.0
Brandon Webb,388,29,284,156,169,76,893.0,0,0,96.0,284,156,25.1,2011,0.0
Duwan Kornegay,422,32,400,152,101,60,1177.0,204,58,63.0,196,94,21.2,2011,0.0
Beloved Rogers,210,47,224,69,40,25,812.0,153,47,51.0,71,22,17.6,2011,0.0
Jeff Wherry,101,42,111,34,24,12,439.0,80,21,34.0,31,13,17.2,2011,0.0
Michael Webb,132,7,87,52,60,28,514.0,0,0,27.0,87,52,13.6,2011,0.0
Aron Walker,57,0,46,21,25,15,161.0,0,0,9.0,46,21,20.1,2011,0.0
Chris Sights,114,71,134,41,39,27,656.0,29,5,56.0,105,36,15.5,2011,0.0
Kendall Lewis,3,2,7,1,0,0,47.0,2,1,5.0,5,0,12.3,2011,0.0
Jacob Munoz,0,0,0,0,0,0,2.0,0,0,0.0,0,0,0.0,2011,0.0
Jake Troyli,697,41,605,255,187,153,1775.0,102,34,108.0,503,221,25.2,2011,0.0
Walt Allen,554,95,434,196,113,77,2249.0,232,85,93.0,202,111,14.7,2011,0.0
Kareem Maddox,822,143,589,282,309,243,2264.0,78,15,155.0,511,267,22.2,2011,0.0
Dan Mavraides,1054,149,830,330,288,229,2779.0,431,165,174.0,399,165,23.6,2011,0.0
Bobby Foley,47,6,41,17,1,0,127.0,35,13,7.0,6,4,19.9,2011,0.0
Tom Noonan,2,1,4,1,0,0,11.0,2,0,0.0,2,1,20.0,2011,0.0
Marshon Brooks,1629,175,1265,587,402,297,2855.0,475,158,207.0,790,429,27.9,2011,0.0
Ray Hall,126,11,115,54,48,18,581.0,0,0,30.0,115,54,10.7,2011,0.0
Xavier Davis,0,0,2,0,0,0,9.0,2,0,0.0,0,0,10.3,2011,0.0
E'Twaun Moore,2136,400,1774,780,457,333,4517.0,639,243,289.0,1135,537,27.5,2011,1.0
Patrick Bade,69,6,76,25,30,18,414.0,4,1,26.0,72,24,14.6,2011,0.0
Bubba Day,9,1,10,3,0,0,27.0,5,3,1.0,5,0,21.2,2011,0.0
Deontay Twyman,658,184,551,223,165,131,1701.0,232,81,120.0,319,142,21.1,2011,0.0
Justin Rutty,1521,109,1151,647,466,227,3392.0,0,0,215.0,1151,647,23.8,2011,0.0
Dominique Langston,213,59,185,71,63,46,688.0,82,25,55.0,103,46,18.5,2011,0.0
Raheem May-Thompson,67,12,76,28,30,11,338.0,0,0,20.0,76,28,15.5,2011,0.0
Mike Gabriel,19,1,16,7,10,5,58.0,0,0,2.0,16,7,18.5,2011,0.0
William Harrison,12,4,19,4,4,3,76.0,5,1,5.0,14,3,16.1,2011,0.0
Sean Light,31,12,40,11,19,9,290.0,2,0,18.0,38,11,11.4,2011,0.0
Gorkem Sonmez,330,40,327,115,67,36,934.0,189,64,82.0,138,51,23.2,2011,0.0
Evan Faulkner,232,88,238,65,78,57,1118.0,177,45,84.0,61,20,15.7,2011,0.0
Jamal Curry,22,2,27,8,11,6,160.0,0,0,12.0,27,8,13.6,2011,0.0
Delroy James,1460,224,1196,534,435,304,3102.0,318,88,271.0,878,446,28.2,2011,0.0
Marquis Jones,840,459,692,275,284,197,3188.0,280,93,248.0,412,182,17.4,2011,0.0
Will Martell,664,69,497,273,187,118,2181.0,3,0,118.0,494,273,16.3,2011,0.0
Ben Eaves,282,24,257,93,69,51,874.0,138,45,35.0,119,48,18.0,2011,0.0
Daniel West,83,60,63,19,48,34,330.0,39,11,35.0,24,8,18.8,2011,0.0
Anthony Baskerville,6,5,7,2,1,0,54.0,5,2,5.0,2,0,11.9,2011,0.0
Trey Stanton,939,127,831,346,227,160,2991.0,257,87,185.0,574,259,20.0,2011,0.0
Cory Pflieger,713,172,607,235,108,73,2527.0,454,170,130.0,153,65,16.2,2011,0.0
Suleiman Braimoh,542,45,442,221,174,100,1679.0,0,0,138.0,442,221,21.8,2011,0.0
Bryan Beasley,281,153,275,93,120,61,1901.0,103,34,151.0,172,59,12.5,2011,0.0
Trevan Abraham,34,36,46,11,10,9,282.0,22,3,16.0,24,8,12.6,2011,0.0
Justin Harper,1457,102,1111,537,287,204,3133.0,468,179,172.0,643,358,24.6,2011,1.0
Dan Geriot,1389,269,1158,531,340,230,3396.0,261,97,259.0,897,434,25.0,2011,0.0
Kevin Smith,527,299,401,193,194,120,3044.0,77,21,183.0,324,172,12.1,2011,0.0
Kevin Hovde,195,61,136,77,33,20,918.0,49,21,44.0,87,56,11.4,2011,0.0
Mike Ringgold,1386,250,1181,610,466,166,4030.0,1,0,327.0,1180,610,21.4,2011,0.0
Patrick Mansell,266,53,232,78,44,38,1053.0,204,72,43.0,28,6,14.0,2011,0.0
Jhamar Youngblood,933,178,799,347,266,169,2484.0,228,70,227.0,571,277,24.5,2011,0.0
Karon Abraham,796,81,539,226,235,200,1560.0,332,144,109.0,207,82,24.7,2011,0.0
Gary Wallace,679,180,519,222,230,159,2724.0,207,76,178.0,312,146,14.5,2011,0.0
Yann Charles,149,12,150,62,46,24,657.0,5,1,41.0,145,61,16.7,2011,0.0
Elton Roy,25,7,35,9,2,1,104.0,19,6,4.0,16,3,19.8,2011,0.0
Deion Turman,9,0,9,4,3,1,62.0,0,0,2.0,9,4,10.3,2011,0.0
James Beatty,450,213,373,153,61,40,1847.0,272,104,102.0,101,49,14.2,2011,0.0
Mike Coburn,866,367,740,301,310,208,3177.0,167,56,258.0,573,245,18.5,2011,0.0
Robert Lumpkins,183,21,185,65,39,30,635.0,89,23,32.0,96,42,18.3,2011,0.0
Frank Mitchell,2,0,4,1,0,0,11.0,0,0,2.0,4,1,29.0,2011,0.0
Matthew Schiff,0,0,0,0,0,0,3.0,0,0,0.0,0,0,0.0,2011,0.0
Soo Soo Taulelei,0,0,0,0,0,0,0.0,0,0,0.0,0,0,0,2011,0.0
Sultan Toles-Bey,651,234,584,196,205,171,1881.0,260,88,182.0,324,108,23.9,2011,0.0
Duro Bjegovic,465,59,389,171,93,63,1275.0,152,60,94.0,237,111,21.6,2011,0.0
Alpha N'Diaye,114,8,94,42,53,28,394.0,3,2,12.0,91,40,17.6,2011,0.0
Antoine Proctor,52,28,43,15,25,18,186.0,14,4,25.0,29,11,22.6,2011,0.0
Jerrell Thompson,632,295,550,219,154,123,2229.0,205,71,183.0,345,148,18.0,2011,0.0
Mehmet Sahan,356,51,293,149,98,57,1399.0,6,1,89.0,287,148,15.1,2011,0.0
Toso Abedamowo,4,0,3,1,2,1,13.0,3,1,1.0,0,0,18.2,2011,0.0
Mislav Jukic,590,86,466,217,200,143,1619.0,39,13,159.0,427,204,24.7,2011,0.0
Sorena Orandi,373,108,357,129,84,59,1428.0,174,56,95.0,183,73,18.1,2011,0.0
Daniel Witczak,3,0,3,1,0,0,12.0,3,1,1.0,0,0,17.3,2011,0.0
Robert Wortman,3,3,0,0,4,3,14.0,0,0,3.0,0,0,18.2,2011,0.0
Idris Hilliard,919,131,700,356,279,195,3073.0,44,12,155.0,656,344,16.8,2011,0.0
Charoy Bentley,178,63,191,64,42,21,840.0,106,29,68.0,85,35,17.5,2011,0.0
Todd O'Brien,333,31,295,132,118,69,1371.0,0,0,105.0,295,132,17.3,2011,0.0
Paul Eckerle,234,57,207,78,48,31,1175.0,134,47,63.0,73,31,15.2,2011,0.0
Mickey McConnell,1234,476,808,395,311,257,3364.0,404,187,220.0,404,208,17.8,2011,0.0
Phil Benson,52,9,51,22,15,8,286.0,5,0,21.0,46,22,13.7,2011,0.0
Tim Harris,6,0,3,2,0,0,9.0,3,2,1.0,0,0,22.9,2011,0.0
Jeron Belin,634,45,536,219,272,155,1486.0,147,41,119.0,389,178,27.2,2011,0.0
Nick Leon,1466,332,1253,467,401,344,3850.0,531,188,369.0,722,279,24.5,2011,0.0
Wesley Jenkins,1557,146,1439,525,317,234,3702.0,718,273,249.0,721,252,25.6,2011,0.0
Ryan Bacon,1075,122,814,423,361,229,2960.0,4,0,245.0,810,423,22.4,2011,0.0
Steven Samuels,372,71,343,136,70,42,1397.0,167,58,110.0,176,78,17.9,2011,0.0
Kelsey Grant,4,0,4,2,0,0,12.0,0,0,1.0,4,2,21.7,2011,0.0
Gilberto Clavell,1166,72,739,418,454,326,1862.0,21,4,186.0,718,414,30.0,2011,0.0
Josten Crow,799,268,584,262,279,185,2442.0,264,90,136.0,320,172,17.1,2011,0.0
Lance Pevehouse,726,185,599,225,178,128,2272.0,446,148,82.0,153,77,16.5,2011,0.0
Nafis Richardson,218,55,188,76,79,45,660.0,67,21,57.0,121,55,21.2,2011,0.0
Drae Murray,479,323,440,159,95,70,1801.0,270,91,132.0,170,68,16.8,2011,0.0
Marcus Williams,161,73,144,53,59,40,515.0,55,15,57.0,89,38,22.1,2011,1.0
Kelly Lawson,10,0,11,3,10,4,79.0,0,0,5.0,11,3,13.0,2011,0.0
Byron Randle,9,12,12,2,6,4,118.0,6,1,9.0,6,1,10.0,2011,0.0
Josh Bedwell,719,117,510,220,134,114,2205.0,390,165,122.0,120,55,19.7,2011,0.0
Andy King,742,191,561,251,110,79,2303.0,403,161,138.0,158,90,20.1,2011,0.0
Gaby Bermudez,162,109,150,55,62,37,1323.0,64,15,115.0,86,40,13.1,2011,0.0
Kawhi Leonard,990,156,840,377,262,195,2236.0,164,41,153.0,676,336,26.0,2011,1.0
Malcolm Thomas,1193,211,841,446,512,297,3156.0,17,4,233.0,824,442,20.7,2011,1.0
D.J. Gay,1178,344,1046,379,288,201,4223.0,607,219,191.0,439,160,17.5,2011,0.0
Billy White,1294,161,881,529,332,221,3530.0,50,15,222.0,831,514,18.7,2011,0.0
Brian Carlwell,343,26,240,132,132,75,1100.0,11,4,66.0,229,128,17.9,2011,0.0
Mehdi Cheriet,199,25,166,76,43,30,645.0,66,17,30.0,100,59,16.6,2011,0.0
Devin Ginty,546,199,440,165,136,108,2496.0,316,108,135.0,124,57,14.2,2011,0.0
Matt Dorr,627,196,514,207,130,94,2735.0,295,119,162.0,219,88,14.8,2011,0.0
Chris Gabriel,262,14,217,105,80,52,676.0,0,0,56.0,217,105,28.9,2011,0.0
Joran Mackie,117,20,94,40,47,27,440.0,26,10,34.0,68,30,18.5,2011,0.0
Trevor Fuller,71,3,65,30,19,11,266.0,0,0,15.0,65,30,18.1,2011,0.0
Ryan Harbour,38,10,28,13,10,7,202.0,10,5,14.0,18,8,12.6,2011,0.0
Mitch Woolpert,2,0,7,1,0,0,14.0,3,0,0.0,4,1,27.1,2011,0.0
Moustapha Diarra,451,22,369,185,141,81,1004.0,0,0,89.0,369,185,26.5,2011,0.0
Marko Petrovic,146,26,114,49,29,21,436.0,77,27,28.0,37,22,18.1,2011,0.0
Osekalome Akhile,0,1,0,0,0,0,1.0,0,0,0.0,0,0,0.0,2011,0.0
Adrian Oliver,1918,280,1506,646,565,470,3509.0,416,156,313.0,1090,490,30.0,2011,0.0
Brylle Kamen,61,2,60,17,38,27,203.0,4,0,20.0,56,17,24.2,2011,0.0
Jerry Casey,0,0,1,0,0,0,5.0,0,0,1.0,1,0,20.1,2011,0.0
Billy Dick,0,0,0,0,0,0,2.0,0,0,0.0,0,0,0.0,2011,0.0
Ben Dowdell,836,140,612,294,388,245,3114.0,18,3,232.0,594,291,18.0,2011,0.0
Troy Payne,346,91,287,127,158,92,1716.0,10,0,103.0,277,127,13.5,2011,0.0
Michael Santos,369,129,270,128,135,89,2024.0,77,24,148.0,193,104,11.7,2011,0.0
Nate Mensah,10,1,20,3,2,2,43.0,17,2,1.0,3,1,32.3,2011,0.0
Jovonni Shuler,892,111,731,292,252,190,2516.0,351,118,179.0,380,174,25.5,2011,0.0
Darnel Jones,31,21,34,9,25,11,287.0,12,2,29.0,22,7,13.9,2011,0.0
David Paulk,2,0,3,1,0,0,27.0,0,0,1.0,3,1,7.9,2011,0.0
Alex Jones,643,21,453,225,246,171,1116.0,70,22,114.0,383,203,26.8,2011,0.0
Mark McLaughlin,123,13,127,43,27,22,302.0,53,15,28.0,74,28,25.0,2011,0.0
Garrett Lever,225,90,184,70,125,67,1522.0,70,18,76.0,114,52,9.2,2011,0.0
Brandon Durham,78,10,60,31,42,16,403.0,0,0,31.0,60,31,12.4,2011,0.0
Fredrick Wilson,39,15,53,16,7,4,226.0,14,3,29.0,39,13,17.0,2011,0.0
Taylor Stevens,27,4,34,9,2,1,88.0,31,8,4.0,3,1,19.9,2011,0.0
Jeremy Hazell,2146,133,1676,701,554,416,3684.0,954,328,172.0,722,373,28.7,2011,0.0
Eniel Polynice,909,380,870,360,252,145,2930.0,181,44,246.0,689,316,20.9,2011,0.0
Keon Lawrence,846,253,787,312,178,137,2679.0,253,85,169.0,534,227,15.3,2011,0.0
Jamel Jackson,236,32,224,81,19,12,613.0,182,62,19.0,42,19,19.8,2011,0.0
Darnell Gatling,4,3,12,0,5,4,43.0,7,0,3.0,5,0,20.2,2011,0.0
Ryan Rossiter,1457,140,1009,525,526,402,3663.0,32,5,180.0,977,520,19.0,2011,0.0
Clarence Jackson,1164,90,998,410,227,158,2359.0,531,186,167.0,467,224,26.0,2011,0.0
Jonathan Breeden,156,58,135,48,64,48,449.0,34,12,46.0,101,36,22.9,2011,0.0
Kyle Griffin,120,50,119,40,18,14,537.0,77,26,32.0,42,14,14.7,2011,0.0
Steven Priestley,43,0,35,14,31,15,265.0,1,0,13.0,34,14,11.5,2011,0.0
Allyn Cooks,479,170,427,164,140,93,1678.0,159,58,123.0,268,106,18.3,2011,0.0
Gary Redus,792,158,678,265,255,191,2266.0,217,71,162.0,461,194,18.8,2011,0.0
P.J. Reyes,36,6,28,10,17,11,81.0,17,5,7.0,11,5,25.8,2011,0.0
Todd Martin,17,10,21,5,5,3,134.0,18,4,7.0,3,1,11.0,2011,0.0
Raymond Sims,52,41,39,17,14,10,285.0,17,8,42.0,22,9,15.3,2011,0.0
Matt Cline,6,0,2,2,0,0,1.0,2,2,0.0,0,0,97.0,2011,0.0
Darnell Porter,898,120,662,278,296,233,1936.0,298,109,190.0,364,169,26.0,2011,0.0
Tyvon Williams,423,193,355,147,120,79,1312.0,166,50,147.0,189,97,21.2,2011,0.0
Rio Pitt,328,36,283,134,95,60,1431.0,0,0,95.0,283,134,14.9,2011,0.0
Carrio Bennett,844,269,776,264,270,197,2978.0,402,119,260.0,374,145,16.7,2011,0.0
Westley Telfare,279,58,293,95,52,39,1076.0,178,50,89.0,115,45,18.2,2011,0.0
Joseph Wright,41,2,30,13,21,15,203.0,0,0,18.0,30,13,14.2,2011,0.0
Dennis Rowe,0,0,1,0,0,0,3.0,0,0,0.0,1,0,16.6,2011,0.0
Josh Chavis,848,295,786,262,154,124,3222.0,600,200,201.0,186,62,16.8,2011,0.0
Mezie Uzochukwu,857,163,777,334,277,166,3345.0,84,23,180.0,693,311,17.4,2011,0.0
Tony Dukes,170,26,189,58,33,18,613.0,117,36,45.0,72,22,21.1,2011,0.0
Marquis Sloan,67,26,90,22,32,18,407.0,35,5,40.0,55,17,18.5,2011,0.0
Chandler Hash,59,10,59,18,11,7,177.0,53,16,25.0,6,2,26.1,2011,0.0
Sam Muldrow,863,35,768,341,217,144,2583.0,132,37,123.0,636,304,19.4,2011,0.0
Johndre Jefferson,113,13,95,49,46,15,646.0,0,0,29.0,95,49,10.8,2011,0.0
Clint Sargent,1505,212,1202,483,380,287,3673.0,659,252,174.0,543,231,21.6,2011,0.0
Dale Moss,676,123,486,243,265,173,2318.0,53,17,134.0,433,226,15.3,2011,0.0
Aireus Stephenson,45,20,53,16,12,8,129.0,15,5,10.0,38,11,26.1,2011,0.0
Payton Tivis,58,23,57,24,15,9,388.0,8,1,17.0,49,23,11.9,2011,0.0
Dwight Pederson,9,1,13,4,5,1,37.0,0,0,4.0,13,4,25.8,2011,0.0
Kendall Cutler,511,277,328,153,295,204,1535.0,7,1,168.0,321,152,19.6,2011,0.0
Mitchell Bouie,331,34,232,131,135,68,774.0,6,1,68.0,226,130,22.3,2011,0.0
KC Rodenburg,12,2,11,4,0,0,17.0,9,4,1.0,2,0,33.3,2011,0.0
Conrad Krutwig,62,16,53,27,21,8,194.0,1,0,16.0,52,27,19.3,2011,0.0
Cliff Warner,0,0,0,0,0,0,1.0,0,0,0.0,0,0,0.0,2011,0.0
Jarrid Famous,605,29,439,226,222,153,1594.0,2,0,108.0,437,226,21.5,2011,0.0
Anthony Crater,189,188,190,64,51,30,1588.0,128,31,106.0,62,33,10.7,2011,0.0
Shedrick Haynes,27,17,32,10,4,3,152.0,18,4,22.0,14,6,19.6,2011,0.0
Anthony Allison,683,90,615,239,191,135,1887.0,177,70,119.0,438,169,22.3,2011,0.0
Cameron Butler,338,25,225,114,186,110,1168.0,1,0,95.0,224,114,17.9,2011,0.0
Nate Schulte,77,7,61,26,28,18,219.0,22,7,12.0,39,19,20.2,2011,0.0
Rae-Vonn Banks,84,4,65,34,32,16,382.0,0,0,21.0,65,34,13.5,2011,0.0
Trent Hutchin,761,43,577,255,102,94,1524.0,371,157,74.0,206,98,23.4,2011,0.0
David Ndoumba,602,58,401,211,292,180,2030.0,2,0,95.0,399,211,17.4,2011,0.0
Gary Dixon,475,56,395,156,107,80,1278.0,241,83,82.0,154,73,21.1,2011,0.0
Jason Marks,278,102,197,111,74,55,1280.0,6,1,80.0,191,110,12.5,2011,0.0
Rodney Jones,299,62,253,110,67,47,969.0,92,32,63.0,161,78,18.9,2011,0.0
Josh Lockett,13,2,13,6,2,1,57.0,0,0,3.0,13,6,15.1,2011,0.0
Nikola Vucevic,962,97,721,367,256,191,2409.0,122,37,129.0,599,330,22.7,2011,1.0
Alex Stepheson,806,24,638,332,286,142,2619.0,0,0,152.0,638,332,18.1,2011,1.0
Donte Smith,494,105,459,163,78,63,1666.0,321,105,111.0,138,58,18.9,2011,0.0
Marcus Simmons,321,86,288,118,117,71,1791.0,44,14,107.0,244,104,13.3,2011,0.0
James Dunleavy,1,0,3,0,4,1,10.0,3,0,0.0,0,0,26.3,2011,0.0
Cornelius Chatt,338,64,290,118,75,52,766.0,153,50,66.0,137,68,26.0,2011,0.0
Nikola Bundalo,704,20,512,304,149,96,1179.0,1,0,100.0,511,304,21.2,2011,0.0
Cody Rincker,250,54,221,81,19,17,815.0,194,71,34.0,27,10,16.5,2011,0.0
LeShaun Murphy,230,39,204,85,97,53,628.0,20,7,68.0,184,78,25.7,2011,0.0
Anthony Mitchell,139,17,148,54,44,24,473.0,33,7,61.0,115,47,24.9,2011,0.0
Dobrivoje Mavrak,80,9,72,34,33,12,522.0,1,0,28.0,71,34,11.3,2011,0.0
Abel Tillman,20,3,26,10,5,0,95.0,0,0,8.0,26,10,19.5,2011,0.0
Gerald Jones,13,5,8,2,16,9,45.0,0,0,6.0,8,2,24.4,2011,0.0
Alex Newlin,15,0,14,6,2,1,67.0,7,2,2.0,7,4,12.9,2011,0.0
Carlton Fay,1165,83,920,399,300,247,2911.0,368,120,156.0,552,279,23.5,2011,0.0
John Freeman,286,96,210,96,111,82,1212.0,39,12,56.0,171,84,14.2,2011,0.0
Jack Crowder,214,14,178,77,55,37,700.0,69,23,36.0,109,54,18.5,2011,0.0
Mykel Cleveland,93,64,87,35,38,23,546.0,3,0,42.0,84,35,14.7,2011,0.0
Troy Long,72,9,85,24,11,8,263.0,57,16,13.0,28,8,21.4,2011,0.0
Jordan Myers,2,0,6,1,0,0,12.0,1,0,2.0,5,1,36.3,2011,0.0
Nate Mitchell,15,3,19,6,8,3,311.0,0,0,13.0,19,6,6.1,2011,0.0
Papa Dia,1437,133,1059,549,458,326,3218.0,31,13,321.0,1028,536,27.5,2011,0.0
Mike Walker,590,143,506,182,121,95,2391.0,374,131,122.0,132,51,15.6,2011,0.0
Collin Mangrum,378,82,347,133,70,53,1461.0,206,59,78.0,141,74,16.4,2011,0.0
Justin Haynes,394,86,257,146,166,79,1691.0,65,23,93.0,192,123,14.2,2011,0.0
Ryan Harp,266,108,248,95,72,51,1880.0,103,25,102.0,145,70,11.0,2011,0.0
Myles Luttman,21,1,12,5,17,11,153.0,0,0,16.0,12,5,13.2,2011,0.0
Austin Horn,6,0,3,2,0,0,12.0,2,2,0.0,1,0,14.4,2011,0.0
Tomasz Kwiatkowski,4,0,4,2,1,0,40.0,0,0,7.0,4,2,15.6,2011,0.0
Gary Flowers,1078,78,897,422,228,159,1999.0,199,75,157.0,698,347,29.8,2011,0.0
R.L. Horton,1511,268,1316,529,469,332,4257.0,372,121,186.0,944,408,20.9,2011,0.0
Josimar Ayarza,410,27,299,143,168,121,1026.0,17,3,73.0,282,140,22.5,2011,0.0
Sai'Quon Stone,952,192,562,240,656,466,3462.0,20,6,222.0,542,234,16.0,2011,0.0
Kayland Partee,4,0,8,2,0,0,11.0,5,0,0.0,3,2,36.6,2011,0.0
Ryan Brimley,493,66,425,151,120,100,1357.0,259,91,69.0,166,60,20.6,2011,0.0
Jake Nielson,547,177,433,184,222,156,1623.0,74,23,184.0,359,161,24.4,2011,0.0
Jordan Weirick,210,46,198,82,24,18,737.0,69,28,47.0,129,54,17.6,2011,0.0
Blake Sanford,423,42,387,138,93,66,1079.0,235,81,64.0,152,57,23.3,2011,0.0
Julius Ingram,754,63,556,297,242,152,1945.0,30,8,173.0,526,289,22.4,2011,0.0
Brandon White,297,140,314,110,115,66,1508.0,55,11,166.0,259,99,18.0,2011,0.0
Ray Ray Chase,74,11,51,25,45,24,360.0,0,0,24.0,51,25,13.8,2011,0.0
Marceis Davis,23,2,22,8,4,2,96.0,17,5,4.0,5,3,14.9,2011,0.0
Lloyd Hickinson,14,2,19,4,4,3,65.0,9,3,3.0,10,1,18.9,2011,0.0
John Tatum,6,3,5,0,7,6,37.0,3,0,3.0,2,0,15.7,2011,0.0
Ogo Adegboye,559,197,428,171,197,130,1879.0,238,87,127.0,190,84,18.0,2011,0.0
Sam de Haas,20,10,31,8,2,0,129.0,24,4,7.0,7,4,16.0,2011,0.0
Ricky Cadell,1643,253,1347,551,440,319,3685.0,631,222,317.0,716,329,25.7,2011,0.0
Akeem Bennett,826,197,663,260,362,241,1994.0,216,65,228.0,447,195,27.4,2011,0.0
Adam Chmielewski,61,32,59,14,30,25,356.0,28,8,24.0,31,6,13.6,2011,0.0
Alexander Harrington,68,2,74,28,27,11,279.0,2,1,14.0,72,27,18.5,2011,0.0
Richard Clark,82,6,85,29,14,9,319.0,48,15,12.0,37,14,16.8,2011,0.0
Dwight Hardy,907,87,692,298,240,195,1773.0,316,116,112.0,376,182,26.7,2011,0.0
Justin Brownlee,621,93,530,253,124,86,1592.0,105,29,92.0,425,224,22.1,2011,0.0
D.J. Kennedy,1504,311,1089,475,579,432,3927.0,341,122,266.0,748,353,21.1,2011,1.0
Paris Horne,1199,189,1023,444,259,163,3452.0,416,148,196.0,607,296,19.7,2011,0.0
Malik Boothe,539,370,498,180,217,146,2816.0,143,33,229.0,355,147,14.9,2011,0.0
Sean Evans,774,54,643,311,304,152,2425.0,1,0,164.0,642,311,19.8,2011,0.0
Dele Coker,186,19,182,78,66,30,973.0,0,0,67.0,182,78,14.6,2011,0.0
Cameron Edison,6,0,5,2,4,2,9.0,0,0,2.0,5,2,51.3,2011,0.0
Kevin Clark,4,1,12,2,2,0,18.0,6,0,1.0,6,2,39.8,2011,0.0
Jeremy Green,1267,78,1031,428,227,183,2622.0,552,228,129.0,479,200,25.0,2011,0.0
Chris Barnum,0,0,0,0,0,0,2.0,0,0,0.0,0,0,0.0,2011,0.0
Doug Mills,0,0,0,0,0,0,2.0,0,0,0.0,0,0,0.0,2011,0.0
Jordan Glynn,608,69,405,219,212,170,1854.0,3,0,93.0,402,219,17.2,2011,0.0
Eddie Williams,1044,316,884,405,282,165,3437.0,227,69,182.0,657,336,18.6,2011,0.0
Dion Prewster,149,35,112,50,42,31,501.0,46,18,34.0,66,32,17.5,2011,0.0
Mark Gomillia,216,26,182,92,53,30,760.0,24,2,38.0,158,90,17.1,2011,0.0
Denzel Barnes,287,134,262,95,83,56,932.0,126,41,97.0,136,54,22.8,2011,0.0
Brandon Cutler,80,6,62,30,26,20,212.0,1,0,13.0,61,30,21.8,2011,0.0
Zac Downing,45,4,56,15,7,5,169.0,36,10,8.0,20,5,21.1,2011,0.0
Ridge Graham,737,62,655,302,280,123,1755.0,44,10,182.0,611,292,28.4,2011,0.0
Graeme Radford,109,7,107,46,77,17,1053.0,0,0,42.0,107,46,8.9,2011,0.0
Spence Purnell,2,1,2,0,2,2,2.0,2,0,0.0,0,0,75.4,2011,0.0
Preye Preboye,129,22,135,50,38,25,537.0,17,4,56.0,118,46,20.3,2011,0.0
Rick Jackson,1245,192,900,532,353,181,3456.0,1,0,232.0,899,532,18.5,2011,0.0
Lavoy Allen,1421,281,1109,592,325,218,4352.0,66,19,189.0,1043,573,19.3,2011,1.0
Dutch Gaitley,203,92,175,58,130,83,1681.0,16,4,122.0,159,54,11.4,2011,0.0
Benzor Simmons,1130,54,813,367,417,341,2402.0,194,55,168.0,619,312,23.7,2011,0.0
Reuben Clayton,878,163,816,310,253,171,2320.0,292,87,183.0,524,223,23.4,2011,0.0
Andres Iarrazabel,357,53,274,138,130,81,1749.0,0,0,67.0,274,138,11.2,2011,0.0
Daron Hood,37,7,29,15,11,7,202.0,0,0,9.0,29,15,10.3,2011,0.0
Trey Edwards,0,0,1,0,0,0,4.0,0,0,2.0,1,0,37.4,2011,0.0
Verkeneo Mann,40,7,42,11,10,8,185.0,36,10,7.0,6,1,15.1,2011,0.0
Jerret Towns,17,5,14,5,5,4,49.0,11,3,4.0,3,2,21.6,2011,0.0
Blake Kirby,3,2,9,0,4,3,23.0,3,0,3.0,6,0,31.4,2011,0.0
Alfred Jones Jr.,691,49,451,289,154,102,1895.0,33,11,81.0,418,278,16.1,2011,0.0
Charles Newton,51,10,29,16,14,9,146.0,21,10,14.0,8,6,16.6,2011,0.0
Byron Pickens,89,16,95,37,33,15,474.0,3,0,31.0,92,37,14.9,2011,0.0
Scotty Hopson,1305,134,1071,475,304,204,2757.0,426,151,217.0,645,324,25.3,2011,1.0
Tobias Harris,521,44,402,185,170,128,993.0,76,23,62.0,326,162,27.2,2011,1.0
Melvin Goins,668,219,625,226,210,156,2252.0,194,60,173.0,431,166,20.6,2011,0.0
John Fields,868,38,570,324,440,220,2387.0,0,0,152.0,570,324,20.2,2011,0.0
Josh Bone,408,66,414,144,54,39,1645.0,254,81,62.0,160,63,10.5,2011,0.0
Steven Pearl,126,51,116,56,41,14,845.0,1,0,53.0,115,56,10.7,2011,0.0
Michael Hubert,13,2,9,4,2,1,21.0,9,4,3.0,0,0,29.5,2011,0.0
Demond Watt,1269,135,802,457,529,351,3221.0,20,4,226.0,782,453,19.8,2011,0.0
Justin Reynolds,1243,124,981,466,435,261,3134.0,172,50,247.0,809,416,22.7,2011,0.0
Garland Judkins,228,68,198,83,73,51,864.0,48,11,110.0,150,72,20.4,2011,0.0
Horace Bond,575,100,433,214,244,127,2949.0,75,20,166.0,358,194,12.0,2011,0.0
Jawan Nelson,322,29,304,122,71,49,1048.0,94,29,98.0,210,93,20.7,2011,0.0
Hollis Hill,88,21,92,27,30,21,304.0,49,13,35.0,43,14,23.8,2011,0.0
Antonio Topps,174,33,197,58,15,12,755.0,162,46,35.0,35,12,15.8,2011,0.0
Jaamon Echols,65,24,71,22,17,14,251.0,18,7,22.0,53,15,20.6,2011,0.0
Darren Warren,6,2,12,3,0,0,47.0,6,0,3.0,6,3,16.3,2011,0.0
Michael Bables,5,1,7,2,0,0,23.0,1,1,4.0,6,1,24.0,2011,0.0
B.J. Holmes,993,228,704,273,330,263,2803.0,465,184,144.0,239,89,18.3,2011,0.0
Nathan Walkup,656,98,501,230,170,115,1971.0,248,81,93.0,253,149,18.3,2011,0.0
Andrew Darko,86,23,90,30,14,5,391.0,68,21,22.0,22,9,15.7,2011,0.0
Derrek Lewis,56,14,44,19,8,6,209.0,29,12,11.0,15,7,14.5,2011,0.0
Marshall Carrell,12,2,12,4,5,4,41.0,1,0,2.0,11,4,20.9,2011,0.0
Armani Williams,295,36,279,93,54,37,710.0,215,72,42.0,64,21,23.5,2011,0.0
Bryant Smith,101,48,78,29,62,37,448.0,24,6,38.0,54,23,15.8,2011,0.0
Rivest Aduku,0,0,0,0,0,0,6.0,0,0,0.0,0,0,0.0,2011,0.0
Daniel Francis,0,0,0,0,0,0,2.0,0,0,1.0,0,0,24.4,2011,0.0
Ronnie Moss,1095,323,939,388,279,198,2459.0,337,121,262.0,602,267,29.6,2011,0.0
Greg Hill,462,66,352,136,130,106,1218.0,236,84,64.0,116,52,20.6,2011,0.0
Nikola Gacesa,669,53,576,237,186,144,2305.0,133,51,118.0,443,186,14.5,2011,0.0
Zach Huie,2,0,2,1,1,0,9.0,1,0,0.0,1,1,14.4,2011,0.0
Marin Bavcevic,0,5,1,0,0,0,39.0,1,0,6.0,0,0,9.3,2011,0.0
Zack Price,0,0,1,0,0,0,4.0,0,0,1.0,1,0,25.9,2011,0.0
Randy Culpepper,2338,274,1825,782,614,456,4283.0,923,318,272.0,902,464,27.1,2011,0.0
Christian Polk,1148,231,1041,407,185,147,3097.0,513,187,201.0,528,220,22.9,2011,0.0
Jeremy Williams,903,82,645,309,335,222,2413.0,168,63,149.0,477,246,20.1,2011,0.0
Julyan Stone,801,714,595,253,394,243,4261.0,196,52,264.0,399,201,12.6,2011,1.0
Claude Britten,598,20,474,257,155,84,1204.0,2,0,69.0,472,257,27.2,2011,0.0
Isaac Gordon,125,49,118,38,44,34,847.0,54,15,32.0,64,23,9.3,2011,0.0
Wayne Portalatin,110,13,84,45,38,20,794.0,0,0,30.0,84,45,9.2,2011,0.0
Tony Baker,4,0,1,0,4,4,7.0,0,0,0.0,1,0,21.8,2011,0.0
Eric Munoz,5,1,8,2,2,0,47.0,1,1,1.0,7,1,12.4,2011,0.0
Perry Petty,467,139,370,159,152,104,1190.0,151,45,150.0,219,114,29.9,2011,0.0
Matt Mierzycki,407,74,339,132,223,141,1309.0,18,2,127.0,321,130,22.5,2011,0.0
Julius Hearn,368,173,333,105,231,134,1983.0,90,24,159.0,243,81,15.7,2011,0.0
Calvin Walker,20,3,17,9,3,2,93.0,0,0,5.0,17,9,12.8,2011,0.0
"Dwayne ""DJ"" Gutridge",18,6,14,7,6,3,64.0,5,1,6.0,9,6,18.2,2011,0.0
Malik Jamal Hughes,1,1,5,0,2,1,40.0,0,0,3.0,5,0,11.4,2011,0.0
Devin Gibson,1681,549,1123,474,844,643,3937.0,278,90,355.0,845,384,24.2,2011,0.0
Kalif Bakare,9,8,11,4,2,0,59.0,2,1,6.0,9,3,15.3,2011,0.0
Mike White,27,0,28,13,8,1,126.0,0,0,6.0,28,13,13.3,2011,0.0
Travele Jones,837,86,555,264,429,271,1892.0,154,38,191.0,401,226,25.3,2011,0.0
Kevin Galloway,441,279,363,147,203,118,1651.0,103,29,222.0,260,118,21.5,2011,0.0
Harrison Smith,336,29,292,110,126,79,868.0,141,37,42.0,151,73,23.0,2011,0.0
Justin Ray,161,23,142,52,36,28,543.0,99,29,32.0,43,23,17.9,2011,0.0
Nicos Norris,61,15,56,18,16,13,251.0,42,12,20.0,14,6,17.2,2011,0.0
Abdallah Boune,85,8,106,29,21,9,312.0,81,18,15.0,25,11,21.3,2011,0.0
Vanderis Christie,8,1,6,3,2,1,23.0,3,1,5.0,3,2,26.8,2011,0.0
Tony Bishop,638,50,448,238,251,160,1355.0,5,2,95.0,443,236,22.0,2011,0.0
Ryan White,989,414,753,273,448,355,2691.0,286,88,335.0,467,185,21.1,2011,0.0
J.B. Conley,444,31,341,154,177,112,1020.0,89,24,87.0,252,130,22.4,2011,0.0
Jonathan Sloan,390,26,309,138,180,114,924.0,2,0,72.0,307,138,21.9,2011,0.0
A.J. Stewart,186,24,149,75,56,34,519.0,13,2,58.0,136,73,21.9,2011,0.0
Uriel Segura,258,94,218,71,84,68,959.0,142,48,71.0,76,23,15.3,2011,0.0
Stevie Rogers,8,6,6,2,9,4,59.0,3,0,7.0,3,2,13.3,2011,0.0
John Roberson,1772,636,1363,548,504,402,4436.0,699,274,400.0,664,274,21.7,2011,0.0
Mike Singletary,1536,240,1068,493,698,509,3359.0,147,41,295.0,921,452,23.9,2011,0.0
Brad Reese,633,86,575,226,158,117,1624.0,179,64,103.0,396,162,22.4,2011,0.0
David Tairu,643,49,486,220,190,139,1488.0,151,64,67.0,335,156,20.9,2011,0.0
D'walyn Roberts,625,67,468,255,178,115,2230.0,9,0,105.0,459,255,14.0,2011,0.0
Paul Cooper,42,5,32,14,29,14,234.0,0,0,16.0,32,14,12.9,2011,0.0
Wally Dunn,66,6,48,23,10,7,141.0,33,13,4.0,15,10,19.9,2011,0.0
Tristan Thompson,471,45,315,172,261,127,1104.0,0,0,64.0,315,172,22.4,2011,1.0
Cory Joseph,375,109,322,136,73,51,1166.0,126,52,54.0,196,84,17.3,2011,1.0
Dogus Balbay,361,293,296,148,123,63,1988.0,16,2,127.0,280,146,11.6,2011,0.0
Jai Lucas,474,151,402,171,103,71,1747.0,159,61,98.0,243,110,15.9,2011,0.0
Trent Morgan,0,0,0,0,0,0,7.0,0,0,1.0,0,0,7.0,2011,0.0
Malcolm Griffin,553,195,476,223,125,73,1457.0,99,34,203.0,377,189,28.0,2011,0.0
Jay Shunnar,236,53,199,73,79,56,1101.0,115,34,57.0,84,39,14.7,2011,0.0
Zack Leahy,143,33,119,41,63,40,547.0,61,21,54.0,58,20,20.1,2011,0.0
Justin Anyijong,786,58,733,301,121,79,2618.0,321,105,139.0,412,196,19.8,2011,0.0
Jess Chadwell,20,9,16,6,12,7,134.0,7,1,11.0,9,5,13.2,2011,0.0
Braxton Dupree,468,14,388,172,189,124,1424.0,0,0,99.0,388,172,20.8,2011,0.0
RaShawn Polk,602,60,539,221,109,72,1484.0,251,88,80.0,288,133,23.4,2011,0.0
Brian Morris,679,400,596,213,224,147,3214.0,325,106,207.0,271,107,14.5,2011,0.0
Danny Quinn,24,8,29,10,5,2,189.0,10,2,4.0,19,8,9.8,2011,0.0
Vernon Taylor,654,82,524,223,217,163,1460.0,165,45,114.0,359,178,24.8,2011,0.0
Bernard Toombs,438,39,342,179,139,80,1473.0,0,0,74.0,342,179,15.9,2011,0.0
Regis Huddleston,372,32,352,123,36,27,904.0,288,99,32.0,64,24,21.1,2011,0.0
Levan Patsatsia,320,67,285,114,101,59,1139.0,109,33,59.0,176,81,16.8,2011,0.0
Travis Lee,369,27,302,118,51,40,797.0,241,93,29.0,61,25,22.1,2011,0.0
DeAndrae Ross,161,49,178,62,22,14,674.0,76,23,38.0,102,39,17.0,2011,0.0
Flynn Clayman,144,19,149,53,29,19,541.0,62,19,33.0,87,34,16.5,2011,0.0
Kris Richard,1103,223,995,398,250,169,3212.0,433,138,218.0,562,260,21.6,2011,0.0
David Booker,557,34,444,192,218,145,1864.0,108,28,94.0,336,164,17.9,2011,0.0
Johnny Mayhane,525,87,507,181,92,64,1716.0,295,99,112.0,212,82,20.2,2011,0.0
Aaron Holmes,367,60,291,119,138,96,994.0,91,33,65.0,200,86,21.5,2011,0.0
Geoff Hogan,74,10,87,29,18,13,548.0,20,3,16.0,67,26,10.6,2011,0.0
Jonathan Frye,6,2,8,3,0,0,32.0,4,0,1.0,4,3,14.8,2011,0.0
Kelth Cameron,6,0,4,2,6,2,17.0,0,0,1.0,4,2,24.2,2011,0.0
Brady Hadden,3,0,2,1,0,0,15.0,2,1,1.0,0,0,10.5,2011,0.0
Justin Hurtt,1542,172,1212,512,361,291,3252.0,598,227,211.0,614,285,25.3,2011,0.0
Shane Heirman,30,24,28,8,11,7,237.0,22,7,14.0,6,1,10.2,2011,0.0
Blondy Baruti,9,0,14,3,6,3,87.0,4,0,3.0,10,3,11.8,2011,0.0
Colter Morgan,3,0,6,1,4,1,35.0,0,0,1.0,6,1,13.1,2011,0.0
Ladarrius Whitehead,0,0,1,0,0,0,8.0,0,0,0.0,1,0,6.4,2011,0.0
Malcolm Lee,913,184,707,312,304,218,2514.0,255,71,161.0,452,241,21.1,2011,1.0
Tyler Honeycutt,608,163,494,213,171,117,1873.0,181,65,163.0,313,148,20.4,2011,1.0
Blake Arnet,11,0,5,2,6,5,35.0,5,2,3.0,0,0,15.9,2011,0.0
Jack Haley,0,0,1,0,0,0,4.0,1,0,1.0,0,0,25.4,2011,1.0
Alex Schrempf,0,0,0,0,0,0,2.0,0,0,0.0,0,0,0.0,2011,0.0
Tai Wesley,1749,356,1102,657,608,428,3768.0,12,7,281.0,1090,650,24.8,2011,0.0
Brian Green,615,104,442,212,80,62,1454.0,268,129,47.0,174,83,19.6,2011,0.0
Pooh Williams,859,242,724,305,194,132,2992.0,320,117,140.0,404,188,18.5,2011,0.0
Tyler Newbold,1014,364,748,335,187,150,3935.0,477,194,126.0,271,141,12.9,2011,0.0
Nate Bendall,573,36,420,226,158,121,1580.0,2,0,86.0,418,226,20.0,2011,0.0
Matt Formisano,223,27,206,93,57,37,922.0,2,0,40.0,204,93,15.5,2011,0.0
Brad Brown,6,0,5,1,4,3,23.0,3,1,1.0,2,0,18.4,2011,0.0
Jordan Swarbrick,992,262,691,316,332,268,2744.0,226,92,166.0,465,224,20.8,2011,0.0
Justin Baker,519,33,393,201,149,106,1250.0,29,11,92.0,364,190,23.1,2011,0.0
Shawn Deadwiler,653,186,551,185,253,198,2234.0,271,85,171.0,280,100,17.1,2011,0.0
Chris Kupets,218,42,202,77,44,35,564.0,85,29,53.0,117,48,25.0,2011,0.0
Jay Watkins,569,49,425,208,233,147,1664.0,18,6,79.0,407,202,20.9,2011,0.0
David Foster,243,39,203,101,80,41,1349.0,0,0,74.0,203,101,11.7,2011,0.0
Antonio DiMaria,30,5,30,9,9,6,168.0,23,6,9.0,7,3,13.1,2011,0.0
Cory Johnson,1170,123,820,432,379,260,2399.0,142,46,187.0,678,386,26.4,2011,0.0
Howard Little,931,177,741,352,256,150,2998.0,244,77,151.0,497,275,16.8,2011,0.0
Michael Rogers,749,102,634,291,132,85,2467.0,260,82,144.0,374,209,16.2,2011,0.0
Cameron Witt,203,28,198,88,48,24,693.0,21,3,67.0,177,85,19.1,2011,0.0
Joe Duffy,56,11,46,20,17,13,219.0,6,3,12.0,40,17,15.2,2011,0.0
Chris Meriweather,6,5,14,3,0,0,48.0,6,0,4.0,8,3,18.9,2011,0.0
Evan Fjeld,1085,94,807,439,293,203,2711.0,20,4,140.0,787,435,20.3,2011,0.0
Joey Accaoui,845,169,722,303,134,107,2426.0,367,132,137.0,355,171,19.6,2011,0.0
Garrett Kissel,197,15,160,76,120,45,979.0,0,0,59.0,160,76,14.6,2011,0.0
Simeon Marsalis,112,49,107,26,69,52,687.0,48,8,63.0,59,18,15.0,2011,0.0
Corey Fisher,1672,487,1284,530,583,451,3662.0,473,161,287.0,811,369,25.2,2011,0.0
Corey Stokes,1315,123,1008,413,257,225,3298.0,677,264,148.0,331,149,19.0,2011,0.0
Antonio Pena,1100,152,801,410,399,276,3236.0,16,4,230.0,785,406,19.0,2011,0.0
Russell Wooten,4,0,2,2,1,0,41.0,0,0,1.0,2,2,8.7,2011,0.0
Jamie Skeen,1231,140,850,412,453,308,3115.0,271,99,170.0,579,313,20.0,2011,0.0
Joey Rodriguez,1362,580,1132,438,343,275,4401.0,596,211,326.0,536,227,19.5,2011,0.0
Brandon Rozzell,972,124,814,335,142,109,2523.0,510,193,104.0,304,142,20.3,2011,0.0
Ed Nixon,751,184,633,266,184,134,2728.0,241,85,153.0,392,181,17.1,2011,0.0
Toby Veal,107,6,94,46,36,15,424.0,0,0,20.0,94,46,16.7,2011,0.0
Austin Kenon,1767,294,1318,551,388,316,3153.0,910,349,205.0,408,202,23.1,2011,0.0
Stephen Sargent,127,5,120,57,36,13,512.0,0,0,31.0,120,57,13.0,2011,0.0
Malcolm Delaney,2255,543,1585,635,853,721,4692.0,727,264,377.0,858,371,25.4,2011,1.0
Jeff Allen,1702,173,1327,647,587,372,3927.0,134,36,354.0,1193,611,25.2,2011,0.0
Terrell Bell,577,180,481,207,165,100,2686.0,191,63,137.0,290,144,13.1,2011,0.0
Paul Debnam,45,4,33,17,18,8,85.0,7,3,7.0,26,14,29.0,2011,0.0
Andrew Griffin,2,0,4,1,0,0,15.0,0,0,1.0,4,1,17.5,2011,0.0
Prince Parker,2,0,1,1,0,0,5.0,0,0,0.0,1,1,10.5,2011,0.0
Mustapha Farrakhan,727,135,620,234,219,170,1941.0,267,89,144.0,353,145,24.3,2011,0.0
Will Sherrill,197,30,188,77,11,6,927.0,103,37,34.0,85,40,13.6,2011,0.0
Danny Mundweiler,285,44,242,90,55,37,1105.0,183,68,61.0,59,22,15.5,2011,0.0
Clifton Spiller,227,23,156,85,103,57,1163.0,0,0,80.0,156,85,12.7,2011,0.0
Clayfell Harris,58,7,50,25,13,8,304.0,0,0,29.0,50,25,14.9,2011,0.0
T.J. Czeski,234,129,214,79,86,58,1204.0,54,18,146.0,160,61,17.0,2011,0.0
Josh Daniel,0,0,0,0,0,0,1.0,0,0,0.0,0,0,0.0,2011,0.0
Brett Stewart,0,0,0,0,0,0,5.0,0,0,0.0,0,0,0.0,2011,0.0
Denmore McDermott,2,1,4,1,2,0,13.0,0,0,0.0,4,1,18.9,2011,0.0
Klay Thompson,1756,259,1414,599,382,316,3367.0,620,242,289.0,794,357,31.9,2011,1.0
DeAngelo Casto,872,64,614,332,342,208,2356.0,3,0,175.0,611,332,22.2,2011,0.0
Ben Loewen,12,2,15,5,0,0,67.0,5,2,1.0,10,3,12.3,2011,0.0
Steven Bjornstad,11,0,7,5,5,1,37.0,0,0,4.0,7,5,18.4,2011,0.0
Chris McNamara,0,1,1,0,0,0,9.0,0,0,0.0,1,0,5.7,2011,0.0
Matthew Bryan-Amaning,1182,73,954,483,381,216,2822.0,1,0,182.0,953,483,22.4,2011,0.0
Justin Holiday,654,188,569,252,125,92,2414.0,169,58,128.0,400,194,16.4,2011,1.0
Venoy Overton,857,390,645,266,383,278,2879.0,179,47,267.0,466,219,18.5,2011,0.0
Lindsey Hughey,641,145,511,216,180,126,1641.0,227,83,145.0,284,133,23.6,2011,0.0
Trevor Morris,720,50,467,271,248,178,2301.0,6,0,139.0,461,271,16.7,2011,0.0
B.J. Porter,131,37,109,48,30,17,532.0,55,18,33.0,54,30,15.6,2011,0.0
Casey Mitchell,539,47,454,177,106,92,992.0,263,93,62.0,191,84,29.1,2011,0.0
John Flowers,740,156,608,278,243,138,2569.0,144,46,129.0,464,232,16.8,2011,0.0
Joe Mazzulla,700,370,486,209,392,255,2649.0,92,27,189.0,394,182,16.7,2011,0.0
Cam Thoroughman,171,120,130,57,105,57,1315.0,4,0,75.0,126,57,9.8,2011,0.0
Jonnie West,138,18,112,44,21,19,350.0,84,31,6.0,28,13,18.6,2011,0.0
Craig Carey,0,1,2,0,0,0,4.0,0,0,2.0,2,0,51.2,2011,0.0
Jake Ferguson,0,0,1,0,0,0,2.0,1,0,0.0,0,0,25.6,2011,0.0
Kenny Ross,0,0,1,0,0,0,10.0,1,0,0.0,0,0,5.1,2011,0.0
Richie Gordon,933,114,706,379,281,175,2448.0,1,0,191.0,705,379,20.4,2011,0.0
Blake Gallagher,296,49,214,108,130,80,1219.0,0,0,74.0,214,108,14.1,2011,0.0
Anthony Phillip,56,14,49,20,18,10,141.0,16,6,10.0,33,14,23.1,2011,0.0
Matt Lander,742,139,566,227,307,238,1745.0,148,50,158.0,418,177,28.2,2011,0.0
Kaimarr Price,301,44,258,117,107,67,830.0,3,0,71.0,255,117,26.1,2011,0.0
Jelani Johnson,236,59,227,88,27,17,1176.0,100,43,73.0,127,45,15.1,2011,0.0
Emeka Okafor Jr,152,7,130,56,73,40,671.0,0,0,57.0,130,56,18.6,2011,0.0
Mael Amenvedzi,46,11,38,13,19,13,271.0,23,7,22.0,15,6,14.5,2011,0.0
Abdou Niang,54,9,81,20,13,8,449.0,38,6,25.0,43,14,14.1,2011,0.0
Arsenio Mims,43,8,74,20,9,3,433.0,3,0,12.0,71,20,11.8,2011,0.0
Sergio Kerusch,1164,46,953,442,277,176,2408.0,337,104,111.0,616,338,24.8,2011,0.0
Steffphon Pettigrew,1544,116,1233,579,440,274,3621.0,336,112,202.0,897,467,23.1,2011,0.0
Juan Pattillo,549,50,399,203,215,143,1223.0,3,0,125.0,396,203,24.9,2011,0.0
Cliff Dixon,262,36,244,103,103,52,843.0,19,4,68.0,225,99,21.6,2011,0.0
Brandon Peters,78,23,77,28,23,15,279.0,24,7,28.0,53,21,20.2,2011,0.0
Ken Brown,60,26,45,18,19,16,206.0,21,8,31.0,24,10,20.0,2011,0.0
Mike Gabbard,3,5,2,1,2,1,44.0,1,0,3.0,1,1,6.6,2011,0.0
Ed Thomas,2,7,4,0,7,2,33.0,0,0,11.0,4,0,27.9,2011,0.0
J.T. Durley,1327,127,1019,493,372,275,3073.0,231,66,231.0,788,427,24.3,2011,0.0
Gabe Blair,818,104,703,330,235,158,2871.0,14,0,153.0,689,330,18.4,2011,0.0
Graham Hatch,700,130,530,223,169,129,2502.0,331,125,146.0,199,98,16.4,2011,0.0
Aaron Ellis,469,52,452,197,107,67,2243.0,34,8,92.0,418,189,13.8,2011,0.0
Derek Brown,16,3,16,5,2,2,77.0,13,4,3.0,3,1,14.5,2011,0.0
Tyler Richardson,9,1,15,3,5,1,44.0,11,2,1.0,4,1,22.1,2011,0.0
Jerome Hamilton,6,0,2,2,4,2,10.0,0,0,3.0,2,2,36.6,2011,0.0
Josh Walker,0,0,7,0,0,0,25.0,0,0,1.0,7,0,17.0,2011,0.0
Marcus Kitts,666,98,476,277,256,112,1995.0,0,0,151.0,476,277,20.9,2011,0.0
Robbie Dreher,540,81,508,174,208,135,1529.0,203,57,111.0,305,117,23.6,2011,0.0
Charles Corbin,954,81,877,380,283,182,2612.0,50,12,175.0,827,368,23.3,2011,0.0
Justin Burton,456,191,475,152,146,107,1855.0,145,45,127.0,330,107,18.5,2011,0.0
Patrick Marcu,0,0,1,0,0,0,1.0,1,0,0.0,0,0,50.5,2011,0.0
Jon Leuer,1376,135,1074,518,332,240,2810.0,272,100,142.0,802,418,28.4,2011,1.0
Keaton Nankivil,743,68,567,277,125,97,2255.0,219,92,77.0,348,185,18.2,2011,0.0
Tim Jarmusz,345,78,267,105,82,62,2144.0,205,73,49.0,62,32,9.6,2011,0.0
Brett Valentyn,32,8,29,10,4,3,172.0,27,9,7.0,2,1,12.9,2011,0.0
Wquinton Smith,20,13,24,8,9,3,160.0,5,1,8.0,19,7,13.3,2011,0.0
J.P. Gavinski,10,1,13,3,8,4,43.0,1,0,1.0,12,3,23.2,2011,0.0
Noah Dahlman,2013,97,1276,764,693,485,3636.0,6,0,149.0,1270,764,27.4,2011,0.0
Cameron Rundles,1169,288,911,373,368,244,3276.0,443,179,210.0,468,194,21.0,2011,0.0
Jamar Diggs,746,192,566,236,295,224,1925.0,138,50,130.0,428,186,22.9,2011,0.0
Terry Martin,662,63,455,226,283,209,1794.0,4,1,141.0,451,225,21.8,2011,0.0
Nathan Parker,78,11,64,30,23,15,261.0,9,3,32.0,55,27,21.5,2011,0.0
Cameron McQueen,2,0,3,1,0,0,9.0,0,0,2.0,3,1,29.4,2011,0.0
Vaughn Duggins,1777,330,1414,611,475,368,4428.0,521,187,240.0,893,424,23.9,2011,0.0
N'Gai Evans,944,251,725,314,322,243,2947.0,222,73,199.0,503,241,20.6,2011,0.0
Troy Tabler,859,133,690,265,191,164,2492.0,458,165,146.0,232,100,21.0,2011,0.0
Cooper Land,599,58,477,189,183,126,1881.0,270,95,107.0,207,94,20.2,2011,0.0
Kegan Clark,28,13,35,11,10,3,195.0,11,3,12.0,24,8,15.1,2011,0.0
Djibril Thiam,738,65,523,276,291,175,2355.0,46,11,147.0,477,265,17.6,2011,0.0
Joe Hudson,63,7,80,21,6,5,225.0,68,16,9.0,12,5,20.9,2011,0.0
Brian Gibson,54,1,35,22,23,10,192.0,0,0,6.0,35,22,13.8,2011,0.0
Jamel McLean,963,87,637,346,464,269,2825.0,9,2,169.0,628,344,18.7,2011,0.0
Dante Jackson,795,255,680,252,166,119,3342.0,483,172,193.0,197,80,14.1,2011,0.0
Andrew Taylor,170,22,109,65,59,39,705.0,3,1,27.0,106,64,11.5,2011,0.0
Kevin Feeney,8,2,7,2,6,2,62.0,7,2,3.0,0,0,10.8,2011,0.0
Johnny Mazza,9,3,5,3,2,1,23.0,4,2,2.0,1,1,17.3,2011,0.0
Joe Hughes,19,7,16,7,6,3,99.0,8,2,6.0,8,5,12.1,2011,0.0
Porter Braswell,693,214,553,211,249,192,2449.0,258,79,183.0,295,132,17.7,2011,0.0
Raffi Mantilla,150,34,142,52,37,17,664.0,96,29,36.0,46,23,14.7,2011,0.0
Alfonso Costa,0,0,7,0,0,0,6.0,2,0,0.0,5,0,62.1,2011,0.0
Vytas Sulskis,392,61,253,122,149,105,819.0,115,43,59.0,138,79,23.3,2011,0.0
Devonte Maymon,183,33,167,61,51,32,475.0,80,29,38.0,87,32,24.1,2011,0.0
Tre Brewer,121,47,139,51,39,18,518.0,14,1,34.0,125,50,18.4,2011,0.0
Dan Boudler,155,31,132,67,35,21,1015.0,0,0,32.0,132,67,9.0,2011,0.0
Sheldon Brogdon,12,2,17,4,2,1,45.0,13,3,2.0,4,1,22.1,2011,0.0
Taylor Stewart,352,120,296,128,137,79,1505.0,54,17,104.0,242,111,18.3,2012,0.0
Colt Barnhill,19,5,23,6,12,6,89.0,5,1,3.0,18,5,20.7,2012,0.0
Shawn Hempsey,85,70,96,33,31,13,743.0,38,6,45.0,58,27,12.4,2012,0.0
Adam Brakeville,19,4,14,7,7,5,138.0,0,0,6.0,14,7,9.9,2012,0.0
Brian Davidson,0,0,0,0,0,0,1.0,0,0,1.0,0,0,58.2,2012,0.0
Scott Stucky,4,0,7,2,0,0,15.0,4,0,0.0,3,2,27.4,2012,0.0
Nikola Cvetinovic,1158,197,964,452,365,235,3065.0,61,19,232.0,903,433,22.9,2012,0.0
Brett McClanahan,713,130,667,247,78,58,2290.0,465,161,108.0,202,86,18.2,2012,0.0
Josh Egner,49,3,50,19,20,11,193.0,3,0,14.0,47,19,19.6,2012,0.0
C.J. Oldham,11,4,12,5,0,0,53.0,3,1,5.0,9,4,16.4,2012,0.0
Kyle Petersen,8,0,10,2,5,4,33.0,6,0,2.0,4,2,22.3,2012,0.0
Casey Cantey,1276,131,1047,415,566,375,2837.0,265,71,295.0,782,344,28.7,2012,0.0
Eddie Hardy,43,10,44,15,3,2,180.0,39,11,10.0,5,4,15.4,2012,0.0
Diamon Alexander,94,14,112,31,29,17,397.0,63,15,22.0,49,16,18.1,2012,0.0
Reginald Martin,40,6,42,16,12,8,290.0,1,0,25.0,41,16,12.4,2012,0.0
Devin Colman,3,0,1,1,0,0,3.0,1,1,1.0,0,0,33.3,2012,0.0
Cameron Moore,1060,80,858,425,299,181,2704.0,97,29,138.0,761,396,22.8,2012,0.0
K.C. Whitaker,84,18,103,23,23,18,330.0,82,20,17.0,21,3,21.8,2012,0.0
Beas Hamga,16,3,13,7,4,2,139.0,0,0,5.0,13,7,7.7,2012,0.0
Tramaine Butler,1088,191,984,376,433,226,2847.0,374,110,217.0,610,266,26.6,2012,0.0
Ivory White,744,152,665,269,152,96,2891.0,335,110,113.0,330,159,15.8,2012,0.0
Kenderek Washington,507,42,409,177,145,93,1246.0,171,60,81.0,238,117,22.7,2012,0.0
Jeffery Middlebrooks,414,311,350,104,207,145,2326.0,220,61,201.0,130,43,14.3,2012,0.0
Quintarius Hutchinson,17,3,18,7,12,3,101.0,6,0,12.0,12,7,17.7,2012,0.0
JaMychal Green,1656,152,1184,614,598,425,3340.0,17,3,312.0,1167,611,27.4,2012,1.0
Gerardo Suero,689,100,479,220,265,220,1015.0,81,29,134.0,398,191,37.5,2012,0.0
Ralph Watts,171,80,156,58,61,34,969.0,63,21,60.0,93,37,13.5,2012,0.0
Tanner Gibson,19,8,14,6,9,6,122.0,5,1,2.0,9,5,8.6,2012,0.0
Kendrick McDonald,614,90,561,219,199,143,1611.0,112,33,137.0,449,186,23.7,2012,0.0
KeDorian Sullivan,174,11,140,68,62,37,633.0,4,1,27.0,136,67,15.9,2012,0.0
Chris Brand,69,8,64,27,12,9,198.0,13,6,18.0,51,21,22.7,2012,0.0
Jarvis Moore,58,30,58,23,8,7,280.0,10,5,35.0,48,18,17.8,2012,0.0
Tyson Tufono,14,4,16,5,0,0,81.0,13,4,6.0,3,1,13.9,2012,0.0
Devon Francois,5,0,4,2,0,0,46.0,2,1,5.0,2,1,10.0,2012,0.0
Charles Hinkle,756,85,584,230,226,187,1659.0,293,109,108.0,291,121,26.7,2012,0.0
Troy Brewer,822,101,716,285,135,107,2337.0,417,145,96.0,299,140,20.5,2012,0.0
Riley Grafft,293,38,224,116,84,55,1110.0,21,6,65.0,203,110,16.2,2012,0.0
Simon McCormack,376,125,310,153,114,70,1683.0,0,0,114.0,310,153,15.7,2012,0.0
Wayne Simon,26,14,28,10,16,5,218.0,6,1,15.0,22,9,13.0,2012,0.0
Joe Hill,95,18,93,32,0,0,366.0,85,31,16.0,8,1,16.3,2012,0.0
Omar Carter,1721,187,1440,617,438,313,3583.0,494,174,235.0,946,443,25.9,2012,0.0
Andre Williamson,813,87,561,304,314,196,2580.0,19,9,157.0,542,295,16.9,2012,0.0
Isaac Butts,847,95,605,365,197,117,2508.0,0,0,203.0,605,365,18.0,2012,0.0
G.J. Vilarino,163,41,142,54,80,48,645.0,31,7,46.0,111,47,17.8,2012,0.0
Rodney Milium,104,12,86,32,22,14,235.0,69,26,11.0,17,6,23.2,2012,0.0
Mitch Woods,113,110,110,39,55,27,956.0,34,8,74.0,76,31,11.1,2012,0.0
Petey Hausley,245,7,183,96,93,53,676.0,0,0,44.0,183,96,20.2,2012,0.0
Chanse Creekmur,226,27,194,73,28,21,1055.0,168,59,33.0,26,14,12.6,2012,0.0
Pierre Newton,3,1,2,1,0,0,10.0,2,1,0.0,0,0,11.1,2012,0.0
Kyle Fogg,1341,302,983,404,441,340,3829.0,478,193,226.0,505,211,19.4,2012,0.0
Jesse Perry,678,72,494,237,266,186,1806.0,65,18,93.0,429,219,20.9,2012,0.0
Josiah Turner,197,70,151,63,102,64,721.0,31,7,60.0,120,56,19.3,2012,0.0
Brendon Lavender,438,94,348,142,65,46,1568.0,263,108,63.0,85,34,14.8,2012,0.0
Kyryl Natyazhko,154,18,143,61,37,26,859.0,15,6,44.0,128,55,12.4,2012,0.0
Alex Jacobson,60,6,51,26,13,7,391.0,1,1,24.0,50,25,10.8,2012,0.0
Robert Arvizu,2,0,0,0,2,2,10.0,0,0,3.0,0,0,20.6,2012,0.0
Dondre Wise,2,7,0,0,2,2,36.0,0,0,2.0,0,0,4.3,2012,0.0
D'Andre Williams,650,231,548,221,197,150,2006.0,160,58,141.0,388,163,20.7,2012,0.0
Daylon Guy,594,126,498,190,178,134,1722.0,247,80,85.0,251,110,20.6,2012,0.0
Courtney Jackson,682,83,585,282,234,110,2403.0,30,8,153.0,555,274,18.7,2012,0.0
Tramar Sutherland,176,28,142,56,100,60,709.0,19,4,30.0,123,52,16.5,2012,0.0
Eric Lawton,69,13,62,22,28,22,286.0,21,3,24.0,41,19,18.5,2012,0.0
Marlon Louzeiro,170,13,135,68,57,31,638.0,5,3,32.0,130,65,16.1,2012,0.0
Reggie Fondren,48,12,53,17,11,10,219.0,18,4,8.0,35,13,16.1,2012,0.0
Savalance Townsend,1357,259,1077,429,530,378,3888.0,343,121,319.0,734,308,23.8,2012,0.0
Clay Johnson,148,82,106,52,66,42,1065.0,17,2,90.0,89,50,11.1,2012,1.0
Rontrell Bailey,86,28,63,28,39,25,505.0,18,5,30.0,45,23,11.5,2012,0.0
Lavoris Weathers,122,9,126,43,105,36,604.0,1,0,37.0,125,43,18.3,2012,0.0
Austin Allen,56,2,50,19,33,18,211.0,1,0,11.0,49,19,19.0,2012,0.0
Jamar Harris,48,5,46,22,21,4,350.0,1,0,20.0,45,22,11.3,2012,0.0
Derrius Nelson,19,6,16,6,4,3,98.0,13,4,7.0,3,2,13.3,2012,0.0
Edward Buford,6,2,3,2,4,2,26.0,0,0,3.0,3,2,15.9,2012,0.0
Malcoln Kirkland,620,31,449,241,211,138,1757.0,0,0,125.0,449,241,20.0,2012,0.0
Darion Griswold,119,3,82,50,35,19,348.0,1,0,13.0,81,50,17.0,2012,0.0
Adam Sterrenberg,276,48,219,83,112,75,952.0,108,35,44.0,111,48,17.2,2012,0.0
Kinley Ogbonnaya-Branch,58,5,48,16,16,12,158.0,41,14,11.0,7,2,22.0,2012,0.0
Marvell Waithe,224,30,177,77,75,51,738.0,67,19,37.0,110,58,16.9,2012,0.0
Michael Sanchez,380,44,295,123,209,133,1574.0,3,1,108.0,292,122,15.6,2012,0.0
Matt Thompson,3,1,4,1,0,0,7.0,3,1,0.0,1,0,28.1,2012,0.0
Julian Simmons,1255,58,1140,419,242,188,2568.0,614,229,151.0,526,190,28.3,2012,0.0
Jason Pancoe,191,100,184,65,28,21,857.0,115,40,56.0,69,25,15.1,2012,0.0
Whit Thornton,24,27,26,9,13,6,315.0,2,0,31.0,24,9,10.3,2012,0.0
Chris Gramling,8,0,16,3,1,0,52.0,14,2,2.0,2,1,18.3,2012,0.0
Pat Harris,5,2,9,1,3,3,32.0,6,0,0.0,3,1,16.7,2012,0.0
Matt Walker,2,0,3,1,0,0,4.0,0,0,2.0,3,1,64.4,2012,0.0
Michael Felton,0,0,0,0,0,0,1.0,0,0,0.0,0,0,0.0,2012,0.0
Kenny Gabriel,756,53,663,283,156,105,1963.0,271,85,133.0,392,198,22.9,2012,0.0
Varez Ward,398,160,326,118,213,139,1292.0,105,23,122.0,221,95,21.7,2012,0.0
Adrian Forbes,172,8,136,65,73,42,860.0,0,0,47.0,136,65,13.1,2012,0.0
Jake Drum,25,3,14,7,14,10,92.0,3,1,8.0,11,6,15.5,2012,0.0
Tony Neysmith,84,68,91,36,40,12,771.0,6,0,70.0,85,36,11.9,2012,0.0
Cedrick McAfee,0,0,6,0,0,0,19.0,3,0,1.0,3,0,19.5,2012,0.0
T.J. Rice,0,0,3,0,0,0,5.0,1,0,0.0,2,0,31.7,2012,0.0
TyShwan Edmondson,1017,142,909,373,181,133,2333.0,384,138,169.0,525,235,24.7,2012,0.0
Josh Terry,746,127,597,282,263,180,1989.0,17,2,130.0,580,280,21.2,2012,0.0
Melvin Baker,615,54,494,240,171,120,1494.0,51,15,120.0,443,225,23.1,2012,0.0
John Fraley,956,68,612,355,406,246,2833.0,0,0,167.0,612,355,17.2,2012,0.0
Justin Blake,451,83,388,144,88,57,1353.0,313,106,59.0,75,38,18.1,2012,0.0
Alton Williams,55,5,39,18,5,4,133.0,33,15,1.0,6,3,15.8,2012,0.0
Jarrod Jones,1623,105,1314,622,535,366,3587.0,47,13,229.0,1267,609,27.3,2012,0.0
Randy Davis,929,446,637,240,380,313,3073.0,399,136,222.0,238,104,18.3,2012,0.0
Tyrae Robinson,298,150,234,96,139,91,1080.0,46,15,113.0,188,81,20.6,2012,0.0
Pierre Sneed,269,78,278,97,104,70,1633.0,27,5,102.0,251,92,14.3,2012,0.0
Zeke Chapman,15,1,22,5,2,2,83.0,20,3,4.0,2,2,17.6,2012,0.0
Quincy Acy,1360,86,835,503,496,351,3488.0,7,3,214.0,828,500,19.1,2012,1.0
Perry Jones,862,78,659,344,239,162,2030.0,43,12,125.0,616,332,22.4,2012,0.0
Quincy Miller,393,53,309,138,114,93,903.0,69,24,66.0,240,114,23.9,2012,1.0
Anthony Jones,738,89,600,272,155,109,2653.0,247,85,129.0,353,187,15.2,2012,1.0
Fred Ellis,214,52,192,68,76,59,967.0,68,19,70.0,124,49,15.4,2012,0.0
Drew Hanlen,874,423,640,257,220,171,2957.0,465,189,190.0,175,68,15.6,2012,0.0
Scott Saunders,1030,35,701,360,452,310,2023.0,0,0,170.0,701,360,28.8,2012,0.0
Mick Hedgepeth,1191,62,765,413,522,356,2673.0,29,9,180.0,736,404,22.5,2012,0.0
Seth Cavera,0,1,1,0,1,0,20.0,1,0,0.0,0,0,3.7,2012,0.0
Garrius Holloman,747,118,638,320,161,94,1916.0,46,13,126.0,592,307,23.3,2012,0.0
Anthony Breeze,922,53,642,336,416,249,2192.0,1,1,147.0,641,335,23.3,2012,0.0
Stanley Elliott,631,125,557,225,247,154,2705.0,117,27,136.0,440,198,15.6,2012,0.0
Raymoan McAfee,44,2,47,19,17,6,284.0,1,0,16.0,46,19,13.3,2012,0.0
David Baroum,0,0,3,0,0,0,6.0,0,0,1.0,3,0,34.8,2012,0.0
Omar Richards,141,11,121,57,48,24,574.0,6,3,45.0,115,54,17.8,2012,0.0
Carlyle Francis,33,8,30,10,16,12,143.0,12,1,21.0,18,9,22.2,2012,0.0
Byron Brown,8,3,10,3,4,2,44.0,5,0,2.0,5,3,17.1,2012,0.0
Westly Perryman,409,133,343,145,143,83,1633.0,109,36,84.0,234,109,15.5,2012,0.0
Drew Wiley,315,36,273,106,32,21,959.0,213,82,43.0,60,24,17.7,2012,0.0
Tre Nichols,252,49,242,87,68,53,671.0,99,25,44.0,143,62,24.2,2012,0.0
Jarrell Crayton,33,2,21,12,18,9,128.0,1,0,8.0,20,12,15.4,2012,0.0
Gabriel Moton,167,63,152,61,34,19,958.0,83,26,58.0,69,35,13.0,2012,0.0
John Cahill,114,20,79,35,19,15,735.0,64,29,15.0,15,6,7.7,2012,0.0
Deirunas Visockas,99,19,80,33,20,16,335.0,50,17,24.0,30,16,17.1,2012,0.0
Ryan Kilcullen,2,0,0,0,2,2,9.0,0,0,1.0,0,0,12.1,2012,0.0
Salah Abdo,0,0,0,0,2,0,11.0,0,0,0.0,0,0,4.8,2012,0.0
Peter Rehnquist,12,2,14,6,0,0,41.0,2,0,4.0,12,6,23.0,2012,0.0
Darryl Partin,1304,109,1111,445,336,249,2708.0,492,165,242.0,619,280,30.2,2012,0.0
Patrick Hazel,426,43,297,163,195,100,1880.0,0,0,101.0,297,163,13.8,2012,0.0
Matt Griffin,591,208,481,175,125,106,2684.0,363,135,126.0,118,40,12.9,2012,0.0
Jeff Pelage,319,20,268,126,154,67,1594.0,1,0,111.0,267,126,13.2,2012,0.0
Mike Terry,71,14,88,28,24,11,495.0,28,4,21.0,60,24,13.0,2012,0.0
Scott Thomas,1261,317,1064,450,320,210,3634.0,469,151,239.0,595,299,21.7,2012,0.0
Dee Brown,1041,193,874,375,249,188,2773.0,279,103,164.0,595,272,21.2,2012,1.0
Torian Oglesby,266,10,181,119,70,28,969.0,0,0,43.0,181,119,13.9,2012,0.0
Antonio Ferrell,2,0,2,1,0,0,8.0,0,0,0.0,2,1,13.1,2012,0.0
Charonn Woods,27,9,29,7,16,11,276.0,15,2,8.0,14,5,8.5,2012,0.0
Devon Hodges,0,1,1,0,0,0,21.0,0,0,3.0,1,0,9.9,2012,0.0
Noah Hartsock,1191,158,847,461,282,230,3331.0,99,39,123.0,748,422,16.1,2012,0.0
Charles Abouo,912,164,697,302,306,222,2527.0,244,86,151.0,453,216,19.1,2012,0.0
Stephen Rogers,256,35,193,84,63,51,613.0,107,37,36.0,86,47,20.3,2012,0.0
Nick Martineau,44,34,49,15,10,7,289.0,22,7,16.0,27,8,11.8,2012,0.0
Chris Collinsworth,165,32,153,58,78,42,716.0,42,7,43.0,111,51,16.1,2012,0.0
Jean Herbert-Harris,269,37,234,96,28,22,771.0,147,55,64.0,87,41,21.8,2012,0.0
Tellef Lundevall,42,10,58,15,6,4,230.0,30,8,7.0,28,7,15.9,2012,0.0
Patrick Donnelly,4,1,11,2,0,0,37.0,8,0,2.0,3,2,18.9,2012,0.0
Ben Altit,149,14,156,61,22,15,587.0,48,12,51.0,108,49,19.5,2012,0.0
Troy Robinson,32,19,42,12,11,7,306.0,15,1,18.0,27,11,11.2,2012,0.0
Alex Herzing,2,0,2,1,1,0,16.0,0,0,1.0,2,1,11.2,2012,0.0
Bryan Cohen,1102,313,1003,370,320,225,3829.0,400,137,288.0,603,233,19.9,2012,0.0
Enoch Andoh,186,4,154,67,75,52,679.0,0,0,63.0,154,67,19.3,2012,0.0
Probese Leo,14,1,14,6,7,2,114.0,0,0,8.0,14,6,11.8,2012,0.0
Mitchell Watt,1061,160,796,415,323,220,2495.0,34,11,224.0,762,404,24.3,2012,0.0
Zach Filzen,1155,103,946,394,122,97,2733.0,671,270,140.0,275,124,21.0,2012,0.0
Titus Robinson,681,79,447,220,355,234,2006.0,19,7,195.0,428,213,19.9,2012,0.0
Dave Barnett,469,112,431,180,104,52,1985.0,176,57,126.0,255,123,15.3,2012,0.0
Ronald Nored,835,497,646,251,449,285,4111.0,183,48,329.0,463,203,15.4,2012,0.0
Garrett Butcher,166,19,188,67,35,20,857.0,43,12,29.0,145,55,14.7,2012,0.0
Amaurys Fermin,325,119,308,117,79,54,976.0,114,37,75.0,194,80,23.7,2012,0.0
Will Taylor,475,33,374,188,147,99,1217.0,2,0,76.0,372,188,22.7,2012,0.0
Will Donahue,474,81,341,170,206,133,1696.0,7,1,110.0,334,169,17.5,2012,0.0
Matt Titchenal,88,8,91,32,18,9,300.0,45,15,13.0,46,17,20.6,2012,0.0
Jordan Lewis,343,72,300,138,73,51,1655.0,53,16,73.0,247,122,12.9,2012,0.0
Donald Johnson,484,43,387,183,101,77,1502.0,105,41,103.0,282,142,17.9,2012,0.0
Rashad Savage,342,34,265,135,124,72,1538.0,0,0,66.0,265,135,12.6,2012,0.0
Robert Hayes,130,12,93,39,43,27,228.0,62,25,15.0,31,14,28.3,2012,0.0
Andre Jackson,57,0,53,26,11,5,116.0,0,0,8.0,53,26,29.5,2012,0.0
Ivan Matip,40,5,48,14,14,7,231.0,27,5,10.0,21,9,14.0,2012,0.0
Kwai Pearson,13,3,10,5,4,2,58.0,1,1,6.0,9,4,15.9,2012,0.0
Omondi Amoke,564,54,418,209,263,146,1675.0,8,0,95.0,410,209,18.8,2012,0.0
Orane Chin,1041,170,812,371,322,220,2986.0,225,79,214.0,587,292,20.6,2012,0.0
Perry Webster,341,255,272,104,123,84,1494.0,130,49,98.0,142,55,14.4,2012,0.0
Andre Hardy,582,47,455,207,273,168,1645.0,0,0,125.0,455,207,21.6,2012,0.0
Sedric Martin,141,14,112,58,39,25,481.0,0,0,39.0,112,58,17.5,2012,0.0
Orlando Brown,175,28,126,56,60,43,705.0,53,20,49.0,73,36,14.5,2012,0.0
John Underwood,39,1,32,14,24,11,221.0,0,0,18.0,32,14,13.3,2012,0.0
Bernard Webb,16,0,11,8,1,0,33.0,0,0,5.0,11,8,24.1,2012,0.0
Cameron Glover,6,1,3,1,5,3,13.0,3,1,0.0,0,0,19.9,2012,0.0
Conway James,0,0,0,0,0,0,0.0,0,0,0.0,0,0,0,2012,0.0
Vinnie McGhee,1024,358,991,350,160,120,2946.0,607,204,227.0,384,146,21.1,2012,0.0
John Hayward-Mayhew,151,8,137,48,68,47,610.0,20,8,38.0,117,40,16.5,2012,0.0
Ari Feldman,98,10,83,37,18,14,351.0,21,10,11.0,62,27,14.0,2012,0.0
Michael Lizarraga,369,46,289,136,155,97,1332.0,1,0,94.0,288,136,16.5,2012,0.0
Frankie Eteuati,97,18,89,38,40,18,538.0,15,3,59.0,74,35,15.0,2012,0.0
Davon Potts,44,8,42,17,8,8,165.0,15,2,6.0,27,15,15.1,2012,0.0
Justin Yeargin,2,2,3,1,0,0,7.0,0,0,0.0,3,1,20.6,2012,0.0
Eddie Miller,650,88,552,233,162,113,1562.0,196,71,115.0,356,162,25.3,2012,1.0
Harrison DuPont,432,55,372,156,168,100,1237.0,61,20,105.0,311,136,24.6,2012,0.0
Adam Malik,272,59,235,98,27,18,1035.0,161,58,57.0,74,40,15.1,2012,0.0
Dominic Lippi,9,0,3,3,1,0,12.0,3,3,3.0,0,0,28.5,2012,0.0
Ryan Silva,342,110,281,110,54,39,1127.0,210,83,119.0,71,27,18.9,2012,0.0
Mike Kurtz,71,12,67,27,10,7,320.0,31,10,15.0,36,17,14.4,2012,0.0
Collin Woods,102,27,124,34,27,15,435.0,82,19,21.0,42,15,17.8,2012,0.0
Phil Martin,951,70,792,353,218,180,2005.0,184,65,146.0,608,288,27.5,2012,1.0
Kareem Nitoto,833,306,715,261,315,231,3084.0,254,80,265.0,461,181,19.6,2012,0.0
Kevin Bradshaw,402,30,329,156,156,90,1391.0,1,0,100.0,328,156,19.0,2012,0.0
Elliott Berry,346,14,340,155,51,27,1128.0,35,9,60.0,305,146,19.8,2012,0.0
BJ Shearry,336,47,314,135,118,66,1407.0,3,0,71.0,311,135,16.5,2012,0.0
Harrison Gaines,571,179,523,205,189,127,1648.0,123,34,127.0,400,171,20.4,2012,0.0
Daymond Cowlah,194,72,164,71,43,32,758.0,53,20,53.0,111,51,16.4,2012,0.0
David Chavarria,130,17,93,46,63,38,700.0,1,0,47.0,92,46,13.1,2012,0.0
John Gilliam,20,2,26,7,8,5,102.0,13,1,6.0,13,6,19.2,2012,0.0
Dominique Taplin,5,1,4,2,2,1,19.0,0,0,1.0,4,2,17.1,2012,0.0
Orlando Johnson,2208,319,1615,738,708,510,3878.0,568,222,324.0,1047,516,31.3,2012,1.0
James Nunnally,1685,247,1201,558,487,382,3618.0,484,187,276.0,717,371,25.0,2012,1.0
Jaime Serna,892,73,603,339,308,214,2501.0,3,0,168.0,600,339,19.3,2012,0.0
Greg Somogyi,425,52,359,177,129,71,1494.0,4,0,107.0,355,177,18.7,2012,0.0
Christian Peterson,55,17,45,16,34,22,476.0,1,1,26.0,44,15,9.6,2012,0.0
Jorge Gutierrez,1232,423,959,412,438,323,3425.0,250,85,274.0,709,327,21.8,2012,1.0
Harper Kamp,1133,179,807,424,363,279,3183.0,26,6,205.0,781,418,19.2,2012,0.0
Raffi Chalian,4,1,5,1,3,2,16.0,2,0,0.0,3,1,21.1,2012,0.0
Rob Filley,3,0,4,1,2,1,17.0,1,0,2.0,3,1,21.4,2012,0.0
Eric Griffin,868,74,560,313,357,210,1753.0,91,32,163.0,469,281,25.9,2012,0.0
Rico Ferguson,323,113,250,107,156,108,1205.0,5,1,87.0,245,106,17.3,2012,0.0
Lorne Merthie,1051,232,839,333,211,159,2965.0,556,226,157.0,283,107,18.8,2012,0.0
Amir Celestin,567,250,499,203,187,124,2229.0,111,37,185.0,388,166,18.3,2012,0.0
Jihad Wright,55,6,30,14,36,27,158.0,1,0,6.0,29,14,16.8,2012,0.0
Nnadozie Onuoha,2,0,1,1,0,0,4.0,0,0,0.0,1,1,12.5,2012,0.0
Franklin Milian,70,11,53,20,26,21,247.0,18,9,15.0,35,11,16.3,2012,0.0
David Santiago,29,7,35,11,10,6,172.0,9,1,9.0,26,10,14.2,2012,0.0
Marial Dhal,19,2,12,9,3,1,155.0,0,0,16.0,12,9,9.5,2012,0.0
Tyler Funk,5,1,9,2,2,1,60.0,1,0,5.0,8,2,12.5,2012,0.0
Sean Ezeamama,4,0,1,1,2,2,12.0,0,0,0.0,1,1,8.2,2012,0.0
Mark Rutledge,494,131,421,181,177,100,1623.0,117,32,107.0,304,149,17.5,2012,0.0
Dewan Clayborn,569,207,514,181,191,103,2149.0,316,104,195.0,198,77,17.7,2012,0.0
Chris Henson,277,29,281,103,61,41,875.0,103,30,41.0,178,73,19.1,2012,0.0
Darius Singleton,10,3,11,3,9,4,69.0,3,0,4.0,8,3,12.6,2012,0.0
Jeremy Nordman,4,3,10,1,2,2,33.0,7,0,4.0,3,1,20.4,2012,0.0
Jarrod Brown,0,0,1,0,0,0,3.0,1,0,0.0,0,0,15.0,2012,0.0
Ken Horton,1966,182,1421,718,457,372,3865.0,450,158,209.0,971,560,25.2,2012,0.0
Robby Ptacek,1531,220,1256,511,442,392,3699.0,357,117,293.0,899,394,24.3,2012,0.0
Shelton Mickell,40,12,47,9,23,19,175.0,16,3,20.0,31,6,22.1,2012,0.0
Mark LaPorte,11,0,14,3,6,3,32.0,7,2,1.0,7,1,27.7,2012,0.0
Marcus Jordan,1152,256,886,348,464,342,2928.0,373,114,208.0,513,234,23.5,2012,0.0
A.J. Rompza,741,487,649,242,229,160,3159.0,317,97,217.0,332,145,16.0,2012,0.0
P.J. Gaynor,494,86,386,186,144,100,1832.0,80,22,135.0,306,164,16.7,2012,0.0
Dwight McCombs,155,9,101,58,77,39,777.0,0,0,41.0,101,58,12.3,2012,0.0
Jeff Jordan,175,129,162,65,60,35,1205.0,36,10,73.0,126,55,10.8,2012,0.0
Andre Coimbra,408,32,341,158,113,68,1496.0,73,24,112.0,268,134,17.8,2012,0.0
Jevon Harden,33,1,31,14,12,5,264.0,0,0,14.0,31,14,10.1,2012,0.0
John Morris,59,37,66,23,6,3,529.0,26,10,17.0,40,13,8.5,2012,0.0
Jorddan Myrick,11,9,21,4,4,2,83.0,3,1,8.0,18,3,19.6,2012,0.0
Nick Jordan,2,1,10,1,2,0,50.0,5,0,1.0,5,1,13.0,2012,0.0
Kelvin Martin,1483,181,1062,574,527,330,3505.0,39,5,253.0,1023,569,21.8,2012,0.0
Chris Grier,184,37,152,62,51,37,585.0,57,23,48.0,95,39,18.5,2012,0.0
Javarris Barnett,713,82,615,250,106,79,2204.0,360,134,120.0,255,116,18.1,2012,0.0
Jamar Briscoe,1116,200,949,364,326,249,2582.0,402,139,244.0,547,225,23.0,2012,0.0
Derrio Green,958,230,854,293,259,206,2419.0,554,166,177.0,300,127,24.2,2012,0.0
Kj Sherrill,243,19,187,85,108,73,1041.0,2,0,58.0,185,85,14.6,2012,0.0
Luka Voncina,24,8,25,9,2,1,125.0,16,5,10.0,9,4,14.4,2012,0.0
Ricky Taylor,1225,159,998,408,334,252,2659.0,450,157,182.0,548,251,24.5,2012,0.0
Omar Wattad,896,133,786,284,192,144,2080.0,522,184,144.0,264,100,24.2,2012,0.0
Keegan Bell,905,633,868,294,181,129,3659.0,629,188,312.0,239,106,16.9,2012,0.0
Jahmal Burroughs,289,41,229,107,155,71,1298.0,26,4,66.0,203,103,14.5,2012,0.0
Chris Early,550,71,486,200,156,93,1452.0,177,57,121.0,309,143,22.7,2012,0.0
Drew Baker,34,3,22,13,25,8,129.0,0,0,13.0,22,13,17.8,2012,0.0
Lee Fisher,636,109,523,219,277,168,2336.0,91,30,163.0,432,189,17.3,2012,0.0
Matt Samuels,411,86,347,142,185,109,1095.0,71,18,111.0,276,124,24.4,2012,0.0
Ardarius Simmons,383,133,375,143,77,57,1441.0,103,40,104.0,272,103,17.1,2012,0.0
D'Jari Nelson,110,4,92,43,30,16,570.0,25,8,45.0,67,35,12.8,2012,0.0
Jacobby Anderson,74,14,88,25,4,4,371.0,71,20,23.0,17,5,14.7,2012,0.0
Francisco Concepcion,0,1,3,0,0,0,19.0,0,0,1.0,3,0,10.2,2012,0.0
Dion Dixon,1281,221,1108,421,409,294,3426.0,498,145,177.0,610,276,22.7,2012,0.0
Yancy Gates,1485,108,1246,618,411,242,3573.0,26,7,167.0,1220,611,22.2,2012,0.0
DeVontae Wright,263,94,246,85,99,69,988.0,76,24,75.0,170,61,19.7,2012,0.0
Bo Holston,286,60,241,103,104,68,1267.0,44,12,101.0,197,91,16.5,2012,0.0
Cosmo Morabbi,412,115,418,143,87,58,1884.0,233,68,94.0,185,75,15.3,2012,0.0
Nathan Conley,5,1,6,2,0,0,21.0,4,1,1.0,2,1,17.7,2012,0.0
Will Keistler,1,1,0,0,2,1,5.0,0,0,0.0,0,0,10.1,2012,0.0
Andre Young,1223,342,1004,406,227,175,3489.0,629,236,163.0,375,170,18.7,2012,0.0
Tanner Smith,986,320,777,333,288,209,3166.0,340,111,227.0,437,222,18.3,2012,0.0
Catalin Baciu,184,7,145,79,52,26,494.0,0,0,36.0,145,79,21.7,2012,0.0
Bryan Narcisse,242,39,194,90,75,45,1069.0,60,17,55.0,134,73,13.8,2012,0.0
Trevon Harmon,1326,184,1112,442,290,236,3484.0,618,206,162.0,494,236,21.2,2012,0.0
Jeremy Montgomery,1349,276,1099,446,311,245,3527.0,600,212,281.0,499,234,22.7,2012,0.0
D'Aundray Brown,896,214,731,356,194,149,3262.0,105,35,168.0,626,321,15.9,2012,0.0
Aaron Pogue,686,86,503,252,343,181,2307.0,1,1,180.0,502,251,19.2,2012,0.0
Josh Gottshall,0,0,0,0,0,0,2.0,0,0,0.0,0,0,0.0,2012,0.0
Chris Gradnigo,1461,79,1222,542,306,234,2891.0,397,143,211.0,825,399,28.9,2012,0.0
Jon Pack,413,48,294,160,180,93,1585.0,1,0,98.0,293,160,15.7,2012,0.0
Dexter Moore,559,86,493,197,59,42,1588.0,340,123,67.0,153,74,17.4,2012,0.0
Danny Nieman,512,244,427,178,134,81,2314.0,205,75,127.0,222,103,13.3,2012,0.0
Brandon Crawford,447,86,325,154,167,111,1412.0,68,28,80.0,257,126,17.1,2012,0.0
Willie Kirkland,51,2,37,18,13,10,119.0,17,5,6.0,20,13,20.7,2012,0.0
Mike Venezia,1027,120,918,341,186,149,3289.0,531,196,154.0,387,145,18.9,2012,0.0
Sterling Melville,513,63,363,170,280,159,1466.0,51,14,120.0,312,156,22.2,2012,0.0
Nick Pascale,595,93,443,219,248,157,2167.0,1,0,148.0,442,219,17.2,2012,0.0
Yaw Gyawu,1228,91,962,473,430,279,2880.0,16,3,220.0,946,470,25.4,2012,0.0
Antwaine Wiggins,1306,232,1156,487,286,158,3939.0,545,174,205.0,611,313,19.1,2012,0.0
Will Bell,343,23,231,120,132,103,999.0,0,0,64.0,231,120,19.4,2012,0.0
Jesse Carr,598,204,451,200,170,121,2010.0,217,77,152.0,234,123,17.6,2012,0.0
Kaipo Sabas,140,33,96,46,25,20,681.0,63,28,35.0,33,18,11.5,2012,0.0
Carlon Brown,1308,307,1085,478,370,262,3516.0,295,90,270.0,790,388,23.4,2012,0.0
Austin Dufault,1076,118,866,410,304,199,3439.0,185,57,143.0,681,353,17.8,2012,0.0
Nate Tomlinson,675,405,486,216,163,118,3540.0,308,125,241.0,178,91,12.2,2012,0.0
Shannon Sharpe,99,54,84,34,53,29,601.0,18,2,37.0,66,32,12.3,2012,0.0
Damiene Cain,8,0,4,3,4,2,52.0,0,0,8.0,4,3,14.2,2012,0.0
Beau Webb,6,0,2,2,0,0,16.0,2,2,1.0,0,0,9.9,2012,0.0
Trey Eckloff,101,19,103,39,24,13,450.0,39,10,36.0,64,29,18.2,2012,0.0
Chris Crockett,175,29,157,56,21,15,455.0,130,48,34.0,27,8,24.2,2012,0.0
Blaise Staab,134,18,122,55,42,22,468.0,6,2,26.0,116,53,19.6,2012,0.0
Steve Egee,194,53,205,69,42,30,842.0,96,26,72.0,109,43,18.7,2012,0.0
Noruwa Agho,1207,226,1024,413,356,247,2773.0,335,134,205.0,689,279,26.1,2012,0.0
Matt Johnson,58,16,73,19,15,11,482.0,51,9,29.0,22,10,12.0,2012,0.0
Darius Stevens,8,0,5,1,8,6,25.0,0,0,2.0,5,1,23.8,2012,0.0
Jeremy Lamb,1060,124,828,399,180,145,2406.0,336,117,120.0,492,282,22.2,2012,1.0
Andre Drummond,340,15,292,157,88,26,967.0,2,0,52.0,290,157,20.9,2012,1.0
Kyle Bailey,0,1,1,0,0,0,20.0,1,0,1.0,0,0,4.2,2012,0.0
P.J. Cochrane,0,0,0,0,0,0,3.0,0,0,0.0,0,0,0.0,2012,0.0
Benjamin Stewart,2,0,2,1,0,0,7.0,0,0,0.0,2,1,14.5,2012,0.0
Ethan Waite,0,0,0,0,0,0,1.0,0,0,2.0,0,0,100.0,2012,0.0
Tony Gallo,856,191,650,249,298,227,1863.0,377,131,142.0,273,118,24.9,2012,0.0
Akeem Ellis,746,167,584,249,241,145,1922.0,278,103,155.0,306,146,22.0,2012,0.0
Logan Wiens,272,42,201,91,49,45,627.0,111,45,23.0,90,46,19.6,2012,0.0
Antonio Williams,462,59,331,182,156,97,1512.0,6,1,84.0,325,181,16.1,2012,0.0
Jordan Lee,313,15,273,100,73,59,687.0,159,54,35.0,114,46,26.1,2012,0.0
Rodney Edwards,6,0,7,2,2,1,20.0,3,1,2.0,4,1,24.8,2012,0.0
Chris Wroblewski,1202,481,912,367,339,279,3594.0,456,189,259.0,456,178,20.8,2012,0.0
Andrew Ferry,668,76,562,224,72,53,1834.0,436,167,67.0,126,57,19.0,2012,0.0
Max Groebe,297,29,265,102,20,14,829.0,202,79,21.0,63,23,18.4,2012,0.0
Anthony Gatlin,315,29,274,123,49,34,1220.0,89,35,62.0,185,88,18.1,2012,0.0
Antoine Young,1342,505,1120,454,509,362,3815.0,245,72,229.0,875,382,22.2,2012,0.0
Ross Ferrarini,17,1,18,6,0,0,45.0,15,5,3.0,3,1,24.8,2012,0.0
Matt Dorwart,11,0,11,3,6,3,53.0,5,2,4.0,6,1,17.8,2012,0.0
Derek Sebastian,12,4,9,5,6,2,51.0,0,0,3.0,9,5,15.5,2012,0.0
R.J. Griffin,591,68,520,192,155,120,1907.0,248,87,114.0,272,105,20.0,2012,0.0
Jabari Trotter,776,164,737,284,169,106,2836.0,302,102,155.0,435,182,18.3,2012,0.0
David Rufful,812,133,827,315,157,97,2729.0,256,85,191.0,571,230,21.2,2012,0.0
Kirk Crecco,245,26,234,91,71,51,853.0,60,12,49.0,174,79,20.2,2012,0.0
Nick Jackson,54,4,64,21,2,2,235.0,27,10,19.0,37,11,18.9,2012,0.0
Frank Ben-Eze,130,19,129,55,38,20,713.0,0,0,48.0,129,55,13.5,2012,0.0
Will Reigel,49,30,31,14,28,21,442.0,5,0,14.0,26,14,6.5,2012,0.0
A.J. Atkinson,19,2,16,7,5,3,91.0,8,2,3.0,8,5,11.6,2012,0.0
Paul Williams,876,147,764,278,210,165,3044.0,426,155,131.0,338,123,16.6,2012,0.0
Josh Parker,954,229,780,300,252,189,2338.0,470,165,202.0,310,135,23.5,2012,0.0
Luke Fabrizius,541,45,490,188,31,19,1335.0,385,146,46.0,105,42,21.0,2012,0.0
Dennis Williams,0,0,0,0,0,0,1.0,0,0,0.0,0,0,0.0,2012,0.0
Jay Threatt,748,460,637,253,241,179,3026.0,216,63,172.0,421,190,17.2,2012,0.0
James Marcellus,121,10,91,45,51,31,652.0,0,0,24.0,91,45,12.1,2012,0.0
Lewis Lott,7,1,5,3,1,0,20.0,3,1,1.0,2,2,18.0,2012,0.0
Abdulwali Kasim,5,2,10,2,2,1,63.0,0,0,0.0,10,2,9.7,2012,0.0
Everett Christian,2,1,2,1,0,0,12.0,1,0,0.0,1,1,9.3,2012,0.0
Hakim McCullar,294,25,294,115,103,64,1223.0,3,0,63.0,291,115,17.5,2012,0.0
Samer Madarani,17,3,17,6,6,2,30.0,12,3,3.0,5,3,39.1,2012,0.0
Brian Stafford,1586,248,1040,501,399,320,4101.0,616,264,212.0,424,237,22.1,2012,0.0
Justin Coughlin,394,92,298,138,111,71,1475.0,145,47,86.0,153,91,18.8,2012,0.0
Travis Hallam,483,194,393,173,90,61,2710.0,195,76,122.0,198,97,14.0,2012,0.0
Tyler Thalken,152,29,94,47,38,31,739.0,60,27,27.0,34,20,11.8,2012,0.0
Alex Pickert,12,1,10,5,3,1,40.0,2,1,5.0,8,4,25.5,2012,0.0
Jeremiah Kelly,795,364,780,284,108,75,3504.0,466,152,145.0,314,132,14.0,2012,0.0
Krys Faber,460,36,352,173,176,113,1922.0,1,1,100.0,351,172,14.0,2012,0.0
Joe Belcaster,4,0,2,1,2,1,15.0,2,1,1.0,0,0,12.7,2012,0.0
Chase Simon,1484,226,1315,525,418,290,3556.0,449,144,316.0,866,381,25.6,2012,0.0
Eli Holman,1030,70,679,411,322,208,2431.0,0,0,164.0,679,411,20.3,2012,0.0
LaMarcus Lowe,419,21,306,148,188,123,1686.0,0,0,110.0,306,148,15.1,2012,0.0
Donavan Foster,529,193,499,185,186,118,2140.0,135,41,159.0,364,144,17.6,2012,0.0
Brandon Romain,2,0,1,0,4,2,8.0,0,0,0.0,1,0,18.3,2012,0.0
Kurt Alexander,454,105,379,153,163,125,1240.0,61,23,111.0,318,130,24.7,2012,0.0
Kraidon Woods,239,29,142,92,137,55,1101.0,0,0,74.0,142,92,13.9,2012,0.0
David Smith,63,33,41,20,41,23,478.0,0,0,38.0,41,20,11.2,2012,0.0
Judd Welfringer,15,9,19,5,4,2,134.0,16,3,6.0,3,2,10.7,2012,0.0
Cory Parker,20,4,14,7,11,5,148.0,4,1,3.0,10,6,8.2,2012,0.0
Greg Whitaker,5,0,2,1,4,3,12.0,0,0,0.0,2,1,17.4,2012,0.0
Reece Uhlenhopp,115,10,104,39,19,16,594.0,54,21,16.0,50,18,12.1,2012,0.0
Samme Givens,1226,154,954,481,437,264,3418.0,1,0,207.0,953,481,21.2,2012,0.0
Austin Rivers,527,71,402,174,184,121,1129.0,159,58,79.0,243,116,25.2,2012,1.0
Miles Plumlee,650,45,470,262,200,125,2133.0,1,1,138.0,469,261,16.2,2012,1.0
B.J. Monteiro,1227,211,1028,475,367,195,2901.0,262,82,173.0,766,393,23.2,2012,0.0
Eric Evans,1055,309,893,343,387,271,3008.0,360,98,196.0,533,245,20.8,2012,0.0
Rich Piekarski,0,2,1,0,0,0,1.0,0,0,0.0,1,0,50.3,2012,0.0
Darrius Morrow,1506,120,946,514,723,478,3717.0,3,0,254.0,943,514,22.2,2012,0.0
Erin Straughn,465,103,405,163,95,60,2076.0,233,79,118.0,172,84,14.1,2012,0.0
Austin Steed,283,22,219,106,111,71,1070.0,0,0,65.0,219,106,16.0,2012,0.0
Darius Morales,57,1,49,25,16,7,262.0,0,0,17.0,49,25,14.7,2012,0.0
Adam Sollazzo,1031,409,740,337,520,340,3184.0,68,17,304.0,672,320,22.1,2012,0.0
Tommy Hubbard,877,90,742,326,277,192,2580.0,114,33,177.0,628,293,21.4,2012,0.0
J.C. Ward,154,23,113,54,64,36,1054.0,23,10,35.0,90,44,8.5,2012,0.0
Ryan Woumn,1,1,1,0,2,1,13.0,0,0,3.0,1,0,19.0,2012,0.0
Jeremy Granger,1287,313,1021,451,367,319,3344.0,178,66,202.0,843,385,22.4,2012,0.0
L.C. Doss,282,53,261,99,42,30,1056.0,153,54,46.0,108,45,16.6,2012,0.0
Zavier Sanders,313,46,269,123,113,67,1254.0,3,0,65.0,266,123,16.6,2012,0.0
James Hollowell,590,90,525,234,156,110,1665.0,36,12,112.0,489,222,22.9,2012,0.0
Nick Mcfarlin,149,20,120,58,44,31,605.0,6,2,42.0,114,56,15.8,2012,0.0
Jonathan Miller,25,2,19,8,9,6,58.0,6,3,7.0,13,5,28.0,2012,0.0
Jaron Jones,617,69,405,216,208,158,1384.0,71,27,72.0,334,189,23.3,2012,0.0
Joshua Jones,1192,236,943,405,255,182,3615.0,510,200,170.0,433,205,19.2,2012,0.0
D'Mitri Riggs,250,43,218,80,67,52,867.0,106,38,28.0,112,42,17.9,2012,0.0
Jeff Allgood,206,47,176,67,20,16,768.0,146,56,35.0,30,11,16.2,2012,0.0
Jabs Newby,98,74,115,37,35,20,615.0,23,4,41.0,92,33,15.8,2012,0.0
Taylor Filipek,53,37,72,19,36,14,598.0,13,1,25.0,59,18,10.8,2012,0.0
Darrell Lampley,894,265,836,295,242,196,2260.0,371,108,233.0,465,187,27.1,2012,0.0
Quintin Dailey,230,59,220,81,43,31,1049.0,112,37,60.0,108,44,15.4,2012,1.0
Kamil Janton,121,3,105,51,49,19,624.0,0,0,45.0,105,51,14.2,2012,0.0
Cliff Colimon,797,207,660,267,189,149,1753.0,311,114,165.0,349,153,26.0,2012,0.0
Cliff Ederain,591,131,459,221,270,146,1766.0,13,3,173.0,446,218,21.5,2012,0.0
Laron Griffin,598,52,454,229,255,140,1875.0,0,0,89.0,454,229,17.6,2012,0.0
Tremayne Johnson,505,34,431,168,187,137,1258.0,125,32,108.0,306,136,25.0,2012,0.0
Willie Hankins,4,1,8,2,0,0,16.0,1,0,0.0,7,2,24.7,2012,0.0
Jaylen Henry,19,2,24,8,6,3,160.0,2,0,6.0,22,8,10.4,2012,0.0
Rocky Brown,34,6,38,12,15,7,186.0,11,3,12.0,27,9,15.6,2012,0.0
Drew Spradlin,1259,164,1060,433,338,213,2951.0,483,180,196.0,577,253,24.1,2012,0.0
Brett Ervin,235,12,188,83,44,27,745.0,117,42,34.0,71,41,16.2,2012,0.0
Lucas Weavil,5,1,7,2,0,0,10.0,6,1,1.0,1,1,39.6,2012,0.0
Kenny Harris,617,94,443,188,306,220,1715.0,73,21,115.0,370,167,21.9,2012,0.0
Denver Holmes,975,269,744,333,260,211,2889.0,256,98,207.0,488,235,19.8,2012,0.0
Matt Peeler,27,0,27,11,16,5,171.0,0,0,14.0,27,11,15.1,2012,0.0
Rakim Sanders,1663,246,1383,632,369,229,3637.0,503,170,326.0,880,462,26.3,2012,0.0
Ryan Olander,972,124,798,371,291,182,3114.0,158,48,189.0,640,323,18.9,2012,0.0
Sean Crawford,347,98,296,99,111,90,1169.0,182,59,79.0,114,40,18.3,2012,0.0
Adam Jones,27,3,24,10,10,7,164.0,0,0,5.0,24,10,10.8,2012,0.0
Gary Martin,16,5,22,6,4,2,66.0,11,2,2.0,11,4,20.4,2012,0.0
George Goode,487,55,412,200,122,85,1302.0,12,2,68.0,400,198,22.1,2012,0.0
Briahn Smith,344,43,357,116,70,50,1206.0,203,62,50.0,154,54,18.4,2012,0.0
Lonnie Hayes,143,45,143,49,50,35,400.0,40,10,48.0,103,39,27.4,2012,0.0
Mouhamed Lo,405,37,329,154,187,97,1625.0,6,0,122.0,323,154,18.2,2012,0.0
Ayotunde Oyeniyi,75,6,66,28,26,19,377.0,0,0,29.0,66,28,14.4,2012,0.0
Sam Fernley,74,34,82,22,18,12,590.0,65,18,21.0,17,4,9.0,2012,0.0
Louis Larizza,35,8,41,11,10,6,164.0,25,7,9.0,16,4,17.0,2012,0.0
Amin Stevens,970,88,776,377,277,179,2103.0,142,37,181.0,634,340,25.1,2012,0.0
Yannick Crowder,876,44,706,324,334,228,2827.0,2,0,172.0,704,324,18.6,2012,0.0
Jeremy Dean,290,60,249,108,154,71,1323.0,23,3,97.0,226,105,15.2,2012,0.0
Nathaniel Drayton,143,4,128,58,49,26,384.0,3,1,33.0,125,57,22.7,2012,0.0
Chris Watson,208,25,178,70,73,39,702.0,84,29,51.0,94,41,18.0,2012,0.0
Jeffrey Kennings,96,74,140,38,24,12,786.0,45,8,90.0,95,30,14.7,2012,0.0
Brandon Hosley,277,45,237,85,77,56,778.0,148,51,62.0,89,34,20.9,2012,0.0
Vaughn Rose,11,0,9,4,8,3,107.0,0,0,7.0,9,4,8.8,2012,0.0
Isaac Brown,40,38,64,12,30,14,387.0,22,2,36.0,42,10,14.6,2012,0.0
Jeffrey Neal,6,1,5,1,6,4,15.0,0,0,1.0,5,1,27.9,2012,0.0
Shavar Richardson,1018,136,931,351,194,159,2548.0,463,157,134.0,468,194,23.3,2012,0.0
Alex Tucker,740,538,577,230,364,264,3204.0,75,16,272.0,502,214,16.5,2012,0.0
Jelani Floyd,67,16,89,24,28,15,472.0,21,4,30.0,68,20,14.3,2012,0.0
Kevin Cantinol,254,23,237,109,80,36,1042.0,0,0,60.0,237,109,16.6,2012,0.0
Ed Rolax,193,50,171,64,87,60,1024.0,24,5,61.0,147,59,12.8,2012,0.0
Zachery Christian,2,1,1,1,0,0,2.0,0,0,0.0,1,1,25.1,2012,0.0
Jeremy Allen,1093,125,939,372,293,232,3076.0,361,117,206.0,578,255,21.8,2012,0.0
Phil Taylor,480,105,372,141,158,125,1155.0,193,73,95.0,179,68,24.6,2012,0.0
DeJuan Wright,789,76,514,263,316,228,1673.0,83,35,139.0,431,228,24.6,2012,0.0
Dominique Ferguson,394,31,345,142,183,97,1379.0,64,13,89.0,281,129,19.6,2012,0.0
Bernard James,671,24,437,274,233,123,1698.0,0,0,123.0,437,274,19.7,2012,1.0
Luke Loucks,595,391,504,193,178,121,2673.0,271,88,249.0,233,105,15.7,2012,0.0
Deividas Dulkys,876,141,779,299,106,75,2804.0,572,203,160.0,207,96,17.6,2012,0.0
Xavier Gibson,605,40,485,237,189,119,1610.0,48,12,156.0,437,225,22.7,2012,0.0
Jeff Peterson,711,329,599,238,236,173,2738.0,192,62,287.0,407,176,20.2,2012,0.0
Jon Kreft,177,15,143,67,72,43,605.0,0,0,66.0,143,67,20.1,2012,0.0
Bradley Beal,546,83,393,175,173,133,1267.0,186,63,79.0,207,112,23.0,2012,1.0
Erving Walker,1777,547,1345,527,550,438,4358.0,755,285,302.0,590,242,22.9,2012,0.0
Kervin Bristol,263,24,231,116,70,31,1385.0,0,0,51.0,231,116,11.2,2012,0.0
Alberto Estwick,791,133,801,296,80,49,2853.0,466,150,130.0,335,146,16.6,2012,0.0
Lamount Samuell,141,64,123,45,71,43,537.0,30,8,70.0,93,37,20.7,2012,0.0
Ryan Hage,11,4,9,3,12,5,69.0,2,0,8.0,7,3,16.1,2012,0.0
Jonathan Wills,638,155,530,215,209,158,2272.0,161,50,135.0,369,165,18.8,2012,0.0
Steven Shepp,444,395,415,146,122,72,2717.0,259,80,170.0,156,66,12.4,2012,0.0
Larry McGaughney,68,4,64,28,5,1,245.0,32,11,6.0,32,17,16.1,2012,0.0
Grant Hefeng,4,1,10,1,4,2,55.0,0,0,6.0,10,1,17.7,2012,0.0
Brandon Sebirumbi,903,87,554,295,478,313,2788.0,1,0,184.0,553,295,18.2,2012,0.0
Bryson Barnes,656,50,515,222,249,176,1640.0,110,36,132.0,405,186,24.3,2012,0.0
Chris Toler,271,31,268,109,92,53,1528.0,0,0,97.0,268,109,14.0,2012,0.0
Tyler Hunt,0,0,0,0,3,0,5.0,0,0,1.0,0,0,25.4,2012,0.0
Graham Rogers,0,0,0,0,0,0,6.0,0,0,0.0,0,0,0.0,2012,0.0
Jason Dawson,502,181,445,155,125,89,1764.0,285,103,137.0,160,52,20.5,2012,0.0
Laron Buggs,513,113,434,167,210,141,1614.0,125,38,121.0,309,129,20.9,2012,0.0
Santoine Butler,133,5,95,54,37,25,381.0,0,0,20.0,95,54,17.9,2012,0.0
Jay Royster,2,10,3,1,2,0,72.0,2,0,5.0,1,1,6.4,2012,0.0
Michael Morrison,932,147,668,379,377,174,2792.0,1,0,139.0,667,379,17.8,2012,0.0
Andre Cornelius,949,176,779,321,196,141,2902.0,435,166,194.0,344,155,18.8,2012,0.0
Jordan Baird,2,1,3,1,0,0,5.0,0,0,1.0,3,1,40.6,2012,0.0
Jacob Hoxie,2,0,1,1,0,0,3.0,0,0,0.0,1,1,16.9,2012,0.0
Tony Taylor,1345,486,1081,434,522,365,3821.0,328,112,267.0,753,322,21.4,2012,0.0
Aaron Ware,644,101,551,222,258,192,2233.0,35,8,130.0,516,214,18.4,2012,0.0
Jabari Edwards,172,23,154,76,55,20,1206.0,0,0,45.0,154,76,9.6,2012,0.0
Michael Conward,4,0,3,2,2,0,9.0,0,0,1.0,3,2,27.5,2012,0.0
Roy Ghantous,0,0,0,0,0,0,3.0,0,0,2.0,0,0,34.6,2012,0.0
Malik Tonkins,0,0,0,0,0,0,1.0,0,0,0.0,0,0,0.0,2012,0.0
Jason Clark,1363,206,990,475,300,230,3760.0,504,183,257.0,486,292,19.7,2012,0.0
Hollis Thompson,859,105,645,308,170,115,2434.0,291,128,107.0,354,180,18.3,2012,1.0
Henry Sims,591,167,447,214,246,161,1822.0,17,2,158.0,430,212,21.3,2012,1.0
Ben Drayton,1495,379,1155,533,432,304,3650.0,343,125,300.0,812,408,22.8,2012,0.0
Willie Powers,1321,460,1042,466,369,276,3256.0,338,113,290.0,704,353,24.6,2012,0.0
Tyrone Brown,73,5,53,32,14,9,246.0,0,0,20.0,53,32,17.1,2012,0.0
Edwin Harvey,2,0,1,1,0,0,3.0,0,0,1.0,1,1,35.2,2012,0.0
Chad Waddell,2,1,3,1,0,0,12.0,1,0,3.0,2,1,26.4,2012,0.0
Joe Goydish,0,0,0,0,0,0,2.0,0,0,0.0,0,0,0.0,2012,0.0
Jihad Ali,923,129,914,361,144,94,2809.0,304,107,137.0,610,254,20.9,2012,0.0
Eric Buckner,658,24,447,262,249,134,1798.0,0,0,102.0,447,262,19.4,2012,0.0
James Fields,643,244,551,227,280,171,2683.0,68,18,195.0,483,209,17.0,2012,0.0
Josh Micheaux,451,192,350,155,207,132,1569.0,33,9,152.0,317,146,20.0,2012,0.0
Tony Kimbro,111,28,96,43,41,17,477.0,26,8,30.0,70,35,15.9,2012,0.0
Brandon McGee,369,45,355,137,91,54,1030.0,160,41,70.0,195,96,23.8,2012,0.0
Jamar Taylor,22,0,16,7,12,8,126.0,0,0,10.0,16,7,13.2,2012,0.0
Justin Green,0,1,1,0,0,0,4.0,0,0,0.0,1,0,13.0,2012,0.0
Glen Rice Jr.,861,185,727,316,211,129,2156.0,289,100,162.0,438,216,23.0,2012,0.0
Nick Foreman,144,34,115,49,39,27,928.0,49,19,25.0,66,30,8.4,2012,0.0
Derek Craig,21,6,26,8,2,2,80.0,17,3,8.0,9,5,22.3,2012,0.0
McPherson Moore,8,1,6,3,0,0,19.0,3,2,1.0,3,1,19.3,2012,0.0
D.J. Spain,2,1,2,1,0,0,3.0,0,0,1.0,2,1,53.9,2012,0.0
Gerald Robinson,1876,404,1517,676,495,377,3981.0,460,147,342.0,1057,529,26.9,2012,0.0
Dustin Ware,1007,400,808,306,250,201,3823.0,536,194,186.0,272,112,15.0,2012,0.0
Connor Nolte,397,64,342,134,75,49,1584.0,227,80,85.0,115,54,15.6,2012,0.0
Jay Rome,3,0,3,1,2,1,17.0,0,0,1.0,3,1,16.2,2012,0.0
Matt Bucklin,6,3,5,1,6,4,40.0,1,0,4.0,4,1,16.0,2012,0.0
Elliott Long,0,0,1,0,0,0,6.0,0,0,0.0,1,0,9.2,2012,0.0
Robert Sacre,1270,91,812,409,614,451,2946.0,4,1,220.0,808,408,22.8,2012,1.0
Marquise Carter,347,128,238,107,142,109,1115.0,76,24,85.0,162,83,17.9,2012,0.0
Mathis Monninghoff,166,19,134,55,16,11,535.0,110,45,18.0,24,10,15.1,2012,0.0
Mathis Keita,76,21,56,29,26,14,284.0,15,4,18.0,41,25,15.4,2012,0.0
Quincy Roberts,657,72,544,215,213,170,1457.0,188,57,127.0,356,158,27.3,2012,0.0
Xavier Rogers,215,40,230,77,38,22,720.0,132,39,47.0,98,38,21.5,2012,0.0
Rondale Livas,117,54,132,40,54,34,702.0,13,3,87.0,119,37,18.3,2012,0.0
Raschard Boatner,154,36,167,57,17,10,559.0,104,30,41.0,63,27,21.4,2012,0.0
Tyrik Tucker,0,0,0,0,0,0,0.0,0,0,2.0,0,0,0,2012,0.0
Steve Baker,428,99,380,162,66,44,1544.0,142,60,93.0,238,102,16.9,2012,0.0
Terry Johnson,176,44,155,57,73,52,598.0,41,10,43.0,114,47,20.2,2012,0.0
Clayton Heuer,59,5,73,23,9,7,197.0,41,6,11.0,32,17,23.1,2012,0.0
Eric Valentin,11,5,12,3,6,4,44.0,7,1,4.0,5,2,22.2,2012,0.0
Darrion Pellum,1609,172,1471,549,438,314,3632.0,651,197,285.0,820,352,27.4,2012,0.0
Christopher Tolson,735,128,717,253,166,119,2294.0,437,110,137.0,280,143,18.3,2012,0.0
Mike Tuitt,521,262,442,170,280,154,1880.0,115,27,184.0,327,143,20.3,2012,0.0
Danny Agbelese,324,25,241,132,144,60,1507.0,0,0,42.0,241,132,11.8,2012,0.0
Orin O'Bryant,43,8,36,18,21,7,273.0,0,0,20.0,36,18,12.1,2012,0.0
Koron Reed,96,4,71,43,31,10,524.0,0,0,13.0,71,43,9.6,2012,0.0
Travis McClenny,4,1,12,1,3,1,35.0,10,1,1.0,2,0,20.7,2012,0.0
Bakari Taylor,18,1,17,9,0,0,85.0,1,0,2.0,16,9,11.3,2012,0.0
Milade Lola-Charles,81,3,87,31,42,19,786.0,0,0,53.0,87,31,10.4,2012,0.0
Andres Torres,716,331,571,223,256,177,2788.0,307,93,258.0,264,130,18.5,2012,0.0
Genesis Maciel,575,83,539,209,86,61,1728.0,272,96,112.0,267,113,21.8,2012,0.0
Clayton Brothers,373,150,371,127,165,89,2316.0,121,30,159.0,250,97,14.3,2012,0.0
Ryan Baker,128,16,101,43,23,17,524.0,70,25,14.0,31,18,13.0,2012,0.0
Ben O'Neill,1,0,5,0,2,1,18.0,2,0,1.0,3,0,21.0,2012,0.0
Charles White,132,35,132,54,40,22,617.0,16,2,42.0,116,52,16.8,2012,0.0
Keith Wright,1178,89,870,487,290,204,2926.0,2,0,221.0,868,487,23.2,2012,0.0
Oliver McNally,901,326,568,252,328,282,3222.0,299,115,158.0,269,137,15.1,2012,0.0
Joston Thomas,738,73,576,277,286,178,1474.0,44,6,161.0,532,271,29.4,2012,0.0
Zane Johnson,1060,143,826,336,204,168,2757.0,572,220,157.0,254,116,19.7,2012,0.0
Trevor Wiseman,316,60,206,107,138,100,1281.0,6,2,89.0,200,105,13.9,2012,0.0
Jeremiah Ostrowski,211,251,183,70,88,53,1246.0,73,18,110.0,110,52,13.3,2012,0.0
Bobby Miles,121,96,107,40,62,32,838.0,33,9,78.0,74,31,12.7,2012,0.0
Pi'i Minns,6,1,6,2,2,2,15.0,1,0,1.0,5,2,25.7,2012,0.0
Nick Barbour,2121,137,1582,660,620,487,3525.0,780,314,265.0,802,346,30.3,2012,0.0
Shay Shine,925,175,702,311,239,186,1920.0,292,117,141.0,410,194,25.5,2012,0.0
Xavier Martin,327,103,292,101,154,102,1067.0,78,23,105.0,214,78,22.6,2012,0.0
Georges Massoda,15,2,15,6,6,3,161.0,0,0,13.0,15,6,9.6,2012,0.0
Mike Moore,1641,190,1326,535,448,362,3424.0,585,209,230.0,741,326,26.7,2012,0.0
Nathaniel Lester,1139,108,970,377,433,320,3109.0,255,65,210.0,715,312,22.0,2012,0.0
Dwan McMillan,245,189,211,78,128,86,1203.0,24,3,110.0,187,75,16.3,2012,0.0
Bryant Crowder,23,0,15,9,13,5,55.0,0,0,7.0,15,9,25.9,2012,0.0
Jereme Good,0,0,1,0,0,0,10.0,0,0,2.0,1,0,15.2,2012,0.0
Tevin Smikle,0,0,0,0,0,0,0.0,0,0,0.0,0,0,0,2012,0.0
Devin Brown,1427,149,1047,439,450,358,2991.0,507,191,230.0,540,248,25.6,2012,1.0
Mike Cavataio,716,160,629,274,184,146,2177.0,91,22,126.0,538,252,19.8,2012,0.0
Jeff Harris,15,9,12,4,5,5,54.0,8,2,9.0,4,2,22.6,2012,0.0
Charlie Mills,0,0,1,0,0,0,12.0,0,0,1.0,1,0,8.6,2012,0.0
Terry Bembry,512,38,453,200,222,112,1431.0,0,0,88.0,453,200,20.9,2012,0.0
Joe Latas,353,32,278,137,143,79,1034.0,0,0,89.0,278,137,19.9,2012,0.0
Ronald March,129,9,108,48,28,17,280.0,49,16,23.0,59,32,23.4,2012,0.0
Aaron Asp,12,3,20,1,14,10,83.0,8,0,8.0,12,1,19.2,2012,0.0
Jonathon Simmons,441,65,301,154,141,101,902.0,83,32,100.0,218,122,26.1,2012,1.0
Darian Thibodeaux,424,137,360,147,45,36,1905.0,240,94,78.0,120,53,12.4,2012,0.0
Rakim Stevenson,0,0,1,0,0,0,7.0,0,0,0.0,1,0,7.5,2012,0.0
Glenn Andrews,814,115,808,267,205,141,1838.0,468,139,157.0,340,128,29.6,2012,0.0
Dadrian Collins,710,76,668,237,132,93,2074.0,424,143,138.0,244,94,21.3,2012,0.0
Brandon Bailey,37,4,29,16,9,5,223.0,0,0,20.0,29,16,11.9,2012,0.0
Clinton Cuffee,50,41,51,20,23,9,437.0,3,1,42.0,48,19,12.0,2012,0.0
Kenny McGowan,709,111,573,217,220,174,1523.0,315,101,122.0,258,116,27.5,2012,0.0
Chase Grabau,534,148,369,179,177,127,1741.0,132,49,102.0,237,130,16.7,2012,0.0
Abner Moreira,353,57,287,131,128,91,1811.0,2,0,127.0,285,131,13.7,2012,0.0
Garrett Swanson,68,1,73,27,17,11,252.0,21,3,16.0,52,24,20.2,2012,0.0
Brandon Glanz,17,1,10,5,11,7,38.0,0,0,2.0,10,5,23.7,2012,0.0
Travis Martin,7,2,3,2,2,2,18.0,1,1,1.0,2,1,14.4,2012,0.0
Vishal Banipal,6,3,9,2,2,0,40.0,8,2,0.0,1,0,13.0,2012,0.0
Conner Moore,0,0,1,0,0,0,16.0,0,0,0.0,1,0,3.3,2012,0.0
Deremy Geiger,743,179,555,222,192,156,2060.0,374,143,111.0,181,79,19.9,2012,0.0
Djim Bandoumel,295,38,227,117,95,61,879.0,0,0,48.0,227,117,19.6,2012,0.0
Landon Tatum,426,252,318,137,199,134,1729.0,43,18,123.0,275,119,16.7,2012,0.0
Dazmond Starke,54,5,53,22,16,10,149.0,0,0,16.0,53,22,27.7,2012,0.0
Sheridan Shayne,2,5,1,0,2,2,14.0,0,0,3.0,1,0,19.0,2012,0.0
Darrin Williams,429,37,327,172,148,85,1147.0,0,0,97.0,327,172,22.4,2012,0.0
Paris Carter,304,29,244,112,164,80,1154.0,1,0,92.0,243,112,18.6,2012,0.0
Greg Travis,100,53,96,36,47,23,432.0,15,5,44.0,81,31,19.7,2012,0.0
Sammy Sutter,42,6,39,14,12,10,115.0,15,4,10.0,24,10,25.0,2012,0.0
Matt Bush,41,11,51,15,2,0,262.0,36,11,18.0,15,4,14.0,2012,0.0
Jerome Brown,22,2,22,8,0,0,43.0,19,6,1.0,3,2,28.1,2012,0.0
Rob Robinson,18,0,19,6,4,3,80.0,11,3,6.0,8,3,17.6,2012,0.0
Dorian Tyler,60,10,68,26,15,5,283.0,18,3,18.0,50,23,17.0,2012,0.0
Darious Clark,10,2,18,3,5,3,56.0,9,1,3.0,9,2,23.0,2012,0.0
Meyers Leonard,502,48,349,198,144,105,1290.0,12,1,94.0,337,197,21.1,2012,1.0
Sam Maniscalco,1381,419,1035,431,375,307,4116.0,623,212,232.0,412,219,18.7,2012,0.0
Jean Selus,1,2,3,0,2,1,14.0,2,0,0.0,1,0,14.9,2012,0.0
Dwayne Lathan,1228,138,915,403,467,350,2785.0,241,72,262.0,674,331,27.7,2012,0.0
Carl Richard,1040,111,966,381,250,193,3611.0,253,85,226.0,713,296,19.7,2012,0.0
Myles Walker,476,23,435,199,156,78,1596.0,0,0,96.0,435,199,20.5,2012,0.0
Jordan Printy,831,190,735,281,78,54,2947.0,542,215,102.0,193,66,16.2,2012,0.0
Verdell Jones III,1347,389,1067,454,510,371,3297.0,228,68,342.0,839,386,25.9,2012,0.0
Matt Roth,453,33,336,141,51,45,1291.0,303,126,24.0,33,15,15.6,2012,0.0
Tom Pritchard,559,85,425,225,218,109,2458.0,2,0,137.0,423,225,14.1,2012,0.0
Kory Barnett,12,3,19,4,8,2,99.0,14,2,4.0,5,2,14.1,2012,0.0
Daniel Moore,148,119,103,44,72,51,1006.0,28,9,101.0,75,35,12.4,2012,0.0
Michael Glover,1286,66,801,499,454,288,2378.0,3,0,173.0,798,499,24.5,2012,0.0
Scott Machado,1613,880,1232,529,584,432,4143.0,360,123,440.0,872,406,23.6,2012,1.0
Jermel Jenkins,884,268,786,302,139,104,2926.0,462,176,168.0,324,126,18.4,2012,0.0
Randy Dezouvre,272,49,216,109,83,51,802.0,14,3,41.0,202,106,18.1,2012,0.0
Ra'Shad James,90,9,69,36,20,14,224.0,13,4,5.0,56,32,18.2,2012,0.0
Trinity Fields,320,87,288,101,102,78,1206.0,126,40,86.0,162,61,17.2,2012,0.0
Royce White,456,170,328,175,205,102,1072.0,12,4,130.0,316,171,26.5,2012,1.0
Scott Christopherson,1130,196,890,382,188,162,3107.0,462,204,160.0,428,178,18.3,2012,0.0
Chris Allen,1231,220,1065,411,243,192,3079.0,606,217,203.0,459,194,22.7,2012,0.0
Matt Gatens,1635,298,1264,525,401,346,4444.0,652,239,216.0,612,286,20.4,2012,0.0
Bryce Cartwright,698,445,695,262,185,134,2493.0,157,40,249.0,538,222,21.1,2012,0.0
Andrew Brommer,199,39,139,75,106,49,989.0,1,0,65.0,138,75,13.6,2012,0.0
Devon Archie,62,11,50,27,28,8,319.0,0,0,22.0,50,27,13.5,2012,0.0
Branden Stubbs,26,6,13,8,6,6,54.0,6,4,7.0,7,4,21.3,2012,0.0
Steven McCarty,2,0,5,1,0,0,19.0,1,0,2.0,4,1,18.6,2012,0.0
Cody Cox,0,1,3,0,0,0,16.0,1,0,1.0,2,0,12.6,2012,0.0
Trey McCorkle,901,81,653,374,216,153,2306.0,0,0,127.0,653,374,20.3,2012,0.0
John Peckinpaugh,341,133,313,127,98,61,1970.0,91,26,114.0,222,101,13.0,2012,0.0
Antwaun Boyd,250,95,218,92,81,57,990.0,28,9,96.0,190,83,18.2,2012,0.0
Jason Smeathers,181,47,162,56,54,40,742.0,99,29,39.0,63,27,15.7,2012,0.0
Hichem Benayad-Cherif,14,0,8,3,12,7,17.0,1,1,2.0,7,2,46.3,2012,0.0
Logan Shipleu,2,0,3,1,0,0,6.0,2,0,0.0,1,1,25.0,2012,0.0
Stephen Thomas,785,222,646,268,208,174,2582.0,215,75,134.0,431,193,17.9,2012,0.0
Christian Siakam,657,47,474,279,123,93,1757.0,9,6,104.0,465,273,19.1,2012,0.0
Jenirro Bush,719,47,613,252,204,139,1423.0,230,76,106.0,383,176,29.8,2012,0.0
Josh Armstrong,15,5,22,5,6,5,199.0,1,0,9.0,21,5,9.1,2012,0.0
Jamarious Sykes,22,0,16,8,10,6,67.0,0,0,3.0,16,8,18.3,2012,0.0
Tim Kendricks,2,0,3,1,0,0,7.0,2,0,1.0,1,1,30.6,2012,0.0
Jacolby Pittman,6,2,9,3,0,0,111.0,0,0,4.0,9,3,6.0,2012,0.0
Stephen Hall,928,86,785,359,292,196,2508.0,55,14,167.0,730,345,22.7,2012,0.0
Frankie Bougher,104,14,96,35,17,12,311.0,65,22,23.0,31,13,21.7,2012,0.0
Terrence Turner,13,3,12,5,6,3,58.0,0,0,8.0,12,5,18.4,2012,0.0
Shamile Cabell,472,101,398,152,170,120,1049.0,128,48,106.0,270,104,27.7,2012,0.0
Delwan Graham,586,92,461,208,247,168,1563.0,10,2,151.0,451,206,23.1,2012,0.0
Tevin Galvin,670,133,616,232,214,133,2511.0,267,73,153.0,349,159,17.0,2012,0.0
Chris Davis,150,36,144,47,63,40,762.0,56,16,53.0,88,31,14.8,2012,0.0
Shamile Jeffers,128,6,101,51,51,26,569.0,0,0,41.0,101,51,14.5,2012,0.0
Admir Sahbegovic,22,3,24,7,11,7,129.0,2,1,12.0,22,6,16.0,2012,0.0
Anthony Humpty Hitchens,1326,346,1184,467,234,158,3724.0,647,234,274.0,537,233,21.8,2012,0.0
Julius Wells,1414,210,1246,481,289,205,3688.0,703,247,259.0,543,234,23.0,2012,0.0
Trevon Flores,155,29,152,67,29,19,749.0,21,2,23.0,131,65,12.9,2012,0.0
Jamar Samuels,1259,169,860,411,641,390,3136.0,152,47,206.0,708,364,21.0,2012,0.0
Victor Ojeleye,120,10,112,51,29,15,577.0,10,3,30.0,102,48,12.4,2012,0.0
James Watson,53,6,48,23,24,7,208.0,0,0,11.0,48,23,17.2,2012,0.0
Thomas Robinson,1026,101,753,395,378,229,1960.0,14,7,173.0,739,388,28.3,2012,1.0
Tyshawn Taylor,1580,575,1156,551,506,358,4039.0,324,120,379.0,832,431,21.8,2012,1.0
Conner Teahan,294,56,258,95,43,36,1036.0,198,68,51.0,60,27,15.3,2012,0.0
Jordan Juenemann,41,3,34,16,8,3,103.0,13,6,7.0,21,10,21.7,2012,0.0
Anthony West,0,0,0,0,0,0,1.0,0,0,0.0,0,0,0.0,2012,0.0
Spencer Dixon,1319,398,1288,456,312,218,4057.0,596,189,331.0,692,267,23.0,2012,0.0
Romain Henry,115,46,118,40,36,20,752.0,42,15,57.0,76,25,13.7,2012,0.0
Mirza Sabic,136,11,115,45,32,20,491.0,71,26,36.0,44,19,18.0,2012,0.0
Nick Turner,57,18,82,20,8,3,315.0,51,14,26.0,31,6,18.8,2012,0.0
Sam Glover,2,0,1,1,0,0,2.0,0,0,0.0,1,1,27.0,2012,0.0
Brandon Sewell,2,0,1,1,0,0,13.0,0,0,0.0,1,1,4.1,2012,0.0
Justin Greene,1550,155,1142,574,547,402,3414.0,1,0,296.0,1141,574,25.0,2012,0.0
Carlton Guyton,726,196,613,260,142,106,2044.0,276,100,126.0,337,160,19.8,2012,0.0
Michael Porrini,839,364,764,294,278,182,2637.0,226,69,256.0,538,225,21.9,2012,0.0
Justin Manns,326,16,225,136,97,54,1131.0,1,0,44.0,224,136,14.0,2012,0.0
Eric Gaines,230,34,194,82,98,53,1047.0,46,13,46.0,148,69,13.7,2012,0.0
Shakir Dunning,0,0,1,0,0,0,2.0,1,0,0.0,0,0,25.3,2012,0.0
Anthony Davis,567,50,337,210,203,144,1281.0,20,3,41.0,317,207,18.8,2012,1.0
Doron Lamb,1018,122,693,336,249,202,2327.0,303,144,94.0,390,192,19.9,2012,1.0
Michael Kidd-Gilchrist,476,75,326,160,192,143,1245.0,51,13,87.0,275,147,20.6,2012,1.0
Terrence Jones,1064,111,820,383,401,256,2311.0,128,42,137.0,692,341,25.4,2012,1.0
Marquis Teague,401,191,352,145,119,85,1303.0,80,26,109.0,272,119,20.2,2012,1.0
Darius Miller,1248,278,990,444,227,185,3789.0,462,175,214.0,528,269,17.3,2012,1.0
Eloy Vargas,90,6,89,31,53,28,524.0,3,0,21.0,86,31,12.3,2012,0.0
Earl Pettis,1060,222,911,398,175,141,2872.0,348,123,207.0,563,275,20.9,2012,0.0
Matt Sheehan,5,0,15,2,3,1,27.0,1,0,6.0,14,2,41.3,2012,0.0
Ryan Willen,1453,182,1014,442,535,418,3143.0,412,151,224.0,602,291,24.9,2012,0.0
Jim Mower,1312,169,992,432,249,213,3098.0,587,235,134.0,405,197,21.2,2012,0.0
Rob Delaney,501,192,445,179,118,74,1688.0,198,69,123.0,247,110,19.7,2012,0.0
Nick Petkovich,438,37,384,151,34,21,1218.0,301,115,56.0,83,36,19.8,2012,0.0
J.D. Pelham,28,12,30,10,9,5,399.0,12,3,21.0,18,7,7.3,2012,0.0
Mike James,847,107,709,313,183,147,1437.0,218,74,106.0,491,239,29.1,2012,1.0
Anthony Miles,1487,416,1068,457,603,476,3517.0,282,97,280.0,786,360,21.9,2012,0.0
Devon Lamb,708,107,551,264,254,145,1769.0,117,35,89.0,434,229,19.8,2012,0.0
Charlie Harper,798,130,719,296,283,192,2408.0,61,14,138.0,658,282,19.4,2012,0.0
Vincenzo Nelson,139,37,114,44,73,48,549.0,16,3,43.0,98,41,16.0,2012,0.0
Jordan Hamilton,403,45,327,139,89,67,1375.0,179,58,63.0,148,81,15.7,2012,1.0
John Adams,306,36,247,106,90,61,1315.0,91,33,82.0,156,73,14.2,2012,0.0
Justin Maneri,186,23,143,71,90,44,806.0,1,0,44.0,142,71,14.3,2012,0.0
Jesse Sanders,1235,727,844,390,540,404,4143.0,172,51,342.0,672,339,17.7,2012,0.0
David Minaya,914,107,891,342,219,165,2547.0,239,65,131.0,652,277,22.2,2012,0.0
Stephen Baird,40,2,33,15,14,6,128.0,11,4,7.0,22,11,18.9,2012,0.0
Chene Phillips,101,56,106,28,55,41,606.0,23,4,56.0,83,24,15.7,2012,0.0
Hart Gliedman,7,1,8,2,5,3,47.0,1,0,2.0,7,2,13.7,2012,0.0
Walt Aikens,6,0,6,1,10,4,61.0,2,0,0.0,4,1,9.1,2012,0.0
Tanner Hoyt,0,0,6,0,0,0,26.0,2,0,0.0,4,0,11.9,2012,0.0
Jordan Burgason,1132,182,835,360,164,130,2574.0,642,282,148.0,193,78,19.7,2012,0.0
Jacob Arnett,429,205,393,148,102,79,1936.0,156,54,133.0,237,94,14.2,2012,0.0
Justin Glenn,462,83,358,186,158,82,1796.0,24,8,126.0,334,178,15.8,2012,0.0
Damarius Smith,150,98,130,59,58,29,644.0,13,3,71.0,117,56,17.1,2012,0.0
Robert Boyd,302,80,282,108,65,43,975.0,132,43,74.0,150,65,19.0,2012,0.0
Casper Ware,1841,545,1458,586,582,456,4319.0,610,213,368.0,848,373,25.1,2012,1.0
Larry Anderson,1538,361,1050,522,602,406,3852.0,256,88,294.0,794,434,21.1,2012,0.0
T.J. Robinson,1718,95,1235,652,642,405,3964.0,25,9,278.0,1210,643,22.7,2012,0.0
Eugene Phelps,1030,120,805,398,431,231,3120.0,28,3,213.0,777,395,19.9,2012,0.0
Edis Dervisevic,175,68,147,74,52,23,907.0,20,4,62.0,127,70,12.9,2012,0.0
Sean Starkey,30,1,33,11,4,4,108.0,21,4,2.0,12,7,17.2,2012,0.0
Corey Jackson,56,6,51,17,25,16,161.0,18,6,14.0,33,11,23.6,2012,0.0
Mike Vantrimpont,4,0,3,1,4,2,41.0,0,0,3.0,3,1,9.7,2012,0.0
Michael Culpo,951,100,803,326,117,85,2886.0,526,214,111.0,277,112,15.8,2012,0.0
Arnold Mayorga,299,37,267,96,80,57,1301.0,171,50,51.0,96,46,13.1,2012,0.0
Robinson Odoch Opong,36,2,28,10,18,11,105.0,18,5,11.0,10,5,20.6,2012,0.0
Kurt Joseph,18,6,17,8,2,1,69.0,7,1,13.0,10,7,20.6,2012,0.0
Peter Aquilar,6,0,9,3,0,0,14.0,5,0,1.0,4,3,33.1,2012,0.0
Antwan Carter,1886,128,1452,781,419,283,3351.0,148,41,249.0,1304,740,26.7,2012,0.0
Martiz Washington,1089,213,986,372,124,70,2982.0,726,275,140.0,260,97,18.7,2012,0.0
Jeremiah Bowman,664,261,436,223,273,194,1690.0,65,24,137.0,371,199,20.0,2012,0.0
Martavius Adams,1020,74,851,397,307,188,2876.0,133,38,226.0,718,359,23.5,2012,0.0
Jan van der Kooij,418,67,430,154,62,32,1582.0,262,78,102.0,168,76,17.0,2012,0.0
Durann Neil,624,248,583,202,193,113,2056.0,336,107,160.0,247,95,18.7,2012,0.0
Darshawn McClellan,507,112,405,171,173,112,2072.0,149,53,145.0,256,118,15.0,2012,0.0
David Perez,850,95,714,271,186,155,2070.0,440,153,119.0,274,118,22.4,2012,0.0
Darnell Jackson,65,12,64,24,21,11,326.0,19,6,19.0,45,18,13.9,2012,1.0
Scottie Farrington,195,8,120,62,133,71,535.0,1,0,50.0,119,62,21.2,2012,0.0
Fred Brown,1150,207,1042,416,184,135,2716.0,479,183,219.0,563,233,27.6,2012,1.0
Charles Winborne,316,46,250,113,44,32,754.0,132,58,42.0,118,55,22.6,2012,0.0
Hugh Mingo,541,75,549,205,112,69,1736.0,220,62,120.0,329,143,22.5,2012,0.0
Christian Bibi Ndongo,120,18,112,41,57,35,731.0,10,3,40.0,102,38,13.3,2012,0.0
Fabio Ribero,173,12,170,71,62,30,890.0,2,1,59.0,168,70,15.6,2012,0.0
D'Andre Martin,0,0,4,0,1,0,13.0,0,0,3.0,4,0,31.3,2012,0.0
Justin Hamilton,758,45,540,289,239,177,2091.0,12,3,101.0,528,286,18.4,2012,1.0
Storm Warren,922,49,771,377,264,168,2320.0,3,0,125.0,768,377,22.6,2012,0.0
Malcolm White,342,18,293,134,130,74,1044.0,0,0,76.0,293,134,21.2,2012,0.0
John Isaac,84,33,89,30,21,16,441.0,28,8,30.0,61,22,14.8,2012,0.0
Chris Bass,201,269,220,75,79,34,1959.0,71,17,129.0,149,58,10.1,2012,0.0
Ronald Martin,0,0,0,0,0,0,1.0,0,0,0.0,0,0,0.0,2012,1.0
Trevor Gaskins,953,222,822,322,203,147,2599.0,448,162,192.0,374,160,20.9,2012,0.0
Romario Souza,353,25,243,137,113,78,1004.0,3,1,53.0,240,136,17.5,2012,0.0
Lonnie Smith,235,30,210,76,56,36,854.0,128,47,40.0,82,29,16.2,2012,0.0
Robby Price,2,0,2,1,0,0,5.0,0,0,0.0,2,1,20.1,2012,0.0
Kyle Kuric,979,102,757,348,150,114,2808.0,448,169,82.0,309,179,16.2,2012,0.0
Elisha Justice,94,42,84,31,37,22,416.0,42,10,26.0,42,21,15.3,2012,0.0
Mike Marra,294,79,301,95,50,38,928.0,247,66,51.0,54,29,20.1,2012,0.0
Walt Gibler,1041,69,695,323,468,366,2391.0,96,29,155.0,599,294,23.9,2012,0.0
Chim Kadima,178,34,177,59,62,39,864.0,77,21,49.0,100,38,16.3,2012,0.0
Jonathon Gac,66,6,47,28,23,10,213.0,0,0,18.0,47,28,19.9,2012,0.0
John Benkoske,77,9,61,24,46,29,580.0,0,0,28.0,61,24,10.1,2012,0.0
Adam Cooper,0,0,1,0,0,0,7.0,0,0,1.0,1,0,16.2,2012,0.0
Drew Viney,1382,148,1040,475,360,285,2850.0,353,147,201.0,687,328,24.4,2012,0.0
LaRon Armstead,678,89,526,207,250,203,2162.0,186,61,126.0,340,146,18.0,2012,0.0
Quincy Lawson,89,12,76,39,24,11,356.0,2,0,14.0,74,39,14.2,2012,0.0
Tim Diederichs,444,68,322,161,207,122,1602.0,4,0,90.0,318,161,14.7,2012,0.0
Kelsey Chine,17,2,17,6,5,1,55.0,10,4,3.0,7,2,20.0,2012,0.0
Daniel Latimer,0,1,4,0,0,0,13.0,3,0,0.0,1,0,15.5,2012,0.0
Shane Walker,881,110,731,293,301,227,2762.0,193,68,204.0,538,225,19.9,2012,0.0
J'hared Hall,512,60,420,174,97,71,1318.0,245,93,92.0,175,81,21.5,2012,0.0
Pierson Williams,24,4,34,9,4,2,120.0,20,4,6.0,14,5,17.7,2012,0.0
Gerald McLemore,1657,147,1383,561,253,212,3856.0,845,323,189.0,538,238,22.9,2012,0.0
Raheem Singleton,486,209,377,153,199,138,1455.0,145,42,130.0,232,111,21.8,2012,0.0
Andrew Rogers,294,274,283,106,61,39,1915.0,145,43,128.0,138,63,12.0,2012,0.0
Svetoslav Chetinov,121,8,94,54,23,13,540.0,0,0,42.0,94,54,14.1,2012,0.0
Travon Wilcher,16,2,19,7,3,2,138.0,1,0,11.0,18,7,11.8,2012,0.0
Kidani Brutus,561,134,466,186,81,63,1823.0,314,126,130.0,152,60,17.8,2012,0.0
Liam McCabe-Moran,180,30,157,55,47,31,567.0,113,39,29.0,44,16,18.2,2012,0.0
Djibril Coulibaly,67,5,91,31,13,5,452.0,1,0,25.0,90,31,13.9,2012,0.0
Kevin Laue,36,1,30,17,9,2,223.0,0,0,7.0,30,17,9.6,2012,0.0
DeCarlos Anderson,2,1,17,0,3,2,45.0,12,0,7.0,5,0,28.0,2012,0.0
Torgrim Sommerfeldt,2,3,2,1,0,0,25.0,1,0,1.0,1,1,5.9,2012,0.0
Chris Viven,0,0,1,0,0,0,7.0,1,0,1.0,0,0,14.1,2012,0.0
R.J. Hall,564,182,475,179,187,135,1730.0,201,71,176.0,274,108,22.1,2012,0.0
Darius Johnson-Odom,1649,262,1257,558,432,312,3238.0,549,221,223.0,708,337,26.2,2012,1.0
Jae Crowder,1049,131,762,375,287,196,2174.0,294,103,74.0,468,272,21.9,2012,1.0
Damier Pitts,1551,517,1197,483,475,384,3771.0,605,201,328.0,592,282,23.0,2012,0.0
Dago Pena,763,141,610,263,142,90,2284.0,382,147,116.0,228,116,17.2,2012,0.0
Jake Wasco,139,23,131,59,41,21,775.0,1,0,32.0,130,59,11.7,2012,0.0
Chris De La Rosa,913,395,791,323,296,213,2426.0,177,54,189.0,614,269,24.0,2012,0.0
Hillary Haley,1410,106,1294,479,436,308,3136.0,515,144,214.0,779,335,27.2,2012,0.0
Percy Woods,327,96,299,108,107,74,998.0,133,37,100.0,166,71,22.1,2012,0.0
Tyler Hines,748,60,602,307,243,134,2538.0,2,0,167.0,600,307,17.5,2012,0.0
Mark Robertson,347,36,380,112,52,33,1451.0,299,90,84.0,81,22,16.7,2012,0.0
Gregory Womack,83,11,88,32,7,3,317.0,55,16,23.0,33,16,17.7,2012,0.0
Akeem Anderson,48,2,46,20,15,8,224.0,0,0,17.0,46,20,15.3,2012,0.0
Chukwuemeka Duruji,1,0,0,0,2,1,11.0,0,0,0.0,0,0,4.2,2012,0.0
Terrell Stoglin,1066,170,818,351,300,240,1755.0,329,124,146.0,489,227,31.1,2012,0.0
Sean Mosley,1103,269,879,370,374,294,3423.0,208,69,214.0,671,301,18.1,2012,0.0
Mychal Parker,154,38,120,52,73,42,655.0,32,8,49.0,88,44,15.6,2012,0.0
Berend Weijs,103,12,88,47,26,9,474.0,1,0,21.0,87,47,12.6,2012,0.0
Jon Dillard,2,0,2,1,1,0,11.0,0,0,0.0,2,1,11.4,2012,0.0
Sean Carter,704,79,541,283,300,138,2923.0,0,0,161.0,541,283,13.8,2012,0.0
Andrew McCarthy,8,0,8,3,4,2,22.0,0,0,0.0,8,3,20.7,2012,0.0
Patrick Richard,1625,302,1259,546,540,409,3550.0,402,124,255.0,857,422,25.1,2012,0.0
Rudy Turner,811,26,591,313,278,185,2072.0,2,0,179.0,589,313,21.1,2012,0.0
Daniel Richard,279,36,246,106,112,67,1450.0,0,0,83.0,246,106,13.2,2012,0.0
Will Brown,228,14,210,96,79,36,1038.0,4,0,53.0,206,96,14.9,2012,0.0
Tyson Queen,25,1,22,8,15,8,124.0,5,1,6.0,17,7,14.3,2012,0.0
Will Barton,1062,201,842,397,262,192,2306.0,254,76,164.0,588,321,24.9,2012,1.0
Wesley Witherspoon,993,130,676,316,397,287,2545.0,191,74,173.0,485,242,20.7,2012,0.0
Preston Laird,25,5,21,6,16,10,71.0,9,3,5.0,12,3,23.8,2012,0.0
Justin Cecil,705,49,636,243,121,92,1872.0,380,127,94.0,256,116,23.0,2012,0.0
Paul Larsen,108,9,94,33,70,42,370.0,0,0,32.0,94,33,22.5,2012,0.0
Shaquille Harris,37,3,35,14,10,4,91.0,16,5,8.0,19,9,27.9,2012,0.0
R.J. Miskimon,5,0,3,2,0,0,12.0,2,1,0.0,1,1,13.3,2012,0.0
Marquisse Jackson,22,4,15,5,16,12,130.0,4,0,6.0,11,5,9.6,2012,0.0
Malcolm Grant,1348,332,1058,408,336,275,3236.0,649,257,238.0,409,151,23.0,2012,0.0
DeQuan Jones,508,53,457,201,152,96,1606.0,59,10,123.0,398,191,20.7,2012,1.0
Ryan Quigtar,10,5,9,3,6,3,32.0,3,1,2.0,6,2,22.2,2012,0.0
Julian Mavunga,1389,255,955,433,632,444,3602.0,242,79,352.0,713,354,25.8,2012,0.0
Adam Thomas,67,3,52,24,26,16,320.0,19,3,7.0,33,21,12.4,2012,0.0
Draymond Green,1517,425,1163,543,495,340,3619.0,252,91,277.0,911,452,23.7,2012,1.0
Brandon Wood,1464,248,1161,538,304,221,3129.0,458,167,195.0,703,371,24.7,2012,0.0
Austin Thornton,328,82,251,101,95,83,1479.0,123,43,67.0,128,58,12.6,2012,0.0
Anthony Ianni,5,2,5,2,2,1,43.0,0,0,2.0,5,2,9.6,2012,0.0
Joe Sweeny,2,1,2,0,2,2,11.0,1,0,3.0,1,0,28.2,2012,0.0
Zack Novak,1082,215,876,353,209,163,4357.0,591,213,114.0,285,140,14.1,2012,0.0
Stu Douglass,936,290,871,331,99,69,3900.0,603,205,155.0,268,126,15.5,2012,0.0
Colton Christian,11,3,21,5,6,1,177.0,0,0,11.0,21,5,11.3,2012,0.0
LaRon Dendy,671,80,445,244,320,171,1327.0,41,12,99.0,404,232,26.8,2012,0.0
Jimmy Oden,421,269,293,103,262,189,1837.0,88,26,191.0,205,77,16.3,2012,0.0
Kaylon Williams,827,544,727,273,333,196,3107.0,273,85,309.0,454,188,20.1,2012,0.0
Tony Meier,1044,115,776,341,226,173,2717.0,492,189,168.0,284,152,20.0,2012,0.0
Ralph Sampson III,1016,189,812,394,303,222,3092.0,37,6,168.0,775,388,19.0,2012,0.0
Dee Bost,1640,633,1296,498,557,407,4192.0,690,237,379.0,606,261,23.6,2012,0.0
Arnett Moultrie,1142,100,863,441,343,232,3020.0,97,28,206.0,766,413,21.9,2012,1.0
Renardo Sidney,550,30,424,215,151,98,1137.0,61,22,90.0,363,193,26.9,2012,0.0
Brian Bryant,374,115,313,143,109,73,1359.0,48,15,65.0,265,128,16.5,2012,0.0
Taylor Luczak,12,0,11,4,4,3,51.0,4,1,7.0,7,3,19.9,2012,0.0
Reed Clayton,1,0,2,0,4,1,9.0,1,0,2.0,1,0,34.5,2012,0.0
Charles Parker,4,1,7,1,3,2,40.0,4,0,3.0,3,1,14.6,2012,0.0
Paul Crosby,712,97,600,243,255,176,1771.0,161,50,154.0,439,193,23.6,2012,0.0
Terrence Joyner,732,150,623,237,204,141,1804.0,319,117,149.0,304,120,22.9,2012,0.0
Cor-J Cox,625,63,497,243,170,103,1611.0,137,36,105.0,360,207,20.4,2012,0.0
Kevin Burwell,756,374,693,237,256,183,2939.0,343,99,274.0,350,138,17.8,2012,0.0
Falando Jones,427,77,338,147,144,92,1159.0,111,41,98.0,227,106,20.6,2012,0.0
Amos Studivant,495,52,451,210,200,75,2317.0,2,0,150.0,449,210,14.6,2012,0.0
William Pugh,138,26,144,46,35,29,420.0,69,17,25.0,75,29,21.1,2012,0.0
Roger Hubbard,0,0,0,0,0,0,2.0,0,0,1.0,0,0,24.1,2012,0.0
Terrance Henry,1095,153,826,390,354,256,3165.0,179,59,265.0,647,331,20.8,2012,0.0
Steadman Short,313,25,253,130,107,53,1366.0,0,0,80.0,253,130,14.0,2012,0.0
Dale Hughes,527,39,476,174,95,63,1195.0,326,116,82.0,150,58,25.7,2012,0.0
Reggie Chamberlain,994,184,739,327,188,160,2371.0,422,180,132.0,317,147,22.3,2012,0.0
Dustin Dibble,350,62,315,121,107,78,1575.0,124,30,79.0,191,91,14.2,2012,0.0
Michael Gholston Jr,255,69,242,85,49,36,1162.0,136,49,63.0,106,36,15.0,2012,0.0
Bernard Kamwa,103,5,84,38,64,27,514.0,0,0,50.0,84,38,17.0,2012,0.0
Trevor Mason,14,3,11,4,7,4,53.0,2,2,5.0,9,2,19.7,2012,0.0
Jordan Payton,2,1,5,1,0,0,35.0,2,0,5.0,3,1,14.9,2012,0.0
Kyle Weems,1868,198,1550,681,337,266,3981.0,641,240,181.0,909,441,25.9,2012,0.0
Caleb Patterson,741,40,617,286,173,135,1740.0,108,34,82.0,509,252,24.5,2012,0.0
Michael Bizoukas,312,338,323,118,85,46,2407.0,96,30,141.0,227,88,11.1,2012,0.0
Isaiah Rhine,189,9,149,71,70,46,846.0,5,1,32.0,144,70,13.8,2012,0.0
Corey Copeland,71,18,84,27,9,5,385.0,46,12,11.0,38,15,14.2,2012,0.0
Corbin Thomas,5,0,5,1,5,3,50.0,0,0,5.0,5,1,13.7,2012,0.0
Marcus Denmon,1775,237,1311,597,373,298,3598.0,705,283,140.0,606,314,22.2,2012,0.0
Kim English,1570,204,1227,515,414,301,3409.0,606,239,236.0,621,276,23.8,2012,1.0
Ricardo Ratliffe,847,60,576,366,166,111,1749.0,15,4,90.0,561,362,21.4,2012,0.0
Matt Pressey,406,107,352,143,121,83,1452.0,118,37,76.0,234,106,16.8,2012,0.0
Steve Moore,225,55,164,85,92,52,1386.0,10,3,58.0,154,82,9.5,2012,0.0
Jarrett Sutton,46,1,53,15,2,1,150.0,50,15,1.0,3,0,17.7,2012,0.0
Andy Rosburg,4,0,1,1,2,2,28.0,0,0,1.0,1,1,5.6,2012,0.0
Mike Meyers Keitt,925,152,795,318,259,202,2488.0,279,87,154.0,516,231,22.4,2012,0.0
Will Campbell,880,93,759,283,244,190,2207.0,384,124,151.0,375,159,24.0,2012,0.0
Phil Wait,317,16,265,133,112,51,1049.0,1,0,84.0,264,133,19.8,2012,0.0
Mykel Harris,26,1,28,8,13,10,115.0,7,0,8.0,21,8,18.3,2012,0.0
Daniel James,4,2,7,1,6,2,76.0,0,0,5.0,7,1,9.7,2012,0.0
Shawn Reid,479,42,421,161,115,77,1198.0,226,80,71.0,195,81,23.0,2012,0.0
Tre Johnson,312,30,282,127,92,58,1003.0,1,0,71.0,281,127,19.9,2012,0.0
Rod Singleton,456,215,347,146,179,123,1709.0,112,41,140.0,235,105,17.0,2012,0.0
Mohammed Fall,202,25,151,78,57,46,682.0,0,0,43.0,151,78,16.1,2012,0.0
Jordan Allou,235,16,173,100,83,35,949.0,1,0,45.0,172,100,13.7,2012,0.0
Patrick Webb,2,0,0,0,2,2,2.0,0,0,0.0,0,0,23.7,2012,0.0
Art Steward,577,81,414,212,193,130,1744.0,57,23,88.0,357,189,18.2,2012,0.0
Derek Selvig,844,256,682,288,243,162,2800.0,264,106,236.0,418,182,20.0,2012,0.0
Shawn Stockton,245,89,223,89,61,40,1372.0,102,27,81.0,121,62,13.1,2012,0.0
Jordan Wood,141,47,146,53,41,15,759.0,87,20,45.0,59,33,14.9,2012,0.0
Ty Proffitt,678,160,546,217,148,120,2499.0,323,124,108.0,223,93,15.3,2012,0.0
Marsell Holden,270,24,230,83,34,31,690.0,193,73,41.0,37,10,22.9,2012,0.0
Terrance Hill,981,141,839,322,201,164,2625.0,475,173,177.0,364,149,22.3,2012,0.0
Lamont Austin,232,162,203,68,91,74,1471.0,85,22,105.0,118,46,12.7,2012,0.0
Will Bailey,51,3,37,17,26,16,138.0,5,1,10.0,32,16,23.6,2012,0.0
Kevin Thompson,1499,177,1177,584,564,330,3738.0,2,1,306.0,1175,583,22.5,2012,1.0
Aric Brooks,821,131,579,225,403,324,2538.0,137,47,187.0,442,178,19.3,2012,0.0
Ameer Ali,602,76,443,220,244,145,1917.0,50,17,172.0,393,203,19.2,2012,0.0
Larry Bastfield,530,353,526,177,214,137,3429.0,144,39,248.0,382,138,14.3,2012,0.0
Jeremy Canty,28,1,33,10,2,1,106.0,19,7,5.0,14,3,18.4,2012,0.0
James Hamilton,10,2,4,2,9,6,19.0,0,0,1.0,4,2,24.5,2012,0.0
Derrick Banks,18,2,18,5,4,3,84.0,14,5,9.0,4,0,16.3,2012,0.0
Danny Thompson,453,34,377,173,183,107,1760.0,0,0,90.0,377,173,16.7,2012,0.0
Jacolby Wells,114,9,100,44,47,26,496.0,0,0,28.0,100,44,16.0,2012,0.0
Lamar Trice,508,120,428,178,124,82,1181.0,194,70,158.0,234,108,29.1,2012,0.0
Dan Kenny,2,2,5,0,2,2,24.0,1,0,3.0,4,0,19.7,2012,0.0
Donte Poole,882,129,659,276,282,221,2311.0,322,109,147.0,337,167,21.1,2012,0.0
Ivan Aska,1218,57,925,477,380,262,3020.0,5,2,187.0,920,475,22.1,2012,0.0
Jewuan Long,706,192,544,260,210,149,2414.0,109,37,177.0,435,223,17.7,2012,0.0
Harley Nussman,2,0,3,1,0,0,16.0,0,0,0.0,3,1,9.8,2012,0.0
Jordan Sugars,1346,115,1122,456,335,235,3245.0,563,199,203.0,559,257,23.7,2012,0.0
Jordan Brickman,120,64,138,43,21,12,670.0,83,22,49.0,55,21,16.3,2012,0.0
Carlton Smith,78,3,52,30,31,18,300.0,0,0,12.0,52,30,14.0,2012,0.0
Chall Montgomery,15,1,13,3,11,8,58.0,9,1,7.0,4,2,24.1,2012,0.0
Ted Connolly,18,21,30,7,4,3,232.0,13,1,17.0,17,6,11.2,2012,0.0
Jacob Liebert,3,1,4,0,4,3,27.0,0,0,1.0,4,0,13.9,2012,0.0
Tre McNeil,2,0,1,1,2,0,10.0,0,0,2.0,1,1,21.9,2012,0.0
Bo Spencer,1375,308,1189,448,326,275,3567.0,610,204,278.0,579,244,24.0,2012,0.0
Toney McCray,759,101,644,291,148,97,2086.0,221,80,170.0,423,211,23.6,2012,0.0
Brandon Richardson,794,235,569,238,278,230,2810.0,284,88,154.0,285,150,16.8,2012,0.0
Caleb Walker,398,61,306,140,118,79,1418.0,126,39,87.0,180,101,17.6,2012,0.0
Jorge Brian Diaz,765,75,655,340,157,85,2061.0,1,0,131.0,654,340,22.7,2012,0.0
Mike Fox,46,7,41,18,12,6,266.0,10,4,9.0,31,14,11.8,2012,0.0
Christopher Niemann,10,3,21,4,2,2,170.0,1,0,17.0,20,4,12.9,2012,0.0
Chace Stanback,1265,147,1030,468,200,161,2956.0,437,168,159.0,593,300,22.1,2012,0.0
Oscar Bellfield,1226,584,1095,426,221,167,4050.0,570,207,279.0,525,219,18.6,2012,0.0
Brice Massamba,545,67,324,206,236,133,1885.0,1,0,97.0,323,206,14.4,2012,0.0
Kendall Wallace,556,87,481,183,66,50,1833.0,375,140,59.0,106,43,16.0,2012,0.0
Wade Norman,3,2,2,1,0,0,8.0,2,1,1.0,0,0,18.6,2012,0.0
Olek Czyz,790,70,545,289,275,168,1783.0,121,44,144.0,424,245,23.3,2012,0.0
Dario Hunt,1103,122,828,424,464,255,3655.0,0,0,248.0,828,424,19.0,2012,0.0
Jordan Finn,95,26,62,26,52,37,478.0,21,6,42.0,41,20,13.6,2012,0.0
Alvin Abreu,1564,222,1421,527,395,295,3844.0,653,215,273.0,768,312,26.4,2012,0.0
Brian Benson,525,21,438,199,179,86,2185.0,125,41,100.0,313,158,15.2,2012,0.0
Ryan Herrion,14,8,25,4,6,2,113.0,23,4,5.0,2,0,15.5,2012,0.0
Wendell McKines,1521,207,1194,582,432,274,3576.0,228,83,220.0,966,499,21.6,2012,0.0
Hernst Laroche,1209,552,934,405,398,287,4417.0,303,112,285.0,631,293,16.7,2012,0.0
Hamidu Rahman,1081,48,699,386,593,309,2691.0,0,0,226.0,699,386,22.5,2012,0.0
Christian Kabongo,455,120,373,141,205,149,1167.0,111,24,128.0,262,117,25.1,2012,0.0
D.J. Lewis,8,3,5,2,4,3,44.0,2,1,1.0,3,1,8.4,2012,0.0
Drew Gordon,1007,71,752,407,277,191,2323.0,4,2,173.0,748,405,23.5,2012,1.0
Phillip McDonald,1146,116,934,397,206,145,2951.0,548,207,132.0,386,190,20.3,2012,0.0
A.J. Hardeman,736,55,577,297,288,142,2616.0,3,0,152.0,574,297,16.9,2012,0.0
Josh Turner,75,11,80,24,22,13,236.0,46,14,10.0,34,10,21.0,2012,0.0
Ali Langford,53,8,37,21,9,6,309.0,11,5,14.0,26,16,8.8,2012,0.0
Eric Williams,183,11,142,74,60,35,709.0,0,0,44.0,142,74,15.0,2012,1.0
Paul Kowalski,6,0,4,2,2,1,38.0,3,1,1.0,1,1,6.8,2012,0.0
Trevon Lewis,354,28,262,131,123,78,684.0,37,14,56.0,225,117,28.2,2012,0.0
Bryan Hammond,340,120,315,131,94,54,1316.0,102,24,80.0,213,107,17.5,2012,0.0
Chris Talkington,256,24,210,80,64,47,660.0,144,49,32.0,66,31,21.4,2012,0.0
Ben Martin,147,54,138,45,25,19,980.0,120,38,26.0,18,7,9.8,2012,0.0
Bryson Triggs,32,4,17,8,16,13,140.0,9,3,5.0,8,5,11.3,2012,0.0
Isaiah Wilkerson,1577,199,1344,544,452,343,3433.0,439,146,265.0,905,398,26.9,2012,0.0
Lamar Kearse,456,117,416,157,116,79,1337.0,194,63,76.0,222,94,20.8,2012,0.0
Arjun Ohri,291,51,240,100,23,21,795.0,175,70,33.0,65,30,18.2,2012,0.0
Sammy Schickel,335,53,326,124,30,21,1121.0,199,66,65.0,127,58,18.1,2012,0.0
Ryan Regis,281,20,254,110,103,61,1922.0,1,0,113.0,253,110,11.0,2012,0.0
Kherel Silcott,123,11,84,41,74,40,583.0,3,1,25.0,81,40,12.5,2012,0.0
Garrett Frick,46,5,36,21,13,4,232.0,2,0,11.0,34,21,11.7,2012,0.0
Marques Jones,41,12,50,15,8,5,236.0,29,6,26.0,21,9,17.3,2012,0.0
Teddy Schickel,111,60,149,41,32,23,854.0,37,6,67.0,112,35,13.4,2012,0.0
Kyle O'Quinn,1607,122,1104,610,486,333,3542.0,207,54,262.0,897,556,23.0,2012,1.0
Chris McEachin,879,121,792,308,210,142,2260.0,380,121,173.0,412,187,23.1,2012,0.0
Marcos Tamares,469,42,462,172,131,85,1617.0,137,40,102.0,325,132,19.1,2012,0.0
Brandon Wheeless,368,35,304,134,112,71,1079.0,104,29,57.0,200,105,18.9,2012,0.0
Rodney McCauley,285,83,241,99,117,66,1686.0,66,21,81.0,175,78,11.2,2012,0.0
Winston Graham,11,4,20,4,2,2,57.0,11,1,6.0,9,3,23.6,2012,0.0
Reggie Revels,32,5,46,12,7,4,209.0,37,4,13.0,9,8,14.4,2012,0.0
Matt Dickey,1778,429,1252,546,578,487,3959.0,573,199,332.0,679,347,22.5,2012,0.0
J.P. Primm,1689,607,1260,517,569,450,4047.0,597,205,393.0,663,312,23.5,2012,0.0
Chris Stephenson,1145,248,1004,432,282,206,2911.0,279,75,282.0,725,357,23.2,2012,0.0
Quinard Jackson,491,83,388,205,174,72,1959.0,23,9,108.0,365,196,14.0,2012,0.0
Jeremy Harn,36,6,34,16,12,4,171.0,1,0,5.0,33,16,12.8,2012,0.0
Madison Davis,11,3,22,4,6,2,62.0,13,1,4.0,9,3,22.7,2012,0.0
Marc Hill,959,330,885,319,260,189,2819.0,383,132,229.0,502,187,21.3,2012,0.0
Nic Simpson,1016,113,831,304,293,229,2395.0,537,179,146.0,294,125,22.6,2012,0.0
Anthony Estes,71,4,64,29,12,8,172.0,9,5,24.0,55,24,26.3,2012,0.0
Jared Williams,123,13,126,41,17,13,491.0,92,28,13.0,34,13,14.6,2012,0.0
Kam Shephard,59,10,39,22,25,15,185.0,0,0,17.0,39,22,17.7,2012,0.0
Jordan Herrera,13,1,20,3,10,7,64.0,10,0,3.0,10,3,20.9,2012,0.0
Dominique Sutton,1110,171,761,399,467,301,3018.0,45,11,211.0,716,388,19.8,2012,0.0
Nick Chasten,1016,91,891,426,142,96,2922.0,221,68,176.0,670,358,19.8,2012,0.0
Landon Clement,887,70,698,287,163,133,1825.0,459,180,92.0,239,107,24.4,2012,0.0
Justin Leemow,277,191,316,106,65,31,1717.0,133,34,133.0,183,72,14.5,2012,0.0
Tramar Beaman,72,16,54,21,24,17,252.0,34,13,18.0,20,8,17.0,2012,0.0
Tracy O'Neal,77,7,62,32,27,13,403.0,0,0,19.0,62,32,12.0,2012,0.0
David Best,85,7,70,38,29,9,480.0,0,0,38.0,70,38,13.1,2012,0.0
Johnathan Nicely,38,2,37,17,6,4,235.0,2,0,10.0,35,17,10.9,2012,0.0
Aloysius Henry,479,19,383,170,213,136,1197.0,12,3,86.0,371,167,22.7,2012,0.0
Aaron Bracket,371,28,336,158,81,53,1351.0,13,2,70.0,323,156,15.7,2012,0.0
Cody Henegar,55,1,64,21,12,7,196.0,21,6,8.0,43,15,19.0,2012,0.0
Elhanan Bone,116,6,122,44,54,27,547.0,6,1,37.0,116,43,15.7,2012,0.0
Alex Johnson,935,330,805,282,248,177,3078.0,549,194,217.0,256,88,19.5,2012,0.0
Patrick Johnson,0,0,1,0,0,0,2.0,0,0,0.0,1,0,25.0,2012,0.0
Donte Morales,364,78,308,124,110,80,1492.0,105,36,110.0,203,88,16.6,2012,0.0
Trevor Deloach,466,58,424,170,123,81,1304.0,124,45,87.0,300,125,23.0,2012,0.0
Cam Chambers,15,1,7,3,11,8,26.0,2,1,4.0,5,2,32.5,2012,0.0
Harrison Barnes,1226,96,1018,438,319,234,2198.0,332,116,146.0,686,322,27.3,2012,1.0
Tyler Zeller,1503,69,1010,548,525,407,2696.0,2,0,165.0,1008,548,24.1,2012,1.0
John Henson,1124,108,955,475,349,169,2594.0,24,5,166.0,931,470,22.7,2012,1.0
Kendall Marshall,523,581,406,181,163,113,2101.0,131,48,193.0,275,133,14.7,2012,1.0
Justin Watts,170,49,171,63,70,32,815.0,42,12,50.0,129,51,14.2,2012,0.0
David Dupont,10,3,14,3,2,1,49.0,9,3,1.0,5,0,14.8,2012,0.0
Patrick Crouch,18,6,19,7,4,2,58.0,9,2,12.0,10,5,25.8,2012,0.0
Stewart Cooper,5,1,6,2,3,1,49.0,0,0,4.0,6,2,10.6,2012,0.0
Dylan Hale,293,88,292,97,58,36,1093.0,199,63,82.0,93,34,18.1,2012,0.0
Eric Carlson,917,150,707,329,383,258,2270.0,3,1,173.0,704,328,23.6,2012,0.0
Drew Lundberg,377,93,303,128,109,77,1258.0,123,44,58.0,180,84,16.6,2012,0.0
Joel Lindberg,55,38,39,18,15,15,443.0,11,4,18.0,28,14,7.8,2012,0.0
Patrick Mitchell,954,94,775,321,219,143,2415.0,453,169,123.0,322,152,21.7,2012,0.0
Mike Mathison,45,3,39,16,21,10,205.0,11,3,18.0,28,13,17.2,2012,0.0
Spencer Goodman,208,38,169,62,93,67,844.0,64,17,75.0,105,45,18.2,2012,0.0
Nick Haugen,207,64,176,70,44,41,938.0,84,26,62.0,92,44,14.8,2012,0.0
Matt Sauey,799,82,554,324,238,146,2636.0,12,5,148.0,542,319,16.4,2012,0.0
Jimmy Williams,740,277,562,255,316,173,2440.0,170,57,260.0,392,198,21.2,2012,0.0
Kendrick Hogans,590,40,445,239,226,112,2111.0,2,0,104.0,443,239,15.8,2012,0.0
Alonzo Edwards,164,13,119,59,74,42,574.0,7,4,51.0,112,55,18.2,2012,0.0
Kashief Edwards,874,50,689,332,346,209,2431.0,9,1,174.0,680,331,21.3,2012,0.0
Durrell Norman,400,55,279,141,166,111,1333.0,23,7,84.0,256,134,17.1,2012,0.0
Danny Cheek,43,5,61,15,8,5,139.0,32,8,12.0,29,7,28.3,2012,0.0
Colby Weaver,3,2,4,1,0,0,16.0,3,1,0.0,1,0,12.8,2012,0.0
Mike Proctor,830,126,623,318,304,194,2499.0,9,0,179.0,614,318,20.2,2012,0.0
Elliott Lloyd,553,181,438,174,129,101,2093.0,253,104,177.0,185,70,16.6,2012,0.0
Aaron Hawk-Harris,30,4,31,12,9,2,123.0,12,4,8.0,19,8,18.2,2012,0.0
Tim Toler,451,45,404,177,56,41,1140.0,147,56,84.0,257,121,23.0,2012,0.0
Marquavese Ford,140,63,142,55,39,22,562.0,31,8,69.0,111,47,21.6,2012,0.0
Tyler Storm,313,52,313,107,73,56,1217.0,152,43,84.0,161,64,18.1,2012,0.0
Stian Berg,111,38,101,34,26,16,514.0,79,27,35.0,22,7,15.3,2012,0.0
Zach Miller,48,37,46,14,12,11,342.0,30,9,29.0,16,5,12.5,2012,0.0
Jeremiah Jackson,36,2,26,12,22,12,124.0,0,0,8.0,26,12,19.0,2012,0.0
DeMarcus Grady,69,18,52,18,33,26,231.0,23,7,16.0,29,11,18.3,2012,0.0
DeAndre Barnette,2,0,1,0,2,2,19.0,1,0,1.0,0,0,8.2,2012,0.0
Johnny Moran,1048,234,951,359,177,129,4025.0,601,201,165.0,350,158,17.2,2012,0.0
Tyler Lange,13,2,12,4,9,5,70.0,3,0,4.0,9,4,16.8,2012,0.0
William Mosley,993,112,635,393,515,207,3392.0,1,0,136.0,634,393,14.7,2012,0.0
Louis Ellis,616,127,542,210,123,82,1425.0,335,114,124.0,207,96,23.9,2012,0.0
Demetrice Jacobs,105,22,98,35,35,24,350.0,38,11,26.0,60,24,19.3,2012,0.0
Tyler Lindsey,0,1,0,0,0,0,0.0,0,0,0.0,0,0,0,2012,0.0
John Shurna,2038,295,1509,704,478,356,4132.0,684,274,215.0,825,430,26.7,2012,0.0
Davide Curletti,323,118,231,103,150,98,1447.0,54,19,69.0,177,84,14.3,2012,0.0
Luka Mirkovic,708,228,548,268,249,150,2532.0,67,22,138.0,481,246,18.3,2012,0.0
Nick Fruendt,85,18,72,29,23,18,297.0,31,9,15.0,41,20,17.4,2012,0.0
Joey Brooks,187,35,146,59,103,57,636.0,37,12,41.0,109,47,20.3,2012,0.0
Mike Broghammer,83,10,72,37,28,8,251.0,4,1,13.0,68,36,21.3,2012,0.0
Tim Abromaitis,1137,121,792,368,289,241,2382.0,390,160,104.0,402,208,23.0,2012,0.0
Reggie Hamilton,2185,548,1546,687,644,534,3852.0,713,277,427.0,833,410,29.6,2012,0.0
Laval Lucas-Perry,621,137,487,176,257,174,2032.0,319,95,108.0,168,81,18.6,2012,0.0
Blake Cushingberry,421,74,354,141,104,66,1590.0,241,73,79.0,113,68,15.2,2012,0.0
Jared Sullinger,1282,89,849,450,495,363,2295.0,52,19,130.0,797,431,27.4,2012,1.0
William Buford,1990,361,1690,744,355,287,4727.0,558,215,254.0,1132,529,23.8,2012,0.0
Kenny Belton,38,2,34,15,23,8,143.0,0,0,12.0,34,15,41.7,2012,0.0
Keiton Page,1651,265,1226,496,419,360,4322.0,812,299,194.0,414,197,19.4,2012,0.0
Grayson George,0,0,0,0,0,0,3.0,0,0,0.0,0,0,0.0,2012,0.0
Barry Honore',576,32,518,230,134,84,1774.0,83,32,134.0,435,198,12.1,2012,0.0
T.J. Franklin,16,15,22,4,21,7,104.0,8,1,18.0,14,3,24.2,2012,0.0
Kent Bazemore,1416,379,1155,516,489,284,3681.0,299,100,320.0,856,416,23.8,2012,1.0
Chris Cooper,615,64,550,238,251,139,2058.0,1,0,122.0,549,238,19.6,2012,0.0
Trian Iliadis,621,156,581,214,105,75,1879.0,384,118,104.0,197,96,20.0,2012,0.0
Marquel De Lancey,218,125,220,79,74,46,1275.0,46,14,90.0,174,65,13.8,2012,0.0
Nayquann Mitchell,0,1,3,0,0,0,32.0,2,0,2.0,1,0,7.8,2012,0.0
Shquan Rogers,0,1,2,0,0,0,18.0,1,0,1.0,1,0,8.3,2012,0.0
Dominique Morrison,2080,246,1476,687,668,543,4295.0,424,163,206.0,1052,524,23.8,2012,0.0
Michael Craion,813,108,577,311,294,188,2023.0,16,3,154.0,561,308,22.2,2012,0.0
Roderick Pearson,1053,378,847,366,344,248,3354.0,259,73,338.0,588,293,17.4,2012,0.0
Robert Aery,22,3,29,7,4,3,49.0,22,5,3.0,7,2,36.1,2012,0.0
Jared Cunningham,1271,193,835,380,566,427,2733.0,244,84,251.0,591,296,24.5,2012,1.0
Kevin McShane,111,36,87,48,34,15,868.0,11,0,56.0,76,48,9.3,2012,0.0
Rhys Murphy,28,1,23,9,9,4,122.0,18,6,5.0,5,3,12.8,2012,0.0
Devoe Joseph,1051,274,872,372,196,144,2634.0,412,163,188.0,460,209,22.6,2012,0.0
Garrett Sim,1078,256,884,368,192,157,3320.0,490,185,183.0,394,183,17.6,2012,0.0
Olu Ashaolu,1320,134,939,499,553,302,3279.0,82,20,322.0,857,479,24.0,2012,0.0
Jeremy Jacob,528,28,477,219,142,89,1493.0,4,1,78.0,473,218,21.0,2012,0.0
Tyrone Nared,278,39,226,100,83,59,1224.0,60,19,63.0,166,81,13.6,2012,0.0
Brett Kingma,58,7,68,21,3,1,186.0,48,15,5.0,20,6,20.4,2012,0.0
Bruce Barron,3,5,4,1,2,0,21.0,3,1,3.0,1,0,19.3,2012,0.0
Rundell Mauge,39,7,38,18,5,3,166.0,0,0,10.0,38,18,16.5,2012,0.0
Markcus Falley,28,7,40,9,8,4,107.0,30,6,7.0,10,3,25.8,2012,0.0
Marvin Cotton,6,8,13,3,1,0,60.0,4,0,4.0,9,3,15.8,2012,0.0
Adam Eakles,4,2,9,2,0,0,68.0,1,0,3.0,8,2,9.6,2012,0.0
Cammeron Woodyard,387,33,384,129,76,60,1384.0,216,69,51.0,168,60,18.5,2012,0.0
Billy Oliver,220,21,208,72,46,30,986.0,149,46,46.0,59,26,15.3,2012,0.0
Zack Rosen,1723,587,1247,540,496,418,4198.0,576,225,327.0,671,315,25.2,2012,0.0
Tyler Bernardini,1456,168,1142,480,384,297,3275.0,542,199,202.0,600,281,23.9,2012,0.0
Rob Belcore,565,213,474,197,130,89,2914.0,262,82,152.0,212,115,13.1,2012,0.0
Marin Kukoc,81,21,78,29,6,4,329.0,52,19,21.0,26,10,17.3,2012,0.0
Mike Howlett,263,13,198,101,90,58,923.0,18,3,61.0,180,98,17.9,2012,0.0
Keelan Cairns,3,0,3,1,0,0,9.0,2,1,0.0,1,0,18.6,2012,0.0
Taylor Darby,997,74,828,368,446,261,3224.0,0,0,152.0,828,368,18.9,2012,0.0
Corbin Moore,645,65,521,252,175,114,2580.0,59,27,114.0,462,225,14.3,2012,0.0
Joshua Lowery,486,199,398,142,212,161,1977.0,133,41,123.0,265,101,16.3,2012,0.0
Richard Branning,18,0,17,6,0,0,37.0,15,6,2.0,2,0,27.2,2012,0.0
Dane Suttle Jr.,530,54,443,175,124,84,1448.0,252,96,95.0,191,79,20.6,2012,0.0
Don Martin,0,4,8,0,0,0,55.0,3,0,3.0,5,0,10.3,2012,1.0
Dominic Redix,0,1,0,0,0,0,5.0,0,0,2.0,0,0,21.3,2012,0.0
Ashton Gibbs,1748,255,1360,562,375,327,3837.0,724,297,175.0,636,265,23.3,2012,0.0
Nasir Robinson,962,187,764,407,297,141,2917.0,29,7,198.0,735,400,19.8,2012,0.0
Nick Rivers,13,6,19,4,4,2,41.0,10,3,5.0,9,1,33.0,2012,0.0
Isaiah Epps,2,16,16,1,3,0,103.0,12,0,5.0,4,1,11.4,2012,0.0
Charles Odum,1033,167,630,332,381,301,1868.0,188,68,171.0,442,264,26.5,2012,0.0
Chehales Tapscott,734,105,513,259,281,199,1712.0,55,17,124.0,458,242,22.7,2012,0.0
Nate Lozeau,401,8,307,167,101,67,1282.0,0,0,70.0,307,167,17.0,2012,0.0
Jerron Smith,22,4,16,10,6,1,52.0,5,1,2.0,11,9,20.3,2012,0.0
Kidus Ephrem,16,4,13,7,1,1,73.0,5,1,1.0,8,6,10.0,2012,0.0
Nemanja Mitrovic,796,105,675,276,102,85,2009.0,408,159,143.0,267,117,22.5,2012,0.0
Eric Waterford,213,111,202,76,63,38,903.0,66,23,72.0,136,53,17.7,2012,0.0
Taylor Mossman,1,0,2,0,2,1,5.0,2,0,0.0,0,0,30.5,2012,0.0
Tim Meadows,760,136,725,268,201,131,2847.0,320,93,161.0,405,175,15.1,2012,0.0
Cortney Bell,222,27,189,89,88,43,869.0,3,1,58.0,186,88,15.9,2012,0.0
Marcellus Jackson,75,8,80,30,32,14,258.0,2,1,30.0,78,29,22.7,2012,0.0
Jayvian Scranton,14,1,20,5,7,3,39.0,6,1,3.0,14,4,31.6,2012,0.0
Marvin Adu,17,1,11,7,10,3,133.0,0,0,8.0,11,7,8.5,2012,0.0
Michael Griffin,835,268,874,290,179,122,2326.0,430,133,228.0,444,157,25.1,2012,0.0
Al'lonzo Coleman,1501,185,1045,540,632,417,3196.0,26,4,326.0,1019,536,33.3,2012,0.0
Pierre Miller,937,329,784,320,143,90,3622.0,540,207,226.0,244,113,16.4,2012,0.0
Josh Johnson,912,183,752,308,167,119,3366.0,487,177,161.0,265,131,15.4,2012,0.0
Jay Reynolds,228,11,159,88,73,52,1296.0,0,0,61.0,159,88,11.0,2012,0.0
Tyler Deihl,52,18,50,18,3,1,228.0,46,15,20.0,4,3,17.9,2012,0.0
Doug Davis,1550,171,1291,545,228,184,3940.0,687,276,200.0,604,269,23.3,2012,0.0
Patrick Saunders,667,98,526,246,93,76,2505.0,267,99,109.0,259,147,15.5,2012,0.0
John Comfort,91,9,86,32,17,9,289.0,57,18,15.0,29,14,22.0,2012,0.0
Mike Murray,2,0,1,1,0,0,13.0,0,0,4.0,1,1,18.8,2012,0.0
Maurice Grant,1,0,0,0,2,1,1.0,0,0,1.0,0,0,98.8,2012,0.0
Robbie Hummel,1772,268,1315,583,464,390,3830.0,555,216,138.0,760,367,24.2,2012,1.0
Lewis Jackson,885,456,708,325,300,208,2991.0,101,27,212.0,607,298,18.7,2012,0.0
Ryne Smith,628,123,481,202,65,55,2293.0,414,169,49.0,67,33,12.8,2012,0.0
Nate Gause,77,5,100,30,10,5,229.0,51,12,10.0,49,18,23.9,2012,0.0
Alex Jackson,36,7,42,11,29,14,202.0,3,0,13.0,39,11,16.3,2012,0.0
Terrance Bobb-Jones,8,2,6,4,0,0,17.0,0,0,4.0,6,4,28.1,2012,0.0
Austin Alecxih,16,3,25,5,5,4,59.0,15,2,4.0,10,3,24.6,2012,0.0
Kevin Tarca,7,1,14,2,11,2,42.0,9,1,5.0,5,1,27.5,2012,0.0
Jareal Smith,560,113,511,173,210,156,1499.0,206,58,147.0,305,115,25.4,2012,0.0
Johnathan Edwards,388,26,323,147,185,94,1176.0,4,0,77.0,319,147,20.8,2012,0.0
Tolga Cerrah,354,31,279,141,135,72,1278.0,0,0,89.0,279,141,17.0,2012,0.0
Chance Smith,124,48,128,46,12,8,692.0,85,24,44.0,43,22,13.0,2012,0.0
Daniel Mitchell,134,25,164,52,24,12,663.0,76,18,23.0,88,34,15.0,2012,0.0
Lukas Winegarner,122,3,115,45,52,31,466.0,4,1,32.0,111,44,18.5,2012,0.0
Devin Cole,0,1,0,0,0,0,11.0,0,0,1.0,0,0,4.6,2012,0.0
Orion Outerbridge,762,31,650,304,189,126,1872.0,88,28,81.0,562,276,21.2,2012,0.0
Jamal Wilson,352,67,315,127,101,77,1031.0,75,21,74.0,240,106,21.4,2012,0.0
Anthony Malhoit,68,15,56,25,20,10,304.0,18,8,18.0,38,17,13.4,2012,0.0
Connor Frizzelle,1234,226,1086,412,292,247,3537.0,471,163,210.0,615,249,21.1,2012,0.0
Lucas Kuipers,845,86,737,309,123,95,2509.0,375,132,129.0,362,177,19.1,2012,0.0
Ahmad Ibrahim,204,33,208,77,32,23,614.0,88,27,37.0,120,50,21.6,2012,0.0
Emerson Herndon,109,10,110,41,48,27,341.0,0,0,18.0,110,41,22.8,2012,0.0
J.R. Reynolds,5,2,11,2,2,1,70.0,3,0,4.0,8,2,11.9,2012,0.0
Nate Schwarze,35,46,36,11,11,3,554.0,29,10,28.0,7,1,6.5,2012,0.0
Francis-Cedric Martel,557,138,460,195,153,97,2468.0,194,70,111.0,266,125,14.1,2012,0.0
Darrius Garrett,311,52,268,109,171,90,1869.0,20,3,94.0,248,106,12.9,2012,0.0
Josh Duinker,330,67,290,126,80,48,1128.0,101,30,66.0,189,96,18.8,2012,0.0
Conor Smith,86,10,77,28,14,13,266.0,57,17,15.0,20,11,19.9,2012,0.0
Liam Billings,8,1,5,3,0,0,18.0,4,2,0.0,1,1,15.0,2012,0.0
Zak Estes,2,0,2,1,2,0,26.0,1,0,1.0,1,1,8.3,2012,0.0
Brandon Penn,867,97,721,296,166,128,2295.0,380,147,147.0,341,149,20.9,2012,0.0
Novar Gadson,1475,224,1183,540,395,281,3294.0,359,114,317.0,824,426,25.8,2012,0.0
Eddie Mitchell,127,87,124,42,44,35,617.0,38,8,80.0,86,34,18.7,2012,0.0
Kevin Noon,3,1,7,1,0,0,17.0,6,1,0.0,1,0,21.1,2012,0.0
Mark Medley,1,0,0,0,3,1,7.0,0,0,0.0,0,0,10.4,2012,0.0
Lijah Thompson,561,37,398,204,206,153,1512.0,0,0,87.0,398,204,19.6,2012,0.0
Lawrence Bridges,287,48,224,119,114,49,1458.0,2,0,99.0,222,119,14.0,2012,0.0
Brandon Herman,55,20,63,21,18,8,293.0,21,5,19.0,42,16,15.6,2012,0.0
Darren Washington,4,0,4,2,0,0,11.0,0,0,0.0,4,2,18.4,2012,0.0
Charlie Rigoglioso,8,4,10,4,0,0,50.0,1,0,2.0,9,4,12.4,2012,0.0
Mike Kuhn,9,2,18,4,3,1,57.0,10,0,4.0,8,4,21.3,2012,0.0
Heath Hoffman,325,52,256,105,81,66,1135.0,143,49,56.0,113,56,16.3,2012,0.0
Josh McCarver,191,17,128,78,63,35,610.0,0,0,45.0,128,78,17.6,2012,0.0
Walter Jackson,237,36,194,100,46,33,950.0,24,4,43.0,170,96,14.4,2012,0.0
Jordan Estada,63,25,94,20,9,5,396.0,82,18,11.0,12,2,14.6,2012,0.0
Magd Owayed,1,0,0,0,2,1,5.0,0,0,0.0,0,0,10.0,2012,0.0
Stan Dulaire,478,80,333,175,231,128,1970.0,3,0,109.0,330,175,14.2,2012,0.0
Steve Zazuri,41,94,56,17,13,7,833.0,0,0,73.0,56,17,8.1,2012,0.0
Jon Taylor,270,30,238,108,91,53,944.0,4,1,49.0,234,107,18.7,2012,0.0
Dexter Lindsey,6,0,6,2,0,0,14.0,4,2,2.0,2,0,31.3,2012,0.0
Morece Issac,2,0,1,1,0,0,14.0,0,0,1.0,1,1,7.8,2012,0.0
Ryan Hess,2,1,1,1,0,0,7.0,0,0,1.0,1,1,15.1,2012,0.0
Brian Conklin,1161,105,792,404,498,352,3137.0,4,1,206.0,788,403,23.0,2012,0.0
Kyle Cassity,636,320,599,234,84,55,3259.0,355,113,148.0,244,121,13.9,2012,0.0
Brian Daly,2,3,4,1,2,0,31.0,1,0,5.0,3,1,17.4,2012,0.0
Grant Gehlen,0,0,0,0,0,0,9.0,0,0,2.0,0,0,12.1,2012,0.0
Rob Jones,1585,222,1326,627,370,238,3943.0,310,93,302.0,1016,534,24.7,2012,0.0
Clint Steindl,759,102,615,251,87,72,2513.0,463,185,76.0,152,66,15.0,2012,0.0
Kenton Walker II,574,29,438,236,164,101,1587.0,3,1,86.0,435,235,19.6,2012,0.0
Brandon Hall,237,248,256,77,102,60,2122.0,90,23,141.0,166,54,10.9,2012,0.0
Jack Hill,113,23,108,50,28,13,729.0,0,0,39.0,108,50,11.4,2012,0.0
Gaetano Spera,5,0,8,1,6,3,68.0,0,0,1.0,8,1,9.2,2012,0.0
Tyler DeChalus,1,0,4,0,2,1,13.0,0,0,1.0,4,0,24.1,2012,0.0
Marcus James,434,39,356,166,166,96,1372.0,27,6,116.0,329,160,21.0,2012,0.0
Steven Werner,288,12,189,119,89,50,588.0,0,0,59.0,189,119,26.4,2012,0.0
Antuan Bootle,358,48,293,156,87,46,1234.0,0,0,96.0,293,156,17.4,2012,0.0
Wesley Fritz,14,4,6,4,8,6,54.0,2,0,3.0,4,4,12.5,2012,0.0
Cameron Sadler,2,2,4,0,4,2,20.0,3,0,8.0,1,0,37.2,2012,0.0
Jeffrey Merritt,798,213,645,296,232,123,3024.0,239,83,179.0,406,213,18.0,2012,0.0
Matthew Friday,236,154,199,104,47,21,1396.0,51,7,111.0,148,97,14.1,2012,0.0
Devin McNeil,93,40,91,33,19,14,337.0,41,13,34.0,50,20,21.7,2012,0.0
Kaylin Johnson,317,61,276,107,69,49,1326.0,163,54,93.0,113,53,18.0,2012,0.0
Garrett Green,513,43,450,210,189,84,1793.0,32,9,114.0,418,201,18.8,2012,0.0
Tim Shelton,548,124,454,216,171,98,2048.0,62,18,85.0,392,198,13.9,2012,0.0
Alec Williams,128,7,106,46,35,28,362.0,28,8,26.0,78,38,21.3,2012,0.0
Darian Norris,691,186,583,230,197,148,2225.0,259,83,153.0,324,147,20.3,2012,0.0
Blair Banker,1,0,1,0,2,1,11.0,0,0,0.0,1,0,9.4,2012,0.0
Angelo Caloiaro,1271,234,894,402,364,280,3781.0,499,187,179.0,395,215,16.8,2012,0.0
Rashad Green,1207,259,944,414,375,285,3123.0,295,94,323.0,649,320,23.2,2012,0.0
Dominique O'Connor,151,51,128,52,57,43,512.0,18,4,49.0,110,48,20.0,2012,0.0
Jay Wey,27,6,23,9,2,1,66.0,19,8,3.0,4,1,20.4,2012,0.0
Wil Carter,731,59,553,270,243,187,1996.0,15,4,107.0,538,266,19.9,2012,0.0
Calvin Douglas,370,48,353,127,48,38,1235.0,237,78,29.0,116,49,16.8,2012,0.0
Matt Ballard,138,38,133,42,86,54,1693.0,2,0,39.0,131,42,6.4,2012,0.0
Garrett Ton,19,5,15,6,8,7,153.0,0,0,4.0,15,6,7.6,2012,0.0
Joe Henson,39,3,41,15,15,9,501.0,0,0,24.0,41,15,7.2,2012,0.0
Jeremy Pope,0,1,1,0,0,0,4.0,0,0,0.0,1,0,13.1,2012,0.0
Jordan Akwenuke,31,5,21,13,6,5,251.0,0,0,10.0,21,13,6.9,2012,0.0
Phillip Bach,34,10,37,13,11,4,115.0,22,4,11.0,15,9,23.0,2012,0.0
Nick Lamson,4,0,3,1,2,1,7.0,1,1,0.0,2,0,28.7,2012,0.0
Demetri Posey,0,0,0,0,0,0,1.0,0,0,0.0,0,0,0.0,2012,0.0
Deric Rudolph,352,52,324,109,47,36,949.0,282,98,45.0,42,11,21.0,2012,0.0
Richard Connor,50,31,52,16,30,16,408.0,17,2,32.0,35,14,12.4,2012,0.0
Keith Edwards,11,3,8,4,9,3,45.0,0,0,7.0,8,4,22.8,2012,0.0
Aaron Broussard,1261,103,1035,479,327,220,2474.0,251,83,169.0,784,396,24.3,2012,0.0
Eric Wallace,432,28,416,186,140,53,1247.0,22,7,81.0,394,179,21.9,2012,0.0
Cervante Burrell,887,331,751,328,321,225,2306.0,27,6,249.0,724,322,21.9,2012,0.0
Gavin Gilmore,237,29,224,93,84,51,1087.0,1,0,85.0,223,93,14.0,2012,0.0
Obie Hurt,4,2,5,1,3,2,32.0,1,0,7.0,4,1,18.8,2012,0.0
Jordan Theodore,1371,541,1138,460,423,334,3720.0,346,117,281.0,792,343,23.0,2012,0.0
Herb Pope,1338,184,1165,528,450,248,3198.0,114,34,265.0,1051,494,25.3,2012,0.0
Peter Dill,2,2,4,1,0,0,13.0,2,0,0.0,2,1,15.7,2012,0.0
John Snow,0,0,1,0,0,0,4.0,1,0,0.0,0,0,13.0,2012,0.0
Kyle Downey,790,151,729,297,160,126,2383.0,252,70,173.0,477,227,20.6,2012,0.0
Owen Wignot,541,123,488,201,95,63,2313.0,222,76,93.0,266,125,13.4,2012,0.0
Davonte Beard,52,16,42,15,25,18,227.0,17,4,18.0,25,11,16.4,2012,0.0
Conner Fenlon,9,0,9,2,6,4,27.0,7,1,1.0,2,1,23.8,2012,0.0
Antione Lundy,263,10,220,99,89,60,668.0,19,5,46.0,201,94,22.8,2012,0.0
Dallas Jones,126,23,116,45,17,10,426.0,81,26,14.0,35,19,16.1,2012,0.0
DeAndre Hersey,163,22,140,62,50,36,718.0,9,3,44.0,131,59,14.4,2012,0.0
Jose Diaz,14,5,15,5,4,3,69.0,5,1,7.0,10,4,17.1,2012,0.0
Andre Gowins,12,0,13,4,5,4,46.0,0,0,4.0,13,4,20.6,2012,0.0
Brandon Riley,781,78,700,288,149,116,1593.0,258,89,157.0,442,199,28.2,2012,0.0
Omar Sanders,512,36,412,200,179,97,1406.0,65,15,103.0,347,185,20.8,2012,0.0
Aaron Martin,170,29,164,44,78,55,622.0,105,27,41.0,59,17,18.6,2012,0.0
Presano Bell,377,26,288,137,197,103,1220.0,3,0,68.0,285,137,18.0,2012,0.0
Shaquille Barber,176,29,187,70,49,29,715.0,37,7,57.0,150,63,17.9,2012,0.0
Joe Ikhinmwin,351,31,303,147,87,54,1082.0,6,3,83.0,297,144,19.3,2012,0.0
Dante Wooten,8,1,11,3,5,2,84.0,0,0,11.0,11,3,13.8,2012,0.0
Terrance Gilleylen,2,0,4,1,0,0,16.0,2,0,1.0,2,1,14.9,2012,0.0
Darian Coleman,0,1,0,0,0,0,8.0,0,0,0.0,0,0,0.0,2012,0.0
Sabastian Opon,0,0,0,0,0,0,5.0,0,0,0.0,0,0,0.0,2012,0.0
Carter Cook,547,133,481,199,132,90,1711.0,190,59,137.0,291,140,19.6,2012,0.0
Chalmers Rogers,278,56,322,106,51,33,1690.0,115,33,66.0,207,73,12.6,2012,0.0
Shane Porchea,56,11,67,20,21,11,277.0,22,5,16.0,45,15,17.0,2012,0.0
Malik Cook,1070,119,803,368,362,276,3044.0,175,58,187.0,628,310,20.5,2012,0.0
Damontre Harris,318,28,233,130,78,58,1294.0,2,0,59.0,231,130,13.2,2012,0.0
Carlton Geathers,28,1,23,10,12,8,219.0,0,0,7.0,23,10,8.7,2012,0.0
Griffan Callahan,868,101,647,270,209,163,2758.0,423,165,113.0,224,105,15.9,2012,0.0
Zach Monaghan,54,14,56,16,21,14,192.0,33,8,20.0,23,8,23.4,2012,0.0
Charlie Westbrook,1009,98,784,370,292,212,1762.0,165,57,140.0,619,313,29.8,2012,0.0
Louie Krogman,1274,248,1064,449,215,153,2849.0,610,223,150.0,454,226,22.6,2012,0.0
Allan Saint-Gelais,199,27,155,69,68,48,801.0,40,13,61.0,115,56,15.8,2012,0.0
Ricardo Andreotti,261,49,213,111,73,39,1276.0,4,0,78.0,209,111,12.4,2012,0.0
Nick Mabbutt,14,7,17,5,4,0,86.0,14,4,8.0,3,1,16.1,2012,0.0
Jake Krogman,0,0,1,0,2,0,3.0,0,0,0.0,1,0,33.5,2012,0.0
Augustus Gilchrist,1209,61,1019,436,431,296,2888.0,123,41,214.0,896,395,27.0,2012,0.0
Ron Anderson,752,129,528,279,362,194,2686.0,3,0,155.0,525,279,17.1,2012,1.0
Hugh Robertson,506,106,436,198,108,76,2018.0,119,34,95.0,317,164,15.9,2012,0.0
Blake Nash,116,39,95,36,34,28,416.0,62,16,31.0,33,20,19.6,2012,0.0
Alberto Damour,7,0,5,3,2,1,17.0,0,0,0.0,5,3,20.0,2012,0.0
Leon Powell,771,52,486,298,340,175,1801.0,0,0,117.0,486,298,21.8,2012,0.0
Marcus Brister,378,200,320,146,195,86,1534.0,4,0,174.0,316,146,19.7,2012,0.0
Telvin Wilkerson,29,6,38,11,3,1,130.0,12,6,6.0,26,5,18.0,2012,0.0
Logan Nutt,71,61,62,23,26,18,420.0,24,7,41.0,38,16,14.1,2012,0.0
Zach House,74,7,79,28,34,18,460.0,0,0,27.0,79,28,13.6,2012,0.0
Waylon Jones,40,13,28,14,21,12,307.0,0,0,26.0,28,14,10.7,2012,0.0
Daron Populist,245,60,198,77,55,41,1056.0,129,50,62.0,69,27,14.1,2012,0.0
Elgin Bailey,406,15,350,146,213,114,1182.0,1,0,117.0,349,146,24.5,2012,0.0
DeShawn Patterson,625,381,553,213,276,171,2958.0,121,28,237.0,432,185,16.5,2012,0.0
Donovon Ross,48,6,44,23,11,2,211.0,0,0,7.0,44,23,13.9,2012,0.0
Jonathan Curtis,7,2,7,3,1,1,21.0,1,0,2.0,6,3,23.2,2012,0.0
Maurice Jones,753,221,729,256,225,148,2393.0,290,93,147.0,439,163,23.2,2012,0.0
Alexis Moore,138,49,171,49,24,14,794.0,92,26,40.0,79,23,16.3,2012,0.0
Eric Strangis,23,9,26,9,2,2,317.0,15,3,6.0,11,6,6.1,2012,0.0
Evan Smith,18,6,26,7,0,0,167.0,19,4,13.0,7,3,12.9,2012,0.0
Danilo Dragovic,0,0,0,0,0,0,1.0,0,0,0.0,0,0,0.0,2012,0.0
Corey Wickware,611,144,460,176,180,149,1661.0,289,110,137.0,171,66,21.1,2012,0.0
Kevin Stineman,399,189,339,134,135,90,1693.0,134,41,164.0,205,93,14.9,2012,0.0
David Boarden,218,51,265,82,37,19,1132.0,121,35,59.0,144,47,15.4,2012,0.0
Mamadou Seck,760,127,600,292,236,176,1911.0,2,0,118.0,598,292,22.9,2012,0.0
Justin Bocot,787,142,709,266,222,152,2366.0,314,103,181.0,395,163,22.3,2012,0.0
Kourtney Goff,41,44,49,12,21,14,419.0,20,3,32.0,29,9,11.1,2012,0.0
Harry Whitt,35,1,46,11,14,10,155.0,10,3,8.0,36,8,20.1,2012,0.0
Robert Nyakundi,1353,124,998,452,216,182,3206.0,615,267,189.0,383,185,23.1,2012,0.0
Rodney Clinkscales,402,75,317,131,62,53,1460.0,222,87,60.0,95,44,16.0,2012,0.0
Aliaksei Patsevich,114,36,122,40,21,16,679.0,71,18,30.0,51,22,14.1,2012,0.0
Maurice Bolden,846,68,698,290,279,202,2150.0,185,64,149.0,513,226,23.4,2012,0.0
Angelo Johnson,1055,389,904,346,323,237,4039.0,347,126,211.0,557,220,16.2,2012,0.0
Darnell Dodson,478,24,394,161,106,83,959.0,206,73,45.0,188,88,25.2,2012,0.0
Torye Pelham,350,20,241,142,83,60,1204.0,21,6,54.0,220,136,14.3,2012,0.0
Ahyaro Phillips,70,8,64,31,13,6,248.0,2,2,23.0,62,29,18.9,2012,0.0
Richard Carlisle,2,0,3,1,0,0,11.0,1,0,0.0,2,1,14.0,2012,0.0
Keith DeWitt,2,1,2,0,4,2,27.0,0,0,5.0,2,0,16.9,2012,0.0
Alahjah Franklin,0,0,3,0,0,0,9.0,1,0,1.0,2,0,22.8,2012,0.0
Ramell Taylor,517,52,454,208,142,94,1351.0,25,7,141.0,429,201,25.9,2012,0.0
Ray Jones,585,259,393,192,233,174,1967.0,83,27,168.0,310,165,17.8,2012,0.0
Matt Massey,775,98,577,288,239,182,2248.0,51,17,165.0,526,271,19.7,2012,0.0
Brian Cameron,25,13,26,10,7,4,104.0,8,1,12.0,18,9,20.3,2012,0.0
Quinton Doggett,719,28,657,288,228,142,2087.0,7,1,106.0,650,287,21.7,2012,0.0
Michael Celestine,289,54,266,100,41,27,847.0,178,62,54.0,88,38,21.5,2012,0.0
Frederick Coleman,212,48,174,90,107,32,1342.0,4,0,99.0,170,90,12.7,2012,0.0
Russell Hill,78,5,93,32,14,11,188.0,29,3,16.0,64,29,33.1,2012,0.0
Neal Webb,141,23,147,48,23,16,633.0,100,29,40.0,47,19,16.3,2012,0.0
Patrick Coleman,48,16,52,15,13,10,277.0,30,8,15.0,22,7,13.7,2012,0.0
Andrew Nicholson,2103,87,1407,809,633,456,3672.0,77,29,296.0,1330,780,29.1,2012,1.0
Da'Quan Cook,567,81,412,181,294,205,2270.0,0,0,160.0,412,181,16.5,2012,0.0
Jake Houseknecht,24,4,29,9,9,6,241.0,0,0,14.0,29,9,10.3,2012,0.0
Zach Moore,4,0,2,1,2,2,6.0,0,0,0.0,2,1,25.7,2012,0.0
Stefan Perunicic,1163,112,1000,377,188,129,3437.0,766,280,223.0,234,97,19.4,2012,0.0
Justin Newton,215,301,211,70,93,56,2437.0,95,19,190.0,116,51,9.3,2012,0.0
Maurice Harkless,497,47,427,193,139,94,1155.0,79,17,80.0,348,176,24.9,2012,1.0
Malik Stith,194,83,201,69,70,48,1004.0,41,8,52.0,160,61,14.6,2012,0.0
Drew Bashen,0,0,0,0,0,0,2.0,0,0,1.0,0,0,25.1,2012,0.0
Boris Brakalov,0,0,1,0,0,0,2.0,1,0,0.0,0,0,25.1,2012,0.0
Gerard Rivers,0,0,0,0,0,0,1.0,0,0,0.0,0,0,0.0,2012,0.0
Josh Owens,1054,100,761,436,293,182,2665.0,0,0,158.0,761,436,20.3,2012,0.0
Jarrett Mann,504,353,431,150,369,196,2614.0,53,8,256.0,378,142,16.9,2012,0.0
Andrew Zimmermann,365,66,328,146,111,64,1464.0,46,9,113.0,282,137,18.0,2012,0.0
Jack Trotter,400,43,336,161,103,70,1545.0,28,8,52.0,308,153,14.5,2012,0.0
Jereal Scott,1227,66,878,462,438,303,2328.0,0,0,184.0,878,462,29.3,2012,0.0
Jonathan King,197,23,129,66,91,63,671.0,7,2,42.0,122,64,17.4,2012,0.0
Kevin Broussard,60,7,53,21,7,5,161.0,34,13,3.0,19,8,20.1,2012,0.0
Micah Delph,29,13,35,11,4,3,126.0,12,4,7.0,23,7,19.0,2012,0.0
Tyshawn Patterson,535,120,465,183,188,120,1430.0,200,49,155.0,265,134,25.1,2012,0.0
Amara Thompson,72,40,55,26,37,18,299.0,7,2,50.0,48,24,19.9,2012,0.0
Jermol Paul,238,19,206,77,101,70,890.0,63,14,75.0,143,63,17.5,2012,0.0
Diego Morales,7,5,5,2,3,2,35.0,2,1,3.0,3,1,13.2,2012,0.0
Bryan Dougher,1609,233,1415,514,300,244,4067.0,900,337,204.0,515,177,23.7,2012,0.0
Dallis Joyner,903,86,748,353,375,197,3134.0,1,0,202.0,747,353,18.3,2012,0.0
Al Rapier,383,70,301,156,125,71,1327.0,6,0,104.0,295,156,18.5,2012,0.0
Danny Carter,374,47,341,136,74,50,1781.0,164,52,85.0,177,84,13.1,2012,0.0
Kris Joseph,1476,208,1094,491,544,382,3725.0,338,112,217.0,756,379,21.9,2012,1.0
Dion Waiters,690,142,547,248,166,125,1445.0,198,69,78.0,349,179,25.0,2012,1.0
Scoop Jardine,1265,619,1022,465,312,214,3480.0,332,121,311.0,690,344,21.2,2012,0.0
Fab Melo,311,29,229,132,85,47,1090.0,0,0,68.0,229,132,15.9,2012,1.0
Mookie Jones,202,27,160,67,27,18,411.0,126,50,20.0,34,17,24.0,2012,0.0
Matt Tomaszewski,26,1,15,9,2,1,39.0,10,7,0.0,5,2,21.0,2012,0.0
Brandon Reese,29,17,27,9,17,10,95.0,7,1,9.0,20,8,24.6,2012,0.0
Nick Resavy,8,7,11,4,0,0,39.0,4,0,6.0,7,4,21.9,2012,0.0
Ramone Moore,1393,277,1123,496,384,290,3123.0,317,111,221.0,806,385,25.8,2012,0.0
Juan Fernandez,1247,423,1083,425,239,190,3514.0,515,207,237.0,568,218,22.0,2012,0.0
Micheal Eric,592,64,512,258,140,76,1670.0,0,0,114.0,512,258,22.3,2012,0.0
Jake Godino,11,1,9,4,6,1,26.0,5,2,2.0,4,2,27.8,2012,0.0
Dane Smith,392,73,319,150,139,90,1456.0,11,2,98.0,308,148,16.8,2012,0.0
Troy King,545,58,450,183,141,101,1453.0,221,78,125.0,229,105,22.3,2012,0.0
Corderio Maclin,189,10,153,75,59,39,435.0,0,0,36.0,153,75,25.5,2012,0.0
Chris Richardson,87,64,97,26,49,29,812.0,31,6,78.0,66,20,12.3,2012,0.0
Gary Love,38,9,34,13,7,3,225.0,24,9,11.0,10,4,11.0,2012,0.0
Martez Harris,29,8,37,11,6,3,194.0,11,4,13.0,26,7,13.9,2012,0.0
Eli York,17,2,18,6,6,5,65.0,0,0,4.0,18,6,19.5,2012,0.0
Wale Akinbobola,0,0,0,0,0,0,3.0,0,0,0.0,0,0,0.0,2012,0.0
Wil Peters,951,386,754,298,287,227,3572.0,338,128,252.0,416,170,16.2,2012,0.0
Kenny Moore,626,90,445,194,243,185,1379.0,142,53,123.0,303,141,25.7,2012,0.0
Chris Conner,301,37,258,87,108,80,1002.0,160,47,64.0,98,40,14.8,2012,0.0
Bawa Muniru,18,0,22,6,12,6,119.0,0,0,5.0,22,6,13.9,2012,0.0
Kevin Murphy,2019,249,1594,706,567,416,3718.0,513,191,381.0,1081,515,30.0,2012,1.0
Zach Bailey,772,160,589,237,273,224,2607.0,220,74,178.0,369,163,17.3,2012,0.0
Zac Swansey,849,545,818,329,144,90,3422.0,299,101,339.0,519,228,17.5,2012,0.0
Liam McMorrow,226,14,140,81,115,64,754.0,0,0,72.0,140,81,17.5,2012,0.0
Bassey Inameti,408,45,296,161,146,86,1486.0,2,0,111.0,294,161,16.4,2012,0.0
Chase Dunn,298,46,234,86,95,77,718.0,151,49,56.0,83,37,22.8,2012,0.0
Riley Hunley,26,23,30,10,11,6,153.0,9,0,12.0,21,10,14.0,2012,0.0
Cameron Tatum,1081,232,921,368,286,190,3039.0,476,155,194.0,445,213,20.3,2012,0.0
Dwight Miller,56,1,49,25,8,2,161.0,8,4,4.0,41,21,18.5,2012,0.0
Ryan Kilmartin,5,0,4,2,0,0,7.0,3,1,0.0,1,1,29.1,2012,0.0
Tyler Summit,3,0,1,1,0,0,10.0,1,1,1.0,0,0,9.9,2012,0.0
Chris Mast,516,59,452,188,193,120,1501.0,94,20,125.0,358,168,23.1,2012,0.0
Myron Dempsey,241,25,217,104,81,33,775.0,0,0,41.0,217,104,19.9,2012,0.0
Jason Smith,91,18,86,29,39,27,275.0,22,6,33.0,64,23,26.0,2012,1.0
Jordan Pope-Didier,42,3,48,20,7,2,296.0,4,0,18.0,44,20,12.2,2012,0.0
David Loubeau,1215,52,942,472,408,269,2959.0,8,2,175.0,934,470,23.8,2012,0.0
Khris Middleton,981,175,789,340,272,209,2263.0,287,92,173.0,502,248,25.5,2012,1.0
Dash Harris,505,379,510,163,232,123,2967.0,210,56,215.0,300,107,14.8,2012,0.0
Zach Kinsley,163,24,167,55,35,25,742.0,82,28,39.0,85,27,15.8,2012,0.0
Alex Baird,4,5,2,0,7,4,52.0,2,0,3.0,0,0,8.7,2012,0.0
LaMarcus Reed,1245,140,920,405,400,309,2685.0,344,126,236.0,576,279,23.9,2012,0.0
Bo Ingram,748,43,582,248,183,139,1613.0,320,113,127.0,262,135,23.5,2012,0.0
Bradley Gay,417,56,334,145,109,75,1100.0,147,52,80.0,187,93,20.2,2012,0.0
Jorge Redmon,72,20,60,24,15,9,184.0,35,15,13.0,25,9,20.3,2012,0.0
Nicholaus Osbourne,16,0,14,6,0,0,32.0,11,4,3.0,3,2,24.8,2012,0.0
Hank Thorns,1029,562,975,348,264,191,3506.0,433,142,291.0,542,206,20.1,2012,0.0
J.R. Cadot,637,79,408,231,240,154,1809.0,67,21,79.0,341,210,16.9,2012,0.0
Craig Williams,504,49,431,174,95,67,1281.0,247,89,59.0,184,85,22.4,2012,0.0
Cheick Kone,7,2,12,2,5,3,36.0,0,0,3.0,12,2,24.5,2012,0.0
Gabriel McCulley,783,132,574,268,250,176,2564.0,207,71,141.0,367,197,18.0,2012,0.0
Kevin Perry,6,1,8,1,6,4,31.0,0,0,1.0,8,1,20.9,2012,0.0
Mauricio Cheda,0,0,0,0,0,0,6.0,0,0,0.0,0,0,0.0,2012,0.0
Jared Maree,1103,164,879,380,337,256,3143.0,274,87,172.0,605,293,20.1,2012,0.0
Nick Weiermiller,775,409,694,261,152,114,3209.0,414,139,274.0,280,122,17.7,2012,0.0
Earl Jefferson,118,24,114,41,49,30,602.0,25,6,59.0,89,35,17.4,2012,0.0
Enrique Mason,168,16,155,65,56,38,676.0,0,0,37.0,155,65,16.9,2012,0.0
Kieondre Arkwright,153,41,139,51,42,26,514.0,71,25,50.0,68,26,21.1,2012,0.0
Josh Sanchez,2,1,5,1,0,0,32.0,4,0,2.0,1,1,11.7,2012,0.0
Julio Oyervides,0,0,1,0,0,0,9.0,0,0,2.0,1,0,17.8,2012,0.0
Neo Sanchez,0,1,0,0,0,0,10.0,0,0,1.0,0,0,5.3,2012,0.0
Michael Yahnke,0,0,0,0,0,0,15.0,0,0,0,0,0,0,2012,0.0
Stephen Franklin,460,123,315,142,164,123,1613.0,129,53,108.0,186,89,15.8,2012,0.0
Alex Vouyoukas,278,54,269,118,57,39,1119.0,9,3,75.0,260,115,17.0,2012,0.0
Sei Paye,359,122,287,112,120,78,1804.0,166,57,75.0,121,55,11.9,2012,0.0
Ryan Whitehead,22,15,27,7,8,7,140.0,9,1,10.0,18,6,14.8,2012,0.0
Daquan Joyner,305,37,230,119,119,67,1211.0,1,0,68.0,229,119,14.9,2012,0.0
Timothy Price,276,22,258,112,100,51,1272.0,3,1,83.0,255,111,14.7,2012,0.0
Daniel King,222,51,158,81,100,60,1267.0,1,0,71.0,157,81,11.3,2012,0.0
Keithtrick Denson,124,20,87,52,50,20,562.0,0,0,34.0,87,52,13.3,2012,0.0
Brooks Ybarra,449,54,314,149,92,71,1012.0,185,80,51.0,129,69,18.7,2012,0.0
Travis Jones,477,47,416,168,76,47,1385.0,255,94,63.0,161,74,17.1,2012,0.0
Eddie Rios,685,201,612,232,157,107,1839.0,316,114,166.0,296,118,21.7,2012,0.0
John Bowman,681,163,604,253,208,122,2394.0,176,53,205.0,428,200,17.0,2012,0.0
Dante Bachus,27,2,27,11,10,5,107.0,0,0,7.0,27,11,16.8,2012,0.0
Jordan Kirschke,29,5,19,7,15,9,75.0,13,6,6.0,6,1,19.8,2012,0.0
Luke Mergerson,20,2,14,5,14,10,73.0,0,0,1.0,14,5,13.7,2012,0.0
Xavier Dade,11,2,12,5,2,1,54.0,4,0,3.0,8,5,13.7,2012,0.0
Robert Lewandowski,756,98,631,323,170,109,2312.0,4,1,151.0,627,322,18.1,2012,0.0
Kevin Wagner,45,27,49,15,15,10,266.0,10,5,19.0,39,10,15.4,2012,0.0
J'Covan Brown,1376,284,1090,434,398,345,2699.0,466,163,222.0,624,271,27.0,2012,0.0
Clint Chapman,393,20,333,152,139,89,1313.0,9,0,61.0,324,152,18.1,2012,0.0
Alexis Wangmene,369,16,252,115,207,139,1616.0,2,0,92.0,250,115,13.6,2012,0.0
Zack Riddle,11,1,5,1,12,9,29.0,0,0,4.0,5,1,26.4,2012,0.0
Robert Nwankwo,843,50,641,306,458,231,2698.0,0,0,143.0,641,306,20.6,2012,0.0
Erique Gumbs,296,29,268,117,131,61,1121.0,13,1,90.0,255,116,19.5,2012,0.0
Alex Giergen,33,2,36,11,6,3,283.0,29,8,14.0,7,3,9.7,2012,0.0
Deyon Cook,15,1,16,5,1,1,81.0,15,4,5.0,1,1,13.7,2012,0.0
Will Weathers,690,351,641,233,221,167,2154.0,193,57,216.0,448,176,21.7,2012,0.0
Alan Jones,290,18,268,103,29,21,613.0,175,63,26.0,93,40,24.5,2012,0.0
Tim Owens,185,10,116,69,80,47,838.0,0,0,38.0,116,69,11.1,2012,0.0
Steven Cunningham,238,65,215,101,81,25,936.0,40,11,70.0,175,90,16.8,2012,0.0
Daronte Clark,117,15,125,42,16,9,381.0,84,24,16.0,41,18,19.0,2012,0.0
Nic Combs,30,12,24,12,8,4,96.0,2,2,5.0,22,10,16.7,2012,0.0
Brian Feldman,10,4,10,4,0,0,26.0,4,2,0.0,6,2,18.7,2012,0.0
Trent Rogers,247,150,197,74,95,62,1396.0,110,37,112.0,87,37,13.3,2012,0.0
Malte Ziegenhagen,32,7,37,11,2,1,158.0,33,9,4.0,4,2,14.2,2012,0.0
Dan Monckton,230,53,202,88,56,38,855.0,64,16,62.0,138,72,18.8,2012,0.0
Steven Idlet,1054,102,704,364,453,324,2746.0,4,2,178.0,700,362,20.8,2012,0.0
Kodi Maduka,320,29,223,112,171,96,1053.0,2,0,73.0,221,112,19.0,2012,0.0
D.J. Magley,501,75,408,208,139,85,2118.0,0,0,108.0,408,208,13.2,2012,0.0
Joe Richard,433,69,304,161,208,111,2461.0,0,0,146.0,304,161,11.6,2012,0.0
Will Sanger,16,2,12,5,7,4,43.0,7,2,4.0,5,3,23.5,2012,0.0
Donte Medder,172,37,128,50,59,39,478.0,92,33,51.0,36,17,22.1,2012,0.0
Jairus Coleman,0,0,1,0,2,0,2.0,0,0,0.0,1,0,52.2,2012,0.0
Lazeric Jones,743,256,612,254,195,150,2034.0,227,85,155.0,385,169,21.9,2012,0.0
Jerime Andersen,701,366,573,255,186,117,2747.0,194,74,208.0,379,181,16.6,2012,0.0
Reeves Nelson,820,73,531,310,336,193,1837.0,28,7,134.0,503,303,23.3,2012,0.0
Anthony Stover,36,3,38,13,32,10,490.0,0,0,21.0,38,13,7.8,2012,0.0
Matt DeMarcus,0,3,1,0,0,0,11.0,0,0,2.0,1,0,14.0,2012,0.0
Tyler Trapani,2,0,6,1,0,0,14.0,4,0,0.0,2,1,22.4,2012,0.0
Brockeith Pane,1044,299,852,351,359,281,2564.0,221,61,221.0,631,290,25.8,2012,0.0
Morgan Grim,457,55,309,170,178,117,1531.0,1,0,93.0,308,170,17.4,2012,0.0
E.J. Farris,131,39,131,45,28,26,458.0,60,15,42.0,71,30,22.2,2012,0.0
Brady Jardine,527,55,393,208,171,110,1512.0,2,1,95.0,391,207,20.3,2012,0.0
Igor Premasunac,2,1,5,1,0,0,42.0,1,0,6.0,4,1,14.4,2012,0.0
Isiah Williams,1063,129,904,354,224,190,2022.0,470,165,132.0,434,189,28.1,2012,0.0
Geddes Robinson,807,111,562,304,343,199,2361.0,1,0,173.0,561,304,18.9,2012,0.0
Keith Thompson,376,65,305,141,120,75,1027.0,64,19,58.0,241,122,20.4,2012,0.0
Kevin Woods II,260,118,221,100,83,56,1162.0,13,4,106.0,208,96,14.5,2012,0.0
Rory Fannon,70,20,74,26,41,18,713.0,0,0,39.0,74,26,9.5,2012,0.0
Josh Watkins,642,177,542,221,248,172,1319.0,120,28,160.0,422,193,33.2,2012,0.0
Dilon Farr,209,15,179,84,41,23,803.0,48,18,43.0,131,66,17.2,2012,0.0
Kyle Perkins,18,3,16,8,1,0,129.0,6,2,6.0,10,6,10.0,2012,0.0
Corbin Green,0,0,0,0,0,0,2.0,0,0,0.0,0,0,0.0,2012,0.0
Hrvoje Vucic,43,8,44,17,13,9,215.0,1,0,15.0,43,17,16.3,2012,0.0
Tommy Kurth,78,49,67,23,30,17,692.0,48,15,41.0,19,8,9.2,2012,0.0
Nathan Stegelmann,11,0,9,5,1,1,29.0,0,0,2.0,9,5,21.6,2012,0.0
Griffyn Carpenter,5,4,4,1,4,3,22.0,2,0,2.0,2,1,19.6,2012,0.0
Nick Shelton,10,3,17,3,11,4,100.0,7,0,7.0,10,3,16.1,2012,0.0
John Jenkins,1658,111,1102,516,374,320,2998.0,699,306,130.0,403,210,24.2,2012,1.0
Jeffery Taylor,1897,252,1378,665,652,452,3923.0,321,115,309.0,1057,550,26.0,2012,1.0
Brad Tinsley,1253,482,944,410,291,244,3919.0,501,189,258.0,443,221,17.4,2012,0.0
Lance Goulbourne,751,110,552,243,305,211,2527.0,180,54,170.0,372,189,17.6,2012,0.0
Festus Ezeli,934,18,587,330,469,274,2168.0,0,0,195.0,587,330,23.7,2012,1.0
Steve Tchiengang,485,52,371,162,165,116,1978.0,127,45,135.0,244,117,15.1,2012,0.0
Jordan Smart,16,8,16,6,0,0,90.0,13,4,1.0,3,2,9.6,2012,0.0
Aaron Noll,6,0,2,1,5,4,27.0,0,0,0.0,2,1,8.2,2012,0.0
Matt Glass,841,78,705,310,145,108,2257.0,304,113,102.0,401,197,20.3,2012,0.0
Brendan Bald,721,72,720,262,173,114,2081.0,263,83,124.0,457,179,23.3,2012,0.0
Pat Bergmann,207,17,149,88,48,29,571.0,2,2,46.0,147,86,20.2,2012,0.0
Chris Santo,7,1,9,2,4,3,40.0,0,0,3.0,9,2,18.7,2012,0.0
Ryan McKeaney,11,1,12,5,3,1,38.0,0,0,1.0,12,5,20.0,2012,0.0
Jon Angstadt,0,0,0,0,0,0,1.0,0,0,0.0,0,0,0.0,2012,0.0
Maalik Wayns,1191,323,919,379,400,339,2464.0,323,94,223.0,596,285,26.9,2012,1.0
Dominic Cheek,742,79,611,244,210,159,2042.0,302,95,99.0,309,149,19.6,2012,0.0
Dallas Ouano,0,0,0,0,0,0,14.0,0,0,1.0,0,0,3.7,2012,0.0
Bradford Burgess,1684,210,1243,555,450,343,4572.0,583,231,190.0,660,324,20.2,2012,0.0
Heath Houston,6,0,5,3,0,0,38.0,0,0,3.0,5,3,10.9,2012,0.0
Keith Gabriel,1925,168,1569,654,449,306,3082.0,933,311,239.0,636,343,28.6,2012,0.0
Ron Burks,996,382,836,330,305,215,3214.0,388,121,277.0,448,209,17.0,2012,0.0
Michael Sparks,1063,95,842,330,254,176,2711.0,640,227,108.0,202,103,17.0,2012,0.0
Wayne Whiting,100,14,87,38,35,23,389.0,1,1,15.0,86,37,13.4,2012,0.0
Dorenzo Hudson,1200,177,1032,419,332,255,3437.0,360,107,201.0,672,312,20.6,2012,0.0
Victor Davila,720,63,530,286,278,148,2827.0,1,0,130.0,529,286,14.4,2012,0.0
Sammy Zeglinski,947,314,887,327,138,93,3214.0,568,200,217.0,319,127,19.7,2012,0.0
Assane Sene,336,19,278,128,144,80,1749.0,0,0,84.0,278,128,13.5,2012,0.0
Angus Mitchell,0,0,0,0,0,0,6.0,0,0,0.0,0,0,0.0,2012,0.0
Tyler Murray,1208,287,896,389,306,243,3189.0,430,187,230.0,466,202,20.5,2012,0.0
Ryan Schrotenboer,73,15,57,32,17,9,408.0,1,0,25.0,56,32,11.4,2012,0.0
Nikita Mescheriakov,421,84,373,145,132,94,1478.0,145,37,115.0,228,108,19.6,2012,0.0
Ty Walker,224,28,215,96,53,32,1066.0,0,0,47.0,215,96,13.5,2012,0.0
Brooks Godwin,9,0,12,3,8,3,65.0,0,0,1.0,12,3,13.8,2012,0.0
Aaron Ingle,4,2,2,1,4,2,64.0,0,0,4.0,2,1,6.3,2012,0.0
Reggie Moore,1027,419,769,290,472,362,3148.0,250,85,243.0,519,205,20.7,2012,0.0
Faisal Aden,667,66,579,254,106,88,1250.0,213,71,115.0,366,183,31.3,2012,0.0
Marcus Capers,683,232,485,251,278,179,3447.0,20,2,157.0,465,249,11.9,2012,0.0
Abe Lodwick,403,89,362,138,46,34,1897.0,262,93,81.0,100,45,12.4,2012,0.0
Charlie Enquist,165,13,99,59,65,47,791.0,0,0,28.0,99,59,10.6,2012,0.0
Patrick Simon,152,10,145,55,13,8,416.0,107,34,7.0,38,21,20.0,2012,0.0
Dave Wink,1,0,1,0,2,1,6.0,0,0,0.0,1,0,17.8,2012,0.0
Terrence Ross,847,82,700,317,127,97,1681.0,319,116,94.0,381,201,23.8,2012,1.0
Tony Wroten,559,130,447,198,264,154,1062.0,56,9,132.0,391,189,31.2,2012,1.0
Darnell Gant,630,81,587,245,142,98,2557.0,120,42,93.0,467,203,14.1,2012,0.0
Austin Seferian-Jenkins,19,1,21,8,8,3,122.0,0,0,1.0,21,8,10.0,2012,0.0
Alex Wegner,6,0,8,2,0,0,17.0,4,2,2.0,4,0,27.7,2012,0.0
Brendan Sherrer,11,1,11,4,6,3,70.0,1,0,5.0,10,4,12.6,2012,0.0
Damian Lillard,1934,362,1310,584,600,520,3363.0,630,246,246.0,680,338,28.6,2012,1.0
Kyle Bullinger,1040,153,830,347,278,195,3080.0,411,151,161.0,419,196,19.2,2012,0.0
Darin Mahoney,414,85,325,158,137,93,2507.0,17,5,92.0,308,153,10.2,2012,0.0
Kevin Jones,1822,141,1475,728,378,256,4347.0,349,110,136.0,1126,618,20.8,2012,1.0
Darryl Bryant,1590,388,1268,455,616,483,3824.0,603,197,292.0,665,258,24.4,2012,0.0
Paul Williamson,22,9,19,7,3,1,92.0,17,7,2.0,2,0,12.3,2012,0.0
Harouna Mutombo,1578,271,1343,601,508,278,3815.0,338,98,252.0,1005,503,23.3,2012,0.0
Keaton Cole,831,141,669,259,147,109,2442.0,526,204,114.0,143,55,17.0,2012,0.0
Ishmael Hollis,107,7,100,41,22,14,354.0,46,11,16.0,54,30,17.6,2012,0.0
Sam Smithson,60,5,60,26,23,8,228.0,1,0,21.0,59,26,19.7,2012,0.0
Dillon Dunford,15,1,12,6,4,2,28.0,4,1,1.0,8,5,26.3,2012,0.0
Tommie Tyler,577,140,516,195,264,157,2534.0,102,30,166.0,414,165,18.6,2012,0.0
David Gebru,240,20,198,95,92,50,817.0,0,0,54.0,198,95,20.7,2012,0.0
Jalen Packer,20,23,12,6,9,8,138.0,2,0,14.0,10,6,13.1,2012,0.0
Jeremy McDonald,10,1,11,3,5,4,94.0,0,0,3.0,11,3,10.4,2012,0.0
Antwan Watson,6,0,10,2,4,2,27.0,4,0,1.0,6,2,28.4,2012,0.0
Billy Molinari,5,1,7,1,2,2,41.0,7,1,5.0,0,0,18.8,2012,0.0
Kahlil McDonald,501,112,473,143,144,114,1568.0,341,101,106.0,132,42,20.2,2012,0.0
Jay Starks,0,1,0,0,0,0,3.0,0,0,0.0,0,0,0.0,2012,0.0
Demetrius Ward,1021,229,881,320,335,243,2931.0,426,138,204.0,455,182,21.5,2012,0.0
Mike Douglas,783,477,626,248,311,238,3162.0,135,49,263.0,491,199,16.6,2012,0.0
Flenard Whitfield,1256,78,1023,505,390,243,3086.0,34,3,258.0,989,502,24.1,2012,0.0
Muhammed Conteh,118,8,104,52,37,14,746.0,2,0,36.0,102,52,10.7,2012,0.0
Caleb Dean,70,1,61,28,20,13,162.0,2,1,11.0,59,27,25.1,2012,0.0
Joe Ragland,688,209,458,236,151,127,1655.0,213,89,103.0,245,147,19.9,2012,0.0
Garrett Stutz,1106,98,802,413,331,251,2330.0,99,29,183.0,703,384,26.5,2012,0.0
Toure' Murry,1539,429,1280,519,480,366,3999.0,434,135,340.0,846,384,23.5,2012,1.0
Ben Smith,571,70,416,192,132,97,1450.0,233,90,51.0,183,102,19.0,2012,0.0
David Kyles,850,179,716,298,138,101,2471.0,421,153,126.0,295,145,19.6,2012,0.0
James Anacreon,25,1,22,11,7,3,80.0,2,0,3.0,20,11,18.2,2012,0.0
Randall Vautravers,7,2,11,3,0,0,31.0,6,1,6.0,5,2,28.2,2012,0.0
Quinn McDowell,1621,190,1141,528,433,352,4093.0,530,213,172.0,611,315,21.6,2012,0.0
Kendrix Brown,392,215,361,134,119,79,2448.0,141,45,179.0,220,89,13.8,2012,0.0
JohnMark Ludwick,452,67,347,147,51,39,1416.0,300,119,79.0,47,28,17.3,2012,0.0
Reggie Middleton,1185,410,1076,415,361,242,3174.0,364,113,246.0,712,302,24.1,2012,0.0
George Valentine,703,80,521,294,229,115,3045.0,0,0,140.0,521,294,13.1,2012,0.0
Derrick Scott,8,1,10,4,0,0,32.0,4,0,2.0,6,4,19.4,2012,0.0
Tobias Pinson,5,0,3,2,2,1,4.0,1,0,0.0,2,2,52.1,2012,0.0
Chris Brown,0,4,1,0,1,0,8.0,1,0,1.0,0,0,16.3,2012,0.0
Jordan Taylor,1533,464,1215,490,477,373,3950.0,484,180,154.0,731,310,23.7,2012,0.0
Robert Wilson,317,47,254,108,87,64,1170.0,119,37,51.0,135,71,17.3,2012,0.0
Brad Loesing,1068,483,900,372,260,206,3992.0,342,118,304.0,558,254,18.4,2012,0.0
Kevin Giltner,954,130,766,314,187,139,2914.0,490,187,143.0,276,127,19.7,2012,0.0
Drew Crowell,434,61,319,189,93,52,1675.0,13,4,47.0,306,185,14.4,2012,0.0
Domas Rinksalis,54,3,36,15,42,24,269.0,0,0,12.0,36,15,13.8,2012,0.0
Matt Steelman,46,3,31,14,6,5,79.0,27,13,3.0,4,1,24.0,2012,0.0
Lucas Brown,2,0,3,1,2,0,12.0,1,0,0.0,2,1,18.1,2012,0.0
Joseph Tecklenburg,13,4,17,6,3,1,68.0,4,0,8.0,13,6,19.1,2012,0.0
Armond Battle,301,32,227,89,151,93,1052.0,94,30,73.0,133,59,20.0,2012,0.0
Vance Hall,163,32,117,50,39,31,860.0,76,32,26.0,41,18,10.6,2012,0.0
John Balwigaire,133,32,124,46,23,17,578.0,68,24,21.0,56,22,15.2,2012,0.0
Johann Mpondo,442,37,378,172,158,98,2236.0,3,0,127.0,375,172,15.1,2012,0.0
Jason Cuffee,6,13,11,2,2,1,105.0,5,1,4.0,6,1,8.6,2012,0.0
Ulysses Thomas,0,0,3,0,2,0,8.0,3,0,0.0,0,0,27.8,2012,0.0
Francisco Cruz,706,127,565,257,128,100,2032.0,246,92,118.0,319,165,20.3,2012,0.0
Adam Waddell,874,58,606,307,439,259,2743.0,5,1,134.0,601,306,18.2,2012,0.0
JayDee Luster,533,374,436,146,282,189,2776.0,195,52,205.0,241,94,14.5,2012,0.0
Arthur Bouedo,249,68,245,90,41,24,1197.0,152,45,65.0,93,45,14.3,2012,0.0
Rob Watsabaugh,39,2,28,17,11,4,234.0,4,1,11.0,24,16,10.7,2012,0.0
Afam Muojeke,834,87,613,264,282,218,1726.0,277,88,184.0,336,176,27.2,2012,0.0
Tyrone Marshall,7,0,10,2,5,3,39.0,0,0,5.0,10,2,26.1,2012,0.0
Shakir Smith,7,0,19,2,2,2,63.0,10,1,5.0,9,1,23.2,2012,0.0
Tu Holloway,1833,550,1210,499,792,675,4298.0,474,160,345.0,736,339,24.2,2012,0.0
Kenny Frease,1103,127,882,453,341,195,2862.0,12,2,210.0,870,451,21.8,2012,0.0
O'Neil Cooper,3,0,2,1,2,1,4.0,0,0,1.0,2,1,50.8,2012,0.0
Greg Dougan,0,0,1,0,2,0,4.0,0,0,0.0,1,0,25.1,2012,0.0
Greg Mangano,1213,41,973,451,350,233,2418.0,230,78,144.0,743,373,27.8,2012,0.0
Reggie Willhite,743,213,623,290,195,132,2229.0,114,31,168.0,509,259,20.6,2012,0.0
Rhett Anderson,116,31,109,38,61,40,679.0,12,0,48.0,97,38,13.8,2012,0.0
Brian Katz,65,12,81,20,22,12,281.0,55,13,13.0,26,7,19.3,2012,0.0
Ashen Ward,828,184,744,278,177,122,2791.0,444,150,158.0,300,128,18.2,2012,0.0
DuShawn Brooks,487,71,499,190,61,36,1447.0,201,71,72.0,298,119,21.6,2012,0.0
Nate Perry,73,14,65,23,14,9,258.0,51,18,20.0,14,5,18.8,2012,0.0
Cale Zuiker,15,0,13,5,0,0,45.0,11,5,2.0,2,0,18.0,2012,0.0
Chris Morgan,4,1,2,2,0,0,21.0,0,0,2.0,2,2,10.3,2012,0.0
Michael Lyons,1527,214,1201,549,383,287,3482.0,448,142,228.0,753,407,26.7,2013,0.0
Mike Fitzgerald,804,90,551,261,200,162,2389.0,305,120,115.0,246,141,18.3,2013,0.0
Todd Fletcher,822,366,644,292,145,118,3441.0,334,120,172.0,310,172,14.8,2013,0.0
Taylor Broekhuis,828,149,606,303,266,170,2743.0,180,52,176.0,426,251,19.1,2013,0.0
Kyle Green,240,69,201,76,52,41,744.0,134,47,49.0,67,29,20.7,2013,0.0
Zeke Marshall,1265,97,857,470,518,323,3213.0,8,2,196.0,849,468,20.6,2013,0.0
Alex Abreu,833,450,622,258,239,189,2530.0,319,128,245.0,303,130,19.8,2013,0.0
Brian Walsh,532,94,430,176,122,92,1731.0,231,88,64.0,199,88,16.0,2013,0.0
Chauncey Gilliam,1119,105,886,404,247,192,2843.0,323,119,130.0,563,285,21.0,2013,0.0
Jonas Stalyga,14,0,10,5,5,1,7.0,6,3,0.0,4,2,89.3,2013,0.0
Darius Hoisten,2,0,2,0,2,2,7.0,1,0,0.0,1,0,21.3,2013,0.0
Blake Justice,2,2,8,0,2,2,22.0,8,0,1.0,0,0,22.8,2013,0.0
Luke Avsec,0,2,1,0,0,0,17.0,1,0,3.0,0,0,11.9,2013,0.0
Justin Wagner,69,9,70,22,30,17,224.0,37,8,10.0,33,14,21.1,2013,0.0
Anthony Lanier,29,4,30,11,10,7,143.0,0,0,8.0,30,11,15.0,2013,0.0
David Basil,2,0,2,1,0,0,6.0,0,0,1.0,2,1,25.1,2013,0.0
Terence Jones,1148,329,1027,358,347,245,3400.0,573,187,345.0,454,171,22.8,2013,0.0
Jekore Tyler,192,40,184,70,59,38,479.0,48,14,62.0,136,56,30.5,2013,0.0
Alexander Scotland-Williamson,29,5,12,7,23,15,211.0,0,0,21.0,12,7,10.4,2013,0.0
Phillip Crawford,577,25,448,233,176,110,1120.0,5,1,93.0,443,232,28.4,2013,0.0
Shawntez Patterson,396,39,405,144,67,31,1221.0,214,77,85.0,191,67,21.2,2013,0.0
Ryan Watts,433,78,442,148,126,86,1408.0,180,51,136.0,262,97,23.0,2013,0.0
Denaell McDaniel,159,85,138,51,64,37,699.0,57,20,60.0,81,31,16.5,2013,0.0
Stephawn Brown,307,63,301,125,65,30,1520.0,93,27,89.0,208,98,14.1,2013,0.0
Jonathan Jefferson,66,10,86,21,36,22,407.0,27,2,23.0,59,19,15.8,2013,0.0
Joshua Mason,75,25,90,30,33,15,391.0,11,0,45.0,79,30,19.7,2013,0.0
Kimani Key,11,0,17,4,0,0,40.0,9,3,3.0,8,1,25.3,2013,0.0
Anthony Price,32,26,35,12,13,5,234.0,14,3,21.0,21,9,13.5,2013,0.0
Timothy Coleman,9,0,7,3,3,3,48.0,0,0,2.0,7,3,11.0,2013,0.0
Terrelle Green,2,0,10,1,0,0,30.0,2,0,3.0,8,1,21.9,2013,0.0
Andrew Steele,399,128,301,124,176,126,1775.0,90,25,101.0,211,99,14.3,2013,0.0
Keon Blackledge,4,4,7,2,0,0,32.0,5,0,1.0,2,2,13.7,2013,0.0
Julian Goode,0,0,0,0,0,0,7.0,0,0,0.0,0,0,0.0,2013,0.0
Mike Black,1542,383,1190,508,470,346,3831.0,460,180,340.0,730,328,24.5,2013,0.0
Jacob Iati,655,116,501,201,124,100,2029.0,382,153,88.0,119,48,17.2,2013,0.0
Blake Metcalf,471,86,372,207,170,57,2536.0,2,0,124.0,370,207,12.2,2013,0.0
Jayson Guerrier,351,34,287,121,63,44,1118.0,172,65,43.0,115,56,17.1,2013,0.0
Chris Page,13,2,17,5,2,1,37.0,11,2,1.0,6,3,28.2,2013,0.0
Anthony Nieves,547,86,481,181,194,127,1363.0,163,58,151.0,318,123,26.7,2013,0.0
Marquis Baker,415,45,378,127,138,99,891.0,220,62,64.0,158,65,28.5,2013,0.0
Ian Francis,751,86,613,273,346,205,2720.0,5,0,193.0,608,273,17.1,2013,0.0
Michael Starks,378,19,302,145,169,88,1904.0,0,0,86.0,302,145,11.9,2013,0.0
Jamaal Hester,32,4,27,13,13,6,179.0,0,0,10.0,27,13,12.0,2013,0.0
Terrance Birdie,29,8,31,11,10,4,117.0,13,3,8.0,18,8,18.7,2013,0.0
Martrevious Sanders,71,41,69,30,15,11,289.0,2,0,31.0,67,30,19.0,2013,0.0
Stephen Lumpkins,1354,107,968,501,564,352,3202.0,4,0,166.0,964,501,24.7,2013,0.0
Blake Jolivette,446,128,442,168,108,77,1678.0,78,33,133.0,364,135,21.0,2013,0.0
Mike Bersch,203,32,226,72,9,6,772.0,182,53,34.0,44,19,19.5,2013,0.0
Daniel Fisher,64,17,59,25,23,14,430.0,2,0,26.0,57,25,12.6,2013,0.0
Warren Flood,1,0,5,0,2,1,15.0,0,0,2.0,5,0,30.3,2013,0.0
Nathan Healy,816,110,624,298,182,138,2396.0,222,82,125.0,402,216,17.6,2013,0.0
Jamaal Trice,492,52,407,155,150,104,1490.0,205,78,97.0,202,77,19.6,2013,0.0
Brian Okam,35,3,30,11,27,13,246.0,0,0,15.0,30,11,11.8,2013,0.0
Bennett Rutherford,2,1,5,1,0,0,16.0,3,0,0.0,2,1,15.8,2013,0.0
Carrick Felix,955,125,748,341,247,174,2626.0,304,99,162.0,444,242,21.0,2013,1.0
Chris Colvin,441,228,420,147,206,110,1849.0,127,37,201.0,293,110,20.5,2013,0.0
Ruslan Pateev,344,53,270,143,98,58,1292.0,0,0,89.0,270,143,17.2,2013,0.0
Kenny Martin,5,0,11,2,0,0,38.0,8,1,2.0,3,1,17.8,2013,0.0
Joey Hormes,0,0,0,0,0,0,1.0,0,0,0.0,0,0,0.0,2013,0.0
Mark Lyons,1740,358,1375,577,513,392,3975.0,553,194,315.0,822,383,25.1,2013,0.0
Solomon Hill,1430,304,1012,487,458,341,4030.0,307,115,290.0,705,372,19.7,2013,1.0
Kevin Parrom,755,204,557,259,196,141,2257.0,253,96,116.0,304,163,17.6,2013,0.0
Grant Jerrett,176,18,154,63,22,18,606.0,79,32,19.0,75,31,15.6,2013,1.0
Max Wiepking,16,0,8,5,5,2,36.0,7,4,1.0,1,1,16.4,2013,0.0
Quinton Crawford,0,1,3,0,0,0,15.0,3,0,0.0,0,0,10.4,2013,0.0
Michael Javes,341,28,339,134,168,71,1202.0,7,2,85.0,332,132,21.5,2013,0.0
Taggart Lockhart,227,49,199,77,79,49,966.0,86,24,41.0,113,53,14.8,2013,0.0
Ted Crass,7,0,9,3,2,0,34.0,6,1,1.0,3,2,16.1,2013,0.0
Casey Wilmath,3,0,1,1,0,0,15.0,1,1,3.0,0,0,13.2,2013,0.0
Lazabian Jackson,651,146,600,219,137,95,1838.0,366,118,120.0,234,101,21.8,2013,0.0
Terrell Kennedy,664,113,552,240,210,149,1727.0,107,35,122.0,445,205,23.0,2013,0.0
Mitchell Anderson,602,70,575,231,164,97,1687.0,162,43,110.0,413,188,23.2,2013,1.0
Warren Boyd,29,5,30,8,20,13,199.0,2,0,7.0,28,8,11.7,2013,0.0
Kyle Jones,56,20,66,18,8,3,383.0,62,17,21.0,4,1,12.3,2013,0.0
Demetrious Smith,17,5,9,5,6,5,192.0,3,2,15.0,6,3,7.2,2013,0.0
Brandon Peterson,1098,134,811,380,514,335,3676.0,14,3,228.0,797,377,18.0,2013,0.0
Trey Finn,1165,210,894,360,349,261,3845.0,491,184,162.0,403,176,16.4,2013,0.0
Marcus Hooten,644,88,581,220,208,141,1690.0,184,63,108.0,397,157,24.4,2013,0.0
Jordan Weaver,9,3,4,3,4,3,25.0,1,0,2.0,3,3,16.1,2013,0.0
Kristopher Brown,0,0,1,0,0,0,7.0,0,0,0.0,1,0,7.3,2013,0.0
B.J. Young,958,178,752,357,240,169,1673.0,231,75,138.0,521,282,29.3,2013,0.0
Marshawn Powell,1283,120,1011,497,383,247,2482.0,145,42,173.0,866,455,27.1,2013,0.0
Davion Spivey,4,0,5,2,0,0,18.0,0,0,3.0,5,2,21.6,2013,0.0
Charlie Henderson,3,0,4,1,0,0,10.0,1,1,0.0,3,0,19.4,2013,0.0
Ella Ellis,1585,159,1129,479,532,434,2952.0,510,193,206.0,619,286,27.6,2013,0.0
Andrew Stire,221,33,154,89,74,43,890.0,0,0,55.0,154,89,14.0,2013,0.0
Jordan Springer,297,55,225,110,119,77,1475.0,0,0,95.0,225,110,13.1,2013,0.0
Cartavious Kincade,68,19,57,23,27,19,256.0,15,3,17.0,42,20,17.3,2013,0.0
Zach Lord,0,0,0,0,0,0,1.0,0,0,0.0,0,0,0.0,2013,0.0
Frankie Sullivan,1556,287,1268,497,431,334,3755.0,713,228,243.0,555,269,23.2,2013,0.0
Rob Chubb,759,63,675,315,214,129,2191.0,1,0,178.0,674,315,22.7,2013,0.0
Noel Johnson,367,50,395,131,34,21,1350.0,250,84,83.0,145,47,18.5,2013,0.0
Josh Wallace,439,302,395,148,203,132,2429.0,43,11,155.0,352,137,13.7,2013,0.0
Shareif Adamu,155,20,121,53,81,46,591.0,18,3,43.0,103,50,17.3,2013,0.0
Dylan Spencer,3,0,5,1,2,0,17.0,5,1,3.0,0,0,27.6,2013,0.0
Anthony Campbell,1362,158,992,455,341,271,3150.0,507,181,222.0,485,274,22.0,2013,0.0
Herdie Lawrence,171,75,166,54,60,39,715.0,103,24,102.0,63,30,20.7,2013,0.0
Jerome Clyburn,255,113,199,75,116,89,998.0,49,16,84.0,150,59,16.9,2013,0.0
Matt Hasse,47,29,30,14,26,17,266.0,2,2,17.0,28,12,11.1,2013,0.0
Joe Harms,8,0,4,2,8,4,37.0,1,0,3.0,3,2,14.6,2013,0.0
Kevin Covington,1,1,1,0,2,1,17.0,0,0,3.0,1,0,14.5,2013,0.0
Jauwan Scaife,1326,187,1076,403,405,317,3369.0,579,203,198.0,497,200,23.1,2013,0.0
Zach Fields,145,11,127,64,32,17,604.0,0,0,48.0,127,64,16.4,2013,0.0
Pierre Jackson,1235,478,884,390,369,298,2424.0,414,157,256.0,470,233,27.1,2013,1.0
A.J. Walton,778,452,676,271,259,169,3413.0,201,67,298.0,475,204,16.2,2013,0.0
Jacob Neubert,14,2,20,6,4,2,59.0,2,0,5.0,18,6,22.9,2013,0.0
J'mison Morgan,180,13,147,74,83,32,677.0,0,0,42.0,147,74,17.5,2013,0.0
Kerron Johnson,1388,515,848,405,682,511,3205.0,209,67,326.0,639,338,23.4,2013,0.0
Trevor Noack,693,51,592,265,122,84,1852.0,243,79,97.0,349,186,20.3,2013,0.0
Brandon Baker,373,99,339,144,59,36,1600.0,180,49,73.0,159,95,13.7,2013,0.0
Adam Barnes,166,48,118,61,57,37,665.0,15,7,37.0,103,54,13.7,2013,0.0
Adrien Coleman,1027,151,768,392,424,224,2279.0,73,19,187.0,695,373,25.9,2013,0.0
Kevin Dukes,1159,264,982,376,171,131,3712.0,745,276,181.0,237,100,17.5,2013,0.0
Paul Scotland,363,97,310,110,123,91,1033.0,156,52,83.0,154,58,22.1,2013,0.0
Javoris Bryant,745,95,642,274,280,197,2618.0,5,0,131.0,637,274,18.1,2013,0.0
Alex Smith,277,28,196,121,68,35,929.0,1,0,52.0,195,121,15.2,2013,0.0
Marc Mack,155,15,184,63,54,28,852.0,7,1,54.0,177,62,15.8,2013,0.0
Myron Respress,2,0,5,1,0,0,47.0,0,0,0.0,5,1,5.3,2013,0.0
Jimmy Gray,812,291,779,285,101,79,3205.0,506,163,241.0,273,122,17.9,2013,0.0
Taylor Johnston,368,44,326,124,60,40,1707.0,213,80,87.0,113,44,13.8,2013,0.0
Brian Freeman,111,5,97,47,28,17,338.0,0,0,34.0,97,47,22.3,2013,0.0
Javon Ralling,231,29,209,85,103,61,1028.0,1,0,68.0,208,85,17.0,2013,0.0
K.J. Brown,82,18,76,22,42,25,338.0,42,13,29.0,34,9,19.9,2013,0.0
Mike Horn,26,17,53,9,12,5,676.0,29,3,10.0,24,6,5.3,2013,0.0
Kenny Buckner,393,29,275,169,97,55,1133.0,1,0,57.0,274,169,17.5,2013,0.0
Vukasin Vujovic,11,0,13,3,4,4,36.0,5,1,3.0,8,2,26.0,2013,0.0
Andrew Van Nest,171,21,160,61,30,24,622.0,89,25,36.0,71,36,18.4,2013,0.0
Jamaal Gill,2,1,1,1,0,0,5.0,0,0,1.0,1,1,21.7,2013,0.0
Chris Kurz,2,1,9,1,1,0,53.0,0,0,5.0,9,1,14.5,2013,0.0
A'uston Calhoun,1337,64,1166,529,324,240,2855.0,133,39,191.0,1033,490,27.9,2013,0.0
Jordon Crawford,1212,473,1101,455,240,180,3343.0,392,122,337.0,709,333,24.5,2013,0.0
Luke Kraus,338,112,330,105,94,69,1663.0,207,59,72.0,123,46,14.2,2013,0.0
James Erger,87,32,101,32,18,10,677.0,63,13,26.0,38,19,10.6,2013,0.0
Dyricus Simms-Edwards,1255,337,1084,429,378,274,3680.0,399,123,254.0,685,306,21.7,2013,0.0
Will Egolf,823,67,715,326,194,134,2447.0,120,37,141.0,595,289,20.8,2013,0.0
Jake Eastman,571,208,536,199,157,106,2846.0,244,67,110.0,292,132,13.3,2013,0.0
Jalen Crawford,217,44,240,83,19,12,879.0,123,39,46.0,117,44,17.5,2013,0.0
Milos Knezevic,92,8,83,31,19,13,333.0,57,17,24.0,26,14,18.5,2013,0.0
Brandon Davies,1680,213,1166,609,691,456,3251.0,18,6,283.0,1148,603,26.4,2013,1.0
Brock Zylstra,607,147,487,209,129,87,2100.0,288,102,93.0,199,107,14.7,2013,0.0
Craig Cusick,247,148,207,78,61,40,1277.0,130,51,55.0,77,27,10.9,2013,0.0
Agustin Ambrosino,56,8,52,20,10,5,191.0,34,11,13.0,18,9,17.6,2013,0.0
Raul Delgado,48,12,52,18,5,4,171.0,31,8,8.0,21,10,17.6,2013,0.0
Ian Harward,22,1,24,8,9,6,89.0,0,0,9.0,24,8,20.2,2013,0.0
Bronson Kaufusi,21,2,15,9,11,3,128.0,0,0,4.0,15,9,9.1,2013,0.0
Matt Sullivan,1033,206,842,333,270,202,3262.0,455,165,157.0,387,168,18.5,2013,0.0
Tucker Halpern,816,164,733,282,138,108,2234.0,407,144,116.0,326,138,21.7,2013,0.0
Stephen Albrecht,514,98,485,177,74,48,1418.0,299,112,83.0,186,65,23.3,2013,0.0
Tyler Ponticelli,256,122,177,95,104,66,1634.0,1,0,114.0,176,95,11.1,2013,0.0
Joe Sharkey,37,15,45,14,0,0,333.0,31,9,18.0,14,5,10.2,2013,0.0
Frankie Dobbs,1232,505,920,355,416,331,3744.0,549,191,269.0,371,164,19.3,2013,0.0
Vlad Kondratyev,616,34,524,255,125,83,1921.0,79,23,123.0,445,232,19.5,2013,0.0
Daniel Calandrillo,142,31,149,54,17,11,686.0,79,23,17.0,70,31,13.3,2013,0.0
Erick Smith,101,12,118,39,29,14,491.0,35,9,36.0,83,30,18.3,2013,0.0
Raphael Jordan,561,116,535,196,148,100,2033.0,213,69,139.0,322,127,19.5,2013,0.0
Patrick Matthews,0,1,1,0,0,0,11.0,0,0,0.0,1,0,4.8,2013,0.0
Mike Muscala,2036,211,1443,723,695,569,3815.0,67,21,217.0,1376,702,28.4,2013,1.0
Bryson Johnson,1384,200,1022,401,319,259,3690.0,812,323,137.0,210,78,19.3,2013,0.0
Joe Willman,1162,154,1013,504,188,153,3232.0,10,1,152.0,1003,503,21.2,2013,0.0
Colin Klebon,101,11,89,38,37,24,327.0,2,1,20.0,87,37,20.8,2013,0.0
Tony Watson II,609,204,450,185,125,107,2057.0,333,132,110.0,117,53,15.4,2013,0.0
Cameron Downing,245,30,134,88,103,69,638.0,0,0,58.0,134,88,19.6,2013,0.0
Raphell Thomas-Edwards,59,14,56,19,18,11,388.0,33,10,32.0,23,9,13.0,2013,0.0
Richie Sebuharara,24,16,20,7,4,4,183.0,14,6,10.0,6,1,9.1,2013,0.0
Andre McPhail,7,1,9,3,3,1,33.0,0,0,4.0,9,3,22.9,2013,0.0
Rotnei Clarke,1864,208,1398,598,320,279,4086.0,935,389,193.0,463,209,21.4,2013,0.0
Chase Stigall,421,94,454,139,51,33,1858.0,369,110,86.0,85,29,15.9,2013,0.0
Emerson Kampen,4,6,7,2,0,0,81.0,1,0,5.0,6,2,7.8,2013,0.0
Dylan Royer,612,59,478,201,47,41,1722.0,380,169,56.0,98,32,18.1,2013,0.0
Drake U'u,428,132,400,143,181,109,1701.0,151,33,105.0,249,110,19.4,2013,0.0
Chris O'Brien,434,135,373,141,138,100,1993.0,152,52,102.0,221,89,14.9,2013,0.0
Zach Allmon,0,0,0,0,0,0,0.0,0,0,0.0,0,0,0,2013,0.0
Stephon Carter,1628,330,1348,571,660,451,3622.0,159,35,358.0,1189,536,27.8,2013,0.0
Tyrone White,537,99,471,188,76,53,1611.0,294,108,103.0,177,80,19.4,2013,0.0
Adam Young,460,80,448,162,125,85,1689.0,172,51,83.0,276,111,17.4,2013,0.0
Justin Omogun,12,0,9,5,3,2,52.0,0,0,2.0,9,5,12.1,2013,0.0
Kwame Vaughn,1775,342,1246,556,640,508,3767.0,438,155,315.0,808,401,25.0,2013,0.0
D.J. Seeley,1147,194,846,373,344,260,2276.0,343,141,189.0,503,232,26.2,2013,0.0
Sammy Yeager,544,80,448,203,75,53,1162.0,209,85,77.0,239,118,24.7,2013,0.0
James Douglas,435,98,383,155,88,65,1271.0,168,60,96.0,215,95,21.0,2013,0.0
Jordan Knox,43,19,34,16,7,3,201.0,21,8,8.0,13,8,11.4,2013,0.0
Ronell Abaekobe,4,0,1,1,4,2,10.0,0,0,0.0,1,1,14.7,2013,0.0
Mike Gee,3,0,2,1,0,0,9.0,1,1,0.0,1,0,11.3,2013,0.0
Allan Guei,250,118,253,90,65,48,972.0,48,22,65.0,205,68,17.0,2013,0.0
Donovan Johnson,99,17,108,31,36,26,388.0,50,11,26.0,58,20,18.3,2013,0.0
Lonnie Watson,40,11,42,14,7,5,217.0,24,7,5.0,18,7,10.9,2013,0.0
Morgan Tilford,20,2,18,8,9,4,122.0,0,0,6.0,18,8,10.9,2013,0.0
Ian Clark,13,5,9,4,5,3,48.0,6,2,7.0,3,2,17.9,2013,1.0
Ilya Ilyayev,6,0,5,2,2,0,34.0,4,2,2.0,1,0,11.0,2013,0.0
Jordan Mitchell,28,3,21,9,17,10,297.0,0,0,19.0,21,9,7.8,2013,0.0
Ishmael Godfrey,0,2,0,0,0,0,9.0,0,0,0.0,0,0,0.0,2013,0.0
Ryan Howley,522,110,433,208,107,56,2322.0,161,50,108.0,272,158,13.4,2013,0.0
Paolo Mancasola,257,185,202,83,111,76,1506.0,47,15,116.0,155,68,13.1,2013,0.0
Spencer Clayton,12,1,11,4,5,4,76.0,0,0,7.0,11,4,14.2,2013,0.0
Daman Starring,1420,298,1186,478,357,266,4019.0,515,198,284.0,671,280,20.4,2013,0.0
Mike Wilder,1082,272,865,330,285,198,3473.0,632,224,176.0,233,106,16.9,2013,0.0
Adam Folker,706,70,567,302,244,102,2370.0,1,0,146.0,566,302,17.8,2013,0.0
Derick Flowers,431,201,400,135,152,114,1635.0,169,47,156.0,231,88,19.1,2013,0.0
Robert Smith,846,293,818,288,244,165,2914.0,347,105,274.0,471,183,21.6,2013,1.0
Dayton Boddie,61,16,54,22,23,15,210.0,16,2,20.0,38,20,21.4,2013,0.0
Tajai Johnson,34,9,32,13,8,7,129.0,9,1,13.0,23,12,20.0,2013,0.0
T.J. Burke,44,2,40,18,13,6,200.0,5,2,13.0,35,16,16.1,2013,0.0
Nate Garth,468,316,421,145,171,117,2017.0,200,61,165.0,221,84,16.7,2013,0.0
Lewis Thomas,79,29,88,28,18,10,565.0,40,13,31.0,48,15,11.9,2013,0.0
Keegan Hornbuckle,184,43,164,75,20,11,811.0,52,23,41.0,112,52,13.9,2013,0.0
Dalante Dunklin,6,0,6,1,6,4,19.0,1,0,4.0,5,1,35.9,2013,0.0
Allen Crabbe,1537,219,1195,533,320,262,3402.0,547,209,182.0,648,324,23.3,2013,1.0
Robert Thurman,275,15,211,127,49,21,921.0,0,0,43.0,211,127,15.6,2013,0.0
Bak Bak,172,4,149,68,51,36,638.0,6,0,38.0,143,68,17.1,2013,0.0
Kahlil Johnson,6,0,6,2,2,1,17.0,3,1,4.0,3,1,33.2,2013,0.0
Darian Hooker,327,56,285,111,83,63,944.0,136,42,57.0,149,69,20.4,2013,0.0
Darren White,1068,118,805,394,299,193,2295.0,266,87,163.0,539,307,24.4,2013,0.0
Trae Brenner,16,2,17,8,0,0,64.0,0,0,3.0,17,8,15.8,2013,0.0
Tyler Zegarzewski,8,1,4,3,0,0,12.0,3,2,0.0,1,1,16.7,2013,0.0
Harold Washington,977,160,756,334,289,223,2138.0,219,86,192.0,537,248,25.7,2013,0.0
Isaac Sosa,1241,126,996,427,137,102,3082.0,682,285,144.0,314,142,20.1,2013,0.0
Alshwan Hymes,1047,156,985,370,115,87,2716.0,655,220,226.0,330,150,23.5,2013,0.0
Freddy Asprilla,461,39,363,184,217,93,1181.0,0,0,100.0,363,184,17.0,2013,0.0
Tyrel Edwards,10,0,14,4,4,2,39.0,5,0,3.0,9,4,24.7,2013,0.0
Jarvis Garner,750,68,654,280,160,110,1495.0,231,80,125.0,423,200,26.1,2013,0.0
Robert Crawford,646,79,481,214,142,96,1328.0,283,122,91.0,198,92,22.0,2013,0.0
Anthony Borden,235,22,213,103,64,29,851.0,0,0,64.0,213,103,16.5,2013,0.0
Zach Padgett,43,3,52,15,5,3,159.0,36,10,11.0,16,5,18.9,2013,0.0
Alexander Ridley,6,0,7,2,3,2,25.0,2,0,2.0,5,2,19.2,2013,0.0
Joe Efese,611,36,458,244,186,123,1915.0,0,0,128.0,458,244,17.9,2013,0.0
Erik Raleigh,7,0,6,3,2,1,17.0,0,0,0.0,6,3,20.2,2013,0.0
Keith Clanton,1718,236,1246,622,621,399,4040.0,249,75,339.0,997,547,24.2,2013,0.0
Tyler Coons,3,3,2,1,0,0,19.0,2,1,2.0,0,0,10.8,2013,0.0
Bobby Horodyski,10,5,5,3,2,1,57.0,5,3,5.0,0,0,9.6,2013,0.0
Robert King,1,0,3,0,2,1,5.0,1,0,0.0,2,0,40.4,2013,0.0
Kyle Randall,1341,316,1187,445,387,315,3666.0,402,136,281.0,785,309,22.4,2013,0.0
Olivier Mbaigoto,435,27,390,159,116,81,1228.0,125,36,66.0,265,123,21.9,2013,0.0
Finis Craddock,347,64,330,113,140,87,1565.0,132,34,114.0,198,79,17.1,2013,0.0
Luke Wiest,5,3,8,2,0,0,29.0,6,1,0.0,2,1,14.5,2013,0.0
Rick Rowse,0,0,0,0,0,0,7.0,0,0,0.0,0,0,0.0,2013,0.0
Mathiang Muo,671,55,550,217,123,95,1915.0,341,142,103.0,209,75,18.4,2013,0.0
Jeremy Sexton,1253,248,1091,441,213,164,3507.0,572,207,240.0,519,234,20.0,2013,0.0
Joe Williams,36,0,24,16,6,4,77.0,1,0,3.0,23,16,19.1,2013,0.0
Chris Braswell,1465,142,1061,501,573,429,3173.0,125,34,307.0,936,467,26.0,2013,0.0
DeMario Mayfield,552,118,433,188,222,134,1479.0,143,42,103.0,290,146,21.6,2013,0.0
J.T. Thompson,681,67,532,267,212,143,2128.0,21,4,107.0,511,263,17.2,2013,0.0
Colby Lewis,52,6,49,18,0,0,157.0,43,16,6.0,6,2,17.9,2013,0.0
Lamar Bradbury,3,0,1,1,0,0,2.0,1,1,0.0,0,0,25.0,2013,0.0
Ilija Ivankovic,7,2,7,3,1,1,54.0,0,0,0.0,7,3,6.9,2013,0.0
Drazen Zlovaric,631,47,564,282,120,65,1914.0,21,2,107.0,543,280,18.7,2013,0.0
Sam Watson,177,41,131,64,83,43,1014.0,16,6,65.0,115,58,11.3,2013,0.0
Dontay Hampton,391,96,286,107,162,129,1046.0,146,48,74.0,140,59,20.4,2013,0.0
Jeremy Robinson,700,72,626,277,173,118,1622.0,92,28,165.0,534,249,26.8,2013,0.0
Mashawn Chamberlain,14,9,20,6,2,1,250.0,5,1,11.0,15,5,6.4,2013,0.0
Quincy Ukaigwe,48,6,46,22,19,4,401.0,1,0,28.0,45,22,9.9,2013,0.0
Nate Henry,0,0,4,0,0,0,23.0,3,0,4.0,1,0,17.2,2013,0.0
Cashmere Wright,1317,482,1134,451,321,229,3650.0,533,186,268.0,601,265,21.8,2013,0.0
Jaquon Parker,799,137,679,272,285,169,2355.0,237,86,117.0,442,186,20.1,2013,0.0
Cheikh Mbodji,220,12,180,79,97,61,986.0,3,1,36.0,177,78,13.5,2013,0.0
Alex Eppensteiner,13,7,13,4,8,4,50.0,4,1,3.0,9,3,20.2,2013,0.0
Mike Groselle,1359,120,930,548,371,263,2846.0,1,0,179.0,929,548,24.1,2013,0.0
Lawrence Miller,284,62,250,94,46,28,788.0,179,68,53.0,71,26,22.0,2013,0.0
Stephen Elmore,77,20,65,30,42,16,411.0,5,1,36.0,60,29,15.9,2013,0.0
Michael Hundley,9,0,10,4,4,1,47.0,0,0,3.0,10,4,17.1,2013,0.0
Milton Jennings,954,121,843,349,250,170,2633.0,290,86,214.0,553,263,23.7,2013,0.0
Tim Kamczyc,892,188,682,328,176,127,3566.0,280,109,145.0,402,219,13.4,2013,0.0
Anthony Raffa,1741,234,1330,608,486,365,3406.0,459,160,262.0,871,448,27.0,2013,0.0
Kierre Greenwood,1199,481,933,424,386,290,3448.0,179,61,282.0,754,363,20.4,2013,0.0
Charles Ashford,97,20,69,33,48,30,317.0,5,1,28.0,64,32,19.1,2013,0.0
Justin Daniel,31,4,26,13,10,5,165.0,6,0,6.0,20,13,11.2,2013,0.0
Bisi Latunde-Addey,48,3,36,21,11,6,151.0,0,0,11.0,36,21,17.6,2013,0.0
Tre'von James,5,0,4,1,5,3,17.0,0,0,1.0,4,1,21.8,2013,0.0
Richie Berry,2,2,4,1,0,0,16.0,3,0,2.0,1,1,19.0,2013,0.0
Mitch Rolls,938,365,851,314,178,139,3441.0,455,171,285.0,396,143,18.6,2013,0.0
Brandon James,532,82,441,185,144,105,1467.0,183,57,134.0,258,128,23.1,2013,0.0
John Brandenburg,403,46,337,154,139,95,1393.0,1,0,93.0,336,154,18.9,2013,0.0
Lazar Bogdanovic,31,3,31,11,14,9,174.0,0,0,6.0,31,11,12.8,2013,0.0
Jared Accettura,2,1,7,1,0,0,12.0,4,0,2.0,3,1,40.1,2013,0.0
Andrew Lawrence,1219,393,940,381,336,250,3606.0,581,207,232.0,359,174,19.1,2013,0.0
Matt Sundberg,385,31,352,127,69,47,1349.0,250,84,48.0,102,43,16.4,2013,0.0
Trevonte Dixon,29,4,34,10,10,7,122.0,11,2,15.0,23,8,22.6,2013,0.0
Bart Benton,9,1,15,3,2,1,36.0,10,2,5.0,5,1,30.3,2013,0.0
Colton Iverson,1014,120,694,379,454,256,2760.0,0,0,208.0,694,379,20.9,2013,0.0
Dorian Green,1464,373,1081,441,478,385,4247.0,532,197,251.0,549,244,19.2,2013,0.0
Wes Eikmeier,1274,220,1098,425,291,256,3164.0,465,168,197.0,633,257,23.9,2013,0.0
Greg Smith,1051,133,839,356,391,282,2578.0,163,57,212.0,676,299,25.1,2013,1.0
Pierce Hornung,727,188,518,304,173,101,3038.0,62,18,134.0,456,286,12.6,2013,0.0
Trevor Williams,12,1,14,5,6,2,103.0,0,0,8.0,14,5,13.1,2013,0.0
Stephon Wynn,0,0,1,0,0,0,4.0,0,0,0.0,1,0,12.7,2013,0.0
Andre Roberson,1012,119,741,382,340,198,2970.0,143,50,183.0,598,332,19.0,2013,1.0
Sabatino Chen,362,100,301,140,97,59,2053.0,91,23,99.0,210,117,12.8,2013,0.0
Shane Harris-Tunks,191,30,160,76,81,39,1067.0,1,0,101.0,159,76,14.8,2013,0.0
Brian Barbour,1216,346,903,356,447,401,3149.0,319,103,159.0,584,253,21.9,2013,0.0
Mark Cisco,795,69,601,326,221,143,2222.0,0,0,131.0,601,326,20.5,2013,0.0
John Daniels,291,70,246,113,113,65,1733.0,5,0,131.0,241,113,13.4,2013,0.0
Skylar Scrivano,21,0,18,9,6,3,82.0,0,0,8.0,18,9,20.0,2013,0.0
Brad Gilson,13,1,12,4,2,2,35.0,11,3,1.0,1,1,22.7,2013,0.0
Dean Kowalski,7,22,3,2,10,3,182.0,0,0,15.0,3,2,6.7,2013,0.0
Samer Ozeir,6,1,6,2,2,1,26.0,2,1,2.0,4,1,19.3,2013,0.0
R.J. Evans,1285,233,1140,517,428,224,3213.0,144,27,270.0,996,490,25.8,2013,0.0
Enosch Wolf,84,14,70,40,10,4,336.0,0,0,23.0,70,40,15.6,2013,0.0
Brendan Allen,2,2,8,1,1,0,40.0,5,0,3.0,3,1,15.2,2013,0.0
Trey James,0,1,0,0,0,0,2.0,0,0,0.0,0,0,0.0,2013,0.0
Keifer Lammi,0,0,1,0,0,0,2.0,1,0,0.0,0,0,27.1,2013,0.0
Dave Vandal,0,0,0,0,0,0,2.0,0,0,0.0,0,0,0.0,2013,0.0
Javon Williams,0,0,0,0,0,0,1.0,0,0,0.0,0,0,0,2013,0.0
Troy Franklin,787,320,703,242,258,196,2221.0,360,107,249.0,343,135,26.3,2013,0.0
Collin Johnson,198,28,186,74,33,25,831.0,83,25,44.0,103,49,14.6,2013,0.0
Darryln Johnson,22,2,37,8,8,6,142.0,1,0,2.0,36,8,14.9,2013,0.0
Niwayo Adjei,12,2,14,2,10,8,38.0,4,0,6.0,10,2,32.1,2013,0.0
Mike Simpson,52,10,63,19,9,3,249.0,37,11,26.0,26,8,18.6,2013,0.0
Desma Nicholson,0,1,1,0,0,0,5.0,1,0,0.0,0,0,9.9,2013,0.0
Johnathan Gray,618,76,526,207,153,106,1591.0,284,98,104.0,242,109,23.0,2013,0.0
Eitan Chemerinski,385,40,248,153,121,79,1231.0,0,0,94.0,248,153,16.9,2013,0.0
Josh Figini,300,21,278,109,62,46,886.0,101,36,35.0,177,73,20.2,2013,0.0
Miles Asafo-Adjei,174,142,178,63,84,41,1255.0,34,7,75.0,144,56,12.2,2013,0.0
Peter McMillan,30,3,43,10,4,2,161.0,31,8,9.0,12,2,17.5,2013,0.0
Holt Harmon,3,1,3,1,0,0,19.0,1,1,1.0,2,0,10.9,2013,0.0
Jamal Cherry,2,0,3,0,5,2,10.0,2,0,2.0,1,0,38.4,2013,0.0
Gregory Echenique,1364,85,829,496,548,372,3417.0,1,0,220.0,828,496,20.3,2013,0.0
Taylor Stormberg,18,12,18,6,2,2,130.0,14,4,7.0,4,2,10.7,2013,0.0
Joe Kelling,4,4,2,2,3,0,15.0,0,0,3.0,2,2,23.4,2013,0.0
Jvonte Brooks,421,58,271,122,231,173,1318.0,12,4,102.0,259,118,20.1,2013,0.0
Matt LaBove,302,34,294,115,113,72,1277.0,0,0,76.0,294,115,17.9,2013,0.0
Will McConnell,20,0,10,7,2,1,38.0,8,5,1.0,2,2,17.1,2013,0.0
Mack McKearney,55,35,61,14,28,20,371.0,35,7,25.0,26,7,14.7,2013,0.0
Kirill Savolainen,4,1,6,1,2,2,29.0,4,0,0.0,2,1,13.1,2013,0.0
Jake Cohen,1795,147,1260,611,560,451,3157.0,348,122,258.0,912,489,28.8,2013,0.0
Nik Cochran,1105,318,682,296,401,358,3059.0,387,155,180.0,295,141,17.5,2013,0.0
J.P. Kuhlman,1420,412,1111,464,424,320,4060.0,468,172,245.0,643,292,19.4,2013,0.0
Clint Mann,558,57,464,226,167,94,1537.0,33,12,125.0,431,214,22.0,2013,0.0
Youssef Mejri,6,2,10,2,2,2,43.0,7,0,1.0,3,2,14.0,2013,0.0
Kevin Dillard,1647,614,1245,522,516,421,3898.0,482,182,365.0,763,340,24.9,2013,0.0
Josh Benson,765,66,558,312,221,141,2022.0,1,0,152.0,557,312,20.7,2013,0.0
Mitch Asmus,3,1,3,1,0,0,17.0,1,1,0.0,2,0,9.1,2013,0.0
Tahj Tate,796,137,697,297,196,141,1960.0,198,61,148.0,499,236,26.4,2013,0.0
Marques Oliver,1094,123,771,401,430,290,3212.0,13,2,214.0,758,399,20.7,2013,0.0
Jabari Joyner,61,31,67,19,16,13,365.0,40,10,32.0,27,9,16.2,2013,0.0
Brandon Oliver,34,37,34,14,18,6,409.0,1,0,40.0,33,14,11.2,2013,0.0
Michael Coger,8,1,7,4,0,0,26.0,0,0,1.0,7,4,16.9,2013,0.0
"Bryan ""Freddie"" Scott",0,0,2,0,0,0,12.0,1,0,1.0,1,0,9.3,2013,0.0
Jamelle Hagins,1184,86,919,466,377,252,3602.0,2,0,226.0,917,466,19.2,2013,0.0
Josh Brinkley,765,46,541,284,304,197,2385.0,3,0,124.0,538,284,17.8,2013,0.0
Terrell Rogers,98,32,116,31,30,25,399.0,46,11,31.0,70,20,20.7,2013,0.0
Larry Savage,63,8,84,28,17,5,422.0,18,2,18.0,66,26,13.4,2013,0.0
Will Townsville,11,1,19,5,0,0,88.0,8,1,1.0,11,4,11.8,2013,0.0
Troy Thomas,2,0,0,0,2,2,2.0,0,0,0.0,0,0,24.3,2013,0.0
Brendan McNulty,3,0,8,1,0,0,17.0,6,1,2.0,2,0,30.7,2013,0.0
Chase Hallam,1216,263,916,430,272,194,3853.0,382,162,187.0,534,268,19.6,2013,0.0
Blake Foeman,92,31,77,32,25,16,554.0,46,12,34.0,31,20,13.3,2013,0.0
Jake Logan,1,3,2,0,3,1,33.0,2,0,3.0,0,0,11.8,2013,0.0
Worrel Clahar,420,167,325,144,127,96,1313.0,109,36,132.0,216,108,18.8,2013,0.0
Stuart Pirri,6,3,8,2,0,0,28.0,8,2,0.0,0,0,14.6,2013,0.0
Ray McCallum,1618,451,1173,546,593,429,3519.0,335,97,233.0,838,449,23.7,2013,1.0
Nick Minnerath,913,65,662,326,231,188,2003.0,199,73,115.0,463,253,21.7,2013,0.0
Doug Anderson,730,87,554,293,187,130,1758.0,46,14,81.0,508,279,20.5,2013,0.0
Ben Simons,1372,158,1084,484,196,170,3533.0,586,234,162.0,498,250,20.4,2013,0.0
Chris Hines,813,76,716,263,159,116,2468.0,463,171,142.0,253,92,20.4,2013,0.0
Jordan Clarke,614,98,458,223,324,161,2199.0,27,7,137.0,431,216,18.0,2013,0.0
Jeremy Jeffers,353,56,281,116,91,72,1295.0,125,49,64.0,156,67,15.9,2013,0.0
Matt Bowie,0,0,0,0,0,0,5.0,0,0,1.0,0,0,10.4,2013,0.0
Derrick Thomas,947,248,942,341,217,155,3763.0,368,110,180.0,574,231,17.5,2013,0.0
Daryl McCoy,489,96,418,203,140,83,2784.0,0,0,142.0,418,203,12.2,2013,0.0
Aquil Younger,63,39,68,22,24,17,483.0,12,2,56.0,56,20,15.6,2013,0.0
Casey Carroll,2,0,1,1,0,0,4.0,0,0,0.0,1,1,13.9,2013,0.0
Mason Plumlee,1384,212,915,525,569,332,3652.0,10,2,282.0,905,523,20.2,2013,1.0
Seth Curry,2101,290,1582,682,498,412,4357.0,825,325,225.0,757,357,23.8,2013,1.0
Ryan Kelly,949,117,682,314,272,219,2437.0,269,102,104.0,413,212,18.8,2013,1.0
Sean Johnson,1245,181,975,405,449,330,2659.0,322,105,204.0,653,300,25.8,2013,0.0
Andre Marhold,380,27,309,157,159,66,1568.0,1,0,86.0,308,157,14.9,2013,0.0
Kadeem Pantophlet,254,38,216,89,36,25,1038.0,137,51,41.0,79,38,13.1,2013,0.0
Marvin Binney,91,19,73,32,13,12,368.0,39,15,21.0,34,17,13.5,2013,0.0
Martins Abele,175,7,137,69,64,37,561.0,0,0,66.0,137,69,20.7,2013,0.0
P.J. Torres,46,20,49,16,12,7,124.0,26,7,14.0,23,9,27.5,2013,0.0
Mamadou Datt,83,7,80,36,30,11,445.0,1,0,29.0,79,36,13.9,2013,0.0
Derrick Martin,12,6,13,5,3,2,112.0,1,0,9.0,12,5,10.4,2013,0.0
Sam Bott,5,0,5,2,3,1,26.0,3,0,0.0,2,2,12.3,2013,0.0
Maurice Kemp,1122,132,818,401,387,286,2258.0,123,34,155.0,695,367,25.4,2013,0.0
Miguel Paul,1129,528,865,329,391,312,2878.0,462,159,263.0,403,170,22.8,2013,0.0
Ty Armstrong,406,27,309,169,117,68,996.0,3,0,64.0,306,169,21.3,2013,0.0
Shamarr Bowden,433,59,382,144,48,33,1137.0,307,112,56.0,75,32,20.4,2013,0.0
Corvonn Gaines,446,243,373,154,184,94,2478.0,150,44,136.0,223,110,12.4,2013,0.0
Jarvis Jones,793,110,780,290,131,95,2222.0,381,118,123.0,399,172,22.8,2013,0.0
Mario Stramaglia,99,19,95,26,48,33,337.0,56,14,29.0,39,12,23.0,2013,0.0
Yunio Barrueta,60,10,56,19,25,16,294.0,19,6,16.0,37,13,15.0,2013,0.0
Marcus Dubose,366,19,328,132,81,63,860.0,139,39,65.0,189,93,25.1,2013,0.0
Sheldon Cooley,668,177,577,238,229,163,2134.0,103,29,165.0,474,209,19.9,2013,0.0
Morris Woods,381,50,277,143,160,92,912.0,17,3,93.0,260,140,27.7,2013,0.0
Malcolm Herron,236,28,229,81,42,34,666.0,117,40,36.0,112,41,24.1,2013,0.0
Taylor Jones,288,79,247,94,38,33,1410.0,193,67,67.0,54,27,13.1,2013,0.0
Austin Akers,191,186,210,73,39,24,1495.0,77,21,68.0,133,52,11.1,2013,0.0
Alex Lubsey,24,7,18,9,10,6,150.0,0,0,9.0,18,9,11.8,2013,0.0
R.J. McGhee,0,2,7,0,0,0,14.0,4,0,2.0,3,0,36.7,2013,0.0
Mike DiNunno,1377,406,1209,456,308,240,3710.0,672,225,301.0,537,231,22.5,2013,0.0
Derek Thompson,1079,122,989,363,178,127,2541.0,629,226,138.0,360,137,25.5,2013,0.0
Jamell Harris,528,60,442,203,232,121,2697.0,3,1,136.0,439,202,13.9,2013,0.0
Matt Balkema,325,31,292,122,153,81,1352.0,3,0,77.0,289,122,17.8,2013,0.0
Austin Harper,150,84,139,52,50,38,651.0,38,8,62.0,101,44,19.4,2013,0.0
Antoine Chandler,36,11,32,13,10,5,128.0,18,5,11.0,14,8,20.9,2013,0.0
James Still,31,3,33,13,14,5,173.0,2,0,11.0,31,13,13.4,2013,0.0
Josh Lyle,5,3,14,2,4,1,51.0,3,0,2.0,11,2,19.3,2013,0.0
Colin Chiverton,704,27,625,237,129,97,1121.0,352,133,66.0,273,104,33.4,2013,0.0
Jeffrey Forbes,1022,225,859,342,193,167,3650.0,465,171,159.0,394,171,15.1,2013,0.0
Kevin Winford,704,135,649,240,111,86,2166.0,409,138,112.0,240,102,18.8,2013,0.0
Jordan Hickert,189,23,204,62,15,12,683.0,166,53,23.0,38,9,17.1,2013,0.0
Ivan Dorsey,35,2,58,14,7,4,125.0,15,3,13.0,43,11,29.9,2013,0.0
Josh Bonney,486,258,533,180,152,102,1707.0,132,24,201.0,401,156,24.3,2013,0.0
Egheosa Edomwonyi,114,12,111,45,36,24,473.0,0,0,39.0,111,45,17.8,2013,0.0
John Moody,13,2,8,5,4,2,47.0,1,1,5.0,7,4,16.3,2013,0.0
Aaron Smith,14,0,19,5,2,2,31.0,12,2,1.0,7,3,34.7,2013,0.0
Roger Dugas,198,21,208,74,26,16,788.0,115,34,31.0,93,40,15.9,2013,0.0
Colt Ryan,2279,406,1699,708,697,601,4379.0,656,262,295.0,1043,446,28.1,2013,0.0
Ned Cox,1115,308,960,400,222,170,3138.0,394,145,155.0,566,255,20.6,2013,0.0
Troy Taylor,637,416,498,224,295,186,3020.0,6,3,229.0,492,221,15.2,2013,0.0
Lewis Jones,543,63,475,197,217,135,1816.0,57,14,101.0,418,183,19.8,2013,0.0
Jordan Jahr,235,27,217,80,53,42,708.0,108,33,42.0,109,47,21.4,2013,0.0
Jordan Nelson,104,15,99,36,9,7,382.0,75,25,9.0,24,11,15.5,2013,0.0
Andy Chinn,2,1,5,1,0,0,16.0,2,0,2.0,3,1,23.0,2013,0.0
Derek Needham,1875,537,1642,628,466,338,4435.0,849,281,436.0,793,347,26.9,2013,0.0
Desmond Wade,761,487,739,258,211,148,3415.0,295,97,214.0,444,161,15.7,2013,0.0
Colin Nickerson,711,244,573,265,216,140,2993.0,158,41,176.0,415,224,14.9,2013,0.0
Keith Matthews,404,37,348,161,136,80,1387.0,10,2,73.0,338,159,18.6,2013,0.0
Josip Mikulic,143,16,140,54,9,6,472.0,93,29,33.0,47,25,20.6,2013,0.0
Mike Hyland,0,0,0,0,0,0,2.0,0,0,0.0,0,0,0.0,2013,0.0
Melquan Bolding,1355,180,1181,464,413,297,3257.0,443,130,256.0,738,334,25.2,2013,0.0
Kinu Rochford,666,81,488,282,172,102,1521.0,1,0,121.0,487,282,23.2,2013,0.0
Lonnie Robinson,469,117,396,156,162,98,1749.0,152,59,131.0,244,97,17.6,2013,0.0
Yves Jules,224,31,204,86,43,29,761.0,67,23,60.0,137,63,19.0,2013,0.0
Trevor Charles,164,8,114,64,68,36,414.0,0,0,46.0,114,64,23.5,2013,0.0
Dylan Moody,36,33,37,13,2,2,483.0,25,8,36.0,12,5,7.8,2013,0.0
Yosua Cordero-Collado,2,0,3,1,0,0,9.0,0,0,1.0,3,1,22.8,2013,0.0
Markee Teal,308,24,253,120,104,67,1099.0,10,1,86.0,243,119,16.9,2013,0.0
Jakari Bush,28,18,24,10,8,7,143.0,3,1,18.0,21,9,15.4,2013,0.0
Michael Fabiyi,22,4,15,8,9,6,69.0,2,0,3.0,13,8,15.5,2013,0.0
McWisdom Badejo,16,1,18,8,0,0,80.0,0,0,0.0,18,8,10.8,2013,0.0
Chuka Eneh,0,0,0,0,0,0,0.0,0,0,0.0,0,0,0,2013,0.0
Greg Gantt,1972,125,1625,707,360,271,3799.0,774,287,169.0,851,420,26.6,2013,0.0
Jordan McCoy,596,23,426,227,238,142,2432.0,1,0,75.0,425,227,13.0,2013,0.0
Andre Mattison,153,7,109,52,81,49,806.0,0,0,40.0,109,52,12.0,2013,0.0
DeVonte Thornton,10,0,10,4,2,1,59.0,2,1,5.0,8,3,14.0,2013,0.0
Austin Hunt,0,0,1,0,0,0,2.0,0,0,0.0,1,0,25.8,2013,0.0
Sherwood Brown,1241,98,981,447,272,190,2910.0,411,157,154.0,570,290,21.5,2013,0.0
Christophe Varidel,866,101,679,262,193,164,2193.0,462,178,163.0,217,84,21.0,2013,0.0
Eddie Murray,442,43,292,161,151,109,1755.0,40,11,67.0,252,150,12.2,2013,0.0
Alexander Blessig,10,4,12,4,1,0,66.0,5,2,8.0,7,2,15.4,2013,0.0
Deric Hill,241,138,200,75,100,74,1041.0,60,17,97.0,140,58,16.7,2013,0.0
Cameron Bell,328,54,244,99,130,109,964.0,63,21,77.0,181,78,20.2,2013,0.0
Tola Akomolafe,186,33,168,68,51,36,1052.0,59,14,54.0,109,54,11.8,2013,0.0
Juan Ferrales,119,26,98,36,40,29,402.0,47,18,29.0,51,18,18.0,2013,0.0
Gabby Belardo,727,226,709,271,148,95,2071.0,297,90,210.0,412,181,24.0,2013,0.0
Manuel Nunez,9,5,26,4,4,1,155.0,13,0,8.0,13,4,13.1,2013,0.0
Dee Lewis,0,0,0,0,0,0,3.0,0,0,0.0,0,0,0.0,2013,0.0
Michael Snaer,1550,265,1236,525,387,304,3851.0,511,196,326.0,725,329,23.0,2013,0.0
Joey Moreau,22,0,15,4,10,10,36.0,12,4,2.0,3,0,30.6,2013,0.0
Rafael Portuondo,10,1,8,3,4,3,19.0,5,1,7.0,3,2,44.8,2013,0.0
Mike Rosario,1706,193,1486,602,321,254,3628.0,755,248,273.0,731,354,27.2,2013,0.0
Kenny Boynton,2033,392,1671,666,468,368,4674.0,978,333,221.0,693,333,23.6,2013,0.0
Erik Murphy,1052,95,773,397,152,115,2488.0,329,143,139.0,444,254,21.0,2013,1.0
Chris Gaston,1672,128,1434,652,585,363,3409.0,32,5,343.0,1402,647,29.1,2013,0.0
Luka Zivkovic,39,5,46,13,6,4,156.0,36,9,10.0,10,4,18.4,2013,0.0
Devon McMillan,216,83,228,72,111,64,790.0,47,8,83.0,181,64,22.5,2013,0.0
Garrett Johnson,442,60,422,156,83,59,1444.0,231,71,64.0,191,85,18.8,2013,0.0
Brad Ely,2,0,3,1,2,0,30.0,1,0,2.0,2,1,10.9,2013,0.0
Colin Reddick,832,108,670,309,308,214,2202.0,1,0,176.0,669,309,23.9,2013,0.0
Bobby Austin,596,123,552,203,123,92,2499.0,266,98,155.0,286,105,16.3,2013,0.0
Bryant Irwin,643,46,641,231,132,84,2141.0,333,97,92.0,308,134,19.5,2013,0.0
Jordan Loyd,165,51,150,55,62,41,588.0,54,14,46.0,96,41,20.1,2013,1.0
Tyler Bisack,0,0,0,0,0,0,0.0,0,0,0.0,0,0,0,2013,0.0
Tashan Newsome,1059,179,908,363,370,269,2383.0,247,64,176.0,661,299,26.9,2013,0.0
Kevin Hartley,502,63,402,173,74,49,1696.0,260,107,109.0,142,66,16.7,2013,0.0
Paris Bennett,128,26,123,51,37,24,646.0,12,2,38.0,111,49,14.4,2013,0.0
Bryce Lewis,2,4,2,1,0,0,17.0,0,0,3.0,2,1,15.0,2013,0.0
Dwayne Smith,805,62,720,305,257,154,1940.0,127,41,146.0,593,264,25.7,2013,0.0
Bryan Bynes,569,182,561,184,200,145,2406.0,198,56,127.0,363,128,16.4,2013,0.0
Otto Porter,822,135,588,293,241,181,2077.0,155,55,85.0,433,238,20.9,2013,0.0
Greg Whittington,299,55,257,109,71,44,1120.0,111,37,63.0,146,72,17.4,2013,0.0
Clifford Reed,2080,553,1869,685,643,501,4917.0,673,209,411.0,1196,476,28.3,2013,0.0
Cameron Baskerville,495,41,399,176,170,128,2212.0,54,15,165.0,345,161,15.1,2013,0.0
Jessie Pernell,109,22,106,40,12,9,553.0,61,20,25.0,45,20,13.2,2013,0.0
Chris Daniels,18,6,24,8,6,2,151.0,0,0,16.0,24,8,15.5,2013,0.0
Tracy Ham,0,1,3,0,2,0,19.0,1,0,3.0,2,0,19.6,2013,0.0
James Vincent,387,19,304,156,130,75,1536.0,0,0,93.0,304,156,15.8,2013,0.0
Cameron Solomon,109,8,87,39,46,30,227.0,7,1,13.0,80,38,28.7,2013,0.0
Tyler Gamble,6,1,7,3,0,0,19.0,1,0,1.0,6,3,22.0,2013,0.0
Mfon Udofia,977,283,875,329,322,202,3251.0,367,117,240.0,508,212,19.8,2013,0.0
Pierre Jordan,85,53,115,35,9,6,692.0,46,9,49.0,69,26,12.5,2013,0.0
Kentavious Caldwell-Pope,1013,96,814,338,250,188,2114.0,439,149,100.0,375,189,27.0,2013,1.0
Vincent Williams,304,164,285,99,93,57,1424.0,146,49,109.0,139,50,16.7,2013,0.0
Sherrard Brantley,247,65,259,81,28,19,1255.0,209,66,54.0,50,15,14.1,2013,0.0
John Florveus,128,18,120,54,43,20,903.0,0,0,50.0,120,54,11.7,2013,0.0
Kelly Olynyk,903,107,569,338,285,202,1735.0,75,25,140.0,494,313,24.9,2013,1.0
Elias Harris,1857,177,1289,666,618,447,3785.0,219,78,242.0,1070,588,24.6,2013,1.0
Guy Edi,231,32,179,76,105,62,764.0,59,17,42.0,120,59,18.4,2013,0.0
Mike Hart,154,68,114,51,50,34,1217.0,49,18,30.0,65,33,7.1,2013,0.0
"Peter ""PJ"" Roberson",479,29,522,197,136,84,1989.0,6,1,98.0,516,196,17.9,2013,0.0
Demetri Wheeler,188,26,193,81,44,25,1038.0,12,1,52.0,181,80,13.6,2013,0.0
Bryant Purvis,216,33,279,84,44,27,1097.0,96,21,42.0,183,63,17.5,2013,0.0
Brandon Dorsett,238,71,243,81,83,56,937.0,75,20,87.0,168,61,20.8,2013,0.0
Roman Higgins,131,12,153,46,39,28,517.0,48,11,60.0,105,35,23.7,2013,0.0
Will Hornsby,77,48,97,26,34,18,440.0,46,7,57.0,51,19,20.6,2013,0.0
David Copeland,146,101,122,46,75,50,985.0,19,4,87.0,103,42,13.2,2013,0.0
Carl Cobbins,65,10,71,25,22,10,236.0,21,5,19.0,50,20,22.7,2013,0.0
Derron Hobbs,194,70,199,53,91,66,745.0,82,22,103.0,117,31,23.8,2013,0.0
Justin Dobbs,15,0,17,6,0,0,39.0,7,3,7.0,10,3,32.9,2013,0.0
Brennan Cougill,668,123,525,249,146,113,1902.0,182,57,158.0,343,192,21.1,2013,0.0
Sultan Muhammad,197,44,157,63,34,27,798.0,118,44,36.0,39,19,14.0,2013,0.0
Ken Cerroni,411,68,308,120,83,74,1380.0,253,97,60.0,55,23,15.5,2013,0.0
Daniel Turner,292,49,232,95,135,91,1199.0,50,11,89.0,182,84,16.6,2013,0.0
Nick Arenz,13,2,10,4,6,5,96.0,3,0,3.0,7,4,8.8,2013,0.0
Jasper Williams,440,158,460,130,123,82,1783.0,336,98,155.0,124,32,18.4,2013,0.0
Wesley Dunning,273,23,237,103,80,52,1301.0,52,15,71.0,185,88,13.3,2013,0.0
David Bruce,350,11,283,139,113,72,867.0,0,0,73.0,283,139,23.5,2013,0.0
Aaron Austin,127,72,133,44,60,32,727.0,32,7,71.0,101,37,15.7,2013,0.0
John Peterson,436,57,323,139,114,83,1545.0,207,75,65.0,116,64,16.6,2013,0.0
Glenn Akerland,0,0,0,0,0,0,3.0,0,0,0.0,0,0,0.0,2013,0.0
Antoine Burrell,0,0,0,0,1,0,6.0,0,0,0.0,0,0,4.4,2013,0.0
Christian Webster,1016,161,797,314,254,212,3129.0,479,176,200.0,318,138,19.6,2013,0.0
Jeff Georgatos,39,1,42,17,8,4,265.0,4,1,9.0,38,16,11.2,2013,0.0
Tom Hamel,0,0,1,0,0,0,11.0,0,0,2.0,1,0,15.0,2013,0.0
Vander Joaquim,1205,85,880,456,405,280,2658.0,35,13,197.0,845,443,23.5,2013,0.0
Hauns Brereton,613,57,519,225,115,89,1580.0,220,74,82.0,299,151,20.3,2013,0.0
Jace Tavita,152,262,165,54,29,11,1644.0,106,33,139.0,59,21,9.8,2013,0.0
Ozren Pavlovic,60,8,63,17,19,17,195.0,36,9,21.0,27,8,23.3,2013,0.0
Garrett Jefferson,149,42,119,46,114,56,656.0,14,1,49.0,105,45,16.5,2013,0.0
Corey Law,887,54,634,342,377,203,2371.0,6,0,135.0,628,342,19.9,2013,0.0
Branimir Mikulic,272,41,220,90,37,30,1213.0,163,62,53.0,57,28,12.4,2013,0.0
Jairus Simms,301,260,302,116,62,38,1754.0,89,31,139.0,213,85,13.4,2013,0.0
Justin Cheek,212,35,201,68,62,47,843.0,96,29,47.0,105,39,16.9,2013,0.0
Landon Harris,26,2,20,12,2,1,120.0,6,1,1.0,14,11,9.5,2013,0.0
Stevie Mejia,748,384,634,225,326,223,2786.0,222,75,234.0,412,150,19.6,2013,0.0
Taran Buie,435,57,456,144,131,87,1131.0,211,60,100.0,245,84,28.7,2013,0.0
David Imes,701,79,648,272,174,117,2796.0,150,40,118.0,498,232,15.7,2013,0.0
Shaquille Stokes,321,84,311,99,106,80,800.0,135,43,73.0,176,56,26.8,2013,0.0
Matt Grogan,98,11,106,31,18,14,523.0,75,22,24.0,31,9,13.6,2013,0.0
Kentrell Washington,17,5,20,6,8,5,116.0,4,0,7.0,16,6,13.7,2013,0.0
Jody Card,0,0,0,0,0,0,1.0,0,0,0.0,0,0,0.0,2013,0.0
Phil Beans,470,37,388,167,93,76,1495.0,155,60,83.0,233,107,18.6,2013,0.0
Eric Obeysekere,335,49,293,135,99,63,1549.0,12,2,85.0,281,133,14.5,2013,0.0
Dee Goens,289,148,246,93,111,81,1295.0,73,22,121.0,173,71,17.1,2013,0.0
Art Bernardi,720,64,579,276,219,147,1420.0,62,21,121.0,517,255,27.2,2013,0.0
Anthony Hill,584,196,587,188,114,83,2622.0,388,125,140.0,199,63,15.0,2013,0.0
James Harper,133,17,121,46,41,28,408.0,50,13,35.0,71,33,21.2,2013,0.0
Marcus Davis,422,52,340,141,117,98,957.0,115,42,97.0,225,99,23.8,2013,0.0
Dewayne Bowden,50,9,47,16,24,16,167.0,9,2,20.0,38,14,22.6,2013,0.0
Spenser Gales,30,4,24,12,9,6,133.0,1,0,12.0,23,12,14.9,2013,0.0
Lamar Thomas,142,11,155,61,48,20,946.0,2,0,43.0,153,61,11.0,2013,0.0
Jon Evans,222,113,210,66,71,50,1193.0,132,40,98.0,78,26,13.2,2013,0.0
Leon Gibson,310,28,237,115,113,75,857.0,13,5,50.0,224,110,19.7,2013,0.0
Donald Brooks,2,1,2,1,0,0,18.0,0,0,1.0,2,1,8.2,2013,0.0
Mike Phillips,1193,95,1040,427,502,335,3527.0,23,4,268.0,1017,423,22.7,2013,0.0
Simuel Frazier,496,212,437,161,195,128,1707.0,155,46,207.0,282,115,22.4,2013,0.0
Anton Dickerson,629,60,608,209,129,91,1626.0,374,120,104.0,234,89,24.6,2013,0.0
Calvin Thompson,860,146,775,272,370,265,2231.0,183,51,201.0,592,221,26.9,2013,0.0
Alphonso Leary,551,25,437,191,273,169,2349.0,0,0,143.0,437,191,15.5,2013,0.0
Tre Lee,248,51,250,80,90,61,1066.0,113,27,83.0,137,53,18.5,2013,0.0
Faret Estriplet,0,0,1,0,0,0,3.0,1,0,0.0,0,0,18.0,2013,0.0
Melvin Morgan,728,156,668,248,173,133,1909.0,298,99,185.0,370,149,27.2,2013,0.0
Neveij Walters,154,7,130,65,50,24,568.0,0,0,36.0,130,65,19.6,2013,0.0
Sherrod Baldwin,305,73,314,118,60,40,1359.0,79,29,78.0,235,89,16.9,2013,0.0
Jakub Kusmieruk,182,5,118,66,93,50,538.0,0,0,32.0,118,66,19.2,2013,0.0
Nick Mason,102,17,127,36,9,8,597.0,92,22,17.0,35,14,13.6,2013,0.0
Dejan Kostur,97,6,93,40,22,14,406.0,10,3,33.0,83,37,18.0,2013,0.0
Andy Harrington,0,1,0,0,0,0,2.0,0,0,0.0,0,0,0.0,2013,0.0
Brian Hosman,0,0,0,0,0,0,4.0,0,0,1.0,0,0,14.6,2013,0.0
Grant Jones,0,0,1,0,0,0,1.0,0,0,0.0,1,0,58.6,2013,0.0
Kyle Barone,1431,147,898,525,536,381,3424.0,3,0,237.0,895,525,21.8,2013,0.0
Mike McChristian,320,108,254,121,51,35,1153.0,114,43,59.0,140,78,16.0,2013,0.0
Mansa Habeeb,267,65,186,83,136,94,934.0,38,7,92.0,148,76,20.0,2013,0.0
Robert Harris,112,42,112,44,16,8,421.0,41,16,43.0,71,28,21.2,2013,0.0
Denzel Douglas,59,47,50,20,15,12,358.0,23,7,34.0,27,13,13.9,2013,0.0
Wendell Faines,90,10,80,35,32,20,456.0,0,0,36.0,80,35,15.7,2013,0.0
Marcus Bell,36,2,39,17,8,2,160.0,0,0,11.0,39,17,18.4,2013,0.0
Matt Borton,102,35,97,35,22,11,476.0,66,21,25.0,31,14,15.1,2013,0.0
Westin Hill,2,0,4,1,0,0,6.0,3,0,0.0,1,1,36.5,2013,0.0
Max Salesky,2,0,1,1,0,0,2.0,0,0,0.0,1,1,27.4,2013,0.0
Gary Talton,768,250,664,251,237,205,2092.0,208,61,175.0,456,190,24.4,2013,0.0
Daniel Barnes,731,80,658,248,128,86,2096.0,426,149,121.0,232,99,21.3,2013,0.0
Josh Crittle,652,96,513,228,286,196,2082.0,5,0,159.0,508,228,20.5,2013,0.0
Anthony Kelley,103,26,103,36,22,16,519.0,52,15,38.0,51,21,15.6,2013,0.0
Ngijol Songolo,3,0,5,1,0,0,12.0,4,1,0.0,1,0,22.7,2013,0.0
Tyler Brown,1046,165,748,334,274,219,1999.0,379,159,180.0,369,175,27.7,2013,0.0
Jackie Carmichael,1580,88,1113,575,619,426,3273.0,18,4,241.0,1095,571,26.6,2013,0.0
Bryant Allen,474,83,445,170,59,46,1445.0,252,88,59.0,193,82,19.1,2013,0.0
John Wilkins,670,61,500,219,192,148,2053.0,243,84,95.0,257,135,17.9,2013,0.0
Anthony Cousin,394,168,348,124,131,97,1835.0,160,49,114.0,188,75,15.6,2013,0.0
Geoffrey Allen,65,18,60,26,18,7,262.0,22,6,20.0,38,20,17.1,2013,0.0
Brandon Paul,1654,310,1356,521,554,401,3665.0,650,211,312.0,706,310,27.5,2013,1.0
D.J. Richardson,1477,251,1284,498,258,203,4351.0,782,278,193.0,502,220,19.2,2013,0.0
Tyler Griffey,552,50,480,211,82,60,1719.0,211,70,78.0,269,141,18.1,2013,0.0
Sam McLaurin,809,117,556,325,286,158,3209.0,4,1,149.0,552,324,13.2,2013,0.0
Devin Langford,10,4,11,4,5,1,94.0,1,1,1.0,10,3,7.9,2013,0.0
Kevin Berardini,11,3,1,1,12,9,33.0,0,0,3.0,1,1,15.3,2013,0.0
R.J. Mahurin,696,39,541,230,197,136,1631.0,289,100,73.0,252,130,23.5,2013,0.0
Rhett Smith,0,0,1,0,0,0,19.0,0,0,0.0,1,0,2.8,2013,0.0
Cody Zeller,1157,92,674,399,475,359,2087.0,2,0,141.0,672,399,25.4,2013,1.0
Victor Oladipo,1117,175,754,406,359,257,2558.0,142,48,203.0,612,358,22.7,2013,1.0
Christian Watford,1730,129,1293,531,616,504,3759.0,388,164,246.0,905,367,25.0,2013,0.0
Jordan Hulls,1318,365,952,444,205,176,3898.0,575,254,210.0,377,190,16.6,2013,0.0
Derek Elston,498,37,404,194,126,80,1485.0,80,30,91.0,324,164,19.1,2013,0.0
Raphael Smith,6,0,6,2,2,2,30.0,1,0,5.0,5,2,20.3,2013,0.0
MoMo Jones,1851,351,1488,651,483,405,3929.0,460,144,298.0,1028,507,25.5,2013,0.0
Taaj Ridley,482,45,383,191,133,94,1392.0,29,6,83.0,354,185,18.6,2013,0.0
Curtis Dennis,565,68,483,198,107,81,1424.0,282,88,64.0,201,110,21.4,2013,0.0
Nyandigsi Moikubo,44,10,34,19,15,3,198.0,4,3,12.0,30,16,13.1,2013,0.0
Shawn Jackson,124,3,100,49,42,26,406.0,0,0,27.0,100,49,18.8,2013,0.0
DeSean Anderson,4,1,4,1,2,2,21.0,0,0,3.0,4,1,18.5,2013,0.0
Spencer Boateng,0,1,1,0,0,0,2.0,0,0,0.0,1,0,24.4,2013,0.0
Will Clyburn,1036,104,737,329,360,275,2144.0,287,103,167.0,450,226,25.0,2013,0.0
Tyrus McGee,722,68,510,237,123,102,1516.0,334,146,49.0,176,91,20.3,2013,0.0
Korie Lucious,792,434,744,265,128,98,2696.0,488,164,263.0,256,101,19.7,2013,0.0
Chris Babb,942,215,802,302,161,118,3448.0,613,220,102.0,189,82,14.5,2013,1.0
Anthony Booker,509,37,462,204,139,76,1616.0,88,25,107.0,374,179,20.3,2013,0.0
Bubu Palo,239,89,150,57,147,107,951.0,52,18,60.0,98,39,14.6,2013,0.0
Austin McBeth,0,1,2,0,2,0,32.0,1,0,5.0,1,0,12.2,2013,0.0
Eric May,859,183,768,318,191,127,3053.0,288,96,173.0,480,222,17.6,2013,0.0
Christopher Rickert,6,1,6,3,2,0,22.0,0,0,0.0,6,3,15.9,2013,0.0
Frank Gaines,1841,114,1363,601,672,500,3287.0,429,139,219.0,934,462,29.8,2013,0.0
Demario Hines,471,59,354,186,178,99,1346.0,0,0,108.0,354,186,20.9,2013,0.0
Michael Onuorah,2,0,1,1,2,0,8.0,0,0,2.0,1,1,25.1,2013,0.0
Greg Rice,368,142,325,130,103,66,1328.0,118,42,113.0,207,88,19.7,2013,0.0
John Hart,434,70,394,158,58,43,1172.0,206,75,87.0,188,83,23.2,2013,0.0
Sean Esposito,536,123,493,181,49,42,1959.0,355,132,64.0,138,49,15.8,2013,0.0
Jordan Shanklin,192,53,182,64,40,27,791.0,108,37,39.0,74,27,16.3,2013,0.0
Nick Kitcoff,28,4,39,10,6,4,178.0,28,4,4.0,11,6,13.9,2013,0.0
Cameron Loepker,14,3,11,6,4,2,59.0,1,0,8.0,10,6,19.2,2013,0.0
Kevin Rose,2,0,3,1,0,0,5.0,0,0,0.0,3,1,32.5,2013,0.0
Kelsey Howard,850,46,709,290,234,169,1836.0,287,101,121.0,422,189,26.8,2013,0.0
Dundrecous Massey,638,106,532,196,224,158,1147.0,291,88,128.0,241,108,33.6,2013,0.0
Willie Readus,283,27,254,98,127,87,869.0,1,0,68.0,253,98,22.9,2013,0.0
Sydney Coleman,217,19,181,81,94,55,1284.0,0,0,50.0,181,81,11.2,2013,0.0
Phillip Williams,390,95,405,145,119,75,1904.0,114,25,130.0,291,120,15.8,2013,0.0
Keeslee Stewart,167,57,215,60,34,19,792.0,92,28,65.0,123,32,19.8,2013,0.0
Raymond Gregory,214,9,178,78,117,58,900.0,1,0,77.0,177,78,17.7,2013,0.0
Jonathan Lewis,141,160,125,42,64,35,1594.0,59,22,93.0,66,20,8.1,2013,0.0
Kenneth Smith,18,2,17,5,9,6,49.0,13,2,3.0,4,3,25.0,2013,0.0
Kenny Demouchet,17,2,32,8,2,1,114.0,6,0,10.0,26,8,19.0,2013,0.0
Davon Jones,177,14,179,80,51,17,724.0,0,0,55.0,179,80,18.7,2013,0.0
Travis Ballard,7,0,8,2,3,1,73.0,4,2,3.0,4,0,9.1,2013,0.0
Kendall Deese,0,0,1,0,0,0,0.0,0,0,0.0,1,0,0,2013,0.0
Tarvin Gaines,781,35,547,251,276,225,1599.0,185,54,74.0,362,197,25.0,2013,0.0
Ronnie Boggs,560,118,440,222,122,84,1869.0,97,32,98.0,343,190,16.9,2013,0.0
Rinaldo Mafra,212,17,152,78,98,56,817.0,0,0,46.0,152,78,15.8,2013,0.0
Mason Leggett,237,81,214,80,99,66,1137.0,36,11,87.0,178,69,16.1,2013,0.0
Chris Deanes,34,9,22,12,19,10,164.0,1,0,12.0,21,12,14.2,2013,0.0
Gus Klaus,5,1,5,2,0,0,7.0,3,1,2.0,2,1,53.9,2013,0.0
Darrius Moore,2,2,2,0,2,2,27.0,0,0,1.0,2,0,7.9,2013,0.0
Glenn Powell,924,42,728,377,294,170,2751.0,0,0,201.0,728,377,19.2,2013,0.0
Dylan Fritsch,257,12,226,85,35,28,569.0,171,59,20.0,55,26,22.8,2013,0.0
Russell Powell,778,384,708,261,285,212,3103.0,159,44,215.0,549,217,16.8,2013,0.0
Evin Graham,132,75,113,41,77,43,880.0,21,7,70.0,92,34,12.4,2013,0.0
Chris Spurling,5,1,4,2,0,0,47.0,3,1,0.0,1,1,4.2,2013,0.0
Conner Coleman,0,1,0,0,0,0,6.0,0,0,0.0,0,0,0.0,2013,0.0
Rayshawn Goins,725,48,630,264,275,181,1696.0,49,16,107.0,581,248,27.1,2013,0.0
Devon Moore,1317,501,934,441,491,375,4177.0,176,60,316.0,758,381,18.7,2013,0.0
Alioune Diouf,405,87,395,156,128,75,1778.0,71,18,119.0,324,138,17.0,2013,0.0
Arman Marks,152,20,135,49,41,29,541.0,74,25,29.0,61,24,17.9,2013,0.0
Gene Swindle,94,9,76,35,40,24,552.0,0,0,32.0,76,35,12.0,2013,0.0
Rodney McGruder,1576,186,1257,568,332,252,3702.0,494,188,171.0,763,380,21.3,2013,1.0
Martavious Irving,530,171,485,190,113,71,2117.0,224,79,106.0,261,111,15.0,2013,0.0
Jordan Henriquez,589,55,454,227,270,135,1906.0,0,0,108.0,454,227,17.9,2013,0.0
Ben McLemore,589,73,400,198,138,120,1191.0,174,73,77.0,226,125,23.2,2013,1.0
Jeff Withey,938,69,576,327,390,283,2319.0,1,1,138.0,575,326,19.7,2013,1.0
Travis Releford,965,190,645,346,275,191,2985.0,219,82,133.0,426,264,15.4,2013,0.0
Elijah Johnson,942,399,804,341,156,113,3045.0,430,147,233.0,374,194,18.4,2013,0.0
Kevin Young,1057,119,869,418,299,179,3264.0,164,42,203.0,705,376,18.8,2013,0.0
Rio Adams,27,6,25,10,13,5,83.0,5,2,11.0,20,8,25.9,2013,0.0
Markeith Cummings,2048,227,1590,723,752,514,4160.0,293,88,342.0,1297,635,28.5,2013,0.0
Brandon Dawson,267,8,221,94,113,75,1064.0,28,4,49.0,193,90,16.2,2013,0.0
Cole Hobbs,5,1,9,2,0,0,32.0,6,1,4.0,3,1,21.6,2013,0.0
Randal Holt,1417,280,1210,476,266,218,3618.0,686,247,219.0,524,229,21.8,2013,0.0
Bryson Pope,506,124,422,167,245,145,1895.0,107,27,135.0,315,140,18.2,2013,0.0
Justin Brunswick,0,1,1,0,2,0,23.0,0,0,0.0,1,0,4.4,2013,0.0
Brian Frank,6,1,14,2,2,1,31.0,13,1,0.0,1,1,24.4,2013,0.0
Archie Goodwin,466,88,357,157,212,135,1048.0,64,17,101.0,293,140,27.2,2013,1.0
Julius Mays,999,268,765,299,299,252,3091.0,393,149,176.0,372,150,18.7,2013,0.0
Nerlens Noel,251,38,166,98,104,55,765.0,0,0,45.0,166,98,17.4,2013,1.0
Twany Beckham,96,72,108,38,39,19,558.0,13,1,62.0,95,37,17.0,2013,0.0
Ramon Galloway,1588,323,1315,541,340,261,3567.0,635,245,313.0,680,296,25.3,2013,0.0
Garvin Hunt,4,4,5,1,5,2,71.0,0,0,6.0,5,1,9.6,2013,0.0
Tony Johnson,935,374,631,333,274,214,2859.0,145,55,181.0,486,278,17.7,2013,0.0
Levi Giese,480,54,441,172,83,46,1807.0,271,90,92.0,170,82,17.0,2013,0.0
Stan Brown,679,38,544,252,273,175,2085.0,4,0,120.0,540,252,18.1,2013,1.0
Donley Minor,662,211,636,226,148,117,2388.0,284,93,180.0,352,133,17.6,2013,0.0
Hondo Webb,95,27,73,37,26,20,411.0,10,1,54.0,63,36,16.5,2013,0.0
Nikko Acosta,130,20,120,46,70,38,690.0,0,0,47.0,120,46,14.1,2013,0.0
Brennan Doty,28,3,19,7,18,13,79.0,2,1,18.0,17,6,28.1,2013,0.0
Osas Ebomwonyi,108,7,96,45,57,18,671.0,0,0,30.0,96,45,10.7,2013,0.0
Brian Curran,2,0,1,0,2,2,6.0,1,0,1.0,0,0,24.0,2013,0.0
Gabe Knutson,1526,114,1049,536,578,434,3536.0,58,20,166.0,991,516,21.3,2013,0.0
Holden Greiner,1013,118,781,369,226,170,2753.0,291,105,145.0,490,264,19.2,2013,0.0
C.J. McCollum,2361,304,1746,767,739,610,3657.0,576,217,267.0,1170,550,32.4,2013,0.0
B.J. Bailey,237,43,164,74,69,50,856.0,85,39,38.0,79,35,14.2,2013,0.0
Cory Goodman,18,9,15,7,2,1,70.0,9,3,5.0,6,4,15.6,2013,0.0
Tyrone Staggers,7,1,11,2,4,3,47.0,3,0,1.0,8,2,15.3,2013,0.0
Tavares Speaks,801,67,674,299,231,185,2101.0,57,18,126.0,617,281,22.5,2013,0.0
Jarred Jourdan,27,7,26,11,9,4,110.0,4,1,10.0,22,10,19.0,2013,0.0
Larry Taylor,12,12,14,5,8,2,127.0,5,0,15.0,9,5,13.4,2013,0.0
Kelly Assibesi,20,20,18,5,10,7,170.0,10,3,13.0,8,2,10.9,2013,0.0
Deonte Alexander,663,105,592,246,80,56,1675.0,322,115,86.0,270,131,20.4,2013,0.0
Oscar Garcia,61,5,55,21,40,19,341.0,0,0,31.0,55,21,14.7,2013,0.0
Zack Ellis,2,0,3,1,2,0,17.0,2,0,0.0,1,1,11.1,2013,0.0
James Ennis,886,158,606,299,241,190,2080.0,277,98,168.0,329,201,21.5,2013,0.0
Tony Freeland,629,68,472,234,275,161,1686.0,1,0,122.0,471,234,21.8,2013,0.0
Peter Pappageorge,265,55,214,81,52,44,997.0,160,59,31.0,54,22,13.6,2013,0.0
Keala King,500,142,404,178,185,118,1410.0,94,26,147.0,310,152,24.0,2013,0.0
Edgar Garibay,163,25,148,63,53,37,648.0,0,0,40.0,148,63,16.2,2013,0.0
Gatete Djuma,8,0,7,4,0,0,23.0,0,0,1.0,7,4,17.4,2013,0.0
Jamal Olasewere,1873,164,1235,630,859,570,3384.0,150,43,405.0,1085,587,28.5,2013,0.0
C.J. Garner,1386,343,1032,476,542,395,3504.0,101,39,265.0,931,437,21.0,2013,0.0
Booker Hucks,302,9,218,113,52,36,781.0,109,40,50.0,109,73,17.8,2013,0.0
Julian Boyd,1467,96,992,530,546,374,2674.0,96,33,173.0,896,497,24.9,2013,0.0
Kenny Onyechi,794,28,529,274,465,246,2235.0,0,0,159.0,529,274,19.2,2013,0.0
Khalil Murphy,63,5,61,26,32,10,260.0,12,1,13.0,49,25,16.9,2013,0.0
David Robinson,578,88,465,178,160,131,1800.0,264,91,93.0,201,87,17.1,2013,1.0
Nik Brown,165,62,167,56,64,44,475.0,47,9,67.0,120,47,27.0,2013,0.0
Mark Parker,172,16,133,59,10,5,444.0,105,49,25.0,28,10,17.7,2013,0.0
Anthony Taylor,89,24,91,29,46,28,357.0,14,3,50.0,77,26,22.1,2013,1.0
Stephen Shockley,68,24,53,19,24,15,248.0,37,15,22.0,16,4,16.7,2013,0.0
Frank Holloway,15,1,16,6,5,2,41.0,2,1,7.0,14,5,30.1,2013,0.0
Kirk Staine,7,1,6,3,0,0,26.0,3,1,1.0,3,2,13.1,2013,0.0
Alan-Michael Thompson,395,26,334,133,71,52,1083.0,231,77,39.0,103,56,18.4,2013,0.0
Josh Soto,74,4,74,25,17,8,285.0,44,16,14.0,30,9,16.5,2013,0.0
Cornell Barnett,13,1,16,5,9,3,103.0,0,0,8.0,16,5,13.5,2013,0.0
Marcelis Hansberry,390,110,353,142,124,80,1387.0,107,26,94.0,246,116,19.6,2013,0.0
Trey Lindsey,185,71,183,63,53,37,1010.0,70,22,50.0,113,41,13.7,2013,0.0
Ifeanyi Eke,13,1,12,6,5,1,79.0,0,0,3.0,12,6,11.7,2013,0.0
Taylor Birchett,6,0,12,2,2,2,36.0,7,0,2.0,5,2,22.0,2013,0.0
Charles Carmouche,1052,266,831,334,396,256,3163.0,355,128,215.0,476,206,20.9,2013,0.0
Andrew Del Piero,135,4,104,55,48,25,435.0,0,0,27.0,104,55,17.3,2013,0.0
Eddie Ludwig,278,56,220,85,136,101,1282.0,34,7,78.0,186,78,14.5,2013,0.0
Joshua Badeaux,0,0,1,0,0,0,8.0,0,0,1.0,1,0,12.2,2013,0.0
Dave Jackson,0,0,0,0,0,0,5.0,0,0,1.0,0,0,9.8,2013,0.0
Mychal Williams,0,0,2,0,0,0,7.0,0,0,1.0,2,0,21.0,2013,0.0
Brandon Gibson,702,93,644,236,236,137,2022.0,324,93,133.0,320,143,22.2,2013,0.0
J.L. Lewis,313,28,268,121,104,61,1565.0,37,10,91.0,231,111,13.1,2013,0.0
J.D. Wilkerson,4,1,2,1,2,1,10.0,2,1,0.0,0,0,14.0,2013,0.0
Demario Johnson,1,2,3,0,2,1,9.0,2,0,0.0,1,0,20.9,2013,0.0
Peyton Siva,1215,677,989,412,396,292,3774.0,340,99,384.0,649,313,20.7,2013,1.0
Gorgui Dieng,851,127,620,338,272,174,2789.0,3,1,166.0,617,337,16.4,2013,1.0
Michael Baffour,2,0,3,0,4,2,12.0,2,0,0.0,1,0,20.5,2013,0.0
Logan Baumann,2,0,4,0,2,2,11.0,0,0,1.0,4,0,27.2,2013,0.0
Jordan Bond,0,1,3,0,0,0,17.0,2,0,0.0,1,0,8.9,2013,0.0
Ben Averkamp,1360,183,1101,510,364,281,3273.0,182,59,175.0,919,451,24.1,2013,0.0
Jordan Hicks,722,110,593,275,125,85,2255.0,240,87,129.0,353,188,18.8,2013,0.0
Cully Payne,494,244,439,154,151,109,1895.0,237,77,186.0,202,77,20.3,2013,0.0
Tanner Williams,20,4,14,9,4,2,32.0,0,0,2.0,14,9,30.9,2013,0.0
Kody Williams,4,4,1,0,5,4,26.0,0,0,2.0,1,0,10.8,2013,0.0
Ashley Hamilton,1172,108,911,400,459,334,3020.0,119,38,292.0,792,362,23.6,2013,0.0
Bruce English,112,31,134,38,47,26,549.0,55,10,37.0,79,28,18.0,2013,0.0
Taylor Walker,86,15,82,30,21,15,356.0,35,11,35.0,47,19,18.3,2013,0.0
Taj Adams,1,0,0,0,4,1,10.0,0,0,2.0,0,0,20.0,2013,0.0
Erik Etherly,1257,140,936,455,508,342,2969.0,23,5,202.0,913,450,24.0,2013,0.0
Robert Olson,1264,233,1040,429,252,195,3495.0,563,211,176.0,477,218,19.7,2013,0.0
Anthony Winbush,605,180,533,223,187,129,2911.0,103,30,177.0,430,193,14.0,2013,0.0
Julius Brooks,295,17,243,129,92,37,1312.0,1,0,80.0,242,129,14.5,2013,0.0
Luke Wandrusch,4,5,11,2,3,0,66.0,0,0,5.0,11,2,13.6,2013,0.0
Alasdair Fraser,913,80,758,393,191,114,2366.0,44,13,163.0,714,380,21.9,2013,0.0
Mike Allison,527,25,397,196,209,133,2107.0,12,2,85.0,385,194,14.2,2013,0.0
Jon Mesghna,172,30,140,55,33,21,655.0,107,41,30.0,33,14,14.2,2013,0.0
Jon McAllian,67,25,83,21,11,11,360.0,59,14,18.0,24,7,15.1,2013,0.0
Leon Cooper,7,3,13,3,2,1,63.0,2,0,11.0,11,3,19.8,2013,0.0
Luke Hetterman,0,0,0,0,0,0,4.0,0,0,0.0,0,0,0.0,2013,0.0
Roberto Colonette,329,37,242,112,155,101,1186.0,16,4,79.0,226,108,17.1,2013,0.0
Mohamed Koita,274,50,261,90,60,47,1250.0,148,47,69.0,113,43,14.8,2013,0.0
Mark Jackson,17,4,22,7,0,0,98.0,9,3,10.0,13,4,17.6,2013,1.0
Devin Price,1244,274,1050,385,377,300,3375.0,513,174,232.0,537,211,22.6,2013,0.0
Dorvell Carter,410,49,354,152,96,59,1268.0,144,47,58.0,210,105,19.0,2013,0.0
Jesse Martin,3,1,1,1,0,0,8.0,1,1,1.0,0,0,12.9,2013,0.0
Rob Delle Bovi,0,0,0,0,0,0,2.0,0,0,2.0,0,0,51.0,2013,0.0
Vander Blue,982,212,820,352,321,226,2727.0,188,52,208.0,632,300,22.0,2013,1.0
Junior Cadougan,661,435,567,231,256,174,2713.0,115,25,238.0,452,206,17.3,2013,0.0
Trent Lockett,1181,219,844,408,451,317,3341.0,140,48,263.0,704,360,21.7,2013,0.0
Dennis Tinnon,691,78,532,274,187,128,2003.0,44,15,116.0,488,259,17.9,2013,0.0
Nigel Spikes,527,41,353,183,310,161,2170.0,1,0,112.0,352,183,13.8,2013,0.0
Robert Goff,351,35,300,143,148,65,1360.0,3,0,65.0,297,143,15.7,2013,0.0
Jamir Hanner,139,15,100,54,63,27,379.0,8,4,31.0,92,50,20.7,2013,0.0
Ryan Cook,790,99,660,274,202,171,1732.0,214,71,128.0,446,203,25.7,2013,0.0
Brian Neller,966,84,961,332,61,41,2709.0,804,261,95.0,157,71,20.4,2013,0.0
Adrian Satchell,534,73,504,233,140,65,2167.0,11,3,107.0,493,230,16.2,2013,0.0
Jamar Wertz,271,35,258,96,66,43,1039.0,100,36,43.0,158,60,16.2,2013,0.0
Jordan Wejnert,31,4,28,11,15,8,109.0,8,1,10.0,20,10,20.8,2013,0.0
Jarrel Lane,54,51,79,23,16,7,519.0,17,1,46.0,62,22,12.7,2013,0.0
Nate Basalyga,34,9,30,16,5,2,201.0,0,0,9.0,30,16,10.2,2013,0.0
Will Wise,48,3,46,20,21,8,274.0,0,0,18.0,46,20,13.3,2013,0.0
Olatunji Kosile,190,9,177,74,70,42,915.0,1,0,68.0,176,74,15.4,2013,0.0
Dominique Cowell,105,59,116,37,27,21,739.0,40,10,49.0,76,27,12.4,2013,0.0
Donald Williams,92,5,149,34,15,9,322.0,76,15,33.0,73,19,30.3,2013,0.0
Ronald Spencer,337,16,268,123,157,91,1295.0,1,0,73.0,267,123,15.8,2013,0.0
Jarrod Davis,11,1,15,4,2,1,62.0,5,2,9.0,10,2,20.8,2013,0.0
Reginald Ekeanyanwu,0,0,0,0,0,0,1.0,0,0,0.0,0,0,0.0,2013,0.0
Alex Len,583,50,418,225,199,132,1470.0,9,1,93.0,409,224,20.7,2013,1.0
Logan Aronhalt,1320,110,1138,445,245,198,3122.0,623,232,191.0,515,213,24.4,2013,0.0
James Padgett,652,42,470,246,303,160,1834.0,0,0,98.0,470,246,19.3,2013,0.0
Terrell Vinson,1276,132,1005,453,417,279,3256.0,303,91,208.0,702,362,20.6,2013,0.0
Freddie Riley,1006,100,980,365,91,45,2627.0,688,231,118.0,292,134,20.7,2013,0.0
Izzy Freeman,0,0,3,0,2,0,6.0,0,0,0.0,3,0,31.9,2013,0.0
Dontae Cannon,967,228,842,346,271,209,2804.0,216,66,186.0,626,280,20.9,2013,0.0
Jeremie Mitchell,742,110,669,264,110,67,2167.0,395,147,120.0,274,117,19.7,2013,0.0
Josh Jagneaux,0,2,1,0,0,0,9.0,0,0,0.0,1,0,5.7,2013,0.0
Adonis Thomas,589,84,523,223,137,102,1511.0,126,41,82.0,397,182,22.1,2013,1.0
D.J. Stephens,512,45,330,207,128,81,1703.0,46,17,49.0,284,190,12.8,2013,0.0
Ferrakohn Hall,262,31,221,108,87,45,1093.0,11,1,59.0,210,107,14.7,2013,0.0
Stan Simpson,75,6,78,30,20,15,307.0,2,0,24.0,76,30,18.6,2013,0.0
Charles Holt,16,2,15,4,8,5,57.0,9,3,5.0,6,1,21.5,2013,0.0
Hippolyte Tsafack,15,0,9,5,8,5,56.0,0,0,3.0,9,5,14.4,2013,0.0
Travis Smith,984,211,698,316,254,214,2515.0,332,138,209.0,366,178,22.3,2013,0.0
Shane Larkin,760,245,585,256,182,147,2131.0,269,101,142.0,316,155,20.4,2013,1.0
Kenny Kadji,996,57,773,370,290,181,2395.0,202,75,146.0,571,295,23.8,2013,0.0
Durand Scott,1650,404,1285,580,507,392,4238.0,290,98,292.0,995,482,22.4,2013,0.0
Trey McKinney-Jones,998,202,772,343,254,188,3323.0,342,124,171.0,430,219,17.7,2013,1.0
Julian Gamble,550,57,412,224,193,101,1898.0,4,1,102.0,408,223,16.6,2013,0.0
Drew McGhee,312,17,251,140,47,32,957.0,0,0,49.0,251,140,18.7,2013,0.0
Josh Sewell,330,34,277,114,74,51,1084.0,131,51,72.0,146,63,19.9,2013,0.0
Vince Legarza,97,39,89,38,27,21,654.0,3,0,34.0,86,38,11.5,2013,0.0
Jared Tadlock,8,1,16,3,2,1,57.0,10,1,2.0,6,2,18.2,2013,0.0
Joe Mezher,0,0,0,0,0,0,15.0,0,0,2.0,0,0,7.4,2013,0.0
Derrick Nix,823,111,602,321,315,181,2219.0,0,0,138.0,602,321,20.8,2013,0.0
Emmett Dacey,0,0,1,0,0,0,2.0,1,0,0.0,0,0,26.2,2013,0.0
Bella Sibedwo,0,1,1,0,0,0,2.0,0,0,0.0,1,0,26.2,2013,0.0
Trey Burke,1231,416,969,436,291,226,2605.0,362,133,180.0,607,303,27.4,2013,1.0
Tim Hardaway Jr.,1532,225,1239,527,381,276,3560.0,589,202,182.0,650,325,25.2,2013,1.0
Matt Vogrich,260,41,236,94,25,16,1152.0,162,56,35.0,74,38,13.9,2013,0.0
Eso Akunne,53,11,44,20,6,4,177.0,20,9,8.0,24,11,17.1,2013,0.0
Corey Person,23,5,16,8,10,5,57.0,5,2,5.0,11,6,25.3,2013,0.0
Josh Bartelstein,6,4,16,2,3,0,56.0,11,2,2.0,5,0,19.6,2013,0.0
Marcos Knight,830,181,666,309,268,176,1839.0,118,36,137.0,548,273,26.1,2013,0.0
Raymond Cintron,568,84,394,175,92,80,1473.0,317,138,79.0,77,37,18.1,2013,0.0
Bruce Massey,433,245,339,149,191,123,1721.0,54,12,125.0,285,137,16.6,2013,0.0
J.T. Sulton,1019,57,758,375,363,261,2808.0,30,8,204.0,728,367,20.7,2013,0.0
James Gallman,746,126,604,241,163,120,2269.0,381,144,116.0,223,97,18.0,2013,0.0
Jason Jones,732,101,545,259,300,193,2003.0,68,21,138.0,477,238,22.4,2013,0.0
Finoy Perkins,2,1,4,0,2,2,12.0,1,0,1.0,3,0,25.5,2013,0.0
Paris Gulley,670,67,614,223,150,113,1904.0,300,111,88.0,314,112,21.3,2013,0.0
Demetrius Harris,330,22,259,121,202,87,950.0,6,1,90.0,253,120,24.5,2013,0.0
James Haarsma,1009,78,735,358,357,252,2863.0,116,41,164.0,619,317,19.6,2013,0.0
Ryan Haggerty,192,53,170,70,78,36,1281.0,72,16,50.0,98,54,10.4,2013,0.0
Christian Wolf,174,20,153,56,90,62,821.0,1,0,39.0,152,56,13.0,2013,0.0
Trevor Mbakwe,885,89,538,306,434,273,2107.0,1,0,164.0,537,306,22.2,2013,0.0
Julian Welch,673,191,522,223,196,143,1847.0,220,84,154.0,302,139,21.7,2013,0.0
Andre Ingram,115,8,93,45,52,25,604.0,0,0,34.0,93,45,13.1,2013,1.0
Chris Halvorsen,14,9,8,5,11,4,71.0,0,0,5.0,8,5,13.3,2013,0.0
Jalen Steele,622,72,542,200,113,97,1747.0,345,125,94.0,197,75,20.4,2013,0.0
Baxter Price,2,2,9,1,0,0,129.0,2,0,9.0,7,1,7.1,2013,0.0
Darius Tomlin,132,37,115,48,59,36,421.0,8,0,57.0,107,48,22.9,2013,0.0
Nate Brandt,7,5,23,3,1,0,78.0,11,1,6.0,12,2,18.2,2013,0.0
Montreal Holley,5,1,8,2,7,1,89.0,0,0,4.0,8,2,8.3,2013,0.0
Arthur Framery,0,0,0,0,0,0,10.0,0,0,0.0,0,0,0.0,2013,0.0
Murphy Holloway,1476,134,1130,615,478,245,3674.0,11,1,198.0,1119,614,21.0,2013,0.0
Reginald Buckner,911,83,616,353,425,203,3212.0,4,2,169.0,612,351,15.1,2013,0.0
Nick Williams,1100,157,1012,423,210,158,3598.0,311,96,172.0,701,327,18.0,2013,0.0
Will Norman,2,0,1,1,1,0,13.0,0,0,1.0,1,1,9.3,2013,0.0
Thomas Staton,621,145,557,231,153,106,1849.0,150,53,145.0,407,178,22.3,2013,0.0
Nate Rogers,431,119,380,149,109,70,1328.0,183,63,124.0,197,86,22.6,2013,0.0
Brad Reid,134,10,107,56,36,22,507.0,0,0,19.0,107,56,15.2,2013,0.0
Alton Tanner,44,6,40,12,20,15,208.0,19,5,12.0,21,7,15.8,2013,0.0
Trevor Franklin,18,1,18,5,11,8,86.0,6,0,4.0,12,5,16.9,2013,0.0
Anthony Downing,822,162,677,282,226,182,2104.0,261,76,110.0,416,206,23.9,2013,0.0
Tomie Aromona,27,6,26,9,10,6,163.0,14,3,6.0,12,6,12.8,2013,0.0
Ryan Carmichael,5,1,4,1,2,2,15.0,3,1,0.0,1,0,18.8,2013,0.0
Laurence Bowers,1248,132,944,513,273,191,2608.0,92,31,130.0,852,482,22.1,2013,0.0
Phil Pressey,959,580,812,321,268,203,2943.0,329,114,270.0,483,207,20.5,2013,1.0
Alex Oriakhi,1171,49,843,447,432,277,3640.0,1,0,168.0,842,447,16.8,2013,0.0
Keion Bell,1708,267,1318,581,569,437,3193.0,352,109,382.0,966,472,30.7,2013,0.0
Dominique Bull,1,1,1,0,2,1,14.0,0,0,1.0,1,0,10.3,2013,0.0
Jesse Steele,970,291,883,324,195,162,2697.0,450,160,189.0,433,164,21.5,2013,0.0
Ed Waite,1045,150,857,397,382,235,2668.0,71,16,257.0,786,381,24.8,2013,0.0
Stephen Spinella,311,38,277,106,99,66,1210.0,114,33,61.0,163,73,15.5,2013,0.0
Gary Cox,131,2,114,39,53,41,375.0,36,12,43.0,78,27,24.7,2013,0.0
Christian Moon,608,68,439,200,137,106,1500.0,261,102,57.0,178,98,18.9,2013,0.0
Xavier Johnson-Blount,533,78,431,165,207,148,1363.0,166,55,85.0,265,110,22.8,2013,0.0
Jamie Stewart,194,36,142,59,96,65,481.0,32,11,44.0,110,48,24.4,2013,0.0
Jeff Budinich,229,11,235,84,19,14,607.0,149,47,24.0,86,37,22.4,2013,0.0
Mathias Ward,933,50,660,346,263,208,2213.0,76,33,114.0,584,313,22.2,2013,0.0
Will Cherry,1484,397,1138,489,564,405,3565.0,354,101,273.0,784,388,25.6,2013,1.0
Spencer Coleman,242,25,173,87,57,44,686.0,61,24,37.0,112,63,19.3,2013,0.0
Kevin Henderson,111,14,101,42,20,14,437.0,42,13,27.0,59,29,17.3,2013,1.0
Milton Chavis,586,42,480,235,124,81,1288.0,100,35,113.0,380,200,25.6,2013,0.0
Devon Atkinson,289,191,241,101,69,55,1167.0,82,32,114.0,159,69,16.0,2013,0.0
Jarrett Stokes,155,37,156,49,32,28,505.0,103,29,27.0,53,20,18.4,2013,0.0
Kahlil Owens,278,17,196,117,97,44,774.0,0,0,58.0,196,117,19.6,2013,0.0
Maurice Lewis-Briggs,141,14,120,53,37,26,304.0,39,9,33.0,81,44,26.3,2013,0.0
Bruce Reed,113,28,75,39,40,29,402.0,15,6,34.0,60,33,14.9,2013,0.0
Jason Holmes,445,28,362,178,140,76,1497.0,37,13,104.0,325,165,17.0,2013,0.0
Cordell James,47,12,39,17,8,5,142.0,18,8,23.0,21,9,21.7,2013,0.0
Taariq Muhammad,16,32,25,7,6,2,208.0,7,0,29.0,18,7,12.8,2013,0.0
DeWayne Jackson,1600,187,1323,562,406,287,3620.0,616,189,238.0,707,373,23.7,2013,0.0
Tauron Bailey,64,7,49,24,35,16,255.0,0,0,13.0,49,24,15.2,2013,0.0
Daon Riley,2,0,1,0,2,2,7.0,0,0,0.0,1,0,13.8,2013,0.0
Tyrece Edwards,0,0,0,0,0,0,4.0,0,0,0.0,0,0,0.0,2013,0.0
Raven Barber,737,31,491,287,271,163,2116.0,0,0,141.0,491,287,18.9,2013,0.0
Kelvin Parker,410,63,363,148,64,43,1306.0,212,71,64.0,151,77,18.4,2013,0.0
Xavier Owens,164,18,165,64,50,21,665.0,56,15,42.0,109,49,18.1,2013,0.0
Oliver Brown,10,2,13,4,2,2,42.0,5,0,4.0,8,4,22.3,2013,0.0
Aaron DeVan,0,0,2,0,0,0,4.0,1,0,0.0,1,0,25.8,2013,0.0
Isaiah Canaan,2050,385,1411,635,593,476,3876.0,725,304,311.0,686,331,26.7,2013,1.0
Stacy Wilson,554,94,467,201,102,71,1276.0,236,81,116.0,231,120,25.4,2013,0.0
Edward Daniel,931,81,560,311,508,306,2602.0,9,3,181.0,551,308,19.5,2013,0.0
Brandon Garrett,291,31,207,118,104,55,1199.0,0,0,75.0,207,118,14.2,2013,0.0
Latreze Mushatt,839,120,758,327,260,146,2788.0,138,39,164.0,620,288,18.1,2013,0.0
Jordan Burge,0,1,8,0,0,0,26.0,4,0,1.0,4,0,17.8,2013,0.0
Brennan Wyatt,210,118,210,59,95,66,1031.0,111,26,89.0,99,33,17.5,2013,0.0
Jared Smoot,49,0,36,19,23,11,353.0,0,0,23.0,36,19,11.2,2013,0.0
Isaiah Roberts,406,108,336,142,149,95,1472.0,94,27,123.0,242,115,19.0,2013,0.0
Donya Jackson,97,11,92,40,17,9,345.0,26,8,26.0,66,32,20.4,2013,0.0
Ryan Spadaford,15,1,19,4,8,5,50.0,12,2,2.0,7,2,28.5,2013,0.0
Alex Welhouse,256,22,198,87,44,33,836.0,116,49,43.0,82,38,15.6,2013,0.0
Jacques Coleman,57,14,47,20,23,14,171.0,12,3,23.0,35,17,23.5,2013,0.0
Tyler Egli,33,4,34,9,10,8,130.0,27,7,3.0,7,2,16.0,2013,0.0
Koang Doluony,202,16,181,69,43,32,799.0,106,32,54.0,75,37,17.2,2013,0.0
Dylan Talley,982,180,890,344,240,177,2528.0,345,117,182.0,545,227,26.1,2013,0.0
Brandon Ubel,893,109,646,312,299,240,3020.0,98,29,165.0,548,283,17.6,2013,0.0
Andre Almeida,290,37,234,123,78,44,869.0,0,0,71.0,234,123,21.7,2013,0.0
Jordan Tyrance,24,4,23,8,11,8,126.0,5,0,9.0,18,8,16.8,2013,0.0
Max Ritchie,2,0,0,0,2,2,7.0,0,0,0.0,0,0,7.7,2013,0.0
Anthony Bennett,564,34,379,202,177,124,950.0,96,36,65.0,283,166,27.5,2013,1.0
Anthony Marshall,1280,514,973,444,472,321,3803.0,263,71,311.0,710,373,19.9,2013,0.0
Justin Hawkins,728,181,635,245,234,156,2696.0,290,82,90.0,345,163,15.6,2013,0.0
Quintrell Thomas,523,28,350,182,240,159,1432.0,0,0,93.0,350,182,19.5,2013,0.0
Malik Story,1658,249,1390,563,368,262,3699.0,724,270,280.0,666,293,25.6,2013,0.0
Jordan Burris,386,91,349,132,117,84,1460.0,150,38,88.0,199,94,17.3,2013,0.0
Patrick Nyeko,111,49,94,27,67,47,974.0,46,10,42.0,48,17,8.8,2013,0.0
Keith Fuetsch,50,21,44,16,20,11,238.0,21,7,20.0,23,9,15.8,2013,0.0
Brice Crook,5,0,7,1,2,2,18.0,6,1,0.0,1,0,23.0,2013,0.0
Ferg Myrick,979,78,868,329,344,226,2213.0,284,95,208.0,584,234,29.9,2013,0.0
Chandler Rhoads,1015,308,955,322,485,276,3495.0,351,95,237.0,604,227,21.8,2013,0.0
Chris Matagrano,280,29,244,117,60,41,1151.0,34,5,68.0,210,112,15.8,2013,0.0
Jeron Trotman,378,33,279,146,184,85,1247.0,13,1,83.0,266,145,18.2,2013,0.0
Chris Orozco,20,11,27,2,21,15,232.0,9,1,16.0,18,1,12.3,2013,0.0
Garrett Jones,18,6,19,6,2,1,98.0,15,5,6.0,4,1,14.1,2013,0.0
Bandja Sy,912,122,786,330,236,161,2711.0,303,91,194.0,483,239,20.0,2013,0.0
Tyrone Watson,825,266,573,296,350,209,2994.0,94,24,210.0,479,272,15.6,2013,0.0
Emery Coleman,0,0,1,0,0,0,12.0,0,0,2.0,1,0,12.9,2013,0.0
Tony Snell,952,213,738,311,201,165,2583.0,434,165,154.0,304,146,20.1,2013,1.0
Chad Adams,396,62,295,138,113,83,1447.0,87,37,64.0,208,101,14.9,2013,0.0
Jamal Fenton,638,225,543,213,180,116,1985.0,297,96,144.0,246,117,20.1,2013,0.0
Lovell Cook,369,7,278,150,87,65,718.0,7,4,40.0,271,146,23.8,2013,0.0
Rarlensee Nelson,262,172,213,90,116,79,790.0,22,3,104.0,191,87,22.4,2013,0.0
Corey Blake,108,17,112,37,33,26,372.0,40,8,40.0,72,29,21.4,2013,0.0
Max Banchy,67,11,63,24,5,4,354.0,44,15,27.0,19,9,12.4,2013,0.0
Maurice County,44,20,45,18,6,5,225.0,16,3,12.0,29,15,12.7,2013,0.0
Mitchell Parker,9,2,3,2,6,5,27.0,0,0,2.0,3,2,13.8,2013,0.0
Joseph Hebert,0,0,1,0,0,0,4.0,1,0,0.0,0,0,11.9,2013,0.0
Darrell Williams,0,7,2,0,0,0,21.0,2,0,4.0,0,0,13.6,2013,0.0
Devon White,544,44,464,225,169,94,1758.0,1,0,128.0,463,225,18.9,2013,0.0
Malcolm Lemmons,476,72,417,153,177,132,1722.0,144,38,113.0,273,115,17.7,2013,0.0
Lawrence Johnson,1,1,1,0,2,1,5.0,0,0,0.0,1,0,19.2,2013,0.0
Skylar Jones,183,10,209,64,45,29,681.0,99,26,33.0,110,38,19.3,2013,0.0
Fred Hunter,1595,152,1076,584,581,373,2994.0,196,54,248.0,880,530,29.7,2013,0.0
Linden Smith-Hyde,166,25,160,60,28,17,849.0,97,29,35.0,63,31,12.6,2013,0.0
Lachlan Prest,113,29,104,40,7,6,523.0,75,27,30.0,29,13,13.5,2013,0.0
Sterling Bailey,65,6,55,22,15,7,263.0,39,14,19.0,16,8,15.8,2013,0.0
Zachary West,6,7,8,2,2,1,91.0,5,1,5.0,3,1,7.9,2013,0.0
Chris Flores,1726,330,1463,587,442,315,3726.0,664,237,265.0,799,350,26.0,2013,0.0
Ryan Woods,682,78,532,218,133,108,1627.0,331,138,67.0,201,80,20.4,2013,0.0
P.J. Miller,819,323,695,296,371,223,2943.0,45,4,254.0,650,292,19.1,2013,0.0
Sean McCarthy,172,15,179,74,61,24,925.0,0,0,68.0,179,74,14.8,2013,0.0
Mitch Farrell,43,2,32,14,10,7,99.0,21,8,7.0,11,6,21.8,2013,0.0
Kris Brown,174,44,172,64,50,26,776.0,67,20,53.0,105,44,15.8,2013,0.0
A.J. Rogers,132,13,107,52,54,28,628.0,0,0,39.0,107,52,13.7,2013,0.0
Quasim Pugh,86,41,78,23,48,35,387.0,26,5,34.0,52,18,17.4,2013,0.0
Jeremy Atkinson,967,156,660,334,330,256,2107.0,132,43,137.0,528,291,22.2,2013,0.0
Trent Meyer,436,181,408,147,76,57,1681.0,263,85,107.0,145,62,16.1,2013,0.0
Jon Nwannunu,342,28,272,139,85,64,965.0,2,0,55.0,270,139,18.6,2013,0.0
Josh Seligson,19,3,18,7,8,5,70.0,4,0,9.0,14,7,21.5,2013,0.0
Zack Davis,3,1,3,1,0,0,10.0,3,1,1.0,0,0,19.6,2013,0.0
Drew Combs,0,0,0,0,0,0,1.0,0,0,0.0,0,0,0.0,2013,0.0
Adrian Powell,1054,161,897,382,263,172,2910.0,343,118,219.0,554,264,21.3,2013,0.0
Jean Louisme,494,76,447,154,142,105,1443.0,287,81,97.0,160,73,21.4,2013,0.0
Austin Witter,705,221,686,268,123,61,3269.0,370,108,220.0,316,160,14.6,2013,0.0
DaMetrius Upchurch,479,37,370,184,208,110,1559.0,4,1,124.0,366,183,18.8,2013,0.0
R.J. Buck,435,81,306,143,224,141,1725.0,39,8,89.0,267,135,14.3,2013,0.0
Lawrence Smith,189,26,163,63,93,62,961.0,12,1,58.0,151,62,13.5,2013,0.0
Khalid King,16,2,21,5,5,3,48.0,13,3,3.0,8,2,28.4,2013,0.0
Dominique Behonh-Tolly,19,2,12,6,13,7,75.0,0,0,4.0,12,6,14.8,2013,0.0
Ray Willis,926,140,691,287,359,290,2264.0,199,62,186.0,492,225,24.2,2013,0.0
Drimir Ferguson,105,53,70,27,54,44,375.0,20,7,32.0,50,20,18.3,2013,0.0
Jordan Marrow,6,0,3,1,4,3,16.0,2,1,1.0,1,0,19.9,2013,0.0
Nathaniel Sims,4,0,4,2,4,0,15.0,0,0,0.0,4,2,21.2,2013,0.0
Rashawn King,2,1,4,1,0,0,3.0,1,0,1.0,3,1,89.7,2013,0.0
Trevis Simpson,1409,83,1213,488,368,279,2315.0,466,154,171.0,747,334,32.1,2013,0.0
Derrell Armstrong,842,133,693,298,234,178,1566.0,201,68,165.0,492,230,29.4,2013,0.0
Kelvin McNeil,523,72,454,194,249,130,2229.0,34,5,130.0,420,189,16.3,2013,0.0
David Williams,474,104,356,175,232,111,2059.0,35,13,184.0,321,162,15.1,2013,0.0
Korey VanDussen,739,220,641,268,163,125,2565.0,226,78,189.0,415,190,17.0,2013,0.0
Taylor Hoffer,52,9,51,17,25,15,464.0,11,3,22.0,40,14,8.7,2013,0.0
Brian Cole,366,12,336,151,54,34,970.0,86,30,52.0,250,121,20.7,2013,0.0
Kendall Bethea,4,1,2,1,2,2,13.0,1,0,1.0,1,1,14.5,2013,0.0
Thomas Sumpter,2,0,1,1,0,0,8.0,0,0,0.0,1,1,6.0,2013,0.0
Demetrius Robinson,0,0,3,0,0,0,14.0,0,0,0.0,3,0,10.2,2013,0.0
C.J. Leslie,1359,113,1020,507,564,332,2859.0,48,13,236.0,972,494,26.6,2013,0.0
Richard Howell,1214,147,936,485,379,240,3058.0,18,4,194.0,918,481,21.5,2013,0.0
Scott Wood,1467,190,1065,450,263,233,4372.0,809,334,141.0,256,116,15.3,2013,0.0
Lorenzo Brown,1167,589,955,410,382,283,3289.0,210,64,304.0,745,346,21.8,2013,1.0
Thomas de Thaey,38,7,44,15,4,3,134.0,20,5,6.0,24,10,19.4,2013,0.0
Jay Lewis,6,3,12,2,0,0,33.0,9,2,4.0,3,0,24.2,2013,0.0
Keith Rendleman,1516,95,1103,594,538,318,3657.0,29,10,217.0,1074,584,22.3,2013,0.0
Tyree Graham,127,38,133,39,30,25,386.0,81,24,41.0,52,15,28.0,2013,0.0
Nate Anderson,70,1,53,24,13,8,175.0,31,14,9.0,22,10,19.8,2013,0.0
Matt Wilson,235,30,180,90,99,54,1143.0,1,1,76.0,179,89,14.1,2013,0.0
Alex Kilmartin,0,0,0,0,0,0,1.0,0,0,0.0,0,0,0.0,2013,0.0
P.J. Hairston,707,74,567,220,175,140,1286.0,364,127,66.0,203,93,25.8,2013,0.0
Reggie Bullock,989,169,815,358,118,85,2457.0,486,188,94.0,329,170,18.2,2013,1.0
Dexter Strickland,899,342,702,323,339,233,3083.0,91,20,189.0,611,303,15.8,2013,0.0
Frank Tanner,2,1,8,1,0,0,20.0,3,0,3.0,5,1,25.9,2013,0.0
Nate Zastrow,369,153,304,91,147,121,1284.0,188,66,101.0,116,25,19.0,2013,0.0
Brett VandenBergh,59,24,50,20,8,3,505.0,37,16,15.0,13,4,7.7,2013,0.0
Jamie Mauch,12,1,16,3,4,3,33.0,13,3,2.0,3,0,34.3,2013,0.0
Mitch Wilmer,271,11,224,86,138,98,1085.0,5,1,97.0,219,85,18.4,2013,0.0
Brandon Brekke,567,33,370,229,188,109,1466.0,0,0,111.0,370,229,20.0,2013,0.0
Jordan Allard,431,79,422,157,178,98,1972.0,94,19,119.0,328,138,16.6,2013,0.0
Doug Archer,153,32,124,60,51,28,829.0,25,5,60.0,99,55,13.1,2013,0.0
Dan Stockdale,15,0,14,6,6,3,48.0,4,0,2.0,10,6,20.4,2013,0.0
Parker Smith,1665,130,1222,500,359,304,3314.0,903,361,214.0,319,139,24.8,2013,0.0
Andy Diaz,1094,95,844,460,425,174,2666.0,3,0,283.0,841,460,26.1,2013,0.0
David Jeune,434,81,369,151,174,115,2518.0,85,17,170.0,284,134,12.9,2013,0.0
William Wilson,238,379,264,91,75,39,2321.0,57,17,201.0,207,74,11.3,2013,0.0
Jibril Smith,2,0,2,1,0,0,4.0,0,0,0.0,2,1,26.0,2013,0.0
Fred Landers,79,11,80,31,15,9,302.0,31,8,11.0,49,23,16.8,2013,0.0
Tony Mitchell,755,62,526,258,272,191,1713.0,141,48,143.0,385,210,23.2,2013,1.0
Roger Franklin,760,81,658,301,215,153,2343.0,22,5,124.0,636,296,18.8,2013,0.0
Jacob Holmen,539,49,511,208,109,85,1493.0,127,38,74.0,384,170,21.4,2013,0.0
Niko Stojilkovic,193,62,185,63,91,57,860.0,52,10,58.0,133,53,16.6,2013,0.0
Clarke Overlander,31,5,52,10,7,4,207.0,46,7,5.0,6,3,14.6,2013,0.0
Austin Mitchell,0,0,1,0,0,0,18.0,0,0,2.0,1,0,8.3,2013,0.0
Joel Smith,1328,248,996,440,241,205,3278.0,609,243,218.0,387,197,22.0,2013,0.0
Jonathan Lee,1161,293,811,374,382,305,2914.0,267,108,255.0,544,266,23.2,2013,0.0
Dinko Marshavelski,187,8,151,76,47,35,498.0,0,0,40.0,151,76,23.5,2013,0.0
Gabe Rogers,1419,245,1289,500,220,173,3265.0,636,246,236.0,653,254,25.9,2013,0.0
Stallon Saldivar,553,505,519,188,147,114,3117.0,220,63,217.0,299,125,13.4,2013,0.0
Michael Dunn,400,109,332,129,133,102,1518.0,140,40,102.0,192,89,16.9,2013,0.0
Ephraim Ekanem,254,9,218,106,97,42,815.0,0,0,41.0,218,106,19.2,2013,0.0
Luis Flores,77,19,66,26,20,10,312.0,42,15,23.0,24,11,16.3,2013,1.0
Ben Olayinka,55,7,44,21,25,13,265.0,0,0,21.0,44,21,14.9,2013,0.0
Bryce Gosar,0,1,1,0,0,0,7.0,1,0,2.0,0,0,22.1,2013,0.0
Nick Wahl,0,0,0,0,0,0,0.0,0,0,0.0,0,0,0,2013,0.0
Paul Garnica,609,172,509,218,84,66,1658.0,259,107,144.0,250,111,21.6,2013,0.0
James Davis,40,22,52,14,6,5,246.0,32,7,15.0,20,7,14.8,2013,1.0
Dylan Elias,7,2,4,2,2,2,18.0,3,1,1.0,1,1,17.2,2013,0.0
Sam Mader,89,10,88,37,18,13,384.0,7,2,20.0,81,35,16.2,2013,0.0
Brandon Hayes,2,0,1,0,2,2,18.0,0,0,0.0,1,0,5.8,2013,0.0
Anthony James,1305,148,1107,481,280,213,3074.0,328,130,182.0,779,351,26.4,2013,0.0
Marc Sonnen,932,157,748,309,144,113,3351.0,480,201,107.0,268,108,15.7,2013,0.0
Jake Koch,1113,262,792,325,426,340,3334.0,383,123,222.0,409,202,20.9,2013,0.0
Austin Pehl,153,15,144,62,46,29,693.0,0,0,45.0,144,62,17.4,2013,0.0
Eshaunte Jones,719,106,572,233,145,103,1754.0,384,150,76.0,188,83,23.0,2013,0.0
Ethan Faulkner,179,89,162,55,57,48,872.0,72,21,50.0,90,34,16.0,2013,0.0
Ernest Watson,161,33,183,68,22,13,714.0,45,12,16.0,138,56,17.1,2013,0.0
Nate Snodgrass,78,32,79,25,11,9,434.0,53,19,17.0,26,6,13.6,2013,0.0
John Staley,30,7,29,14,8,2,247.0,1,0,14.0,28,14,11.0,2013,0.0
Justin Rossi,6,1,8,2,0,0,30.0,7,2,2.0,1,0,19.4,2013,0.0
Quinnten Fuller,0,0,0,0,0,0,3.0,0,0,0.0,0,0,0.0,2013,0.0
Bill Pecora,0,0,2,0,0,0,7.0,2,0,0.0,0,0,16.6,2013,0.0
Shamir Davis,1136,296,830,341,542,386,2876.0,224,68,279.0,606,273,22.0,2013,0.0
James Hulbin,976,61,774,346,331,209,2152.0,222,75,131.0,552,271,22.7,2013,0.0
Gary Roberson,393,44,332,151,94,57,1143.0,100,34,76.0,232,117,18.5,2013,0.0
O.J. Evans,245,26,220,104,76,37,1132.0,1,0,56.0,219,104,12.7,2013,0.0
David Ulak,1,1,5,0,4,1,28.0,4,0,2.0,1,0,14.8,2013,0.0
Reggie Hearn,671,95,484,221,202,152,1923.0,218,77,110.0,266,144,20.3,2013,1.0
Jared Swopshire,657,121,545,220,212,159,2313.0,184,58,114.0,361,162,16.8,2013,0.0
Alex Marcotullio,684,213,540,222,112,83,2497.0,425,157,117.0,115,65,15.9,2013,0.0
Omar Jimenez,7,3,10,2,4,2,60.0,6,1,4.0,4,1,15.0,2013,0.0
Jack Cooley,1017,66,656,394,344,228,2435.0,2,1,110.0,654,393,21.1,2013,1.0
Scott Martin,1048,183,906,369,283,189,3389.0,367,121,164.0,539,248,17.9,2013,0.0
Drew Valentine,1069,241,779,396,276,184,3494.0,262,93,237.0,517,303,16.0,2013,0.0
Matt Poches,78,25,66,28,33,22,381.0,2,0,27.0,64,28,14.2,2013,0.0
Raphael Carter,49,4,36,21,18,7,236.0,0,0,9.0,36,21,11.3,2013,0.0
Korab Imami,2,0,1,1,0,0,13.0,0,0,0.0,1,1,3.8,2013,0.0
Jordan Howenstine,8,2,16,2,7,4,42.0,2,0,4.0,14,2,27.2,2013,0.0
Deshaun Thomas,1628,100,1269,607,338,271,3052.0,418,143,129.0,851,464,26.7,2013,0.0
Evan Ravenel,426,37,317,159,161,108,1426.0,1,0,86.0,316,159,17.3,2013,0.0
Alex Rogers,2,2,9,1,0,0,21.0,0,0,2.0,9,1,27.9,2013,0.0
D.J. Cooper,2075,934,1707,648,681,505,4835.0,851,274,447.0,856,374,25.9,2013,0.0
Reggie Keely,1131,86,847,445,384,240,2823.0,6,1,203.0,841,444,22.2,2013,0.0
Walter Offutt,849,141,633,276,266,195,2255.0,291,102,123.0,342,174,20.2,2013,0.0
Ivo Baltic,1066,177,898,441,271,169,3197.0,51,15,246.0,847,426,20.2,2013,0.0
Kadeem Green,68,2,37,27,25,14,179.0,0,0,8.0,37,27,16.7,2013,0.0
David McKinley,39,8,29,13,4,4,134.0,22,9,6.0,7,4,13.9,2013,0.0
Nick Goff,19,6,16,5,7,6,46.0,11,3,4.0,5,2,26.0,2013,0.0
Philip Jurick,137,31,100,63,31,11,1016.0,0,0,55.0,100,63,8.7,2013,0.0
Kirby Gardner,42,30,54,16,15,8,314.0,15,2,19.0,39,14,13.1,2013,0.0
Jean-Paul Olukemi,516,44,345,153,244,186,1147.0,79,24,87.0,266,129,25.0,2013,0.0
Romero Osby,1211,102,868,427,430,317,2757.0,102,40,160.0,766,387,22.5,2013,0.0
Steven Pledger,1392,167,1129,469,248,205,3424.0,675,249,177.0,454,220,21.4,2013,0.0
Amath M'Baye,813,56,669,313,250,165,2158.0,110,22,172.0,559,291,22.5,2013,0.0
Andrew Fitzgerald,1086,66,913,433,311,220,2763.0,2,0,149.0,911,433,22.8,2013,0.0
Sam Grooms,363,285,314,123,152,103,1617.0,55,14,103.0,259,109,15.2,2013,0.0
Casey Arent,32,1,32,13,6,6,178.0,0,0,15.0,32,13,14.0,2013,0.0
DeShawn Painter,782,44,691,298,266,173,2171.0,41,13,123.0,650,285,21.6,2013,0.0
Donte Hill,489,148,436,169,164,98,1804.0,191,53,122.0,245,116,17.5,2013,0.0
Nick Wright,552,40,504,188,233,151,1795.0,92,25,104.0,412,163,20.1,2013,0.0
Stuart McEwen,4,2,8,2,0,0,56.0,5,0,2.0,3,2,8.9,2013,0.0
Warren Niles,1982,257,1593,673,440,344,4451.0,780,292,286.0,813,381,24.0,2013,0.0
Damen Bell-Holter,1389,143,1018,496,510,371,3446.0,90,26,228.0,928,470,22.2,2013,0.0
Steven Roundtree,982,142,684,370,367,241,2411.0,11,1,207.0,673,369,22.8,2013,0.0
Mikey Manghum,178,99,132,54,32,26,1237.0,111,44,52.0,21,10,8.4,2013,0.0
Jake Lliteras,88,27,91,28,19,13,454.0,65,19,28.0,26,9,14.9,2013,0.0
P.J. Purnell,5,1,4,2,1,1,8.0,2,0,0.0,2,2,28.6,2013,0.0
Caleb Tannehill,0,0,1,0,0,0,8.0,0,0,0.0,1,0,6.4,2013,0.0
Jullian Powers,2,0,3,1,0,0,22.0,1,0,3.0,2,1,13.3,2013,0.0
E.J. Singler,1546,286,1134,507,429,364,4165.0,451,168,253.0,683,339,19.2,2013,0.0
Carlos Emory,640,70,481,221,200,148,1581.0,162,50,116.0,319,171,21.9,2013,0.0
Tony Woods,793,41,569,310,298,173,2110.0,0,0,165.0,569,310,21.2,2013,0.0
Arsalan Kazemi,1523,197,895,500,771,523,3776.0,2,0,232.0,893,500,20.2,2013,0.0
Austin Kuemper,22,1,14,8,6,5,51.0,1,1,1.0,13,7,17.3,2013,0.0
Coleton Baker,4,1,4,1,2,1,32.0,2,1,1.0,2,0,9.2,2013,0.0
Lorenzo McCloud,704,238,511,210,310,241,1790.0,139,43,153.0,372,167,24.8,2013,0.0
Travis Fulton,613,115,511,224,118,90,1723.0,209,75,78.0,302,149,20.5,2013,0.0
Colin Beatty,348,88,328,142,44,24,1406.0,114,40,57.0,214,102,15.8,2013,0.0
Rodrigo De Souza,200,86,154,64,66,42,787.0,82,30,41.0,72,34,15.8,2013,0.0
Markus Duran,299,48,239,92,44,36,1070.0,216,79,38.0,23,13,15.2,2013,0.0
Jordan Turner,15,12,24,6,3,1,182.0,7,2,7.0,17,4,9.8,2013,0.0
Reed Kamler,0,0,2,0,0,0,9.0,2,0,1.0,0,0,18.3,2013,0.0
Sasa Borovnjak,400,23,299,162,120,76,1411.0,2,0,64.0,297,162,15.8,2013,0.0
Nick Colella,196,46,193,60,37,26,1215.0,162,50,31.0,31,10,10.5,2013,0.0
Akosa Maduegbunam,6,2,12,2,4,2,53.0,8,0,0.0,4,2,14.0,2013,0.0
Kevin Onyeaka,0,0,1,0,0,0,2.0,1,0,0.0,0,0,26.6,2013,0.0
Simeon Esprit,5,3,7,2,1,0,69.0,3,1,4.0,4,1,9.1,2013,0.0
Lorne Jackson,1297,311,1013,422,399,309,3129.0,439,144,314.0,574,278,24.9,2013,0.0
Caleb Willis,338,224,269,112,127,85,1771.0,86,29,123.0,183,83,13.5,2013,0.0
Moriba De Freitas,81,21,63,32,34,17,584.0,0,0,31.0,63,32,10.3,2013,0.0
Jan Maehlen,47,4,37,21,17,5,386.0,0,0,18.0,37,21,8.6,2013,0.0
Manny Ochenje,50,0,44,19,17,12,216.0,0,0,11.0,44,19,15.6,2013,0.0
Travon Woodall,1108,580,898,374,283,213,3327.0,437,147,276.0,461,227,20.8,2013,0.0
Steven Adams,231,20,175,100,70,31,749.0,0,0,35.0,175,100,17.7,2013,1.0
Dante Taylor,681,50,464,271,227,139,2170.0,1,0,92.0,463,271,16.2,2013,0.0
Renado Parker,555,36,439,218,170,119,1354.0,1,0,79.0,438,218,23.0,2013,0.0
Michael Harthun,625,112,501,227,106,81,2063.0,220,90,89.0,281,137,16.0,2013,0.0
Lateef McMullan,760,249,632,238,235,173,2481.0,315,111,163.0,317,127,19.0,2013,0.0
Michael Harvey,124,16,108,44,40,30,497.0,32,6,30.0,76,38,16.5,2013,0.0
Martin Whitmore,106,9,93,35,24,18,317.0,59,18,16.0,34,17,19.7,2013,0.0
Derrick Rodgers,390,192,331,139,153,106,1732.0,22,6,161.0,309,133,16.9,2013,0.0
Jake Ehlers,40,3,32,13,17,10,163.0,9,4,10.0,23,9,16.0,2013,0.0
David Ahern,6,3,6,2,3,2,32.0,2,0,3.0,4,2,16.9,2013,0.0
Jourdan Demunyck,825,103,774,305,235,162,1680.0,160,53,151.0,614,252,29.0,2013,0.0
Carl Blair,947,495,742,283,412,311,3311.0,257,70,371.0,485,213,20.2,2013,0.0
Ryan Gesiakowski,538,57,541,184,82,55,1631.0,382,115,76.0,159,69,18.9,2013,0.0
Josh Eleby,188,5,163,87,33,14,447.0,0,0,41.0,163,87,23.2,2013,0.0
Mayol Riathin,127,12,112,46,66,35,662.0,0,0,52.0,112,46,13.9,2013,0.0
Ronald Wright,187,99,229,83,55,19,993.0,15,2,69.0,214,81,15.3,2013,0.0
Cory Jones,28,13,20,8,21,10,185.0,6,2,19.0,14,6,12.5,2013,0.0
John Love,13,1,14,3,6,5,24.0,10,2,2.0,4,1,37.1,2013,0.0
Babajidne Aina,10,0,9,5,5,0,46.0,2,0,2.0,7,5,13.7,2013,0.0
Khalid Mutakabbir,1576,283,1311,567,368,281,4542.0,435,161,340.0,876,406,22.7,2013,0.0
Joshua Clyburn,428,27,331,170,152,87,1399.0,3,1,115.0,328,169,21.1,2013,0.0
Ryan McTavish,237,24,220,90,40,32,1170.0,94,25,51.0,126,65,14.1,2013,0.0
Ryan Hargrave,394,29,343,144,69,54,1215.0,162,52,55.0,181,92,19.9,2013,0.0
Matthew Citron,11,0,8,5,5,1,30.0,0,0,5.0,8,5,29.3,2013,0.0
Jarvis Thibodeaux,10,0,6,3,5,3,23.0,2,1,3.0,4,2,28.3,2013,0.0
Ian Hummer,1625,308,1225,625,524,349,3523.0,84,26,282.0,1141,599,28.2,2013,0.0
Brendan Connolly,408,96,313,165,127,78,1542.0,1,0,82.0,312,165,16.6,2013,0.0
Mack Darrow,465,152,361,150,123,92,1703.0,204,73,61.0,157,77,15.9,2013,0.0
Ameer Elbuluk,0,1,1,0,2,0,15.0,0,0,3.0,1,0,19.1,2013,0.0
Brian Fabrizius,3,0,2,1,0,0,10.0,2,1,0.0,0,0,11.2,2013,0.0
Edo Lawrence,0,0,0,0,0,0,1.0,0,0,0.0,0,0,0.0,2013,0.0
Isaac Serwanga,0,1,2,0,0,0,12.0,1,0,0.0,1,0,9.7,2013,0.0
Vincent Council,1499,725,1365,514,523,362,4024.0,349,109,353.0,1016,405,23.5,2013,0.0
Sidiki Johnson,44,2,50,17,31,10,172.0,0,0,13.0,50,17,22.9,2013,0.0
D.J. Byrd,890,206,735,281,184,133,2663.0,529,195,122.0,206,86,18.3,2013,0.0
Donnie Hale,122,9,120,52,31,17,463.0,1,1,18.0,119,51,16.7,2013,0.0
Dru Anthrop,34,24,26,13,8,5,260.0,11,3,16.0,15,10,9.0,2013,0.0
Jamee Jackson,714,39,577,277,332,160,2396.0,0,0,142.0,577,277,17.5,2013,0.0
Darien Johnson,679,340,577,204,286,220,2422.0,148,51,194.0,429,153,17.9,2013,0.0
Garvey Young,695,131,595,229,255,176,2565.0,201,61,160.0,394,168,16.8,2013,0.0
Tariq Carey,7,0,8,1,4,4,25.0,3,1,4.0,5,0,26.7,2013,0.0
Blake Smith,806,199,764,289,188,128,2580.0,308,100,180.0,456,189,19.6,2013,0.0
Matt Murphy,8,3,5,2,4,4,33.0,0,0,2.0,5,2,13.3,2013,0.0
Andre Malone,606,55,568,220,100,73,1773.0,291,93,59.0,277,127,19.7,2013,0.0
Nikola Malesevic,895,121,737,310,240,158,2377.0,321,117,136.0,416,193,21.4,2013,0.0
Jordan Hare,141,10,106,62,38,17,529.0,0,0,31.0,106,62,16.1,2013,0.0
Ryan Brooks,114,20,115,51,36,12,814.0,0,0,33.0,115,51,10.6,2013,0.0
Alwayne Bigby,271,82,238,98,120,64,1755.0,54,11,114.0,184,87,12.7,2013,0.0
Tamir Jackson,1684,387,1453,573,616,422,4118.0,423,116,342.0,1030,457,26.9,2013,0.0
Elliot Franshaw,8,0,7,2,6,4,76.0,1,0,3.0,6,2,9.6,2013,0.0
Darien Brothers,1274,146,958,399,321,271,2926.0,511,205,129.0,447,194,23.2,2013,0.0
Greg Robbins,386,130,328,151,71,36,1693.0,143,48,85.0,185,103,14.4,2013,0.0
Jonathan Benjamin,5,1,6,2,0,0,22.0,4,1,0.0,2,1,14.9,2013,0.0
Jonathan Thompson,952,372,664,309,315,227,3473.0,272,107,209.0,392,202,15.2,2013,0.0
Nurideen Lindsey,363,78,293,130,144,87,1004.0,72,16,139.0,221,114,25.9,2013,0.0
Dera Nd-Ezuma,170,20,149,73,42,24,753.0,1,0,50.0,148,73,15.1,2013,0.0
Derrick Stewart,26,1,17,8,10,10,69.0,0,0,4.0,17,8,19.7,2013,0.0
Jamal Nwaniemeka,11,1,17,4,2,2,41.0,8,1,0.0,9,3,23.1,2013,0.0
Myles Melville,2,0,1,1,0,0,7.0,0,0,0.0,1,1,7.5,2013,0.0
Russell Johnson,1208,192,1060,424,324,227,3300.0,395,133,267.0,665,291,22.9,2013,0.0
Velton Jones,1588,551,1261,469,688,495,3686.0,484,155,347.0,777,314,26.8,2013,0.0
Vaughn Morgan,34,3,39,15,15,4,216.0,0,0,17.0,39,15,15.2,2013,0.0
Shane Sweigart,2,1,6,1,0,0,24.0,2,0,4.0,4,1,21.5,2013,0.0
Treadwell Lewis,10,2,31,3,6,2,46.0,13,2,5.0,18,1,43.4,2013,0.0
Dane Miller,1042,313,898,400,326,197,3553.0,169,45,273.0,729,355,19.2,2013,0.0
Austin Johnson,533,62,413,214,175,105,1913.0,0,0,131.0,413,214,17.0,2013,0.0
Logan Kelley,0,1,0,0,0,0,3.0,0,0,0.0,0,0,0.0,2013,0.0
John Dickson,1313,96,1077,456,456,329,2933.0,241,72,199.0,836,384,26.9,2013,0.0
Konner Veteto,715,16,529,263,319,189,1807.0,3,0,141.0,526,263,25.5,2013,0.0
Joe Eberhard,514,79,395,177,111,84,1947.0,180,76,69.0,215,101,14.1,2013,0.0
Jackson Carbajal,463,50,413,172,110,62,1307.0,196,57,81.0,217,115,22.1,2013,0.0
Julian Demalleville,56,52,51,17,19,12,554.0,36,10,32.0,15,7,8.9,2013,0.0
Shane Gibson,2079,203,1562,728,395,337,3707.0,691,286,330.0,871,442,28.4,2013,0.0
Nick Greenbacker,409,79,405,171,65,35,1862.0,103,32,108.0,302,139,14.6,2013,0.0
Justin Swidowski,421,17,325,168,84,67,965.0,49,18,52.0,276,150,22.0,2013,0.0
De'Aires Tate,101,5,85,45,18,11,325.0,0,0,27.0,85,45,18.5,2013,0.0
Femi Akinpetide,222,21,211,83,97,55,999.0,4,1,63.0,207,82,16.9,2013,0.0
Anthony Ervin,798,144,715,284,178,138,2593.0,278,92,148.0,437,192,19.6,2013,0.0
Tony Peters,207,51,206,89,65,28,1095.0,9,1,87.0,197,88,15.8,2013,0.0
Kameron Ritter,253,106,201,90,102,51,1460.0,68,22,87.0,133,68,12.4,2013,0.0
Stanley Storm,67,8,53,24,30,19,378.0,0,0,23.0,53,24,12.9,2013,0.0
Zachary Vigneault,4,1,4,1,2,1,16.0,4,1,2.0,0,0,23.6,2013,0.0
Carl Jones,1845,341,1409,570,662,492,3928.0,605,213,266.0,804,357,26.9,2013,0.0
C.J. Aiken,939,89,692,346,249,180,2958.0,236,67,108.0,456,279,16.7,2013,0.0
Taylor Trevisan,27,3,15,9,10,6,38.0,7,3,3.0,8,6,32.2,2013,0.0
Christopher Coyne,5,2,3,2,0,0,12.0,1,1,0.0,2,1,13.5,2013,0.0
Cody Ellis,1062,99,896,329,272,210,2675.0,580,194,107.0,316,135,23.1,2013,0.0
Kwamain Mitchell,1575,420,1257,547,405,281,3939.0,567,200,280.0,690,347,24.7,2013,0.0
Cory Remekun,400,55,312,158,158,84,1847.0,0,0,121.0,312,158,15.0,2013,0.0
Sean Duff,4,0,3,1,4,2,11.0,1,0,2.0,2,1,34.1,2013,0.0
Matthew Dellavedova,1933,768,1423,590,541,465,4944.0,761,288,342.0,662,302,21.2,2013,1.0
Mitchell Young,878,76,630,350,269,171,2251.0,28,7,138.0,602,343,20.6,2013,0.0
Jorden Page,637,175,515,211,128,104,2085.0,319,111,126.0,196,100,17.5,2013,0.0
Kyle Rowley,255,34,209,102,104,51,958.0,0,0,92.0,209,102,19.3,2013,0.0
Zach Sanchez,3,0,5,1,0,0,23.0,5,1,2.0,0,0,15.9,2013,0.0
Yvon Raymond,760,184,631,285,303,173,2558.0,62,17,200.0,569,268,20.0,2013,0.0
Darius Conley,975,76,829,383,354,209,2888.0,2,0,216.0,827,383,22.0,2013,0.0
Blaise Ffrench,405,257,419,155,161,86,2013.0,42,9,190.0,377,146,18.2,2013,0.0
Chris Prescott,618,97,627,206,114,83,2025.0,401,123,142.0,226,83,21.2,2013,0.0
Patrick Jackson,232,28,236,85,95,53,1074.0,58,9,64.0,178,76,16.4,2013,0.0
Karee Ferguson,109,10,121,45,24,11,446.0,26,8,30.0,95,37,19.3,2013,0.0
Jose Irizarry,2,0,1,1,0,0,9.0,0,0,0.0,1,1,6.0,2013,0.0
Darius Gatson,499,254,445,152,173,119,1983.0,220,76,138.0,225,76,17.5,2013,0.0
Jeremy McKay,120,35,139,42,16,10,427.0,96,26,17.0,43,16,19.6,2013,0.0
Aaron Harwell,321,214,301,108,149,89,1736.0,71,16,164.0,230,92,15.9,2013,0.0
Erik Williams,92,6,97,37,22,13,321.0,24,5,14.0,73,32,19.4,2013,0.0
Will Cook,372,59,321,126,110,72,1498.0,173,48,75.0,148,78,16.8,2013,0.0
Jaylen Beckham,23,12,26,7,14,8,129.0,5,1,21.0,21,6,24.0,2013,0.0
Levi Barnes,15,2,20,6,0,0,104.0,13,3,4.0,7,3,12.9,2013,0.0
Mike Fitzpatrick,0,0,0,0,0,0,5.0,0,0,0.0,0,0,0.0,2013,0.0
Gregg Wooten,242,56,209,85,105,58,763.0,55,14,75.0,154,71,25.8,2013,0.0
Jamaal Franklin,1162,162,849,362,436,340,2198.0,325,98,218.0,524,264,29.9,2013,1.0
Chase Tapley,1526,303,1247,573,206,157,3813.0,565,223,182.0,682,350,20.7,2013,0.0
James Rahon,1121,116,991,401,185,131,3375.0,513,188,102.0,478,213,16.7,2013,0.0
Deshawn Stephens,383,19,270,162,130,59,1374.0,0,0,57.0,270,162,14.6,2013,0.0
LaBradford Franklin,158,83,112,47,64,54,593.0,39,10,67.0,73,37,18.3,2013,0.0
Aaron Douglass,9,0,5,3,2,1,15.0,4,2,1.0,1,1,23.9,2013,0.0
Narbeh Ebrahimian,11,4,16,4,7,3,76.0,5,0,0.0,11,4,13.1,2013,0.0
Jeremy Castleberry,7,0,9,3,0,0,20.0,7,1,2.0,2,2,28.4,2013,0.0
Ken Rancifer,953,101,794,346,218,141,2636.0,328,120,180.0,466,226,21.9,2013,0.0
Chris Manresa,885,88,690,347,352,188,2621.0,12,3,139.0,678,344,20.4,2013,0.0
Cameron Miles,354,140,353,122,111,80,1586.0,104,30,123.0,249,92,17.8,2013,0.0
John Sinis,261,26,221,93,51,33,970.0,127,42,58.0,94,51,16.6,2013,0.0
Keith Stackhouse,25,6,28,10,5,2,131.0,15,3,12.0,13,7,17.2,2013,0.0
Trey Guidry,20,1,17,6,14,7,67.0,5,1,4.0,12,5,22.0,2013,0.0
De'End Parker,347,59,279,115,125,88,825.0,66,29,35.0,213,86,24.2,2013,0.0
Coltin Gelb,0,0,0,0,0,0,2.0,0,0,0.0,0,0,0.0,2013,0.0
James Kinney,964,150,854,348,152,117,1863.0,416,151,158.0,438,197,29.6,2013,0.0
LaVanne Pennington,288,23,306,103,75,49,782.0,127,33,58.0,179,70,25.8,2013,0.0
Louis Garrett,172,22,170,60,42,30,512.0,76,22,34.0,94,38,21.6,2013,0.0
Xavier Jones,123,41,130,42,62,37,485.0,13,2,35.0,117,40,19.8,2013,0.0
Stephon Smith,197,19,195,78,67,41,906.0,0,0,50.0,195,78,15.5,2013,0.0
Aalim Moor,75,29,73,32,3,1,359.0,24,10,21.0,49,22,13.3,2013,0.0
Nick Grieves,48,4,46,16,2,1,94.0,44,15,4.0,2,1,27.1,2013,0.0
Kevin Foster,2423,464,1975,771,577,450,4212.0,1184,431,401.0,791,340,33.0,2013,0.0
Marc Trasolini,1699,100,1139,628,517,383,3824.0,182,60,215.0,957,568,22.9,2013,0.0
Raymond Cowels,1090,113,949,363,181,145,3157.0,584,219,131.0,365,144,18.6,2013,0.0
Niyi Harrison,753,24,537,275,340,203,2192.0,0,0,165.0,537,275,19.9,2013,0.0
Kyle Perricone,23,4,21,8,2,1,69.0,15,6,3.0,6,2,18.1,2013,0.0
Rashad Hassan,1386,94,1008,561,404,253,2915.0,36,11,241.0,972,550,25.9,2013,0.0
Preston Blackmon,1250,541,1221,468,198,155,3690.0,509,159,387.0,712,309,24.4,2013,0.0
Arnold Louis,909,81,716,350,365,199,2696.0,41,10,201.0,675,340,21.2,2013,0.0
Cedric Smith,503,129,444,188,255,124,2520.0,33,3,154.0,411,185,15.0,2013,0.0
Robert Burger,58,13,63,21,15,7,437.0,34,9,28.0,29,12,12.1,2013,0.0
Christopher Spears,138,9,121,58,40,21,799.0,1,1,52.0,120,57,12.8,2013,0.0
Chad Rasmussen,537,100,517,180,53,39,1759.0,399,138,99.0,118,42,16.9,2013,0.0
Prince Obasi,377,203,327,131,123,81,1440.0,108,34,118.0,219,97,16.4,2013,0.0
Louis Green,291,13,226,123,69,45,979.0,1,0,71.0,225,123,15.9,2013,0.0
Allen Tate,148,34,167,61,40,22,695.0,29,4,56.0,138,57,16.2,2013,0.0
T.J. Diop,83,14,78,33,27,17,356.0,2,0,28.0,76,33,15.4,2013,0.0
Kyle Smyth,930,194,740,308,138,104,3191.0,552,210,89.0,188,98,14.2,2013,0.0
Connor Laverty,2,0,1,1,0,0,5.0,0,0,1.0,1,1,21.3,2013,0.0
O.D. Anosike,1259,102,970,493,530,272,3621.0,2,1,231.0,968,492,20.6,2013,0.0
Rakeem Brookins,477,165,475,163,134,102,1545.0,174,49,147.0,301,114,22.6,2013,0.0
Trenity Burdine,271,32,212,92,88,66,1022.0,64,21,51.0,148,71,15.4,2013,0.0
Davis Martens,163,15,166,62,70,37,647.0,17,2,44.0,149,60,19.2,2013,0.0
Chris Leppanen,15,12,12,7,2,0,95.0,1,1,10.0,11,6,12.9,2013,0.0
Marcus Hopper,10,0,18,4,3,2,93.0,6,0,5.0,12,4,13.7,2013,0.0
Javier Carter,652,52,525,252,207,147,2294.0,4,1,125.0,521,251,16.1,2013,0.0
Freddie Goldstein,489,120,462,161,82,63,1460.0,303,104,152.0,159,57,22.0,2013,0.0
Xavier Roberson,332,54,252,109,70,51,829.0,149,63,58.0,103,46,20.9,2013,0.0
Dre Conner,307,133,204,74,177,131,1329.0,88,28,85.0,116,46,14.2,2013,0.0
Trey Anderson,262,119,258,88,101,69,1164.0,61,17,130.0,197,71,18.5,2013,0.0
Wendell Wright,109,55,88,39,61,31,958.0,4,0,55.0,84,39,8.6,2013,0.0
Gregoryshon Magee,6,0,6,2,2,2,17.0,0,0,7.0,6,2,40.0,2013,0.0
Khalif Toombs,1143,508,1000,363,402,297,3844.0,393,120,309.0,607,243,19.3,2013,0.0
Phillip Henry,21,2,27,7,7,4,101.0,14,3,2.0,13,4,16.1,2013,0.0
Randall Black,19,3,31,6,8,4,110.0,16,3,10.0,15,3,20.5,2013,0.0
Terrance Linton,4,1,10,1,4,1,42.0,7,1,5.0,3,0,20.3,2013,0.0
Joshua Benjamin,0,2,2,0,0,0,25.0,0,0,4.0,2,0,12.1,2013,0.0
Omari Bennett,0,0,0,0,0,0,4.0,0,0,0.0,0,0,0.0,2013,0.0
Rob Elam,51,25,61,19,23,13,513.0,1,0,19.0,60,19,8.7,2013,0.0
Bruce Haynes,20,3,15,6,4,3,44.0,14,5,1.0,1,1,20.1,2013,0.0
Jeremy Ford,3,2,3,1,2,1,25.0,1,0,1.0,2,1,9.9,2013,0.0
Lakeem Jackson,766,227,675,343,215,75,3001.0,25,5,177.0,650,338,15.7,2013,0.0
Damien Leonard,324,30,354,110,42,28,1066.0,246,76,65.0,108,34,21.5,2013,0.0
LaShay Page,656,51,590,216,131,102,1923.0,355,122,73.0,235,94,19.2,2013,0.0
Shane Phillips,5,4,8,2,2,1,33.0,5,0,4.0,3,2,18.2,2013,0.0
Nate Wolters,2352,668,1716,773,807,648,4204.0,462,158,280.0,1254,615,29.3,2013,1.0
Tony Fiegen,844,106,673,341,237,161,2691.0,1,1,119.0,672,340,17.6,2013,0.0
Taevaunn Prince,329,23,223,105,159,109,888.0,37,10,60.0,186,95,21.5,2013,0.0
Joey Feilmeier,3,1,5,1,0,0,17.0,3,1,2.0,2,0,22.5,2013,0.0
Juevol Myles,502,98,373,148,175,150,1060.0,160,56,67.0,213,92,26.1,2013,0.0
Steve Tecker,495,116,393,194,96,72,1703.0,95,35,81.0,298,159,15.4,2013,0.0
Jordan Boots,536,146,485,186,51,37,1997.0,365,127,90.0,120,59,15.0,2013,0.0
Jared Bartling,6,7,14,1,14,4,162.0,2,0,14.0,12,1,10.8,2013,0.0
Toarlyn Fitzpatrick,869,89,778,316,191,126,3156.0,316,111,178.0,462,205,18.4,2013,0.0
Jawanza Poland,760,99,700,273,196,140,2132.0,276,74,149.0,424,199,24.5,2013,0.0
Kore White,558,54,520,231,136,75,1826.0,60,21,118.0,460,210,20.4,2013,0.0
Mike McCloskey,11,6,11,4,2,1,65.0,7,2,5.0,4,2,14.8,2013,0.0
Mike Dakkak,0,0,0,0,0,0,1.0,0,0,0.0,0,0,0.0,2013,0.0
Corey Wilford,616,90,495,217,92,68,1288.0,280,114,75.0,215,103,24.4,2013,0.0
Marland Smith,1423,248,1201,476,292,220,3671.0,697,251,198.0,504,225,21.5,2013,0.0
A.J. Jones,284,53,229,105,72,44,666.0,70,30,68.0,159,75,25.4,2013,0.0
Nick Niernczyk,541,107,474,188,68,60,1560.0,282,105,56.0,192,83,18.5,2013,0.0
Jared White,57,22,35,17,22,19,207.0,5,4,25.0,30,13,17.4,2013,0.0
Colin Ferguson,12,0,13,6,0,0,63.0,0,0,2.0,13,6,12.2,2013,0.0
Jacob Tolbert,10,3,12,5,0,0,178.0,1,0,8.0,11,5,5.7,2013,0.0
Michael Porter,164,25,127,66,42,27,580.0,17,5,31.0,110,61,15.9,2013,0.0
Matt Floyd,2,0,3,1,0,0,7.0,0,0,0.0,3,1,21.9,2013,0.0
Brandon Fortenberry,1348,421,1057,444,407,292,3639.0,470,168,254.0,587,276,22.3,2013,0.0
Roosevelt Johnson,825,67,697,307,333,209,1930.0,9,2,195.0,688,305,28.3,2013,0.0
Todd Nelson,331,34,290,107,65,39,967.0,221,78,52.0,69,29,20.2,2013,0.0
Jamaal James,18,3,13,5,12,8,187.0,0,0,10.0,13,5,8.1,2013,0.0
Jan Petrovcic,74,23,84,30,35,13,605.0,8,1,43.0,76,29,12.4,2013,0.0
Eric Wise,1662,236,1303,587,615,450,3538.0,111,38,224.0,1192,549,26.9,2013,0.0
Jio Fontan,1056,415,943,350,408,267,2960.0,272,89,266.0,671,261,24.4,2013,0.0
Dewayne Dedmon,360,25,294,153,88,54,1156.0,4,0,78.0,290,153,19.5,2013,1.0
Aaron Fuller,741,46,593,276,253,161,2278.0,104,28,125.0,489,248,20.9,2013,0.0
Ari Stewart,542,45,541,201,75,57,1471.0,268,83,125.0,273,118,23.5,2013,0.0
James Blasczyk,138,17,132,60,33,18,781.0,0,0,35.0,132,60,13.2,2013,0.0
Renaldo Woolridge,320,42,329,118,56,31,1166.0,182,53,56.0,147,65,17.5,2013,0.0
Greg Allen,133,29,143,45,17,12,604.0,106,31,23.0,37,14,16.6,2013,0.0
Tyler Sugiyama,0,0,1,0,1,0,14.0,0,0,1.0,1,0,9.5,2013,0.0
Jerome Jones,699,44,628,261,133,88,1640.0,248,89,127.0,380,172,26.1,2013,0.0
Mark Yelovich,1467,131,1192,526,423,309,2184.0,292,106,140.0,900,420,28.5,2013,0.0
Derian Shaffer,360,24,278,141,143,78,1231.0,0,0,86.0,278,141,18.4,2013,0.0
Reggie Reed,67,114,62,24,32,18,731.0,8,1,74.0,54,23,10.8,2013,0.0
Charles Joy,59,30,70,24,19,9,362.0,19,2,34.0,51,22,16.3,2013,0.0
Michael Birts,39,2,25,11,23,17,179.0,1,0,11.0,24,11,13.6,2013,0.0
Zeke Schneider,43,5,34,16,16,11,507.0,0,0,24.0,34,16,6.7,2013,0.0
Kyle Heck,5,2,3,1,2,2,40.0,2,1,1.0,1,0,6.5,2013,0.0
Jeff Early,656,58,533,259,186,126,1612.0,58,12,107.0,475,247,23.9,2013,0.0
Kendal Brown-Surles,721,281,623,238,160,119,2882.0,380,126,193.0,243,112,16.5,2013,0.0
T.J. Lindsay,336,78,314,123,46,29,1287.0,167,61,64.0,147,62,16.3,2013,0.0
Josh Swan,174,36,160,59,97,52,771.0,27,4,52.0,133,55,17.7,2013,0.0
Tony Bryer,32,2,29,15,2,2,161.0,1,0,7.0,28,15,12.3,2013,0.0
Diamond Taylor,180,25,174,61,54,35,733.0,73,23,46.0,101,38,17.6,2013,0.0
Ryan Bonifield,1,0,0,0,2,1,6.0,0,0,0.0,0,0,8.6,2013,0.0
Calvin Belts,0,0,2,0,2,0,9.0,0,0,0.0,2,0,17.8,2013,0.0
London Giles,425,79,357,136,108,86,1534.0,196,67,105.0,161,69,18.8,2013,0.0
Marcus Holyfield,0,0,0,0,0,0,2.0,0,0,0.0,0,0,0.0,2013,0.0
Garrett Wilson,0,0,2,0,0,0,8.0,1,0,1.0,1,0,20.1,2013,0.0
Dwayne Davis,545,87,395,193,127,100,1026.0,143,59,114.0,252,134,28.2,2013,0.0
Jonathan Mills,667,77,486,246,278,175,1862.0,0,0,125.0,486,246,20.4,2013,0.0
Rashard McGill,378,51,348,130,131,87,1658.0,97,31,88.0,251,99,15.4,2013,0.0
Christian Robbins,1,0,1,0,2,1,17.0,0,0,0.0,1,0,5.8,2013,0.0
Jackson Stevenett,1273,144,954,463,395,312,2959.0,108,35,165.0,846,428,22.6,2013,0.0
Damon Heuir,942,260,810,308,311,221,2591.0,318,105,226.0,492,203,23.3,2013,0.0
Wade Collie,289,73,249,106,72,48,1017.0,84,29,76.0,165,77,18.1,2013,0.0
Julian Scott,106,10,89,42,37,22,287.0,0,0,35.0,89,42,25.2,2013,0.0
Tyson Koehler,188,43,161,76,51,36,802.0,4,0,40.0,157,76,14.3,2013,0.0
Zach Ghormley,7,0,11,2,2,2,21.0,8,1,1.0,3,1,30.3,2013,0.0
John Renfro,4,0,2,1,3,2,9.0,1,0,0.0,1,1,18.7,2013,0.0
Matt Gardner,7,1,6,3,2,1,19.0,2,0,3.0,4,3,27.6,2013,0.0
Derick Beltran,937,100,760,302,269,214,2114.0,361,119,124.0,399,183,25.8,2013,0.0
Jameel Grace,850,435,761,272,344,221,3079.0,291,85,298.0,470,187,20.9,2013,0.0
Brandon Moore,335,51,274,124,116,83,1769.0,17,4,94.0,257,120,12.5,2013,0.0
Madut Bol,392,16,316,135,137,95,1453.0,74,27,65.0,242,108,15.9,2013,0.0
Aaron Alston,21,2,14,8,13,5,99.0,1,0,8.0,13,8,15.4,2013,0.0
Thomas Marshall,50,28,38,15,27,20,402.0,2,0,30.0,36,15,10.8,2013,0.0
Demitrius Conger,1206,249,824,390,412,320,3510.0,297,106,254.0,527,284,18.9,2013,0.0
Eric Mosley,644,119,494,204,139,115,1293.0,308,121,95.0,186,83,26.2,2013,0.0
Michael Davenport,818,204,749,311,163,124,2581.0,225,72,178.0,524,239,20.4,2013,0.0
Akeem Johnson,1009,81,717,377,403,255,2560.0,0,0,161.0,717,377,20.9,2013,0.0
Travis Nichols,705,17,557,250,117,99,1397.0,287,106,71.0,270,144,24.2,2013,0.0
Dre Calloway,376,200,340,137,204,99,1419.0,34,3,124.0,306,134,19.6,2013,0.0
Milos Trivic,40,6,34,14,22,7,186.0,11,5,14.0,23,9,15.6,2013,0.0
Mike Nierva,3,1,2,1,0,0,5.0,1,1,1.0,1,0,29.8,2013,0.0
Amir Garrett,341,51,279,124,157,86,1254.0,30,7,73.0,249,117,17.1,2013,0.0
Sam Sealy,0,0,0,0,2,0,9.0,0,0,0.0,0,0,5.3,2013,0.0
Jamal White,10,1,15,3,2,2,32.0,13,2,1.0,2,1,26.5,2013,0.0
Andy Brown,216,37,176,86,58,30,802.0,40,14,38.0,136,72,15.1,2013,0.0
Gabriel Harris,184,50,183,61,66,47,825.0,51,15,53.0,132,46,16.5,2013,0.0
Taylor Smith,796,65,488,340,272,116,1697.0,0,0,99.0,488,340,22.9,2013,0.0
Antonio Bostic,896,184,838,344,173,131,2755.0,251,77,166.0,587,267,21.3,2013,0.0
Hal Bateman,363,263,305,125,180,107,1431.0,29,6,142.0,276,119,20.2,2013,0.0
Ice Asortse,59,3,37,23,23,13,166.0,0,0,20.0,37,23,22.2,2013,0.0
Jared Harrison,26,11,26,6,10,8,99.0,18,6,11.0,8,0,22.9,2013,0.0
Rex Baxter,24,2,24,9,8,5,60.0,10,1,5.0,14,8,29.6,2013,0.0
Joe Bright,58,16,52,16,36,25,382.0,9,1,21.0,43,15,12.8,2013,0.0
Danilo Toskovic,10,4,10,5,0,0,33.0,3,0,1.0,7,5,18.1,2013,0.0
Adam Perez,8,3,10,3,6,2,68.0,6,0,3.0,4,3,12.6,2013,0.0
Adam Pegg,1105,93,865,441,257,183,2519.0,111,40,179.0,754,401,24.6,2013,0.0
Joel Naburgs,963,289,783,297,247,189,3138.0,520,180,221.0,263,117,17.9,2013,0.0
Liam McInerney,318,90,288,116,92,56,1988.0,95,30,100.0,193,86,10.9,2013,0.0
Dennis Diaz,127,41,125,44,18,12,578.0,88,27,58.0,37,17,16.3,2013,0.0
Logan Irwin,41,20,15,11,16,14,152.0,7,5,13.0,8,6,11.8,2013,0.0
J.R. Weston,77,21,81,26,21,10,343.0,57,15,21.0,24,11,16.5,2013,0.0
Tommy Brenton,971,402,631,315,506,321,3798.0,77,20,223.0,554,295,15.5,2013,0.0
Marcus Rouse,654,105,606,243,88,73,2179.0,278,95,76.0,328,148,17.5,2013,0.0
Ron Bracey,189,12,178,68,41,31,516.0,75,22,35.0,103,46,23.8,2013,0.0
Leonard Hayes,347,56,342,120,41,31,1300.0,225,76,39.0,117,44,16.3,2013,0.0
Brandon Triche,1564,438,1242,536,425,319,3938.0,520,173,303.0,722,363,22.4,2013,0.0
Michael Carter-Williams,544,345,452,180,209,142,1678.0,137,42,154.0,315,138,21.3,2013,1.0
James Southerland,880,68,724,325,104,77,2089.0,413,153,66.0,311,172,20.4,2013,1.0
Noel Jones,2,0,2,1,0,0,8.0,0,0,0.0,2,1,12.6,2013,0.0
Matt Lyde-Cajuste,9,2,12,3,4,3,54.0,3,0,4.0,9,3,16.7,2013,0.0
Griffin Hoffman,9,1,12,3,4,1,44.0,10,2,5.0,2,1,21.7,2013,0.0
Khalif Wyatt,1576,295,1083,482,525,435,2881.0,495,177,227.0,588,305,27.8,2013,0.0
Scootie Randall,734,116,627,265,120,87,2228.0,350,117,76.0,277,148,17.7,2013,0.0
Jake O'Brien,1337,63,1102,466,278,209,3296.0,513,196,155.0,589,270,22.5,2013,0.0
Rahlir Jefferson,914,266,724,353,348,208,3588.0,3,0,187.0,721,353,15.6,2013,0.0
T.J. DiLeo,288,122,242,101,92,56,1768.0,111,30,62.0,131,71,10.0,2013,0.0
Jeremy Washington,348,102,331,138,89,69,1355.0,28,3,63.0,303,135,16.1,2013,0.0
B.J. McLaughlin,113,22,109,43,33,22,455.0,22,5,33.0,87,38,17.0,2013,0.0
Kellen Thornton,963,64,736,384,238,158,2239.0,119,37,145.0,617,347,22.9,2013,0.0
Robert Covington,1748,145,1309,623,399,320,3536.0,431,182,275.0,878,441,25.5,2013,1.0
Jordan Cyphers,753,59,569,215,246,200,1786.0,351,123,102.0,218,92,22.5,2013,0.0
DeShawn Dockery,242,141,237,87,99,42,1494.0,95,26,122.0,142,61,13.6,2013,0.0
Tashon Fredrick,241,34,215,82,91,64,1250.0,46,13,65.0,169,69,13.0,2013,0.0
Kharon Butcher,65,24,60,20,24,13,360.0,44,12,23.0,16,8,13.3,2013,0.0
Devante McClung,11,6,11,4,8,3,104.0,2,0,10.0,9,4,11.8,2013,0.0
Abraham Millsap,4,1,4,2,0,0,30.0,0,0,6.0,4,2,16.5,2013,0.0
Jud Dillard,1729,156,1219,605,618,470,3442.0,162,49,258.0,1057,556,25.8,2013,0.0
Terrell Barnes,393,117,370,153,239,87,2496.0,1,0,129.0,369,153,12.2,2013,0.0
Ryon Riggins,37,9,37,18,4,1,189.0,1,0,13.0,36,18,14.1,2013,0.0
Skylar McBee,611,78,537,182,100,86,2409.0,465,161,70.0,72,21,14.0,2013,0.0
Kenny Hall,506,30,361,198,173,110,1717.0,6,0,114.0,355,198,16.7,2013,0.0
Yemi Makenjuola,111,7,86,42,45,27,457.0,0,0,23.0,86,42,15.0,2013,0.0
Rob Murphy,33,1,12,9,17,15,54.0,0,0,9.0,12,9,26.2,2013,0.0
William Nelson,380,27,349,131,121,82,827.0,130,36,80.0,219,95,31.8,2013,0.0
Kennon Dvorak,44,11,38,13,18,9,238.0,28,9,11.0,10,4,12.8,2013,0.0
Ted Wang,35,2,37,13,19,9,246.0,1,0,12.0,36,13,12.3,2013,0.0
Elston Turner,1310,207,1109,456,243,188,3194.0,561,210,167.0,548,246,24.3,2013,1.0
Ray Turner,776,21,561,300,289,176,2068.0,1,0,131.0,560,300,21.7,2013,0.0
Andrew Young,91,8,90,32,38,27,419.0,1,0,24.0,89,32,17.4,2013,0.0
Jarod Jahns,51,12,44,18,20,14,476.0,8,1,15.0,36,17,7.9,2013,0.0
Grant Jolly,6,0,5,2,6,2,12.0,0,0,0.0,5,2,36.0,2013,0.0
Kevin Butler,997,126,784,348,337,229,3096.0,217,72,165.0,567,276,19.0,2013,0.0
Karol Gruszecki,358,41,313,121,63,40,973.0,194,76,72.0,119,45,21.2,2013,0.0
Jordan Reves,887,85,637,332,350,223,2717.0,0,0,210.0,637,332,18.1,2013,0.0
Cameron Catlett,708,291,609,269,291,159,2415.0,39,11,220.0,570,258,19.4,2013,0.0
Deon Rodgers,11,3,9,4,6,3,84.0,0,0,9.0,9,4,12.5,2013,0.0
Garlon Green,1138,103,951,399,285,218,3278.0,338,122,184.0,613,277,20.4,2013,0.0
Adrick McKinney,415,51,352,153,222,109,1346.0,1,0,103.0,351,153,22.1,2013,0.0
Connell Crossland,278,44,220,108,105,55,1109.0,19,7,63.0,201,101,16.2,2013,0.0
Nate Butler,240,79,247,84,83,48,1381.0,68,24,80.0,179,60,14.2,2013,0.0
Chris Zurcher,26,14,22,9,4,4,190.0,12,4,11.0,10,5,9.9,2013,0.0
Konner Tucker,649,70,547,207,139,111,1810.0,349,124,98.0,198,83,21.5,2013,0.0
Jacques Streeter,1180,600,923,368,381,280,4283.0,441,164,251.0,482,204,16.7,2013,0.0
Brandon Provost,1252,190,856,371,345,277,3096.0,521,233,191.0,335,138,20.5,2013,0.0
Aaron Urbanus,1259,306,1039,409,272,203,3482.0,626,238,261.0,413,171,21.5,2013,0.0
Jesus M. Delgado,480,105,391,170,182,123,1589.0,74,17,107.0,317,153,19.5,2013,0.0
Ruben Cabrera,587,39,468,212,187,119,1524.0,125,44,130.0,343,168,23.6,2013,0.0
DeMarko Nash,39,42,57,12,9,6,312.0,30,9,35.0,27,3,16.3,2013,0.0
Noe Espericueta,6,0,6,3,0,0,10.0,0,0,0.0,6,3,31.7,2013,0.0
Kannon Burrage,984,86,796,319,316,245,1909.0,284,101,132.0,512,218,29.4,2013,0.0
Michael Hale,774,214,598,239,257,193,2013.0,283,103,140.0,315,136,22.2,2013,0.0
Larry Wilkins,272,45,196,106,125,60,1356.0,0,0,66.0,196,106,12.2,2013,0.0
A.J. Price,12,7,12,4,0,0,150.0,10,4,17.0,2,0,10.1,2013,0.0
Tank Mayberry,10,4,8,3,11,4,74.0,0,0,10.0,8,3,16.4,2013,0.0
Jeremy Hines,6,1,4,2,0,0,14.0,4,2,1.0,0,0,18.7,2013,0.0
Dante Willis,0,0,0,0,0,0,5.0,0,0,0.0,0,0,0.0,2013,0.0
Omar Strong,965,118,774,299,170,145,2114.0,591,222,136.0,183,77,24.5,2013,0.0
Fred Sturdivant,645,36,458,256,268,130,1686.0,11,3,107.0,447,253,21.4,2013,0.0
Kyrie Sutton,557,28,456,233,180,91,1720.0,1,0,112.0,455,233,20.4,2013,0.0
Dexter Ellington,262,87,248,87,73,55,1066.0,118,33,87.0,130,54,18.0,2013,0.0
Billy Rosenberg,16,1,7,5,8,6,40.0,0,0,1.0,7,5,15.5,2013,0.0
Ethan Blackwell,3,3,5,1,0,0,48.0,2,1,6.0,3,0,12.1,2013,0.0
Matt Staff,895,103,724,348,165,133,1993.0,186,66,161.0,538,282,22.9,2013,0.0
Vonn Jones,406,207,342,130,135,92,1367.0,168,54,107.0,174,76,17.8,2013,0.0
Deonte' Jones,162,18,123,58,8,7,500.0,86,39,9.0,37,19,13.3,2013,0.0
Basil Brown,112,22,90,32,61,42,405.0,31,6,18.0,59,26,16.2,2013,0.0
Nick Hinton,74,7,95,30,21,7,341.0,21,7,31.0,74,23,18.8,2013,0.0
Darius Richardson,188,28,207,68,14,11,606.0,140,41,28.0,67,27,19.5,2013,0.0
Justin Tanton,3,0,3,1,1,1,7.0,2,0,1.0,1,1,31.3,2013,0.0
Jeffrey Nwankwo,0,0,0,0,0,0,4.0,0,0,2.0,0,0,24.5,2013,0.0
Daylen Robinson,92,58,110,31,35,24,495.0,41,6,53.0,69,25,18.2,2013,0.0
Ty Nurse,339,81,265,104,77,68,1323.0,178,63,66.0,87,41,14.9,2013,0.0
Ioannis Papapetrou,281,41,222,96,96,56,826.0,92,33,59.0,130,63,20.1,2013,0.0
Myck Kabongo,487,237,345,138,249,178,1449.0,106,33,139.0,239,105,20.9,2013,0.0
Andrew Dick,8,0,5,3,4,1,35.0,2,1,2.0,3,2,12.3,2013,0.0
Dean Melchionni,3,1,9,1,0,0,34.0,7,1,2.0,2,0,15.5,2013,0.0
Dominique Buckley,691,209,560,219,145,122,2363.0,339,131,150.0,221,88,17.2,2013,0.0
Josh Lemons,28,24,38,10,10,6,382.0,16,2,17.0,22,8,8.2,2013,0.0
Richard Wonnell,80,12,57,29,44,22,829.0,1,0,26.0,56,29,6.6,2013,0.0
A.J. Mathew,21,13,23,7,5,3,235.0,11,4,6.0,12,3,7.0,2013,0.0
Brendon Schwiebert,3,0,1,1,0,0,13.0,1,1,1.0,0,0,8.1,2013,0.0
James Ewing,6,1,11,2,8,2,60.0,0,0,4.0,11,2,16.4,2013,0.0
Bilal Dixon,780,48,602,316,255,147,2656.0,3,1,140.0,599,315,15.4,2013,0.0
Kris Walden,308,144,350,112,66,47,1617.0,151,37,174.0,199,75,17.7,2013,0.0
Christian Collins,15,4,5,4,6,4,24.0,4,3,1.0,1,1,19.1,2013,0.0
Jeremy Schulkin,2,1,2,1,0,0,8.0,0,0,1.0,2,1,19.0,2013,0.0
Bryan Blackstone,2,4,3,1,0,0,29.0,1,0,11.0,2,1,24.8,2013,0.0
Emil Jones,645,154,590,251,151,108,1934.0,115,35,91.0,475,216,20.4,2013,0.0
Ray Chambers,406,15,332,168,92,70,1227.0,2,0,49.0,330,168,18.2,2013,0.0
Deonata Jethroe,188,12,193,68,30,22,570.0,108,30,21.0,85,38,21.9,2013,0.0
R.J. Scott,376,43,378,128,47,32,1056.0,259,88,77.0,119,40,22.9,2013,0.0
Justin Wright,304,36,249,98,82,63,715.0,134,45,47.0,115,53,23.1,2013,0.0
Breon Dixon,4,0,4,2,0,0,27.0,0,0,3.0,4,2,14.2,2013,0.0
Sidki Muwallif,0,1,1,0,0,0,10.0,0,0,0.0,1,0,5.5,2013,0.0
Jordan Callahan,1269,304,1094,437,247,178,3493.0,582,217,213.0,512,220,21.3,2013,0.0
Kendall Timmons,1327,249,1019,452,570,379,3433.0,133,44,247.0,886,408,23.4,2013,0.0
Josh Birchfield,6,2,9,3,0,0,64.0,0,0,4.0,9,3,10.4,2013,0.0
Scottie Haralson,1087,136,948,363,128,106,3131.0,677,255,120.0,271,108,18.7,2013,0.0
Kauri Black,606,119,441,232,253,142,2400.0,0,0,142.0,441,232,15.6,2013,0.0
Zeldric King,77,7,47,28,31,20,341.0,1,1,39.0,46,27,15.1,2013,0.0
Jamie Booker,2,1,3,1,0,0,27.0,0,0,0.0,3,1,5.8,2013,0.0
Shabazz Muhammad,572,27,456,202,180,128,987.0,106,40,51.0,350,162,29.8,2013,1.0
Larry Drew II,724,632,638,263,198,119,3150.0,230,79,289.0,408,184,15.2,2013,1.0
Kyisean Reed,554,47,342,206,211,142,1386.0,1,0,72.0,341,206,20.3,2013,0.0
Marvin Jean,148,56,139,50,24,17,684.0,92,31,44.0,47,19,15.5,2013,0.0
Quincy Bair,0,0,1,0,0,0,10.0,1,0,0.0,0,0,5.4,2013,0.0
Nick Thompson,391,156,329,154,91,61,1317.0,60,22,131.0,269,132,20.9,2013,0.0
Jason Johnson,302,63,251,111,78,46,889.0,95,34,47.0,156,77,20.6,2013,0.0
Alfonzo Hubbard,439,73,358,171,114,78,1124.0,62,19,72.0,296,152,22.5,2013,0.0
Antoine Hosley,179,25,185,70,28,16,536.0,74,23,38.0,111,47,23.9,2013,0.0
Zach Jones,158,21,138,65,46,28,595.0,3,0,22.0,135,65,16.2,2013,0.0
Will Sinclair,14,4,14,4,13,6,192.0,0,0,8.0,14,4,7.9,2013,0.0
Jarred DuBois,1537,332,1285,487,441,373,4002.0,506,190,299.0,779,297,23.0,2013,0.0
Jason Washburn,1073,63,780,441,236,187,2756.0,9,4,143.0,771,437,20.6,2013,0.0
Cedric Martin,341,119,288,105,106,64,1779.0,189,67,73.0,99,38,13.1,2013,0.0
Aaron Dotson,337,94,289,103,154,100,1464.0,112,31,107.0,177,72,16.7,2013,0.0
Alex Mortensen,11,2,13,2,13,7,87.0,2,0,13.0,11,2,21.1,2013,0.0
Ryan Osterloh,2,0,1,0,2,2,10.0,0,0,0.0,1,0,10.8,2013,0.0
Ryan Broekhoff,1591,246,1103,512,385,315,3642.0,618,252,186.0,485,260,21.5,2013,1.0
Kevin Van Wijk,1030,55,587,357,460,316,1963.0,7,0,185.0,580,357,27.1,2013,0.0
Matt Kenney,876,330,649,296,287,189,3137.0,293,95,212.0,356,201,16.8,2013,0.0
Erik Buggs,638,425,544,250,234,109,3428.0,132,29,316.0,412,221,14.1,2013,0.0
Will Bogan,548,147,438,175,85,68,2374.0,332,130,122.0,106,45,13.6,2013,0.0
Ben Boggs,355,53,286,111,107,88,1336.0,142,45,80.0,144,66,16.7,2013,0.0
Alex Rossi,24,2,15,9,0,0,62.0,12,6,5.0,3,3,17.3,2013,0.0
Kevin Bright,228,39,188,77,34,20,966.0,133,54,50.0,55,23,14.9,2013,0.0
Alex Gendelman,0,0,2,0,0,0,4.0,2,0,0.0,0,0,28.3,2013,0.0
Andris Kehris,0,0,0,0,0,0,3.0,0,0,0.0,0,0,0.0,2013,0.0
Trey Blue,599,90,544,204,142,101,1600.0,290,90,127.0,254,114,24.9,2013,0.0
Ben Crenca,278,11,207,105,113,68,895.0,0,0,57.0,207,105,18.7,2013,0.0
Troy Davine,3,0,2,1,0,0,16.0,2,1,2.0,0,0,13.8,2013,0.0
Mouphtaou Yarou,1068,72,784,384,421,299,2946.0,2,1,163.0,782,383,19.5,2013,0.0
Maurice Sutton,300,30,212,106,144,88,1189.0,1,0,81.0,211,106,15.2,2013,0.0
Troy Daniels,913,48,764,297,87,68,2109.0,650,251,73.0,114,46,20.9,2013,1.0
Darius Theus,760,460,636,277,252,166,3079.0,161,40,236.0,475,237,16.4,2013,0.0
David Hinton,37,5,38,16,16,5,281.0,0,0,11.0,38,16,10.1,2013,0.0
Stan Okoye,2146,212,1590,788,665,441,3471.0,387,129,305.0,1203,659,28.5,2013,0.0
Nick Gore,592,163,514,215,151,92,2068.0,260,70,114.0,254,145,15.1,2013,0.0
Dorian Albritton,98,14,113,35,8,3,277.0,92,25,17.0,21,10,22.2,2013,0.0
Joe Carr,122,80,111,44,40,28,669.0,38,6,65.0,73,38,12.7,2013,0.0
Gavin Stephenson,48,24,51,17,16,11,194.0,19,3,19.0,32,14,18.4,2013,0.0
Erick Green,1742,326,1356,592,520,418,3648.0,414,140,178.0,942,452,25.3,2013,1.0
Marquis Rankin,159,53,154,57,37,22,877.0,66,23,60.0,88,34,13.7,2013,0.0
Joey Racer,10,1,13,4,3,1,46.0,6,1,4.0,7,3,21.1,2013,0.0
Marcus Patrick,6,2,11,2,4,2,43.0,4,0,6.0,7,2,22.3,2013,0.0
Jontel Evans,595,419,594,247,158,88,3096.0,42,13,224.0,552,234,16.5,2013,0.0
Doug Browman,13,18,10,4,6,2,159.0,9,3,13.0,1,1,9.4,2013,0.0
Jonathon Williams,825,56,569,304,239,182,1554.0,111,35,126.0,458,269,25.9,2013,0.0
C.J. Harris,1613,282,1063,459,639,533,3970.0,417,162,299.0,646,297,21.3,2013,0.0
Spencer Jennings,9,1,6,3,7,3,15.0,3,0,2.0,3,3,38.6,2013,0.0
Brock Motum,1530,127,1089,565,433,312,3002.0,249,88,228.0,840,477,27.5,2013,0.0
Mychal Ladd,1067,178,885,380,260,170,3226.0,380,137,145.0,505,243,19.0,2013,0.0
Bryce Leavitt,13,12,8,2,10,9,113.0,1,0,7.0,7,2,9.6,2013,0.0
Keaton Hayenga,3,1,7,1,2,1,23.0,3,0,1.0,4,1,21.5,2013,0.0
Scott Suggs,792,100,640,278,112,92,2089.0,359,144,118.0,281,134,19.1,2013,0.0
Abdul Gaddy,907,469,807,345,222,147,3210.0,221,70,256.0,586,275,17.7,2013,0.0
Aziz N'Diaye,721,29,538,296,312,129,2354.0,1,0,149.0,537,296,17.2,2013,0.0
Dion Overstreet,2,0,0,0,2,2,4.0,0,0,1.0,0,0,24.8,2013,0.0
Scott Bamforth,1346,248,895,415,298,258,3026.0,578,258,159.0,317,157,21.1,2013,0.0
Frank Otis,525,106,362,219,158,87,1808.0,0,0,140.0,362,219,17.0,2013,0.0
Gelaun Wheelwright,378,88,321,134,71,56,1287.0,166,54,98.0,155,80,18.8,2013,0.0
Wayne Bradford,14,7,12,5,7,4,55.0,3,0,6.0,9,5,20.9,2013,0.0
Logan Foster,2,0,1,0,2,2,3.0,1,0,1.0,0,0,52.9,2013,0.0
Deniz Kilicli,899,112,727,357,339,185,2241.0,0,0,217.0,727,357,25.0,2013,0.0
Matt Humphrey,648,97,605,214,165,95,1941.0,377,125,107.0,228,89,21.6,2013,0.0
Dominique Rutledge,129,23,94,45,74,39,517.0,1,0,55.0,93,45,18.0,2013,0.0
Preston Ross,497,55,384,187,150,101,1574.0,71,22,77.0,313,165,16.8,2013,0.0
Brandon Littlejohn,7,1,6,3,2,1,13.0,2,0,2.0,4,3,34.7,2013,0.0
Ceola Clark,1472,464,1032,471,368,283,4186.0,575,247,217.0,457,224,20.0,2013,0.0
Terell Parks,721,92,512,302,223,116,1813.0,1,1,103.0,511,301,24.0,2013,0.0
Jack Houpt,667,121,546,222,83,72,2927.0,386,151,102.0,160,71,13.9,2013,0.0
Don McAvoy,296,54,272,111,83,47,1046.0,75,27,61.0,197,84,21.6,2013,0.0
Jamaal Walker,7,0,8,2,3,2,20.0,4,1,1.0,4,1,31.9,2013,0.0
Isaiah Duncan,2,0,4,0,4,2,12.0,2,0,1.0,2,0,35.1,2013,0.0
Jamal Crook,779,358,715,297,249,169,2677.0,69,16,235.0,646,281,19.9,2013,0.0
Teeng Akol,433,31,363,167,119,82,1139.0,60,17,81.0,303,150,21.9,2013,0.0
Stephon Drane,87,1,67,35,31,17,284.0,1,0,18.0,66,35,17.6,2013,0.0
Kene Anyigbo,114,22,87,38,70,38,488.0,0,0,41.0,87,38,16.5,2013,0.0
Percy Blade,43,7,31,12,23,17,221.0,12,2,23.0,19,10,14.9,2013,0.0
Eddie Alcantara,16,0,16,5,8,6,64.0,7,0,9.0,9,5,22.8,2013,0.0
Marcus Vasquez,10,0,4,2,8,4,49.0,3,2,1.0,1,0,9.1,2013,0.0
Spence Sheldon,2,0,1,0,2,2,11.0,1,0,2.0,0,0,18.2,2013,0.0
Kawaun Jakes,0,0,0,0,0,0,0.0,0,0,0.0,0,0,0,2013,0.0
Darius Paul,367,58,299,140,117,77,868.0,44,10,74.0,255,130,25.7,2013,0.0
Nate Hutcheson,1090,144,896,358,355,255,3277.0,394,119,230.0,502,239,20.1,2013,0.0
Brandon Pokley,446,46,342,133,97,85,1545.0,248,95,79.0,94,38,15.6,2013,0.0
Dan Loney,79,15,46,29,37,21,443.0,0,0,26.0,46,29,10.4,2013,0.0
Nick Stapert,9,0,6,3,5,3,20.0,0,0,1.0,6,3,23.4,2013,0.0
Malcolm Armstead,1071,462,972,411,184,137,3172.0,333,112,272.0,639,299,21.3,2013,0.0
Carl Hall,679,44,454,252,263,175,1652.0,2,0,70.0,452,252,20.2,2013,0.0
Demetric Williams,739,249,589,252,192,150,2659.0,269,85,185.0,320,167,16.9,2013,0.0
Ehimen Orukpe,154,16,125,59,84,36,887.0,0,0,81.0,125,59,14.3,2013,0.0
Matt Rum,612,227,536,197,131,108,2814.0,332,110,166.0,204,87,15.2,2013,0.0
Brett Goodloe,5,1,4,2,0,0,8.0,2,1,1.0,2,1,35.0,2013,0.0
Doug Howard,25,7,21,10,7,5,83.0,2,0,6.0,19,10,20.5,2013,0.0
Andrew Pavloff,30,10,28,9,14,11,192.0,9,1,14.0,19,8,14.2,2013,0.0
Gideon Gamble,679,99,699,259,88,60,2068.0,337,101,122.0,362,158,22.1,2013,0.0
Steve Johnson,113,10,102,38,45,32,418.0,25,5,15.0,77,33,18.5,2013,1.0
Shola Diop,81,3,52,33,29,15,335.0,1,0,24.0,51,33,14.8,2013,0.0
Reggie King,76,47,68,25,33,24,593.0,12,2,32.0,56,23,10.5,2013,1.0
Torrell Priest,0,0,0,0,0,0,1.0,0,0,0.0,0,0,0.0,2013,0.0
Jared Berggren,852,70,688,321,194,136,2276.0,227,74,105.0,461,247,22.2,2013,0.0
Ryan Evans,961,165,923,376,335,196,2943.0,70,13,161.0,853,363,24.2,2013,0.0
Mike Bruesewitz,601,162,514,211,145,104,2723.0,261,75,123.0,253,136,14.9,2013,0.0
Dan Fahey,13,2,8,4,6,5,51.0,1,0,3.0,7,4,15.2,2013,0.0
J.D. Wise,12,0,6,4,2,2,26.0,2,2,3.0,4,2,21.6,2013,0.0
Jarell Byrd,187,47,165,66,54,37,798.0,62,18,47.0,103,48,16.3,2013,0.0
Taylor Wagener,74,17,56,19,29,19,264.0,49,17,25.0,7,2,19.4,2013,0.0
Jacoby Roddy,10,1,8,3,4,4,31.0,1,0,2.0,7,3,21.6,2013,0.0
Bobo Drummond,5,5,6,1,2,2,69.0,5,1,4.0,1,0,8.9,2013,0.0
Derrious Gilmore,494,127,435,160,107,83,1459.0,249,91,117.0,186,69,24.1,2013,0.0
Leonard Washington,1132,111,813,414,404,269,2790.0,153,35,197.0,660,379,25.8,2013,0.0
Luke Martinez,551,65,427,170,116,95,1311.0,325,116,62.0,102,54,24.3,2013,0.0
Travis Taylor,1345,138,983,521,492,303,3191.0,5,0,260.0,978,521,24.3,2013,0.0
Brad Redford,693,64,516,219,70,60,1966.0,457,195,72.0,59,24,16.0,2013,0.0
Jeff Robinson,493,26,399,201,128,85,1798.0,40,6,89.0,359,195,16.2,2013,0.0
Joe Schuessler,0,0,1,0,0,0,6.0,0,0,1.0,1,0,18.2,2013,0.0
Austin Morgan,1173,245,840,332,361,310,3117.0,508,199,201.0,332,133,20.3,2013,0.0
Michael Grace,412,197,383,142,118,90,1649.0,127,38,144.0,256,104,18.3,2013,0.0
Will Bartlett,10,6,7,2,6,4,44.0,2,2,4.0,5,0,15.1,2013,0.0
Blake Allen,1032,273,897,362,115,76,2979.0,593,232,127.0,304,130,18.8,2013,0.0
Damian Eargle,1329,71,1148,532,481,264,3357.0,7,1,188.0,1141,531,23.5,2013,0.0
Danny Reese,10,5,11,4,1,0,47.0,7,2,4.0,4,2,17.2,2013,0.0
Julian Edmonson,340,30,258,104,121,89,587.0,109,43,54.0,149,61,32.5,2014,0.0
Jacob Lancaster,214,7,159,88,58,37,434.0,1,1,41.0,158,87,27.0,2014,0.0
James Pegues,157,16,125,55,56,46,445.0,6,1,46.0,119,54,22.9,2014,0.0
Rafael Farley,133,12,111,44,18,12,421.0,76,33,18.0,35,11,16.9,2014,0.0
Chris Blakeley,4,19,9,2,2,0,145.0,4,0,19.0,5,2,10.3,2014,0.0
Darrius Parker,69,13,39,24,32,19,238.0,7,2,12.0,32,22,15.0,2014,0.0
Chase Kammerer,74,32,59,25,42,22,373.0,11,2,25.0,48,23,15.5,2014,0.0
Nick Jorgensen,14,5,15,5,6,2,127.0,7,2,2.0,8,3,8.4,2014,0.0
Callum Long,14,6,10,4,5,4,76.0,7,2,11.0,3,2,16.6,2014,0.0
Ethan Michael,24,16,19,6,20,11,81.0,5,1,7.0,14,5,23.9,2014,0.0
Scott Adler,8,3,6,3,5,2,32.0,3,0,0.0,3,3,14.1,2014,0.0
Austin Flues,2,0,0,0,2,2,6.0,0,0,0.0,0,0,8.6,2014,0.0
Quincy Diggs,1003,222,781,338,315,215,2830.0,316,112,246.0,465,226,21.5,2014,0.0
Nick Harney,781,77,606,298,238,159,1686.0,101,26,151.0,505,272,26.3,2014,0.0
Carmelo Betancourt,132,125,132,48,47,27,918.0,44,9,109.0,88,39,14.7,2014,0.0
Jeremy Crutcher,1130,462,988,368,415,265,3563.0,361,129,322.0,627,239,21.3,2014,0.0
Brandon Ellis,773,77,690,275,179,124,2077.0,304,99,154.0,386,176,22.7,2014,0.0
Demarquelle Tabb,1178,120,915,443,501,292,3004.0,7,0,194.0,908,443,22.5,2014,0.0
Arthur Capers,243,33,226,94,44,28,690.0,88,27,48.0,138,67,22.2,2014,0.0
Green Hill,523,178,406,158,244,182,1896.0,89,25,145.0,317,133,17.9,2014,0.0
Justin Banks,329,17,235,134,81,61,1299.0,2,0,75.0,233,134,13.6,2014,0.0
Jose Long,220,57,212,72,113,57,1255.0,74,19,45.0,138,53,12.7,2014,0.0
Chad Frazier,549,132,424,170,203,148,1095.0,180,61,123.0,244,109,27.4,2014,0.0
Rod Rucker,808,138,728,318,267,171,2009.0,15,1,147.0,713,317,23.6,2014,0.0
Fahro Alihodzic,719,50,652,297,183,124,2246.0,6,1,123.0,646,296,18.1,2014,0.0
Jordan Swing,1011,207,811,339,251,197,2724.0,408,136,165.0,403,203,20.2,2014,0.0
Preston Purifoy,679,69,508,210,172,144,2086.0,307,115,89.0,201,95,16.7,2014,0.0
Thaddeus Rideau,17,2,21,6,0,0,66.0,17,5,2.0,4,1,16.3,2014,0.0
Karl Moton,19,3,12,7,2,1,49.0,8,4,1.0,4,3,14.0,2014,0.0
Devonte' Neal,11,1,10,3,10,5,54.0,0,0,1.0,10,3,14.6,2014,0.0
Sean Burroughs,0,0,0,0,0,0,0.0,0,0,0.0,0,0,0,2014,0.0
Princeton Davis,0,0,0,0,2,0,4.0,0,0,0,0,0,0,2014,0.0
Trevor Releford,1873,395,1319,638,537,437,4367.0,446,160,303.0,873,478,23.1,2014,0.0
Algie Key,117,45,99,40,54,36,492.0,7,1,25.0,92,39,16.4,2014,0.0
Carl Engstrom,108,16,90,43,37,22,773.0,0,0,45.0,90,43,10.6,2014,0.0
Isiah Wilson,10,1,8,3,8,4,19.0,2,0,0.0,6,3,33.8,2014,0.0
DJ Evans,481,110,401,155,147,113,1476.0,169,58,87.0,232,97,20.8,2014,0.0
Gary Johnson,433,58,315,151,178,129,1309.0,10,2,82.0,305,149,20.2,2014,0.0
John Puk,548,62,471,217,162,114,2845.0,0,0,145.0,471,217,13.3,2014,0.0
Luke Devlin,605,84,529,230,139,92,2389.0,182,53,90.0,347,177,15.5,2014,0.0
Anders Haas,62,5,53,18,13,11,134.0,44,15,8.0,9,3,27.5,2014,0.0
Dave Wiegmann,53,12,56,20,20,11,351.0,13,2,18.0,43,18,13.1,2014,0.0
Levan Shengelia,90,12,71,31,55,28,421.0,0,0,28.0,71,31,14.8,2014,0.0
Twann Oakley,456,46,372,145,124,91,1315.0,221,75,71.0,151,70,19.9,2014,0.0
Anthony Evans,255,93,288,94,50,34,1125.0,131,33,62.0,157,61,17.0,2014,0.0
Shaun Smith,103,15,118,31,38,30,418.0,51,11,32.0,67,20,21.3,2014,0.0
Marius Myles,78,11,63,28,34,22,616.0,0,0,21.0,63,28,8.6,2014,0.0
Stephane Raquil,108,11,97,44,42,20,881.0,1,0,37.0,96,44,9.1,2014,0.0
Josh Nicholas,156,13,130,63,54,30,749.0,1,0,41.0,129,63,13.5,2014,0.0
Denarius Odell,15,4,14,6,7,2,34.0,2,1,3.0,12,5,32.1,2014,0.0
DeCarlos Holmes,0,0,0,0,0,0,0.0,0,0,0.0,0,0,0,2014,0.0
Tony Wroblicky,881,132,657,363,242,155,2565.0,0,0,177.0,657,363,21.5,2014,0.0
Kyle Kager,218,39,172,79,60,44,755.0,53,16,56.0,119,63,20.0,2014,0.0
Austin Carroll,188,58,181,62,29,17,872.0,140,47,56.0,41,15,16.1,2014,0.0
Jordan Borucki,9,0,8,4,2,1,18.0,0,0,1.0,8,4,31.1,2014,0.0
Kade Kager,0,0,0,0,2,0,2.0,0,0,0.0,0,0,28.0,2014,0.0
Michael Neal,704,259,597,226,250,170,2169.0,241,82,229.0,356,144,22.0,2014,0.0
Tevin Baskin,554,25,438,193,219,153,1274.0,46,15,75.0,392,178,24.2,2014,0.0
Jay Canty,578,109,468,212,193,134,1337.0,81,20,106.0,387,192,25.2,2014,0.0
Aaron Scott,37,4,26,13,10,6,99.0,15,5,3.0,11,8,17.0,2014,0.0
Mitch Purgason,3,0,3,1,0,0,6.0,3,1,2.0,0,0,41.6,2014,0.0
Jahii Carson,1261,330,975,442,424,308,2471.0,195,69,240.0,780,373,29.7,2014,0.0
Jermaine Marshall,1362,171,1111,455,356,262,3176.0,534,190,200.0,577,265,24.6,2014,0.0
Jordan Bachynski,968,33,632,354,424,260,2670.0,0,0,158.0,632,354,19.6,2014,0.0
Richie Edwards,321,20,241,115,82,65,635.0,71,26,44.0,170,89,27.7,2014,0.0
Jarett Upchurch,7,1,4,3,0,0,12.0,2,1,1.0,2,2,21.6,2014,0.0
David Whitmore,4,1,3,1,2,2,28.0,1,0,0.0,2,1,7.7,2014,0.0
Nick Johnson,1333,304,1048,441,418,307,3339.0,401,144,197.0,647,297,22.7,2014,1.0
Aaron Gordon,470,75,382,189,180,76,1187.0,45,16,55.0,337,173,23.2,2014,1.0
Jordin Mayes,464,129,421,161,96,64,1664.0,222,78,97.0,199,83,17.7,2014,0.0
Eric Conklin,4,0,2,2,0,0,17.0,0,0,0.0,2,2,6.2,2014,0.0
Chris Johnson,4,0,1,1,2,1,6.0,1,1,0.0,0,0,17.1,2014,1.0
Zach Peters,0,0,6,0,0,0,31.0,6,0,2.0,0,0,13.6,2014,0.0
Will Neighbour,1054,97,788,354,340,257,2458.0,240,89,214.0,548,265,24.1,2014,0.0
Leroy Isler,451,72,363,143,188,136,1644.0,93,29,109.0,270,114,17.1,2014,0.0
DaVon Haynes,754,62,572,284,281,173,1812.0,51,13,137.0,521,271,23.7,2014,0.0
Daniel Broughton,988,78,884,379,315,197,2543.0,89,33,224.0,795,346,25.5,2014,0.0
Chandler Savage,72,34,63,26,33,20,550.0,10,0,33.0,53,26,10.4,2014,0.0
Roy Jackson,5,0,3,1,6,2,17.0,2,1,0.0,1,0,17.8,2014,0.0
Trent Jeffries,5,2,7,1,5,3,64.0,1,0,7.0,6,1,13.2,2014,0.0
Melvin Johnson III,1598,104,1199,527,319,262,2927.0,665,282,200.0,534,245,27.2,2014,0.0
Kirk Van Slyke,922,59,708,325,222,180,2043.0,253,92,112.0,455,233,23.1,2014,0.0
Edward Townsel,1177,240,1027,392,299,217,3366.0,496,176,247.0,531,216,21.8,2014,0.0
Brandon Reed,1168,216,1062,400,287,204,3121.0,493,164,191.0,569,236,23.0,2014,0.0
Kendrick Washington,808,112,614,295,341,213,2620.0,24,5,170.0,590,290,18.4,2014,0.0
Rakeem Dickerson,400,179,298,110,210,153,1708.0,88,27,116.0,210,83,15.6,2014,0.0
Seth Kisler,37,2,24,13,11,7,123.0,9,4,7.0,15,9,15.2,2014,0.0
Coty Clarke,556,116,386,181,206,160,1384.0,77,34,83.0,309,147,19.6,2014,1.0
Fred Gulley III,265,140,270,90,99,55,1816.0,110,30,81.0,160,60,10.9,2014,0.0
Mardracus Wade,797,153,569,235,253,198,2662.0,341,129,121.0,228,106,14.9,2014,0.0
Kikko Haydar,230,64,192,71,42,30,952.0,153,58,32.0,39,13,12.4,2014,0.0
Rickey Scott,532,163,487,195,204,117,1628.0,112,25,94.0,375,170,20.4,2014,0.0
DeQuavious Wagner,37,30,41,11,10,9,163.0,23,6,9.0,18,5,16.2,2014,0.0
Josh Herbeck,777,99,708,266,64,48,2144.0,521,197,101.0,187,69,20.0,2014,0.0
Matt Gramling,184,75,196,69,58,36,797.0,62,10,38.0,134,59,16.6,2014,0.0
Kyle Weldon,4,0,5,2,0,0,29.0,1,0,3.0,4,2,14.0,2014,0.0
Austin Williamson,0,0,0,0,0,0,0.0,0,0,0.0,0,0,0,2014,0.0
Chris Denson,1190,156,873,401,527,341,2496.0,171,47,129.0,702,354,25.9,2014,0.0
Allen Payne,734,135,635,266,231,163,2765.0,154,39,193.0,481,227,17.5,2014,0.0
Asauhn Dixon-Tatum,299,17,220,115,104,69,1123.0,0,0,64.0,220,115,15.2,2014,0.0
Chris Griffin,83,9,82,27,26,20,309.0,34,9,25.0,48,18,20.1,2014,0.0
Travis Betran,1008,152,789,325,231,199,2069.0,416,159,155.0,373,166,25.3,2014,0.0
Will Triggs,1139,154,779,412,519,315,2964.0,3,0,197.0,776,412,20.5,2014,0.0
Corey Arentsen,201,46,168,65,24,18,666.0,136,53,29.0,32,12,15.5,2014,0.0
Preston Herring,111,11,68,40,46,25,369.0,8,6,19.0,60,34,14.7,2014,0.0
Fred Garmon,40,27,44,15,14,6,309.0,18,4,24.0,26,11,11.8,2014,0.0
Thomas Greer,64,21,47,18,35,20,339.0,20,8,29.0,27,10,13.6,2014,0.0
Chris Bond,1050,143,785,392,365,245,3105.0,79,21,205.0,706,371,19.5,2014,0.0
Jesse Berry,1257,181,999,377,379,279,3089.0,661,224,233.0,338,153,23.9,2014,0.0
Majok Majok,645,52,442,229,338,187,1799.0,0,0,143.0,442,229,21.1,2014,0.0
Tyler Koch,267,69,240,94,58,27,1211.0,155,52,70.0,85,42,14.8,2014,0.0
Kindon Crowder,35,11,36,13,4,1,141.0,30,8,8.0,6,5,16.4,2014,0.0
Chase Brogna,15,7,26,5,2,1,140.0,22,4,3.0,4,1,11.0,2014,0.0
Cory Jefferson,1159,51,794,431,424,280,2589.0,50,17,101.0,744,414,21.4,2014,1.0
Brady Heslip,1140,102,829,359,147,121,3015.0,689,301,42.0,140,58,15.8,2014,0.0
Isaiah Austin,883,91,744,338,241,159,2111.0,155,48,135.0,589,290,23.8,2014,0.0
Gary Franklin,513,185,483,163,101,68,2105.0,362,119,116.0,121,44,15.6,2014,0.0
Logan Lowery,228,27,199,86,47,34,673.0,58,22,53.0,141,64,20.5,2014,0.0
Josh Clemons,0,0,0,0,0,0,2.0,0,0,1.0,0,0,25.7,2014,0.0
J.J. Mann,1509,272,1212,524,265,227,3570.0,644,234,184.0,568,290,21.6,2014,0.0
Drew Windler,998,120,691,333,215,158,2152.0,397,174,160.0,294,159,24.1,2014,0.0
Blake Jenkins,918,110,602,337,336,213,2381.0,99,31,156.0,503,306,19.5,2014,0.0
Malik Jackson,501,33,451,174,91,73,1279.0,241,80,60.0,210,94,22.7,2014,0.0
Allan Dempster,153,4,124,62,52,29,502.0,0,0,23.0,124,62,18.0,2014,0.0
Barry Smith,169,20,147,58,71,48,581.0,18,5,38.0,129,53,20.0,2014,0.0
Daquan Brown,135,8,119,54,47,27,450.0,0,0,30.0,119,54,20.0,2014,0.0
Roland Brown,320,22,285,125,111,70,1021.0,2,0,87.0,283,125,21.8,2014,0.0
Rayner Moquete,357,73,357,124,70,45,1479.0,200,64,75.0,157,60,16.1,2014,0.0
Alex Ogundadegbe,234,31,216,91,85,52,1244.0,2,0,60.0,214,91,13.6,2014,0.0
Robert Mansell,526,62,462,169,207,151,1476.0,123,37,112.0,339,132,24.8,2014,0.0
Chris Rice,18,7,26,4,11,7,172.0,18,3,13.0,8,1,13.6,2014,0.0
Ryan Watkins,1070,72,745,409,346,251,2651.0,3,1,122.0,742,408,20.2,2014,0.0
Thomas Bropleh,715,84,567,238,175,125,2038.0,302,114,91.0,265,124,18.9,2014,0.0
Jeff Elorriaga,792,177,607,255,78,61,3111.0,518,221,70.0,89,34,12.0,2014,0.0
Edmunds Dukulis,13,1,12,6,6,1,47.0,0,0,2.0,12,6,18.8,2014,0.0
Joey Nebeker,11,2,14,3,6,4,28.0,8,1,4.0,6,2,38.9,2014,0.0
Danny Rubin,176,26,159,58,15,10,832.0,128,50,27.0,31,8,12.7,2014,0.0
Drew Jacobs,2,0,3,1,0,0,24.0,1,0,3.0,2,1,13.9,2014,0.0
D.J. Irving,1456,469,1146,458,475,370,4126.0,472,170,287.0,674,288,21.5,2014,0.0
Dom Morris,1139,94,856,439,312,220,3410.0,114,41,182.0,742,398,18.6,2014,0.0
Travis Robinson,592,91,520,202,102,66,2269.0,344,122,107.0,176,80,15.9,2014,0.0
James Kennedy,31,4,35,15,7,1,241.0,2,0,15.0,33,15,11.9,2014,0.0
Cameron Black,590,86,516,266,121,58,2690.0,0,0,118.0,516,266,13.4,2014,0.0
Craig Sealey,321,25,297,125,128,68,1068.0,13,3,70.0,284,122,21.0,2014,0.0
Shaun Joplin,0,0,0,0,0,0,0.0,0,0,0.0,0,0,0,2014,0.0
Walt Lemon,1721,367,1422,628,502,361,3935.0,324,104,404.0,1098,524,27.6,2014,0.0
Tyshon Pickett,773,75,631,300,208,157,1985.0,51,16,103.0,580,284,22.1,2014,0.0
Jordan Prosser,684,37,566,279,213,126,2598.0,0,0,113.0,566,279,15.8,2014,0.0
Chris Blake,31,3,24,10,23,11,303.0,0,0,14.0,24,10,8.6,2014,0.0
Mason Alwan,33,5,24,12,7,5,163.0,9,4,9.0,15,8,11.9,2014,0.0
Stefan Zecevic,12,2,12,5,10,2,78.0,1,0,8.0,11,5,16.9,2014,0.0
Darrion Harris,9,3,7,3,4,2,35.0,1,1,2.0,6,2,16.5,2014,0.0
Andrew Johnston,4,1,3,1,4,1,17.0,3,1,2.0,0,0,18.8,2014,0.0
Graham Pingree,0,0,1,0,0,0,10.0,0,0,0.0,1,0,4.6,2014,0.0
Sean McGonagill,1618,522,1363,538,387,293,4110.0,683,249,327.0,680,289,23.8,2014,0.0
Matty Madigan,30,19,33,9,13,8,296.0,15,4,14.0,18,5,8.9,2014,0.0
Josh Biber,41,13,37,13,32,15,253.0,3,0,11.0,34,13,13.2,2014,0.0
Alex Francis,2085,172,1457,791,815,490,4141.0,53,13,457.0,1404,778,28.9,2014,0.0
Corey Maynard,1050,379,854,370,224,172,3406.0,417,138,211.0,437,232,17.9,2014,0.0
Claybrin McMath,278,35,304,114,41,23,1252.0,122,27,60.0,182,87,16.3,2014,0.0
Declan Soukup,23,11,21,6,11,9,98.0,10,2,8.0,11,4,18.0,2014,0.0
Tim McKinney,7,0,6,2,4,3,31.0,2,0,2.0,4,2,16.5,2014,0.0
Cameron Ayers,1526,220,1205,530,319,265,3985.0,488,201,144.0,717,329,20.7,2014,0.0
Brian Fitzpatrick,530,49,373,206,152,111,1589.0,16,7,98.0,357,199,18.7,2014,0.0
Ben Brackney,342,28,268,109,59,52,1065.0,163,72,40.0,105,37,17.3,2014,0.0
Ryan Hill,250,166,209,77,130,84,1729.0,38,12,126.0,171,65,12.6,2014,0.0
Javon McCrea,2004,249,1386,798,653,407,3473.0,4,1,309.0,1382,797,29.4,2014,0.0
Josh Freelove,948,79,818,364,117,88,2243.0,363,132,110.0,455,232,22.6,2014,0.0
Jarod Oldham,562,409,497,182,234,156,2558.0,168,42,235.0,329,140,16.6,2014,0.0
Auraum Nuiriankh,325,98,313,101,102,74,1525.0,186,49,104.0,127,52,15.7,2014,0.0
Corey Raley-Ross,85,33,93,33,30,16,398.0,19,3,41.0,74,30,19.0,2014,0.0
Khyle Marshall,1373,52,1055,572,437,227,3001.0,19,2,123.0,1036,570,24.4,2014,0.0
Erik Fromm,455,20,428,163,117,73,1547.0,196,56,77.0,232,107,19.1,2014,0.0
Michael Volovic,11,1,6,4,3,2,10.0,3,1,0.0,3,3,39.8,2014,0.0
Elliott Kampen,6,1,6,1,4,3,72.0,5,1,3.0,1,0,7.9,2014,0.0
Chris Eversley,1218,143,1037,444,348,244,2761.0,290,86,139.0,747,358,27.1,2014,0.0
Kyle Odister,764,128,691,266,75,56,2059.0,454,176,97.0,237,90,21.7,2014,0.0
Max Betkowski,0,0,1,0,2,0,12.0,1,0,1.0,0,0,13.7,2014,0.0
Markel Leonard,0,0,4,0,0,0,11.0,3,0,1.0,1,0,25.3,2014,0.0
Issiah Grayson,869,307,596,276,262,209,2071.0,248,108,212.0,348,168,23.2,2014,0.0
Brandon Barnes,856,105,705,311,291,180,2273.0,168,54,173.0,537,257,22.4,2014,0.0
Stefon Johnson,857,105,754,360,211,124,2968.0,43,13,166.0,711,347,17.4,2014,0.0
Erik Kinney,164,30,139,49,100,66,765.0,9,0,58.0,130,49,16.4,2014,0.0
Corey Hall,224,15,175,80,82,52,830.0,36,12,60.0,139,68,16.8,2014,0.0
Zach Lamb,424,70,344,156,94,70,1021.0,111,42,81.0,233,114,23.7,2014,0.0
Matt Ratto,62,8,48,18,11,10,179.0,43,16,9.0,5,2,17.7,2014,0.0
Marquis Horne,282,31,255,107,61,42,779.0,78,26,50.0,177,81,22.1,2014,0.0
Jared Brandon,310,69,269,125,78,51,1247.0,43,9,61.0,226,116,15.1,2014,0.0
Floris Versteeg,20,0,21,6,6,4,106.0,17,4,5.0,4,2,14.1,2014,0.0
Ian Spruce,9,0,7,3,0,0,9.0,7,3,0.0,0,0,40.2,2014,0.0
Josh Greene,1549,360,1167,455,472,411,3594.0,590,228,240.0,577,227,22.1,2014,0.0
Ben Vozzola,99,33,99,36,8,8,326.0,53,19,31.0,46,17,20.7,2014,0.0
Trevone Williams,269,54,273,110,34,25,918.0,92,24,50.0,181,86,17.7,2014,0.0
J.J. Thomas,568,62,461,200,207,142,1437.0,76,26,130.0,385,174,23.4,2014,0.0
Dominique Youmans,5,3,10,2,2,1,136.0,0,0,10.0,10,2,7.8,2014,0.0
Kevin Rutledge,0,0,1,0,0,0,1.0,0,0,0.0,1,0,50.4,2014,0.0
Ryan Sypkens,1275,203,1038,435,117,90,3240.0,750,315,202.0,288,120,21.1,2014,0.0
Iggy Nujic,391,50,331,133,120,88,1222.0,116,37,84.0,215,96,20.2,2014,0.0
Clint Bozner,193,17,136,74,76,45,655.0,1,0,60.0,135,74,18.9,2014,0.0
Olivier-Paul Betu,38,30,32,13,19,10,376.0,14,2,30.0,18,11,10.1,2014,0.0
Carlos Mancasola,0,1,3,0,0,0,6.0,3,0,0.0,0,0,26.8,2014,0.0
Chris McNealy,1207,277,1062,439,278,198,3480.0,355,131,177.0,707,308,19.9,2014,1.0
Ege Mala,14,3,13,5,4,3,45.0,3,1,2.0,10,4,19.6,2014,0.0
Chris Patton,783,81,602,319,217,145,1605.0,2,0,149.0,600,319,27.7,2014,0.0
Lucas Devenny,213,48,169,86,89,41,1348.0,0,0,51.0,169,86,10.2,2014,0.0
Chris Harriel,916,141,859,307,305,193,2614.0,383,109,164.0,476,198,22.9,2014,0.0
Tre Owens,59,8,71,19,6,4,239.0,60,17,6.0,11,2,17.6,2014,0.0
Kyle Boswell,975,181,679,297,223,165,2633.0,505,216,118.0,174,81,18.4,2014,0.0
Taran Brown,561,105,524,203,81,59,1721.0,307,96,97.0,217,107,20.6,2014,0.0
Shawn Moore,88,27,67,40,12,6,520.0,9,2,21.0,58,38,9.7,2014,0.0
Aamahd Walker,22,2,21,8,9,5,73.0,5,1,5.0,16,7,22.5,2014,0.0
Logan Louks,4,0,3,2,0,0,4.0,0,0,0.0,3,2,41.0,2014,0.0
Duke DaRe,27,30,47,9,7,5,316.0,32,4,27.0,15,5,13.0,2014,0.0
Justin Cobbs,1539,575,1157,524,491,404,3839.0,256,87,278.0,901,437,22.6,2014,0.0
Richard Solomon,885,81,642,329,385,220,2457.0,28,7,143.0,614,322,20.4,2014,0.0
Jeff Powers,169,19,141,56,28,20,498.0,94,37,20.0,47,19,18.1,2014,0.0
Garrett Galvin,4,0,4,2,2,0,26.0,0,0,2.0,4,2,13.9,2014,0.0
Leek Leek,345,50,292,116,73,57,1250.0,139,56,58.0,153,60,16.1,2014,0.0
Antwon Oliver,236,48,219,91,49,30,958.0,104,24,53.0,115,67,16.1,2014,0.0
Antonio Kalpic,63,6,45,25,18,13,306.0,0,0,21.0,45,25,12.3,2014,0.0
Billy Baron,1716,416,1214,533,513,436,3342.0,558,214,246.0,656,319,25.8,2014,0.0
Jordan Heath,642,53,456,243,167,83,1779.0,184,73,63.0,272,170,17.1,2014,0.0
Chris Manhertz,758,61,545,268,309,222,2694.0,2,0,152.0,543,268,15.8,2014,0.0
Dominique Raney,188,21,168,71,41,30,529.0,58,16,27.0,110,55,20.5,2014,0.0
LaQuentin Miles,1354,226,1127,512,562,311,2412.0,68,19,270.0,1059,493,32.0,2014,0.0
DeShone McClure,549,131,473,207,105,60,1499.0,219,75,84.0,254,132,18.8,2014,0.0
Aubrey Ball,152,19,127,48,34,23,347.0,79,33,18.0,48,15,21.7,2014,0.0
Phabian Glasco,152,20,111,64,53,24,608.0,1,0,21.0,110,64,12.1,2014,0.0
Daouda Berete,255,92,230,85,95,71,1050.0,42,14,75.0,188,71,15.5,2014,0.0
DuShaun Rice,121,44,108,37,40,29,476.0,58,18,28.0,50,19,15.2,2014,0.0
Lenell Brown,198,67,198,75,41,20,958.0,98,28,78.0,100,47,14.3,2014,0.0
Oliver Wells,181,78,167,67,45,30,908.0,49,17,55.0,118,50,12.3,2014,0.0
Ryan Williams,423,142,466,145,115,80,1536.0,182,53,138.0,284,92,19.9,2014,0.0
Chasen Wiilliamson,21,6,24,6,13,8,106.0,9,1,4.0,15,5,15.1,2014,0.0
Jeff Drew,15,2,21,7,0,0,105.0,1,1,11.0,20,6,14.3,2014,0.0
Terry Tidwell,168,10,125,70,60,28,565.0,1,0,52.0,124,70,17.0,2014,0.0
Sean Young,6,0,10,3,0,0,22.0,1,0,2.0,9,3,25.2,2014,0.0
Kyle Vinales,1514,296,1300,518,334,271,2802.0,544,207,249.0,756,311,30.1,2014,0.0
Juwan Newmen,107,4,87,38,46,31,338.0,1,0,31.0,86,38,20.3,2014,0.0
De'Angelo Speech,217,100,204,71,88,57,1274.0,44,18,113.0,160,53,14.0,2014,0.0
Matt Hunter,565,91,517,207,154,110,1405.0,133,41,128.0,384,166,25.2,2014,0.0
Andrew Hurd,16,6,19,5,4,3,116.0,16,3,7.0,3,2,11.8,2014,0.0
Isaiah Sykes,1545,336,1194,588,599,335,3574.0,103,34,344.0,1091,554,25.8,2014,0.0
Tristan Spurlock,928,111,759,305,267,196,2638.0,371,122,118.0,388,183,19.3,2014,0.0
Calvin Newell,754,204,653,261,217,140,2135.0,310,92,175.0,343,169,22.0,2014,0.0
Eugene McCrory,130,8,90,46,61,38,371.0,0,0,13.0,90,46,17.3,2014,0.0
Isaac Lang,16,0,14,6,1,0,49.0,11,4,3.0,3,2,17.6,2014,0.0
DeAndray Buckley,121,28,94,33,87,50,508.0,25,5,21.0,69,28,16.5,2014,0.0
Nick Carlos,33,3,42,13,0,0,108.0,28,7,6.0,14,6,23.2,2014,0.0
Zach Saylor,107,13,125,46,34,15,681.0,1,0,37.0,124,46,13.3,2014,0.0
Derrick Richardson,141,25,116,46,67,39,687.0,37,10,45.0,79,36,14.7,2014,0.0
Sheldon Lowman,10,1,5,4,3,2,20.0,0,0,1.0,5,4,19.4,2014,0.0
Sheldon Strickland,907,231,813,319,170,124,2487.0,390,145,160.0,423,174,20.8,2014,0.0
Alhaji Fullah,264,15,184,115,62,34,931.0,2,0,35.0,182,115,13.2,2014,0.0
Mitchell Deter,54,12,48,18,4,3,188.0,42,15,7.0,6,3,14.9,2014,0.0
Greg Dorleus,31,1,22,11,15,9,104.0,1,0,8.0,21,11,17.6,2014,0.0
Thomas Odom,25,1,24,8,3,2,80.0,20,7,3.0,4,1,17.4,2014,0.0
Shawn Lester,369,48,300,126,90,68,757.0,158,49,76.0,142,77,27.0,2014,0.0
Ben Cherry,446,59,340,141,70,56,1629.0,245,108,60.0,95,33,13.6,2014,0.0
Z Mason,1177,55,883,420,385,272,2206.0,199,65,146.0,684,355,26.6,2014,0.0
Anthanee Doyle,23,6,21,8,5,3,72.0,9,4,4.0,12,4,18.2,2014,0.0
Andrew Houts,18,5,13,6,6,5,35.0,5,1,5.0,8,5,28.5,2014,0.0
Jay Wimbley,2,0,0,0,2,2,1.0,0,0,0.0,0,0,45.5,2014,0.0
Quinton Pippen,802,147,698,274,119,96,1876.0,438,158,119.0,260,116,23.5,2014,0.0
Matt Ross,714,58,612,266,112,89,2044.0,272,93,96.0,340,173,18.8,2014,0.0
Nate Duhon,556,80,463,200,182,137,1488.0,76,19,102.0,387,181,22.1,2014,0.0
Eddie Denard,346,44,309,138,151,70,1165.0,6,0,79.0,303,138,19.5,2014,0.0
Corey Gray,448,137,422,151,109,69,1881.0,239,77,119.0,183,74,16.0,2014,0.0
Jamere Dismukes,312,114,284,104,91,71,849.0,111,33,84.0,173,71,24.4,2014,0.0
Markus Starks,77,6,89,30,26,15,560.0,5,2,31.0,84,28,11.9,2014,0.0
Willie Rosenthal,5,0,5,2,2,1,22.0,0,0,2.0,5,2,18.3,2014,0.0
Arthur Gage,11,1,8,3,8,5,115.0,0,0,5.0,8,3,7.4,2014,0.0
Sean Kilpatrick,2145,279,1687,707,536,418,4315.0,901,313,236.0,786,394,26.0,2014,1.0
Titus Rubles,449,134,400,149,205,147,1725.0,46,4,114.0,354,145,18.1,2014,0.0
David Nyarsuk,117,9,87,51,23,15,521.0,0,0,30.0,87,51,12.5,2014,0.0
Derek Cox,0,0,1,0,0,0,2.0,0,0,0.0,1,0,26.0,2014,0.0
Dylen Setzekorn,182,12,154,63,45,32,463.0,66,24,33.0,88,39,24.1,2014,0.0
Nate Bowser,9,0,13,3,5,3,82.0,0,0,5.0,13,3,13.2,2014,0.0
K.J. McDaniels,1035,85,804,362,300,230,2287.0,259,81,140.0,545,281,26.5,2014,0.0
Ibrahim Djambo,60,4,66,21,12,8,294.0,42,10,14.0,24,11,16.5,2014,0.0
Carson Fields,11,4,19,5,4,1,72.0,10,0,3.0,9,5,18.4,2014,0.0
Jon Harris,895,126,694,318,145,106,2851.0,412,153,108.0,282,165,16.7,2014,0.0
Sebastian Douglas,464,97,380,194,114,68,1692.0,44,8,134.0,336,186,17.8,2014,0.0
Devon Long,307,22,232,134,77,39,1098.0,0,0,55.0,232,134,15.6,2014,0.0
Ludovic Ndaye,167,11,161,67,54,29,880.0,18,4,32.0,143,63,13.1,2014,0.0
Raphael Veira,6,0,14,2,4,2,41.0,10,0,6.0,4,2,28.2,2014,0.0
El Hadji Ndieguene,314,37,275,123,110,68,1563.0,0,0,84.0,275,123,13.1,2014,0.0
Eric Smith,446,195,440,151,133,87,2037.0,196,57,150.0,244,94,16.2,2014,0.0
Murphy Burnatowski,1356,140,1157,484,268,200,3106.0,529,188,177.0,628,296,25.6,2014,0.0
Clayton Graham,168,45,105,66,53,36,768.0,0,0,33.0,105,66,11.8,2014,0.0
Jack Fleming,5,1,4,2,0,0,15.0,2,1,1.0,2,1,19.1,2014,0.0
Willis Hall,1152,119,914,453,196,149,3482.0,271,97,184.0,643,356,18.0,2014,0.0
Anthony Thomas,533,84,479,217,142,79,1868.0,84,20,134.0,395,197,19.5,2014,0.0
Nori Johnson,549,60,450,178,103,74,1754.0,315,119,82.0,135,59,17.4,2014,0.0
Judson Hall,5,1,4,2,0,0,18.0,3,1,0.0,1,1,11.9,2014,0.0
Chad Cooke,2,1,2,1,0,0,10.0,1,0,5.0,1,1,37.4,2014,0.0
Gerson Santo,242,16,165,89,93,64,958.0,0,0,30.0,165,89,12.7,2014,0.0
Josh Morgan,21,2,17,8,4,2,49.0,10,3,4.0,7,5,23.8,2014,0.0
Enrico Bueno,1,1,3,0,4,1,16.0,3,0,1.0,0,0,18.8,2014,0.0
Spencer Dinwiddie,1115,227,690,290,506,420,2590.0,298,115,153.0,392,175,21.8,2014,1.0
Ben Mills,71,5,62,29,21,12,235.0,1,1,17.0,61,28,19.2,2014,0.0
Beau Gamble,24,11,21,8,4,2,41.0,16,6,5.0,5,2,34.7,2014,0.0
Kevin Nelson,3,0,2,1,0,0,17.0,2,1,0.0,0,0,6.0,2014,0.0
Meiko Lyles,586,44,467,201,94,69,1950.0,278,115,74.0,189,86,16.5,2014,0.0
Zach En'Wezoh,80,16,73,38,17,4,334.0,1,0,30.0,72,38,19.0,2014,0.0
Shabazz Napier,1959,646,1447,595,626,509,4614.0,693,260,350.0,754,335,24.0,2014,1.0
DeAndre Daniels,953,52,791,359,202,152,2356.0,238,83,128.0,553,276,23.1,2014,0.0
Niels Giffey,640,79,454,216,152,120,2328.0,209,88,102.0,245,128,14.3,2014,0.0
Lasan Kromah,1256,240,1092,481,293,183,3303.0,347,111,254.0,745,370,22.8,2014,0.0
Tyler Olander,383,91,353,154,105,72,1876.0,17,3,79.0,336,151,13.5,2014,0.0
Tor Watts,2,0,4,1,0,0,16.0,1,0,1.0,3,1,16.7,2014,0.0
Michael Murray,1030,96,957,389,301,191,2982.0,268,61,169.0,689,328,21.1,2014,0.0
Andre Armstrong,702,35,541,181,256,210,1451.0,390,130,74.0,151,51,25.2,2014,0.0
Charles Ieans,195,25,191,74,51,28,772.0,56,19,43.0,135,55,16.6,2014,0.0
Zach Burnham,109,6,125,44,33,21,573.0,1,0,29.0,124,44,14.6,2014,0.0
Jake Matthews,136,29,121,42,34,25,618.0,83,27,28.0,38,15,14.1,2014,0.0
Dominick Scelfo,222,54,224,72,51,28,818.0,172,50,36.0,52,22,18.2,2014,0.0
Montez Blair,26,3,28,8,6,4,70.0,22,6,8.0,6,2,27.4,2014,0.0
Doug McDermott,3150,194,2075,1141,715,594,4569.0,598,274,321.0,1477,867,32.3,2014,1.0
Ethan Wragge,1155,72,816,360,116,101,2732.0,761,334,69.0,55,26,18.4,2014,0.0
Jahenns Manigat,900,298,679,296,129,102,3592.0,508,206,139.0,171,90,13.2,2014,0.0
Grant Gibbs,811,519,555,287,255,173,3136.0,165,64,221.0,390,223,15.3,2014,0.0
Steven Ferrarini,7,2,6,2,3,3,18.0,3,0,0.0,3,2,22.4,2014,0.0
Alex Olsen,18,2,9,6,11,6,60.0,1,0,1.0,8,6,13.9,2014,0.0
Tyler Melville,804,148,658,266,258,201,2153.0,198,71,184.0,460,195,24.0,2014,0.0
De'Mon Brooks,1777,113,1209,647,590,430,2971.0,154,53,232.0,1055,594,29.7,2014,0.0
Tom Droney,746,315,585,254,252,182,3208.0,200,56,197.0,385,198,14.3,2014,0.0
Chris Czerapowicz,1004,70,891,371,126,90,2732.0,506,172,89.0,385,199,19.5,2014,0.0
Joe Aase,20,4,24,8,2,1,152.0,11,3,4.0,13,5,9.8,2014,0.0
Ryan Ansel,3,1,1,1,0,0,9.0,1,1,1.0,0,0,11.4,2014,0.0
Will Thoni,1,1,7,0,2,1,16.0,5,0,2.0,2,0,32.0,2014,0.0
Clay Tormey,11,5,13,4,5,2,76.0,4,1,8.0,9,3,15.8,2014,0.0
Devin Oliver,923,188,723,328,283,200,2971.0,211,67,179.0,512,261,18.1,2014,0.0
Vee Sanford,834,155,673,305,203,156,2005.0,198,68,138.0,475,237,23.6,2014,0.0
Matt Kavanaugh,558,59,407,213,183,132,1685.0,0,0,127.0,407,213,19.1,2014,0.0
Brian Vonderhaar,5,4,2,2,0,0,34.0,1,1,1.0,1,1,4.5,2014,0.0
Casey Walker,1449,101,1324,496,263,191,3980.0,835,266,140.0,489,230,22.3,2014,0.0
Albert Thomas,253,154,205,89,99,66,1395.0,29,9,92.0,176,80,13.7,2014,0.0
Nick Doyle,81,33,95,33,14,8,368.0,34,7,26.0,61,26,19.4,2014,0.0
Jordan Lawson,112,10,83,39,49,34,563.0,1,0,27.0,82,39,13.2,2014,0.0
Ashwell Boyd,13,1,10,5,5,3,32.0,0,0,2.0,10,5,25.3,2014,0.0
Rakeen Brown,3,3,7,1,2,1,31.0,3,0,5.0,4,1,23.5,2014,0.0
J. Walter Lawson,0,0,0,0,0,0,0.0,0,0,1.0,0,0,0,2014,0.0
Davon Usher,1205,102,858,374,409,311,2197.0,388,146,134.0,470,228,26.2,2014,0.0
Devon Saddler,2222,336,1750,748,713,534,4449.0,569,192,368.0,1181,556,28.5,2014,0.0
Jarvis Threatt,1191,308,868,338,613,462,2714.0,189,53,190.0,679,285,25.1,2014,0.0
Carl Baptiste,607,31,451,250,158,105,1989.0,11,2,110.0,440,248,15.9,2014,0.0
Chris Udofia,1501,349,1074,551,515,334,3661.0,225,65,228.0,849,486,25.6,2014,0.0
Dom Samac,64,10,50,25,10,7,235.0,20,7,6.0,30,18,15.6,2014,0.0
Griffin McKenzie,24,5,24,9,1,1,92.0,10,5,5.0,14,4,17.8,2014,0.0
Charles Webb,6,1,10,2,4,2,26.0,0,0,3.0,10,2,34.6,2014,0.0
Cleveland Melvin,1792,87,1509,719,444,290,3349.0,192,64,217.0,1317,655,28.2,2014,0.0
Sandi Marcius,316,17,219,120,126,76,1200.0,0,0,89.0,219,120,15.6,2014,0.0
Charles McKinney,398,116,311,155,133,76,1608.0,52,12,117.0,259,143,14.8,2014,0.0
Edwind McGhee,57,21,52,15,29,20,350.0,27,7,16.0,25,8,11.4,2014,0.0
Evan Bruinsma,760,111,543,260,264,194,2338.0,163,46,148.0,380,214,17.4,2014,0.0
Ugochukwu Njoku,155,18,130,63,74,29,867.0,1,0,36.0,129,63,11.5,2014,0.0
Jermaine Lippert,90,20,60,36,29,16,408.0,6,2,32.0,54,34,12.9,2014,0.0
Olumide Solanke,7,1,6,1,6,5,31.0,0,0,2.0,6,1,17.3,2014,0.0
Richard Carter,808,227,609,252,324,240,1790.0,194,64,146.0,415,188,27.4,2014,0.0
Aaron Hawley,864,66,758,308,137,94,2436.0,383,154,117.0,375,154,21.2,2014,0.0
Seth VanDeest,987,138,651,346,418,291,2802.0,16,4,148.0,635,342,19.5,2014,0.0
Daddy Ugbede,147,5,94,52,63,43,400.0,0,0,27.0,94,52,20.5,2014,0.0
Robert Puleikis,12,0,6,5,5,2,23.0,0,0,0.0,6,5,19.9,2014,0.0
Mitch McLaughlin,1,1,1,0,4,1,20.0,0,0,4.0,1,0,18.6,2014,0.0
Addison Joseph,0,0,0,0,0,0,0.0,0,0,0.0,0,0,0,2014,0.0
Chris Fouch,1744,178,1464,568,426,333,3449.0,780,275,151.0,684,293,28.2,2014,0.0
Frantz Massenat,1646,548,1261,505,649,484,4381.0,419,152,264.0,842,353,23.0,2014,0.0
Dartaye Ruffin,809,58,632,322,269,165,3255.0,0,0,148.0,632,322,15.2,2014,0.0
Goran Pantovic,40,6,37,17,9,6,384.0,0,0,14.0,37,17,7.9,2014,0.0
Stevan Manojlovic,5,3,7,2,0,0,35.0,5,1,2.0,2,1,13.9,2014,0.0
Jake Lerner,2,2,7,1,2,0,27.0,4,0,1.0,3,1,17.8,2014,0.0
Jabari Parker,670,41,499,236,214,160,1074.0,106,38,81.0,393,198,32.7,2014,1.0
Rodney Hood,890,139,699,318,176,136,2200.0,298,118,84.0,401,200,20.5,2014,1.0
Andre Dawkins,1014,66,763,330,160,123,2468.0,568,231,88.0,195,99,18.7,2014,1.0
Tyler Thornton,433,264,308,125,121,94,2590.0,231,89,118.0,77,36,9.5,2014,0.0
Josh Hairston,250,27,220,97,87,56,1139.0,3,0,52.0,217,97,13.9,2014,0.0
Todd Zafirovski,5,1,7,2,4,1,41.0,0,0,1.0,7,2,12.3,2014,0.0
Ovie Soko,1115,124,806,379,523,338,2891.0,80,19,210.0,726,360,23.0,2014,0.0
Jerry Jones,560,117,483,207,106,68,1915.0,233,78,94.0,250,129,16.3,2014,0.0
Brandon Cartmill,0,0,0,0,0,0,1.0,0,0,0.0,0,0,0.0,2014,0.0
Akeem Richmond,1622,146,1338,514,216,178,3514.0,1082,416,128.0,256,98,22.6,2014,0.0
Petar Torlak,119,32,95,41,23,14,379.0,57,23,29.0,38,18,18.5,2014,0.0
Kinard Gadsden-Gilliard,530,145,464,185,174,128,1810.0,99,32,144.0,365,153,19.2,2014,0.0
Hunter Harris,561,35,403,206,231,144,1688.0,27,5,84.0,376,201,18.0,2014,0.0
Lukas Poderis,300,21,240,112,139,75,1492.0,6,1,51.0,234,111,11.9,2014,0.0
Todd Halvorsen,27,9,24,9,5,4,111.0,15,5,10.0,9,4,16.8,2014,0.0
Adam Denison,0,0,0,0,0,0,0.0,0,0,0.0,0,0,0,2014,0.0
Sherman Blanford,771,119,575,277,318,217,1639.0,4,0,114.0,571,277,27.9,2014,0.0
Dennis Green,87,15,67,25,53,36,219.0,9,1,20.0,58,24,26.6,2014,0.0
Donald Moore,16,2,17,4,9,6,75.0,7,2,6.0,10,2,18.9,2014,0.0
Julian Robertson,0,0,0,0,0,0,2.0,0,0,1.0,0,0,26.0,2014,0.0
Glenn Cosey,1077,235,765,328,272,226,2260.0,468,195,102.0,297,133,23.6,2014,0.0
Marcus Lewis,542,79,424,213,136,82,1672.0,134,34,71.0,290,179,18.0,2014,0.0
Tarius Johnson,560,79,414,193,183,119,1646.0,147,55,76.0,267,138,18.8,2014,0.0
Orlando Williams,824,138,637,278,183,131,2246.0,346,137,134.0,291,141,20.8,2014,0.0
Jeff Johnson,489,159,415,178,89,63,2101.0,211,70,113.0,204,108,15.0,2014,0.0
Herb Harrison,22,3,17,10,2,2,90.0,0,0,7.0,17,10,15.2,2014,0.0
Ryan Parsons,38,2,35,12,6,3,101.0,33,11,2.0,2,1,21.4,2014,0.0
Monte Burney,0,0,2,0,0,0,3.0,2,0,1.0,0,0,53.6,2014,0.0
Robbie Stenzel,27,13,25,8,6,5,99.0,22,6,4.0,3,2,17.4,2014,0.0
Glenn Bryant,899,42,739,356,260,169,2364.0,95,18,104.0,644,338,21.7,2014,0.0
Daylen Harrison,683,129,597,239,180,144,2524.0,192,61,146.0,405,178,17.4,2014,0.0
DaShonte Riley,392,76,331,154,148,84,2336.0,4,0,172.0,327,154,13.3,2014,0.0
J.R. Sims,503,96,493,165,145,107,1949.0,236,66,113.0,257,99,18.9,2014,0.0
Mo Hughley,234,57,165,80,119,74,879.0,2,0,62.0,163,80,16.7,2014,0.0
Anthony Strickland,157,28,135,56,67,45,934.0,2,0,40.0,133,56,12.3,2014,0.0
Ali Farhat,12,2,17,5,2,1,29.0,7,1,0.0,10,4,32.4,2014,0.0
Martin Seiferth,487,17,324,206,169,75,1429.0,0,0,72.0,324,206,16.7,2014,0.0
Thomas Reuter,230,69,228,81,89,49,1010.0,79,19,75.0,149,62,17.2,2014,0.0
Danny Powell,30,0,28,10,6,5,49.0,17,5,4.0,11,5,35.7,2014,0.0
Lucas Troutman,1626,80,1219,636,533,353,3168.0,4,1,218.0,1215,635,27.3,2014,0.0
Sebastian Koch,1128,262,873,371,187,144,3502.0,599,242,177.0,274,129,16.6,2014,0.0
Ryley Beaumont,1093,175,969,436,231,148,3354.0,242,73,191.0,727,363,19.4,2014,0.0
Jack Isenbarger,1438,290,1147,446,335,282,3361.0,721,264,206.0,426,182,23.0,2014,0.0
Tyler Ptacek,39,4,36,11,6,6,152.0,27,11,9.0,9,0,16.8,2014,0.0
Rokas Cesnulevicius,29,7,23,11,19,7,200.0,0,0,11.0,23,11,11.1,2014,0.0
Mike Leazer,0,1,2,0,0,0,10.0,0,0,2.0,2,0,21.4,2014,0.0
Maurice Barrow,1309,193,1041,484,429,298,3839.0,142,43,256.0,899,441,20.5,2014,0.0
Sidney Sanders Jr.,716,273,603,242,262,193,1675.0,119,39,128.0,484,203,26.3,2014,0.0
Mathias Seilund,661,71,574,234,135,112,2331.0,211,81,132.0,363,153,16.9,2014,0.0
Scooter Gillette,600,33,395,220,245,160,2122.0,2,0,112.0,393,220,14.7,2014,0.0
Jayde Dawson,74,15,79,26,26,15,219.0,34,7,23.0,45,19,26.9,2014,0.0
Kyle Pearson,124,6,104,49,32,16,367.0,29,10,19.0,75,39,19.3,2014,0.0
Jamie Adams,970,211,795,293,321,251,1886.0,401,133,207.0,394,160,28.8,2014,0.0
Reggie Lewis,1176,167,1139,432,172,124,3169.0,517,188,143.0,622,244,20.3,2014,1.0
Jamari Bradshaw,589,66,509,216,164,91,1231.0,193,66,101.0,316,150,26.3,2014,0.0
D'Andre Bullard,307,138,362,117,69,45,1539.0,91,28,127.0,271,89,16.0,2014,0.0
Muhammad Abdul-Aleem,365,49,344,127,133,84,883.0,96,27,96.0,248,100,27.1,2014,0.0
Christopher Rozier,78,3,106,28,20,14,227.0,38,8,10.0,68,20,25.4,2014,0.0
Richie Spiller,72,33,73,22,30,18,331.0,28,10,37.0,45,12,17.3,2014,0.0
Walter Davis,134,42,111,57,57,20,1112.0,2,0,40.0,109,57,7.6,2014,1.0
Greg Nelson,37,2,29,9,14,12,128.0,23,7,8.0,6,2,15.7,2014,0.0
Onyekachukwu Odi,91,6,100,34,67,23,636.0,0,0,51.0,100,34,13.6,2014,0.0
Pablo Bertone,1153,173,954,422,278,198,2625.0,316,111,211.0,638,311,25.6,2014,0.0
Dragan Sekelja,246,73,208,91,104,61,981.0,9,3,102.0,199,88,18.9,2014,0.0
Richard Morrow,136,23,117,50,60,34,580.0,6,2,47.0,111,48,17.1,2014,0.0
Grant Pelchen,21,10,19,9,10,3,131.0,0,0,2.0,19,9,10.1,2014,0.0
Tyler Pate,16,4,19,5,5,3,75.0,15,3,4.0,4,2,17.4,2014,0.0
Chase Fieler,1306,203,971,487,317,229,3458.0,327,103,201.0,644,384,19.2,2014,0.0
Kevin Boyle,21,8,19,4,10,9,106.0,15,4,7.0,4,0,14.8,2014,0.0
Tymell Murphy,984,132,680,394,258,171,2040.0,84,25,172.0,596,369,24.0,2014,0.0
Rakeem Buckles,699,65,538,250,227,158,1745.0,122,41,146.0,416,209,22.9,2014,0.0
Cody Mann,127,52,112,42,39,26,566.0,44,17,28.0,68,25,14.5,2014,0.0
Raymond Taylor,1110,462,1031,375,266,189,2941.0,507,171,245.0,524,204,24.4,2014,0.0
Ivan Jurkovic,55,3,55,21,18,13,326.0,4,0,23.0,51,21,13.3,2014,0.0
Steven Miro,81,21,70,27,28,21,401.0,17,6,20.0,53,21,12.9,2014,0.0
George Naldjieff,4,0,5,2,0,0,25.0,0,0,2.0,5,2,14.3,2014,0.0
Okaro White,1402,95,944,466,502,401,3417.0,211,69,217.0,733,397,21.0,2014,1.0
Ian Miller,977,193,802,324,227,183,2349.0,408,146,193.0,394,178,24.1,2014,0.0
Robert Gilchrist,154,10,153,68,39,14,683.0,17,4,48.0,136,64,16.8,2014,0.0
Marquez White,3,0,2,1,0,0,10.0,2,1,1.0,0,0,15.6,2014,0.0
Casey Prather,787,109,541,308,254,161,2019.0,32,10,149.0,509,298,21.5,2014,0.0
Scottie Wilbekin,953,419,769,320,246,175,3462.0,367,138,182.0,402,182,16.6,2014,0.0
Patric Young,1307,115,929,536,413,235,3638.0,0,0,187.0,929,536,19.3,2014,0.0
Will Yeguete,515,110,383,189,238,132,2347.0,25,5,124.0,358,184,14.2,2014,0.0
Billy Donovan,4,3,9,0,4,4,44.0,8,0,3.0,1,0,17.0,2014,1.0
Branden Frazier,1642,495,1447,539,479,378,4138.0,634,186,317.0,813,353,23.4,2014,0.0
Travion Leonard,335,19,300,141,97,53,1019.0,2,0,82.0,298,141,20.3,2014,0.0
Chris Whitehead,72,29,55,28,28,16,343.0,1,0,19.0,54,28,12.2,2014,0.0
Jermaine Myers,154,96,136,47,55,42,914.0,68,18,64.0,68,29,12.0,2014,0.0
Jared Fay,11,0,9,4,2,0,32.0,6,3,2.0,3,1,18.1,2014,0.0
Leo Walsh,4,1,4,2,0,0,16.0,0,0,2.0,4,2,18.1,2014,0.0
DC Gaitley,2,0,1,1,0,0,12.0,0,0,0.0,1,1,4.1,2014,0.0
Khalid Robinson,13,2,13,3,12,7,162.0,2,0,15.0,11,3,10.1,2014,0.0
Allen Huddleston,1163,170,889,341,467,307,2996.0,521,174,166.0,368,167,23.4,2014,0.0
Tanner Giddings,112,12,116,49,21,12,813.0,6,2,25.0,110,47,10.1,2014,0.0
Blake Williams,12,1,9,5,2,0,30.0,6,2,3.0,3,3,23.0,2014,0.0
Kyle Jackson,0,1,1,0,0,0,17.0,0,0,0.0,1,0,3.1,2014,0.0
Michael Salazar,0,0,2,0,0,0,10.0,2,0,0.0,0,0,10.7,2014,0.0
Charlie Reddick,746,132,609,250,181,131,2209.0,330,115,144.0,279,135,20.2,2014,0.0
Keith Belfield,186,26,159,58,54,38,681.0,81,32,41.0,78,26,17.8,2014,0.0
Dominic Early,147,17,147,50,42,27,488.0,82,20,15.0,65,30,19.7,2014,0.0
Naji Hibbert,706,168,657,242,175,117,2572.0,316,105,113.0,341,137,17.2,2014,0.0
Donta Harper,902,149,729,332,331,236,2231.0,30,2,225.0,699,330,25.7,2014,0.0
Onzie Branch,292,51,233,111,104,70,1013.0,12,0,64.0,221,111,17.6,2014,0.0
Josh Castellanos,619,369,541,173,280,204,2814.0,230,69,258.0,311,104,17.4,2014,0.0
Michael Byron,457,25,322,173,180,111,1797.0,0,0,110.0,322,173,14.8,2014,0.0
Logan Stumpf,29,2,20,10,6,5,66.0,14,4,4.0,6,6,20.6,2014,0.0
Donell Tuff,12,0,11,6,6,0,40.0,1,0,1.0,10,6,18.8,2014,0.0
Sherrod Wright,1593,138,1132,529,566,428,3530.0,316,107,263.0,816,422,24.1,2014,0.0
Bryon Allen,1048,380,871,380,283,220,3082.0,216,68,239.0,655,312,20.7,2014,0.0
Johnny Williams,468,44,426,190,152,88,1693.0,6,0,99.0,420,190,18.2,2014,0.0
Maurice Creek,841,108,664,280,178,135,1791.0,382,146,119.0,282,134,24.5,2014,0.0
Isaiah Armwood,923,118,670,331,387,256,2859.0,25,5,181.0,645,326,18.0,2014,0.0
Nemanja Mikic,742,70,690,258,70,37,2438.0,497,189,109.0,193,69,17.4,2014,0.0
Miguel Cartagena,33,32,49,11,13,7,206.0,24,4,23.0,25,7,19.0,2014,0.0
Markel Starks,1246,300,1026,438,252,205,3361.0,459,165,201.0,567,273,21.7,2014,0.0
Nate Lubick,640,252,460,260,196,113,3009.0,32,7,169.0,428,253,13.1,2014,0.0
John Caprio,29,15,30,10,22,9,154.0,3,0,17.0,27,10,20.2,2014,0.0
Tre Bussey,1206,138,1038,429,285,193,3303.0,426,155,176.0,612,274,21.4,2014,0.0
Brian Holmes,435,132,353,140,133,94,1603.0,171,61,112.0,182,79,17.2,2014,0.0
Marvin Baynham,580,49,396,221,249,138,2611.0,0,0,173.0,396,221,13.8,2014,0.0
Sam Mike,110,3,87,45,40,20,781.0,0,0,41.0,87,45,9.8,2014,0.0
Kameron Dunnican,84,13,67,36,28,12,594.0,0,0,44.0,67,36,11.2,2014,0.0
Cole Rives,8,1,11,2,4,2,36.0,8,2,1.0,3,0,20.4,2014,0.0
Manny Atkins,1140,138,841,375,290,234,2885.0,381,156,141.0,460,219,20.8,2014,0.0
Devonta White,1393,415,1120,465,431,336,3721.0,388,127,255.0,732,338,22.6,2014,0.0
Rashaad Richardson,497,53,473,186,37,24,1687.0,295,101,52.0,178,85,17.1,2014,0.0
Jaylen Hinton,41,23,32,13,27,15,210.0,2,0,4.0,30,13,12.5,2014,0.0
Denny Burguillos,40,2,33,16,17,8,339.0,0,0,13.0,33,16,8.6,2014,0.0
Kevin Shaw,23,4,24,7,4,2,56.0,22,7,4.0,2,0,28.4,2014,0.0
Darius Sharpe,3,0,2,1,0,0,7.0,2,1,1.0,0,0,23.1,2014,0.0
Trae Golden,1342,441,1013,402,511,408,3384.0,399,130,255.0,614,272,23.3,2014,0.0
Daniel Miller,1007,183,803,423,257,161,3627.0,1,0,186.0,802,423,15.9,2014,0.0
Kammeon Holsey,912,95,677,373,282,166,2473.0,0,0,207.0,677,373,21.4,2014,0.0
Stacey Poole,113,17,113,39,46,29,373.0,28,6,22.0,85,33,21.9,2014,0.0
Jason Morris,515,60,507,185,115,79,1651.0,196,66,123.0,311,119,21.5,2014,0.0
Ron Wamer,6,2,4,2,3,2,33.0,2,0,3.0,2,2,13.4,2014,0.0
Colin Gurry,0,0,0,0,0,0,7.0,0,0,1.0,0,0,7.5,2014,0.0
Tim Dixon,91,21,89,38,24,15,728.0,0,0,34.0,89,38,10.0,2014,0.0
Sam Dower,1271,79,872,490,340,271,2552.0,61,20,152.0,811,470,23.9,2014,0.0
David Stockton,661,423,526,223,207,145,2741.0,229,70,202.0,297,153,15.5,2014,1.0
Drew Barham,410,38,328,136,52,32,1161.0,257,106,39.0,71,30,17.2,2014,0.0
Gerard Coleman,917,134,799,349,322,197,2325.0,97,22,164.0,702,327,23.6,2014,0.0
Brian Bhaskar,9,1,8,3,4,1,32.0,3,2,1.0,5,1,17.6,2014,0.0
Terry Rose,619,46,546,217,63,48,1601.0,376,140,93.0,170,77,21.8,2014,0.0
Steven Danridge,309,30,255,126,126,57,1746.0,1,0,111.0,254,126,12.6,2014,0.0
Windale Glinton,85,5,77,36,19,13,385.0,2,0,20.0,75,36,13.8,2014,0.0
Tyron Bain,59,13,52,17,34,24,225.0,11,1,25.0,41,16,20.8,2014,0.0
Dion Watson,12,1,23,4,4,3,46.0,12,1,1.0,11,3,28.2,2014,0.0
Floyddell Wilson,3,0,1,0,4,3,8.0,0,0,0.0,1,0,18.2,2014,0.0
Brauhnye' Turner,33,5,52,14,16,5,195.0,2,0,9.0,50,14,18.7,2014,0.0
Travis Hawkins,0,0,0,0,0,0,0.0,0,0,0.0,0,0,0,2014,0.0
Reginald Smith,3,0,3,1,2,1,10.0,0,0,0.0,3,1,21.1,2014,0.0
Killian Larson,516,24,333,180,210,155,980.0,3,1,76.0,330,179,26.9,2014,0.0
Blake Davis,238,54,206,78,45,36,943.0,134,46,41.0,72,32,14.8,2014,0.0
Demetrius Walker,616,115,479,181,244,180,1461.0,212,74,126.0,267,107,26.2,2014,0.0
Akachi Okugo,107,63,111,29,50,35,602.0,58,14,39.0,53,15,15.0,2014,0.0
Jeremy Adams,241,24,207,70,134,87,935.0,52,14,58.0,155,56,18.4,2014,0.0
Ben Sanders,10,2,8,4,2,1,25.0,2,1,3.0,6,3,24.8,2014,0.0
Alec Brown,1678,111,1299,604,524,392,3693.0,195,78,263.0,1104,526,25.5,2014,0.0
Vincent Garrett,168,35,147,60,43,32,425.0,35,16,31.0,112,44,23.7,2014,0.0
Lamin Fulton,342,72,328,118,49,35,1228.0,213,71,82.0,115,47,18.4,2014,0.0
Du'Vaughn Maxwell,965,87,741,379,384,202,2481.0,24,5,165.0,717,374,21.3,2014,0.0
Ramon Mercado,402,49,378,131,82,63,1161.0,258,77,69.0,120,54,20.3,2014,0.0
Reggie Price,55,3,69,21,4,1,198.0,44,12,11.0,25,9,20.0,2014,0.0
Miles Jackson,30,7,20,11,7,4,127.0,8,4,7.0,12,7,11.4,2014,0.0
Oren Faulk,220,58,180,84,99,52,945.0,6,0,82.0,174,84,18.2,2014,0.0
Yasin Kolo,71,4,48,23,31,21,162.0,13,4,14.0,35,19,25.6,2014,0.0
Jeremiah Aska,2,1,3,0,3,2,24.0,3,0,1.0,0,0,12.7,2014,0.0
Adam Oresky,0,0,0,0,0,0,7.0,0,0,0.0,0,0,0.0,2014,0.0
Laurent Rivard,1270,95,872,377,276,229,3694.0,700,287,106.0,172,90,16.7,2014,0.0
Kyle Casey,1242,124,881,439,426,320,2828.0,142,44,207.0,739,395,24.9,2014,0.0
Brandyn Curry,953,488,735,316,280,204,3266.0,322,117,228.0,413,199,18.4,2014,0.0
Dee Giger,151,16,142,51,37,28,449.0,75,21,41.0,67,30,23.4,2014,0.0
Michael Hall,7,1,6,3,4,1,24.0,0,0,5.0,6,3,30.2,2014,0.0
Christian Standhardinger,1250,106,866,417,527,382,2304.0,113,34,170.0,753,383,27.7,2014,0.0
Isaac Fotu,785,53,514,308,239,168,1757.0,11,1,102.0,503,307,20.3,2014,0.0
Brandon Spearman,667,91,562,233,181,116,1925.0,246,85,86.0,316,148,18.7,2014,0.0
Davis Rozitis,262,21,178,105,84,52,905.0,0,0,44.0,178,105,14.1,2014,0.0
Michael Harper,12,1,11,4,2,1,70.0,7,3,5.0,4,1,11.8,2014,0.0
Jack Hackman,3,0,2,1,0,0,11.0,1,1,1.0,1,0,13.3,2014,0.0
Derrell Edwards,263,108,266,91,75,54,1432.0,106,27,72.0,160,64,13.3,2014,0.0
Dejuan McGaughy,299,117,285,115,55,38,1105.0,78,31,77.0,207,84,17.9,2014,0.0
Allan Chaney,581,54,425,221,164,129,1135.0,47,10,83.0,378,211,27.5,2014,0.0
Matteo Bellusci,2,0,1,0,2,2,9.0,0,0,0.0,1,0,11.5,2014,0.0
Zeke Upshaw,755,78,588,230,250,187,1583.0,327,108,112.0,261,122,26.7,2014,0.0
Stephen Nwaukoni,576,35,409,186,314,204,2284.0,0,0,140.0,409,186,15.8,2014,0.0
Adam Savion,25,9,21,8,19,9,226.0,0,0,19.0,21,8,11.2,2014,0.0
Dan Steinberg,2,0,1,1,0,0,5.0,0,0,0.0,1,1,10.3,2014,0.0
Dave Dudzinski,1366,66,1029,498,397,311,3048.0,182,59,162.0,847,439,24.5,2014,0.0
Rob Lewis,622,126,473,199,253,183,1363.0,122,41,136.0,351,158,26.4,2014,0.0
Dauson Womack,277,46,230,96,135,83,1167.0,9,2,86.0,221,94,16.1,2014,0.0
Jacob Gonzalez,7,1,6,3,0,0,13.0,3,1,1.0,3,2,26.5,2014,0.0
Brandon Morris,293,81,234,98,53,45,1055.0,126,52,50.0,108,46,14.8,2014,0.0
Tione Womack,207,150,186,79,48,30,1240.0,54,19,75.0,132,60,11.5,2014,0.0
J.J. Richardson,216,18,167,86,76,44,696.0,1,0,58.0,166,86,19.0,2014,0.0
Jimmie Jones,28,28,21,11,6,3,223.0,11,3,20.0,10,8,9.9,2014,0.0
Lawrence Paye,3,0,6,1,1,1,11.0,4,0,1.0,2,1,33.9,2014,0.0
Emmanuel Okoro,3,0,6,1,5,1,78.0,1,0,3.0,5,1,7.8,2014,0.0
Tomas Sanchez,743,237,539,219,256,213,2069.0,255,92,170.0,284,127,22.1,2014,0.0
Andre Hatchett,930,173,777,321,451,263,2866.0,101,25,162.0,676,296,21.8,2014,0.0
Avibakuro Preh,155,19,93,64,48,27,1183.0,0,0,40.0,93,64,7.2,2014,0.0
Clint Thomas,16,2,11,6,2,1,48.0,6,3,1.0,5,3,14.1,2014,0.0
Stephen Madison,1626,238,1173,544,537,403,3418.0,400,135,258.0,773,409,26.3,2014,0.0
Glen Dean,1132,373,865,339,351,279,3293.0,451,175,247.0,414,164,19.9,2014,0.0
Joe Kammerer,156,19,144,71,27,14,1095.0,2,0,48.0,142,71,9.9,2014,0.0
Allen Jiles IV,98,21,80,39,44,20,486.0,2,0,39.0,78,39,14.1,2014,0.0
Kelsey Barlow,957,273,787,326,366,247,2788.0,200,58,206.0,587,268,21.8,2014,0.0
Jordan Harks,691,67,520,289,207,112,1691.0,4,1,83.0,516,288,19.8,2014,0.0
Hayden Humes,970,131,774,338,216,162,3608.0,347,132,161.0,427,206,15.4,2014,0.0
Joey Miller,445,115,397,130,162,127,1345.0,190,58,109.0,207,72,23.3,2014,0.0
Frank Dounis,2,0,0,0,2,2,12.0,0,0,1.0,0,0,8.4,2014,0.0
Michael Middlebrooks,22,4,14,10,3,2,99.0,1,0,4.0,13,10,10.1,2014,0.0
Matt Stacho,4,1,11,2,0,0,21.0,5,0,3.0,6,2,34.0,2014,0.0
Joseph Bertrand,778,94,622,314,153,110,2366.0,116,40,140.0,506,274,18.7,2014,0.0
Jon Ekey,925,131,777,336,108,82,3359.0,468,171,89.0,309,165,14.7,2014,0.0
Anthony Horton,483,51,379,186,98,63,1234.0,139,48,83.0,240,138,20.1,2014,0.0
Ian Markolf,146,41,135,61,59,24,498.0,0,0,51.0,135,61,20.4,2014,0.0
Justin Philippe,113,22,79,41,42,31,329.0,0,0,29.0,79,41,18.4,2014,0.0
Joseph Louwagie,10,3,9,3,8,4,45.0,0,0,2.0,9,3,15.6,2014,0.0
Chris Starkes,6,4,7,2,2,1,24.0,5,1,4.0,2,1,23.6,2014,0.0
Jake Odum,1568,603,1008,452,781,590,4199.0,230,74,326.0,778,378,21.9,2014,0.0
Manny Arop,977,104,805,355,227,165,2674.0,305,102,164.0,500,253,21.3,2014,0.0
Dawon Cummings,546,138,458,185,129,95,1613.0,255,81,91.0,203,104,20.2,2014,0.0
Demetrius Moore,116,10,88,50,24,15,402.0,2,1,26.0,86,49,16.5,2014,0.0
Lucas Eitel,327,86,264,109,46,25,1489.0,209,84,54.0,55,25,12.3,2014,0.0
Will Sheehey,1120,149,873,424,275,186,2875.0,251,86,171.0,622,338,20.7,2014,0.0
Noah Vonleh,338,18,216,113,134,96,794.0,33,16,64.0,183,97,21.4,2014,1.0
Evan Gordon,1363,249,1116,456,345,260,3778.0,556,191,254.0,560,265,20.5,2014,0.0
Jeff Howard,27,7,19,7,23,13,206.0,0,0,10.0,19,7,9.8,2014,0.0
Jonny Marlin,132,107,119,37,36,32,858.0,74,26,52.0,45,11,11.0,2014,0.0
Andrew Calomeris,2,0,2,1,0,0,5.0,0,0,0.0,2,1,19.8,2014,0.0
Joe Fagan,0,0,0,0,0,0,6.0,0,0,1.0,0,0,8.2,2014,0.0
Taylor Wayer,3,0,8,1,2,0,36.0,6,1,0.0,2,0,12.7,2014,0.0
Sean Armand,1694,294,1244,566,279,214,3447.0,807,348,192.0,437,218,22.4,2014,0.0
Tre Bowman,708,66,483,244,143,120,1757.0,250,100,55.0,233,144,17.1,2014,0.0
Mike Poole,721,165,721,297,136,100,2597.0,113,27,163.0,608,270,18.8,2014,0.0
Tavon Sledge,284,143,221,111,84,53,1150.0,28,9,70.0,193,102,14.2,2014,0.0
Da'Shawn Gomez,117,85,107,36,23,16,589.0,84,29,27.0,23,7,12.1,2014,0.0
Britton Williams,109,97,93,38,44,31,655.0,13,2,44.0,80,36,12.2,2014,0.0
DeAndre Kane,2110,645,1694,732,817,492,4511.0,511,154,438.0,1183,578,27.4,2014,0.0
Melvin Ejim,1643,188,1198,596,491,359,3752.0,302,92,246.0,896,504,22.0,2014,0.0
Tyler Ellerman,9,0,10,4,4,1,43.0,0,0,1.0,10,4,14.6,2014,0.0
Roy Devyn Marble,1694,397,1359,564,595,432,3749.0,396,134,232.0,963,430,24.8,2014,0.0
Melsahn Basabe,1119,48,807,431,378,256,2731.0,2,1,180.0,805,430,21.3,2014,0.0
Zach McCabe,871,149,736,298,223,170,2472.0,312,105,174.0,424,193,20.5,2014,0.0
Luis Jacobo,1167,120,935,413,221,170,2806.0,452,171,174.0,483,242,22.4,2014,0.0
Pierre Bland,452,251,328,163,154,101,1907.0,61,25,124.0,267,138,14.3,2014,0.0
Michael Kibiloski,671,73,538,234,85,63,1967.0,358,140,88.0,180,94,17.5,2014,0.0
Will Dunn,13,0,10,5,10,3,51.0,2,0,2.0,8,5,16.9,2014,0.0
Jared Bloom,4,1,4,2,1,0,18.0,1,0,0.0,3,2,12.8,2014,0.0
Mitchell Patton,938,55,744,376,260,181,2150.0,21,5,112.0,723,371,24.3,2014,0.0
Donovan Gibbs,735,91,584,307,145,92,2680.0,79,29,126.0,505,278,15.5,2014,0.0
Ja'Rob McCallum,712,77,618,245,130,96,1883.0,337,126,121.0,281,119,22.1,2014,0.0
P.J. Hubert,293,49,259,97,31,25,919.0,200,74,41.0,59,23,18.4,2014,0.0
Cortell Busby,19,8,18,5,11,9,94.0,3,0,9.0,15,5,18.3,2014,0.0
"Linwood Ross,",18,0,19,6,8,5,39.0,5,1,1.0,14,5,32.5,2014,0.0
Julysses Nobles,1136,376,928,360,435,298,3286.0,343,118,283.0,585,242,21.5,2014,0.0
B.J. West,435,30,327,169,135,96,1074.0,8,1,81.0,319,168,22.0,2014,0.0
Jeff Stubbs,422,76,335,132,163,136,1174.0,82,22,127.0,253,110,23.1,2014,0.0
Chester Victor,3,0,4,1,0,0,6.0,3,1,1.0,1,0,41.7,2014,0.0
Rasheed James,0,0,0,0,0,0,6.0,0,0,0.0,0,0,0.0,2014,0.0
O'Barcus Taylor,0,0,0,0,0,0,0.0,0,0,0.0,0,0,0,2014,0.0
Marquis Todd,0,0,0,0,0,0,1.0,0,0,0.0,0,0,0.0,2014,0.0
Nick Cook,579,111,448,219,294,141,2396.0,3,0,130.0,445,219,16.0,2014,0.0
Teraes Clemmons,100,18,82,36,26,22,313.0,19,6,17.0,63,30,19.1,2014,0.0
Rico Sanders,169,20,176,60,18,14,557.0,113,35,21.0,63,25,19.0,2014,0.0
Giovanni Smith,52,9,47,15,10,8,255.0,39,14,5.0,8,1,11.9,2014,0.0
Mike Louder,48,0,39,19,8,7,137.0,5,3,4.0,34,16,18.3,2014,0.0
Rod McReynolds,10,7,12,4,1,1,36.0,5,1,8.0,7,3,30.3,2014,0.0
Jarvis Haywood,787,110,579,276,254,192,1582.0,114,43,157.0,465,233,26.4,2014,0.0
Keith McDougald,1192,158,1022,405,302,230,2548.0,461,152,217.0,561,253,26.6,2014,0.0
Vince Martin,311,145,249,93,112,83,1037.0,118,42,58.0,131,51,16.8,2014,0.0
RJ Slawson,582,51,463,208,200,137,2018.0,106,29,128.0,357,179,17.0,2014,0.0
Javon Dawson,538,68,468,207,161,109,1813.0,46,15,119.0,422,192,18.4,2014,0.0
Tyler Alderman,115,15,102,45,39,25,493.0,1,0,25.0,101,45,14.4,2014,0.0
Kordario Fleming,281,65,239,109,121,63,1068.0,3,0,85.0,236,109,17.6,2014,0.0
Andrey Semenov,1203,170,945,393,319,249,3321.0,441,168,182.0,504,225,20.3,2014,0.0
Christian Pierce,5,0,8,2,0,0,28.0,4,1,3.0,4,1,20.9,2014,0.0
Shane Southwell,741,271,669,269,156,108,2605.0,270,95,167.0,399,174,17.7,2014,0.0
Will Spradling,1027,331,810,309,281,227,3698.0,524,182,162.0,286,127,15.0,2014,0.0
Omari Lawrence,235,59,225,87,88,50,938.0,51,11,60.0,174,76,17.9,2014,0.0
Ryan Schultz,17,5,23,5,8,5,61.0,14,2,6.0,9,3,27.7,2014,0.0
Jack Karapetyan,2,0,4,1,0,0,20.0,0,0,0.0,4,1,10.3,2014,0.0
Andrew Wiggins,597,54,422,189,227,176,1148.0,126,43,80.0,296,146,26.3,2014,1.0
Joel Embiid,313,38,171,107,143,98,647.0,5,1,66.0,166,106,23.4,2014,1.0
Naadir Tharpe,521,304,457,175,104,87,1892.0,242,84,143.0,215,91,17.3,2014,0.0
Tarik Black,1130,41,722,443,440,244,2797.0,1,0,158.0,721,443,19.5,2014,1.0
Niko Roberts,8,7,20,2,10,4,84.0,11,0,8.0,9,2,19.6,2014,0.0
Justin Wesley,81,12,61,25,57,30,654.0,7,1,32.0,54,24,9.1,2014,0.0
Andrew Osemhen,248,21,216,87,125,74,1475.0,0,0,83.0,216,87,12.6,2014,0.0
Jordan Montgomery,115,22,91,34,45,25,361.0,61,22,24.0,30,12,19.8,2014,0.0
Kris Drees,27,3,21,11,10,5,221.0,0,0,8.0,21,11,7.7,2014,0.0
Darren Goodson,577,126,518,216,163,102,1381.0,144,43,111.0,374,173,26.4,2014,0.0
Mark Henniger,510,32,327,179,219,152,1858.0,4,0,91.0,323,179,14.4,2014,0.0
K.K. Simmons,310,76,262,97,87,66,907.0,144,50,66.0,118,47,20.8,2014,0.0
Melvin Tabb,217,17,165,74,114,68,769.0,3,1,52.0,162,73,18.1,2014,0.0
Tyler Scott,1,1,2,0,2,1,8.0,0,0,0.0,2,0,19.1,2014,0.0
Julius Randle,599,57,391,196,289,204,1233.0,18,3,101.0,373,193,25.4,2014,1.0
James Young,573,67,450,183,177,125,1296.0,235,82,75.0,215,101,23.4,2014,1.0
Jarrod Polson,140,53,113,48,43,29,800.0,48,15,42.0,65,33,11.1,2014,0.0
Jon Hood,95,17,95,32,19,15,425.0,55,16,13.0,40,16,13.8,2014,0.0
Tyreek Duren,1726,500,1267,568,543,430,4600.0,414,160,295.0,853,408,20.2,2014,0.0
Tyrone Garland,859,159,782,295,271,199,1861.0,271,70,118.0,511,225,28.9,2014,0.0
Sam Mills,1020,276,897,366,130,92,4132.0,480,196,169.0,417,170,13.9,2014,0.0
Taylor Dunn,98,14,95,30,21,11,462.0,83,27,10.0,12,3,12.9,2014,0.0
Jack Detmer,7,5,20,2,4,3,133.0,12,0,11.0,8,2,13.4,2014,0.0
Les Smith,130,31,126,38,42,34,647.0,66,20,46.0,60,18,15.9,2014,0.0
Amos Wilson,582,46,507,228,165,126,1574.0,3,0,115.0,504,228,22.2,2014,0.0
Rhon Mitchell,612,70,606,245,156,120,1594.0,22,2,149.0,584,243,25.9,2014,0.0
Octavious Green,98,10,82,35,20,9,325.0,54,19,18.0,28,16,17.2,2014,0.0
Donnell Minton,248,80,256,96,81,55,1116.0,8,1,114.0,248,95,18.1,2014,0.0
Keilan Blanks,213,72,193,68,69,54,743.0,64,23,77.0,129,45,20.1,2014,0.0
Mackey McKnight,1327,578,1040,419,472,366,3914.0,379,123,284.0,661,296,20.6,2014,0.0
Antwan Burrus,1170,60,936,475,299,217,2980.0,8,3,176.0,928,472,21.4,2014,0.0
John Caleb Sanders,1384,335,1098,457,388,290,3306.0,506,180,245.0,592,277,23.8,2014,0.0
Davon Marshall,803,173,646,253,150,124,2097.0,442,173,120.0,204,80,20.6,2014,0.0
JR Coronado,328,34,244,130,132,68,1437.0,0,0,66.0,244,130,13.4,2014,0.0
Joel Vander Pol,472,24,311,165,229,142,1645.0,0,0,110.0,311,165,16.5,2014,0.0
Casey Roberts,249,44,213,82,49,33,753.0,133,52,25.0,80,30,18.0,2014,0.0
Sommy Ogukwe,71,6,56,28,36,15,487.0,1,0,37.0,55,28,11.5,2014,0.0
Khion Sankey,443,140,342,155,165,89,1553.0,126,44,107.0,216,111,16.5,2014,0.0
Dan Jennings,649,42,476,265,259,119,1876.0,0,0,122.0,476,265,19.3,2014,0.0
Desmond Ross,13,2,17,5,3,2,69.0,7,1,3.0,10,4,15.6,2014,0.0
Javion Watson,4,5,6,1,2,1,45.0,4,1,4.0,2,0,12.2,2014,0.0
E.J. Reed,619,23,446,208,272,175,1410.0,94,28,115.0,352,180,24.3,2014,0.0
Jason Brickman,1180,1007,792,348,337,281,4241.0,491,203,432.0,301,145,15.6,2014,0.0
Troy Joseph,294,26,254,97,70,51,1127.0,149,49,48.0,105,48,14.8,2014,0.0
Gilbert Parga,143,15,104,37,74,55,349.0,48,14,23.0,56,23,23.3,2014,0.0
D.J. Griggs,110,19,104,30,43,35,437.0,50,15,20.0,54,15,16.4,2014,0.0
Darien Best,0,0,0,0,0,0,4.0,0,0,0.0,0,0,0.0,2014,0.0
Kaleb Marquis,0,0,0,0,0,0,1.0,0,0,0.0,0,0,0.0,2014,0.0
T.T. Carey,1544,194,1322,571,228,165,3273.0,644,237,185.0,678,334,24.3,2014,0.0
Karl Ziegler,618,74,445,222,230,173,1711.0,8,1,113.0,437,221,19.4,2014,0.0
Jeff Havenstein,126,24,118,48,47,30,1238.0,1,0,52.0,117,48,7.6,2014,0.0
Eric Shaw,0,0,1,0,0,0,0.0,0,0,0.0,1,0,0,2014,0.0
Elfrid Payton,1426,486,1032,501,645,394,3155.0,112,30,336.0,920,471,25.6,2014,1.0
Bryant Mbamalu,1077,119,878,385,286,205,2949.0,297,102,183.0,581,283,19.6,2014,0.0
Elridge Moore,337,103,311,129,143,78,1936.0,13,1,132.0,298,128,13.1,2014,0.0
Braylon Lazare,40,7,41,16,11,8,181.0,0,0,9.0,41,16,14.7,2014,0.0
Jayon James,519,267,460,199,233,117,1814.0,42,4,213.0,418,195,22.8,2014,0.0
Amos Olatayo,652,40,517,238,198,120,1312.0,183,56,100.0,334,182,28.7,2014,0.0
R.J. McCray,437,133,372,157,127,82,1951.0,116,41,133.0,256,116,15.4,2014,0.0
Kyle Koszuta,141,55,129,46,24,15,606.0,89,34,50.0,40,12,16.6,2014,0.0
Millaun Brown,191,15,150,84,59,23,905.0,0,0,55.0,150,84,13.6,2014,0.0
Evan Sims,9,2,13,4,4,1,91.0,1,0,6.0,12,4,12.1,2014,0.0
Leon Carswell II,2,0,0,0,2,2,5.0,0,0,2.0,0,0,31.2,2014,0.0
Colton Ponder,0,0,1,0,0,0,3.0,0,0,0.0,1,0,17.6,2014,0.0
Johnny O'Bryant,1155,115,956,446,415,257,2465.0,27,6,267.0,929,440,28.2,2014,0.0
Andre Stringer,1365,314,1122,421,357,281,3709.0,680,242,229.0,442,179,20.4,2014,0.0
Shavon Coleman,636,90,517,224,181,131,1730.0,166,57,108.0,351,167,19.9,2014,0.0
Chris Anderson,594,55,501,220,178,116,1365.0,129,38,99.0,372,182,23.7,2014,0.0
Kenyon McNeaill,1147,223,927,351,293,221,3049.0,613,224,203.0,314,127,20.3,2014,0.0
Jaron Johnson,494,36,349,167,159,116,1308.0,143,44,53.0,206,123,17.2,2014,0.0
Cordarius Johnson,1003,107,919,347,226,144,2750.0,533,165,164.0,386,182,21.1,2014,0.0
Isaiah Massey,223,16,165,83,80,56,759.0,2,1,30.0,163,82,14.6,2014,0.0
Gilbert Talbot,101,4,78,42,37,17,246.0,0,0,18.0,78,42,21.8,2014,0.0
Stojan Gjuroski,45,8,61,16,8,3,193.0,44,10,12.0,17,6,19.0,2014,0.0
Josh Butler,0,0,0,0,0,0,1.0,0,0,0.0,0,0,0.0,2014,0.0
Russ Smith,1908,378,1501,620,642,488,3228.0,521,180,316.0,980,440,32.6,2014,1.0
Luke Hancock,1370,373,950,430,439,345,3439.0,453,165,239.0,497,265,20.6,2014,0.0
Stephan Van Treese,279,48,181,119,80,40,1719.0,2,1,62.0,179,118,8.1,2014,0.0
Chane Behanan,852,86,641,333,324,179,2280.0,48,7,150.0,593,326,20.7,2014,0.0
Tim Henderson,115,32,106,41,14,8,444.0,75,25,19.0,31,16,14.6,2014,0.0
Cody Johnson,61,5,52,25,6,4,193.0,19,7,10.0,33,18,18.8,2014,0.0
Tony Nixon,468,52,452,162,101,61,1597.0,260,83,71.0,192,79,18.2,2014,0.0
Jeremy King,27,1,14,12,9,3,77.0,0,0,7.0,14,12,18.4,2014,0.0
Bill Clark,18,13,30,7,4,2,136.0,13,2,12.0,17,5,18.1,2014,0.0
Derrick Boone,1,0,5,0,2,1,15.0,3,0,0.0,2,0,22.4,2014,0.0
Anthony Ireland,2172,557,1774,736,633,504,4633.0,568,196,363.0,1206,540,26.2,2014,0.0
Alex Osborne,536,45,428,218,200,100,2119.0,0,0,104.0,428,218,14.7,2014,0.0
C.J. Blackwell,412,43,409,158,51,34,1188.0,188,62,57.0,221,96,20.4,2014,0.0
Nino Jackson,11,4,18,4,3,2,41.0,7,1,3.0,11,3,26.2,2014,0.0
Alozie Erondu,4,0,4,2,0,0,21.0,0,0,0.0,4,2,9.1,2014,0.0
Dylon Cormier,1659,210,1280,552,662,459,3662.0,340,96,182.0,940,456,25.1,2014,0.0
Jordan Latham,414,55,386,159,148,94,1604.0,7,2,103.0,379,157,18.2,2014,0.0
R.J. Williams,438,261,367,133,191,140,2183.0,104,32,154.0,263,101,14.6,2014,0.0
Damion Rashford,18,2,33,7,8,2,115.0,10,2,8.0,23,5,20.4,2014,0.0
Jevon Patton,9,17,12,2,7,5,101.0,3,0,9.0,9,2,12.6,2014,0.0
Chido Onyiuke,5,1,4,1,4,3,46.0,0,0,3.0,4,1,10.1,2014,0.0
Dimitry Akanda-Coronel,318,43,290,113,93,57,704.0,113,35,64.0,177,78,27.3,2014,0.0
Kilian Cato,225,21,209,79,23,18,798.0,142,49,33.0,67,30,15.8,2014,0.0
Stefan Micovic,28,1,26,10,14,8,175.0,2,0,15.0,24,10,13.2,2014,0.0
George Beamon,1843,136,1367,608,645,504,3414.0,342,123,226.0,1025,485,28.0,2014,0.0
Michael Alvarado,1170,364,884,346,565,420,3175.0,193,58,299.0,691,288,23.4,2014,0.0
Rhamel Brown,1172,79,867,478,463,216,3155.0,4,0,202.0,863,478,21.1,2014,0.0
CJ Jones,68,36,96,24,26,15,427.0,30,5,39.0,66,19,18.5,2014,0.0
Adam Lacey,2,0,3,1,0,0,23.0,0,0,3.0,3,1,14.3,2014,0.0
Jay Bowie,988,116,762,341,201,163,2962.0,344,143,155.0,418,198,17.6,2014,0.0
Adam Kemp,973,61,718,356,432,261,3055.0,0,0,185.0,718,356,18.6,2014,0.0
Pieter Prinsolo,149,6,141,54,39,26,932.0,47,15,39.0,94,39,10.9,2014,0.0
Isaiah Morton,505,224,462,159,158,102,2007.0,281,85,179.0,181,74,18.2,2014,0.0
Patrick Ramsey,14,0,10,5,1,0,31.0,8,4,0.0,2,1,17.4,2014,0.0
Davante Gardner,1287,103,767,427,544,430,2410.0,23,3,144.0,744,424,24.8,2014,0.0
Jamil Wilson,1077,205,908,397,277,196,3067.0,259,87,175.0,649,310,20.3,2014,1.0
Todd Mayo,738,119,544,231,256,203,1777.0,229,73,140.0,315,158,22.9,2014,0.0
Jake Thomas,1143,201,859,327,291,237,3224.0,658,252,145.0,201,75,17.2,2014,0.0
Chris Otule,615,19,409,240,256,135,2075.0,0,0,128.0,409,240,16.2,2014,0.0
Dylan Flood,2,0,3,1,0,0,11.0,1,0,0.0,2,1,14.0,2014,0.0
TyQuane Goard,242,30,172,91,91,60,995.0,4,0,40.0,168,91,12.5,2014,0.0
Elijah Pittman,709,54,484,234,233,148,1281.0,250,93,90.0,234,141,25.8,2014,0.0
Youssoupha Mbao,30,9,28,9,28,12,491.0,0,0,39.0,28,9,8.1,2014,0.0
Kevin McNair,6,0,2,1,5,4,9.0,1,0,0.0,1,1,23.5,2014,0.0
Chase Plummer,1307,144,1140,457,538,332,2708.0,202,61,302.0,938,396,31.6,2014,0.0
Quentin Jones,337,123,301,111,92,64,1522.0,131,51,100.0,170,60,14.7,2014,0.0
Brett Roseboro,419,24,376,171,122,73,1320.0,15,4,109.0,361,167,21.0,2014,0.0
Bryan Harris,99,7,81,29,35,29,0,44,12,0,37,17,0,2014,0.0
Joey Getz,302,96,282,111,81,58,1210.0,64,22,90.0,218,89,17.1,2014,0.0
Troy Snyder,777,104,645,279,251,166,2108.0,181,53,144.0,464,226,22.1,2014,0.0
Kyree Jones,501,88,437,145,151,132,1231.0,253,79,71.0,184,66,24.1,2014,0.0
Louis Bell,643,120,646,219,82,56,2329.0,459,149,118.0,187,70,17.3,2014,0.0
Francis Ezeiru,158,3,136,63,78,32,664.0,0,0,41.0,136,63,16.5,2014,0.0
Pina Guillaume,190,17,190,80,44,25,985.0,17,5,55.0,173,75,13.8,2014,0.0
Maceio Choice,2,0,2,1,0,0,8.0,1,0,0.0,1,1,12.8,2014,0.0
Anfernee Robinson,0,0,1,0,0,0,4.0,0,0,1.0,1,0,25.5,2014,0.0
Brandon Turner,0,0,0,0,0,0,4.0,0,0,0.0,0,0,0.0,2014,0.0
John Auslander,21,2,20,7,11,6,132.0,8,1,8.0,12,6,12.7,2014,0.0
Conner Lipinski,7,1,1,1,6,4,17.0,1,1,2.0,0,0,17.3,2014,0.0
A.J. Metz,0,0,0,0,0,0,1.0,0,0,0.0,0,0,0.0,2014,0.0
Akeem Williams,442,95,379,145,122,98,896.0,157,54,90.0,222,91,31.7,2014,0.0
Antonio Bivins,218,7,142,72,97,74,440.0,2,0,27.0,140,72,26.4,2014,0.0
Parris Massey,66,7,47,28,21,10,311.0,0,0,6.0,47,28,10.9,2014,0.0
Kennedy Chukwuocha,20,3,19,7,11,6,171.0,1,0,15.0,18,7,12.4,2014,0.0
Carlos Taylor,17,0,22,6,0,0,47.0,16,5,4.0,6,1,29.9,2014,0.0
Michael Gelineau,7,0,6,2,3,3,9.0,1,0,0.0,5,2,44.5,2014,0.0
James McDonnell,6,0,3,3,0,0,28.0,0,0,1.0,3,3,7.7,2014,0.0
Andrew Nene,0,0,0,0,0,0,4.0,0,0,0.0,0,0,0.0,2014,0.0
Chaz Williams,1978,840,1559,634,667,514,4665.0,521,196,437.0,1038,438,23.5,2014,0.0
Sampson Carter,963,104,765,316,370,272,2946.0,224,59,179.0,541,257,18.2,2014,0.0
Raphiael Putney,1019,155,862,385,172,128,2785.0,380,121,210.0,482,264,19.7,2014,0.0
Clyde Santee,25,2,15,9,5,3,42.0,9,4,3.0,6,5,23.2,2014,0.0
Ledrick Eackles,1008,159,834,301,398,291,2131.0,360,115,181.0,474,186,27.3,2014,0.0
Adrian Fields,474,56,478,157,156,110,1784.0,179,50,96.0,299,107,18.3,2014,0.0
Brandon Regis,181,47,211,65,56,32,670.0,89,19,54.0,122,46,21.6,2014,0.0
Pete Kpan,63,7,41,22,28,19,268.0,1,0,10.0,40,22,12.1,2014,0.0
Joe Jackson,1687,564,1184,540,661,508,3983.0,293,99,373.0,891,441,23.3,2014,0.0
Michael Dixon,1459,365,1045,480,391,333,2987.0,442,166,201.0,603,314,23.6,2014,0.0
Geron Johnson,644,237,560,239,154,100,1897.0,213,66,178.0,347,173,20.8,2014,0.0
David Pellom,702,103,480,296,207,105,2359.0,28,5,129.0,452,291,15.2,2014,0.0
Anthony Cole,6,0,5,1,4,4,19.0,1,0,0.0,4,1,17.6,2014,0.0
Trey Draper,8,1,17,1,11,5,44.0,10,1,6.0,7,0,31.5,2014,0.0
Langston Hall,1579,633,1221,481,447,361,4541.0,677,256,322.0,544,225,20.5,2014,0.0
Daniel Coursey,935,40,686,390,231,155,2277.0,0,0,129.0,686,390,21.7,2014,0.0
Bud Thomas,1059,275,857,397,176,104,3748.0,477,161,170.0,380,236,15.8,2014,0.0
Anthony White Jr.,451,51,340,150,100,81,1143.0,175,70,37.0,165,80,19.8,2014,0.0
Jake Gollon,1153,320,891,392,345,279,3762.0,260,90,297.0,631,302,19.1,2014,0.0
Monty Brown,522,26,333,180,234,162,1332.0,0,0,111.0,333,180,22.3,2014,0.0
Kevin Canevari,136,129,116,45,25,22,1011.0,66,24,81.0,50,21,11.0,2014,0.0
Rion Brown,1124,144,930,377,262,196,3192.0,523,174,127.0,407,203,20.4,2014,0.0
Garrius Adams,804,197,708,261,267,177,2976.0,360,105,161.0,348,156,18.2,2014,0.0
Donnavan Kirk,551,24,476,220,124,84,2166.0,82,27,90.0,394,193,15.2,2014,0.0
Erik Swoope,291,31,206,107,130,75,1190.0,10,2,31.0,196,105,13.9,2014,0.0
Raphael Akpejiori,97,5,66,28,67,41,593.0,0,0,22.0,66,28,10.9,2014,0.0
Justin Heller,4,2,9,2,2,0,20.0,5,0,4.0,4,2,38.5,2014,0.0
Steve Sorenson,1,0,0,0,3,1,12.0,0,0,3.0,0,0,19.9,2014,0.0
Will Felder,1411,118,1056,517,391,306,3431.0,237,71,256.0,819,446,23.1,2014,0.0
Quinten Rollins,734,391,613,269,284,175,3447.0,87,21,259.0,526,248,16.0,2014,0.0
Bill Edwards,289,59,279,104,55,47,921.0,107,34,84.0,172,70,23.2,2014,1.0
Blake McLimans,91,9,107,37,6,5,415.0,63,12,12.0,44,25,16.3,2014,0.0
Philip Bennett,3,0,1,1,0,0,12.0,1,1,0.0,0,0,4.4,2014,0.0
Gary Harris,1025,140,784,345,240,189,2141.0,388,146,111.0,396,199,24.6,2014,1.0
Adreian Payne,1232,85,850,447,367,277,2759.0,149,61,187.0,701,386,22.9,2014,1.0
Keith Appling,1509,465,1140,491,520,389,4229.0,413,138,296.0,727,353,20.7,2014,1.0
Alex Gauna,144,10,113,63,40,18,562.0,1,0,33.0,112,63,15.3,2014,0.0
Russell Byrd,110,25,121,35,32,18,526.0,95,22,28.0,26,13,16.3,2014,0.0
Dan Chapman,5,2,14,2,0,0,52.0,6,1,2.0,8,1,16.0,2014,0.0
Nik Stauskas,1060,170,692,323,291,242,2471.0,390,172,111.0,302,151,21.0,2014,1.0
Glenn Robinson III,912,87,665,349,220,158,2506.0,179,56,78.0,486,293,18.6,2014,1.0
Jordan Morgan,973,64,664,419,239,135,2988.0,0,0,171.0,664,419,17.9,2014,0.0
Mitch McGary,367,37,279,164,76,39,967.0,2,0,60.0,277,164,21.0,2014,1.0
Cole McConnell,4,0,3,1,2,1,10.0,3,1,0.0,0,0,22.2,2014,0.0
Brad Anlauf,2,1,4,1,0,0,16.0,0,0,1.0,4,1,17.5,2014,0.0
Neiko Hunter,698,43,541,264,196,136,1541.0,100,34,102.0,441,230,24.6,2014,0.0
Kerry Hammonds,869,206,644,273,245,183,2699.0,375,140,153.0,269,133,17.3,2014,0.0
Trantell Knight,388,238,279,136,183,103,1483.0,51,13,138.0,228,123,17.5,2014,0.0
Eric Wortham Jr.,31,4,19,10,11,7,75.0,8,4,4.0,11,6,19.3,2014,0.0
Tavarres Jefferson,22,11,26,9,0,0,121.0,15,4,9.0,11,5,10.3,2014,0.0
Tharone Chilton,21,2,12,7,7,6,40.0,5,1,3.0,7,6,23.5,2014,0.0
Torin Walker,105,4,89,38,39,29,377.0,0,0,24.0,89,38,18.0,2014,0.0
Zane Gibson,22,21,23,5,11,8,251.0,18,4,10.0,5,1,7.8,2014,0.0
Blake Johnson,1,1,2,0,2,1,6.0,1,0,0.0,1,0,25.3,2014,0.0
Ronald Ross,0,0,1,0,0,0,5.0,0,0,1.0,1,0,20.6,2014,0.0
Jordan Aaron,918,205,773,288,247,207,2161.0,392,135,188.0,381,153,25.9,2014,0.0
Kyle Kelm,904,122,668,309,359,241,2805.0,182,45,171.0,486,264,18.7,2014,0.0
Malcolm Moore,179,23,145,65,57,38,633.0,34,11,41.0,111,54,17.8,2014,0.0
Thierno Niang,98,31,101,36,24,14,494.0,41,12,45.0,60,24,16.5,2014,0.0
Mitch Roelke,68,19,53,20,17,11,287.0,41,17,17.0,12,3,14.2,2014,0.0
Quinton Gustavson,39,4,31,14,11,5,133.0,16,6,4.0,15,8,15.7,2014,0.0
Austin Hollins,1321,293,1050,452,303,236,3875.0,530,181,198.0,520,271,18.9,2014,0.0
Oto Osenieks,334,67,308,122,102,64,1231.0,111,26,74.0,197,96,18.5,2014,0.0
Maverick Ahanmisi,356,143,275,106,132,96,1413.0,138,48,113.0,137,58,16.7,2014,0.0
Jasen Baranowski,0,0,0,0,0,0,2.0,0,0,0.0,0,0,0.0,2014,0.0
Colin Borchert,546,80,500,203,94,67,1651.0,229,73,133.0,271,130,20.9,2014,0.0
Andre Applewhite,66,16,41,17,43,29,214.0,9,3,20.0,32,14,19.5,2014,0.0
Jacoby Davis,61,19,74,20,5,4,316.0,53,17,17.0,21,3,15.1,2014,0.0
Tyson Cunningham,133,56,123,43,28,20,918.0,75,27,51.0,48,16,10.4,2014,0.0
Tevin Moore,15,0,15,5,8,3,52.0,8,2,3.0,7,3,21.4,2014,0.0
De'Runnya Wilson,6,3,9,1,4,4,52.0,2,0,1.0,7,1,11.7,2014,0.0
Blake Ralling,259,39,246,85,76,53,1079.0,116,36,59.0,130,49,15.1,2014,0.0
Daniel Hurtt,125,9,117,52,27,14,365.0,23,7,13.0,94,45,18.3,2014,0.0
Julius Francis,239,15,268,95,81,47,1002.0,8,2,86.0,260,93,18.7,2014,0.0
Cameron Dobbs,227,28,248,82,29,18,549.0,168,45,28.0,80,37,25.1,2014,0.0
Darryl Marshall,302,113,262,89,115,79,1075.0,144,45,86.0,118,44,17.9,2014,0.0
Cordarius Samples,133,36,104,43,57,37,405.0,22,10,50.0,82,33,21.3,2014,0.0
Ervin Thomas,127,41,147,49,36,19,671.0,47,10,39.0,100,39,14.5,2014,0.0
Thaddeus Fauntleroy,34,24,44,10,18,13,163.0,17,1,20.0,27,9,20.8,2014,0.0
Cortlan Henry,84,13,97,32,17,14,525.0,25,6,29.0,72,26,12.2,2014,0.0
Darryl Wright,2,1,3,1,0,0,7.0,0,0,1.0,3,1,26.7,2014,0.0
Marshall Henderson,1647,151,1341,495,382,325,2891.0,965,332,168.0,376,163,28.8,2014,0.0
Derrick Millinghaus,371,127,358,123,125,85,1001.0,139,40,61.0,219,83,23.0,2014,0.0
Cade Peeper,0,1,0,0,0,0,6.0,0,0,1.0,0,0,7.9,2014,0.0
Nelson Kirksey,623,89,452,221,199,135,1513.0,129,46,134.0,323,175,22.8,2014,0.0
Trinity Hall,923,75,785,324,341,220,2675.0,217,55,196.0,568,269,22.3,2014,0.0
Fred Chatmon,589,21,470,246,208,95,1911.0,30,2,134.0,440,244,19.1,2014,0.0
Caleb Johnson,149,15,112,50,44,31,595.0,38,18,26.0,74,32,13.4,2014,0.0
John Burke,125,10,103,44,32,26,405.0,39,11,34.0,64,33,19.1,2014,0.0
Jacobby Bledsoe,52,30,66,17,16,10,390.0,46,8,18.0,20,9,11.6,2014,0.0
Kirk Korver,597,67,479,193,141,111,2038.0,308,100,107.0,171,93,17.1,2014,0.0
Jamar Gulley,806,92,626,298,234,166,1682.0,135,44,97.0,491,254,27.1,2014,0.0
Emmanuel Addo,729,66,520,258,243,174,1811.0,96,39,139.0,424,219,22.2,2014,0.0
Keith Pickens,568,105,420,199,247,159,2237.0,35,11,116.0,385,188,16.1,2014,0.0
Nathan Scheer,503,97,423,157,116,85,2416.0,308,104,91.0,115,53,13.1,2014,0.0
Bruce Marshall,61,2,53,19,20,13,286.0,31,10,12.0,22,9,14.6,2014,0.0
Michael Simpson,38,9,67,15,0,0,203.0,46,8,2.0,21,7,19.2,2014,0.0
Jabari Brown,1052,103,696,307,385,301,2164.0,355,137,136.0,341,170,24.0,2014,1.0
Jordan Clarkson,1433,249,1075,473,487,392,2952.0,295,95,254.0,780,378,27.8,2014,1.0
Earnest Ross,1339,178,1064,417,442,336,3391.0,525,169,228.0,539,248,22.5,2014,0.0
Anthony Criswell,335,38,283,129,97,68,1268.0,32,9,62.0,251,120,15.7,2014,0.0
Danny Feldmann,21,3,22,10,2,0,166.0,10,1,9.0,12,9,9.7,2014,0.0
Khalil Brown,163,14,131,55,59,40,555.0,47,13,37.0,84,42,17.2,2014,0.0
Greg Noack,54,6,40,24,8,6,209.0,0,0,8.0,40,24,12.0,2014,0.0
Jalen Palm,62,20,68,19,23,16,285.0,37,8,21.0,31,11,17.1,2014,0.0
Marcelo Ruediger,16,1,16,5,12,6,112.0,0,0,6.0,16,5,12.0,2014,0.0
Vuk Baletic,0,1,3,0,2,0,14.0,0,0,0.0,3,0,13.7,2014,0.0
Flavien Davis,700,58,511,247,294,195,1519.0,43,11,103.0,468,236,26.2,2014,0.0
Paul Egwuonwu,534,65,429,205,171,124,1594.0,5,0,101.0,424,205,20.2,2014,0.0
Antonio Biglow,494,154,423,169,168,120,1422.0,121,36,101.0,302,133,22.3,2014,0.0
Calen Coleman,392,45,328,135,65,46,1126.0,205,76,55.0,123,59,19.3,2014,0.0
Kareem Jamar,1673,407,1193,565,556,381,4032.0,426,162,263.0,767,403,23.8,2014,0.0
Eric Hutchison,262,10,183,96,101,70,1155.0,0,0,55.0,183,96,14.0,2014,0.0
Andy Martin,127,9,92,45,48,37,532.0,0,0,23.0,92,45,14.9,2014,0.0
Nick Emerson,6,0,10,3,1,0,33.0,5,0,6.0,5,3,28.7,2014,0.0
Morgan Young,3,0,4,1,2,0,18.0,4,1,0.0,0,0,15.5,2014,0.0
Drew Kelly,1013,103,758,339,365,271,2785.0,213,64,179.0,545,275,20.0,2014,0.0
Chad Posthumus,574,20,427,214,249,146,1480.0,0,0,98.0,427,214,20.5,2014,0.0
Luka Pajkovic,276,45,240,84,114,71,788.0,138,37,96.0,102,47,23.6,2014,0.0
Greg Dotson,142,21,104,52,57,38,482.0,10,0,20.0,94,52,14.8,2014,0.0
Bakari Turner,355,38,294,114,132,83,776.0,157,44,61.0,137,70,25.3,2014,0.0
Jordan Percell,104,12,85,37,51,28,640.0,8,2,23.0,77,35,10.2,2014,0.0
DeAndre Leatherwood,31,2,23,14,9,3,88.0,0,0,6.0,23,14,17.9,2014,0.0
Justin Black,1399,274,1177,486,479,297,3173.0,439,130,280.0,738,356,25.9,2014,0.0
Anthony Hubbard,701,111,535,244,314,186,1785.0,116,27,146.0,419,217,22.7,2014,0.0
Shaquille Duncan,438,44,338,186,143,66,1505.0,2,0,93.0,336,186,16.3,2014,0.0
Thair Heath,85,11,65,37,26,11,341.0,0,0,27.0,65,37,15.0,2014,0.0
Willis Turnipseed,6,0,3,3,0,0,12.0,0,0,1.0,3,3,16.0,2014,0.0
Hassante Manning,5,4,7,2,2,1,60.0,0,0,2.0,7,2,7.9,2014,0.0
Rashad Whack,1075,103,851,345,274,214,2269.0,482,171,133.0,369,174,25.0,2014,0.0
Julian Norfleet,1605,423,1402,569,312,225,4175.0,713,242,279.0,689,327,22.7,2014,0.0
Sam Prescott,1210,150,1053,418,288,210,3148.0,478,164,200.0,575,254,22.9,2014,0.0
Will Lyle,6,0,6,3,0,0,25.0,0,0,1.0,6,3,14.1,2014,0.0
Dexter Fields,849,123,722,290,85,57,2836.0,565,212,101.0,157,78,15.7,2014,0.0
C.J. Ford,99,48,95,34,47,28,512.0,21,3,32.0,74,31,14.7,2014,0.0
Zay Henderson,29,1,18,13,13,3,166.0,0,0,9.0,18,13,10.1,2014,0.0
Thurgood Wynn,339,65,265,114,160,94,1169.0,61,17,70.0,204,97,19.3,2014,0.0
James Loupos,283,40,254,96,132,79,1529.0,40,12,78.0,214,84,13.9,2014,0.0
Payne Andrus,10,7,18,5,1,0,72.0,5,0,3.0,13,5,16.1,2014,0.0
Jerome Alexander,74,5,83,32,18,10,245.0,1,0,16.0,82,32,25.2,2014,0.0
Enouma Ebinum,0,0,1,0,0,0,4.0,0,0,0.0,1,0,13.5,2014,0.0
Phil Guglielmo,64,3,63,22,10,8,206.0,35,12,10.0,28,10,21.7,2014,0.0
John Karhoff,794,134,634,312,211,164,1694.0,25,6,98.0,609,306,23.8,2014,0.0
Justin Simmons,823,110,709,305,180,143,1511.0,216,70,146.0,493,235,30.4,2014,0.0
Alex Phillips,411,86,326,146,90,67,1161.0,135,52,100.0,191,94,19.7,2014,0.0
Matt Hagerbaumer,201,37,120,90,42,21,1068.0,0,0,32.0,120,90,7.8,2014,0.0
Caleb Steffensmeier,218,102,185,69,46,35,1072.0,125,45,41.0,60,24,11.2,2014,0.0
Simon Krych,86,3,69,34,42,18,340.0,2,0,7.0,67,34,13.7,2014,0.0
Ray Gallegos,791,109,816,292,79,49,2786.0,517,158,79.0,299,134,18.5,2014,0.0
Mike Peltz,17,18,18,4,14,7,267.0,3,2,16.0,15,2,8.6,2014,0.0
Khem Birch,611,55,392,208,292,195,1755.0,0,0,82.0,392,208,17.6,2014,1.0
Roscoe Smith,748,43,595,269,252,176,2545.0,122,34,103.0,473,235,16.4,2014,0.0
Kevin Olekaibe,1533,187,1361,508,310,243,3716.0,802,274,178.0,559,234,23.9,2014,0.0
Carlos Lopez-Sosa,430,48,298,159,192,110,1202.0,9,2,85.0,289,157,19.8,2014,0.0
Jerry Evans,985,100,805,344,251,188,3259.0,314,109,149.0,491,235,17.1,2014,0.0
Ali Fall,108,16,91,39,44,30,543.0,0,0,40.0,91,39,14.7,2014,0.0
Richard Bell,2,3,4,1,0,0,50.0,1,0,1.0,3,1,5.3,2014,0.0
Jordon Bronner,692,260,607,223,233,160,3128.0,275,86,129.0,332,137,14.7,2014,0.0
Patrick Konan,1043,94,877,365,308,196,2795.0,342,117,212.0,535,248,23.6,2014,0.0
Chris Pelcher,570,47,450,235,166,100,1600.0,0,0,88.0,450,235,20.6,2014,0.0
Scott Morris,391,43,386,135,14,10,1403.0,313,111,53.0,73,24,17.2,2014,0.0
Sim Bhullar,665,68,417,264,276,137,1643.0,0,0,107.0,417,264,20.4,2014,1.0
Renaldo Dixon,578,62,394,202,215,164,1835.0,33,10,106.0,361,192,16.6,2014,0.0
Kevin Aronis,380,23,305,125,30,19,1039.0,273,111,26.0,32,14,17.0,2014,0.0
Cameron Bairstow,1239,102,808,418,559,401,2787.0,6,2,157.0,802,416,23.3,2014,1.0
Kendall Williams,1813,617,1216,526,725,556,4450.0,539,205,286.0,677,321,21.7,2014,0.0
Alex Kirk,1010,64,791,386,297,203,2552.0,139,35,132.0,652,351,22.1,2014,1.0
Merv Lindsay,23,6,26,10,6,1,155.0,8,2,3.0,18,8,10.7,2014,0.0
Chris Perez,9,2,9,3,6,3,26.0,2,0,3.0,7,3,29.5,2014,0.0
Cory Dixon,603,65,393,196,301,209,1346.0,5,2,155.0,388,194,24.2,2014,0.0
Tradarrius McPhearson,380,76,316,126,138,89,1222.0,120,39,94.0,196,87,18.4,2014,0.0
Isaac Mack,348,103,347,129,83,56,1184.0,119,34,103.0,228,95,19.5,2014,0.0
Matt Derenbecker,458,67,399,159,78,52,1429.0,243,88,65.0,156,71,17.7,2014,0.0
Teris Bourgeois,30,10,31,11,8,6,150.0,9,2,8.0,22,9,13.4,2014,0.0
Micah Walker,30,2,33,9,12,7,119.0,19,5,10.0,14,4,19.2,2014,0.0
John Reese,23,6,23,9,2,1,99.0,11,4,4.0,12,5,13.3,2014,0.0
Tommy Hobbs,40,2,29,15,9,6,70.0,9,4,4.0,20,11,25.3,2014,0.0
Andre Gonzague,3,0,2,1,0,0,4.0,2,1,0.0,0,0,23.5,2014,0.0
Benjamin James,0,0,0,0,0,0,5.0,0,0,3.0,0,0,28.3,2014,0.0
Marvin Jordan,1278,253,1152,420,234,164,3889.0,814,274,184.0,338,146,18.1,2014,0.0
Marcus Ware,848,70,698,293,422,262,2331.0,3,0,186.0,695,293,23.1,2014,0.0
Aaron Bodie,0,0,0,0,0,0,4.0,0,0,0.0,0,0,0.0,2014,0.0
Dantrell Thomas,1215,207,902,431,401,300,2575.0,180,53,187.0,722,378,26.0,2014,0.0
Jeremy Smith,846,112,604,327,235,162,2181.0,88,30,171.0,516,297,21.1,2014,0.0
Cade Towers,24,2,29,10,8,2,111.0,5,2,8.0,24,8,19.2,2014,0.0
Pedro Maciel,66,59,60,21,13,8,595.0,49,16,34.0,11,5,8.7,2014,0.0
Piers Carroll,6,2,3,2,0,0,7.0,3,2,0.0,0,0,22.4,2014,0.0
Jake Duncan,127,13,99,42,23,17,316.0,71,26,16.0,28,16,20.2,2014,0.0
Nigel Sydnor,243,44,197,79,96,60,818.0,79,25,46.0,118,54,17.6,2014,0.0
Pendarvis Williams,1646,269,1166,545,417,339,3913.0,566,217,214.0,600,328,20.2,2014,0.0
Malcolm Hawkins,911,118,712,280,355,253,2112.0,278,98,191.0,434,182,25.7,2014,0.0
Brandon Goode,679,27,459,274,225,131,1825.0,1,0,116.0,458,274,18.8,2014,0.0
Anell Alexis,576,53,438,192,186,147,1643.0,129,45,116.0,309,147,20.1,2014,0.0
Riley Maye,174,14,141,74,29,17,558.0,19,9,30.0,122,65,16.9,2014,0.0
Marese Phelps,195,104,226,73,39,22,886.0,98,27,82.0,128,46,18.7,2014,0.0
Jordan Weathers,94,20,101,33,37,21,461.0,41,7,25.0,60,26,15.6,2014,0.0
Zieyik Estime,56,1,59,19,2,2,148.0,50,16,6.0,9,3,22.2,2014,0.0
Jaron Lane,1297,128,832,431,489,366,2934.0,191,69,167.0,641,362,20.3,2014,0.0
D.J. Cunningham,998,97,815,394,317,209,2650.0,4,1,221.0,811,393,21.6,2014,0.0
Mike Bedulskis,14,0,7,4,9,6,18.0,0,0,1.0,7,4,33.2,2014,0.0
Alex Biggerstaff,3,5,11,1,2,1,49.0,8,0,1.0,3,1,12.9,2014,0.0
Lamont Middleton,1016,149,783,274,518,388,2267.0,275,80,198.0,508,194,27.6,2014,0.0
Jeremy Underwood,769,255,634,207,348,241,2761.0,345,114,313.0,289,93,20.1,2014,0.0
Waylan Siverand,134,10,96,49,65,36,581.0,0,0,35.0,96,49,13.9,2014,0.0
Michael Briscoe,26,29,37,11,11,3,276.0,11,1,24.0,26,10,12.1,2014,0.0
Miles Jenkins,0,0,0,0,0,0,1.0,0,0,0.0,0,0,0.0,2014,0.0
Jeremy Ingram,1525,123,1062,459,568,437,3035.0,464,170,201.0,598,289,26.6,2014,0.0
Alfonzo Houston,430,62,326,143,182,135,1263.0,41,9,57.0,285,134,19.6,2014,0.0
Emanuel Chapman,533,617,480,194,113,83,3158.0,181,62,276.0,299,132,13.5,2014,0.0
Reggie Groves,489,211,496,153,142,95,2150.0,304,88,157.0,192,65,17.1,2014,0.0
Ebuka Anyaorah,457,50,356,147,152,108,1327.0,160,55,100.0,196,92,20.6,2014,0.0
Juwan Moody,32,20,31,11,3,1,137.0,23,9,12.0,8,2,17.0,2014,0.0
Antonin Galaya,101,12,111,33,12,9,284.0,93,26,15.0,18,7,24.8,2014,0.0
Ramon Eaton,90,7,89,30,44,30,429.0,8,0,33.0,81,30,17.7,2014,0.0
Kyle Cain,878,78,761,368,192,133,2299.0,32,9,153.0,729,359,22.7,2014,0.0
Drew Parker,371,294,351,120,70,50,2467.0,227,81,169.0,124,39,10.8,2014,0.0
Tyler McNeely,7,0,6,2,4,3,18.0,0,0,3.0,6,2,26.8,2014,0.0
T.J. Warren,1296,68,951,528,298,195,2182.0,143,45,117.0,808,483,28.6,2014,1.0
Jordan Vandenberg,238,47,175,107,48,24,1317.0,1,0,45.0,174,107,9.5,2014,0.0
Jevoni Robinson,7,0,5,2,4,3,19.0,0,0,2.0,5,2,23.6,2014,0.0
Chris Dixon,517,161,488,181,138,98,1571.0,198,57,139.0,290,124,22.8,2014,0.0
Tanner Milson,719,211,659,228,123,92,2714.0,471,171,195.0,188,57,17.6,2014,0.0
Shane Reybold,237,19,183,91,96,55,977.0,0,0,46.0,183,91,14.6,2014,0.0
Luke Hager,190,27,203,74,63,34,777.0,39,8,53.0,164,66,19.0,2014,0.0
Ben Eblen,154,151,186,66,48,18,1433.0,32,4,87.0,154,62,10.8,2014,0.0
Marcus Graham,32,5,30,11,12,8,76.0,8,2,2.0,22,9,25.7,2014,0.0
Zack Allen,0,1,3,0,0,0,14.0,3,0,0.0,0,0,11.1,2014,0.0
James Michael McAdoo,1232,111,1044,467,524,298,2696.0,9,0,173.0,1035,467,25.5,2014,1.0
Leslie McDonald,841,115,786,287,173,120,2129.0,442,147,96.0,344,140,21.1,2014,0.0
Wade Moody,14,8,13,5,0,0,43.0,8,4,5.0,5,1,19.8,2014,0.0
James Manor,12,1,17,5,0,0,30.0,8,2,0.0,9,3,26.7,2014,0.0
Denzel Robinson,4,1,4,2,0,0,30.0,0,0,2.0,4,2,9.5,2014,0.0
Taylor Braun,1651,338,1105,536,581,454,3495.0,302,125,268.0,803,411,25.5,2014,0.0
Marshall Bjorklund,1440,122,907,592,405,256,3221.0,0,0,173.0,907,592,21.4,2014,0.0
TrayVonn Wright,1131,84,957,443,201,143,3128.0,320,102,114.0,637,341,20.3,2014,0.0
Mike Felt,978,72,779,315,124,104,2294.0,607,244,76.0,172,71,21.5,2014,0.0
Jordan Aaberg,401,24,270,167,85,67,1287.0,0,0,68.0,270,167,15.7,2014,0.0
Fred Newell,41,13,39,13,21,12,154.0,13,3,9.0,26,10,20.6,2014,0.0
Troy Huff,2005,172,1609,698,686,468,3596.0,479,141,271.0,1130,557,31.4,2014,0.0
Jamal Webb,1165,483,969,438,296,173,3935.0,334,116,389.0,635,322,19.5,2014,0.0
Alonzo Traylor,283,4,202,119,79,45,647.0,0,0,35.0,202,119,21.4,2014,0.0
Josh Schuler,852,179,712,273,229,180,2904.0,365,126,93.0,347,147,16.2,2014,0.0
Cole Stefan,295,70,277,96,46,35,1026.0,197,68,47.0,80,28,16.8,2014,0.0
Travis Wallace,1338,100,1048,552,384,233,2670.0,4,1,173.0,1044,551,26.7,2014,0.0
Charles McRoy,651,101,563,230,200,139,2249.0,188,52,149.0,375,178,18.3,2014,0.0
Sean Brennan,51,16,30,13,25,15,125.0,18,10,15.0,12,3,22.4,2014,0.0
Alzee Williams,1064,144,858,381,381,285,3137.0,77,17,125.0,781,364,18.4,2014,0.0
Vertrail Vaughns,848,97,693,280,220,170,2300.0,315,118,106.0,378,162,20.0,2014,0.0
Brandan Walton,502,53,417,160,129,86,1351.0,265,96,66.0,152,64,19.9,2014,0.0
Keith Coleman,126,8,138,54,44,18,671.0,0,0,67.0,138,54,16.7,2014,0.0
Kelvin Gaines,37,4,44,17,17,3,418.0,0,0,26.0,44,17,9.4,2014,0.0
Chris Avenant,57,13,62,21,8,6,386.0,35,9,21.0,27,12,12.1,2014,0.0
Max Jacobsen,727,85,542,315,143,92,1767.0,18,5,131.0,524,310,22.1,2014,0.0
Travis Meeker,5,4,12,1,4,2,90.0,8,1,0.0,4,0,8.3,2014,0.0
Chris Heine,12,3,12,4,4,3,56.0,8,1,8.0,4,3,20.6,2014,0.0
Jordan Banks,0,2,0,0,0,0,9.0,0,0,2.0,0,0,12.0,2014,0.0
Derrick Barden,872,69,613,343,230,153,1973.0,79,33,83.0,534,310,21.5,2014,0.0
Tate Unruh,1194,139,890,406,150,141,2963.0,559,241,142.0,331,165,19.5,2014,0.0
Connor Osborne,542,63,408,210,232,121,1977.0,4,1,126.0,404,209,17.0,2014,0.0
Brendan Keane,99,8,106,38,39,22,461.0,4,1,25.0,102,37,16.9,2014,0.0
Xzaivier James,18,9,11,6,9,4,109.0,7,2,9.0,4,4,11.7,2014,0.0
Collin Sanger,0,0,0,0,0,0,0.0,0,0,0.0,0,0,0,2014,0.0
Aksel Bolin,671,123,516,223,216,151,2633.0,223,74,160.0,293,149,15.5,2014,0.0
Daveon Balls,225,99,249,73,70,56,1157.0,95,23,91.0,154,50,17.0,2014,0.0
J.J. Cravatta,145,12,136,39,49,35,513.0,110,32,21.0,26,7,18.5,2014,0.0
Kevin Gray,251,33,254,97,111,57,1479.0,1,0,73.0,253,97,13.6,2014,0.0
Antone Christian,422,62,440,143,85,66,1323.0,242,70,82.0,198,73,22.0,2014,0.0
Chip Rank,592,53,503,200,110,81,2233.0,336,111,53.0,167,89,15.3,2014,0.0
Matt Morrison,190,54,166,65,29,26,740.0,82,34,45.0,84,31,17.1,2014,0.0
Nate Buchheit,4,0,4,2,1,0,10.0,1,0,0.0,3,2,24.0,2014,0.0
Matt MacDougall,0,0,3,0,0,0,12.0,0,0,1.0,3,0,17.9,2014,0.0
Jack Flournoy,232,21,206,81,30,22,658.0,142,48,27.0,64,33,21.1,2014,0.0
DeQuan Hicks,875,132,628,327,318,219,1343.0,15,2,169.0,613,325,31.6,2014,0.0
Brison White,661,133,575,263,145,95,1399.0,157,40,84.0,418,223,23.3,2014,0.0
Gary Stewart,609,106,497,206,144,106,1908.0,259,91,151.0,238,115,17.2,2014,0.0
Patrick Robinson,398,116,326,138,172,103,2084.0,93,19,136.0,233,119,12.0,2014,0.0
Tyler Washington,183,63,179,61,48,29,765.0,101,32,40.0,78,29,14.6,2014,0.0
Dadrian Harris,33,9,48,12,7,4,172.0,24,5,17.0,24,7,17.8,2014,0.0
Dustin Adams,18,1,15,6,8,6,65.0,0,0,3.0,15,6,15.1,2014,0.0
Austin Adams,15,1,16,5,6,3,35.0,10,2,5.0,6,3,30.7,2014,0.0
Drew Crawford,1920,286,1575,687,432,314,4627.0,658,232,235.0,917,455,24.4,2014,0.0
Nikola Cerina,402,43,323,156,154,82,1623.0,32,8,101.0,291,148,16.3,2014,0.0
James Mongomery III,23,10,35,9,13,3,197.0,20,2,4.0,15,7,13.0,2014,0.0
Eric Atkins,1421,589,1149,480,412,283,4628.0,469,178,249.0,680,302,18.8,2014,0.0
Garrick Sherman,806,54,627,342,194,122,2024.0,0,0,165.0,627,342,23.3,2014,0.0
Tom Knight,365,49,305,154,82,57,1192.0,0,0,53.0,305,154,18.2,2014,0.0
Patrick Crowley,9,3,16,4,0,0,49.0,4,1,2.0,12,3,20.4,2014,0.0
Travis Bader,2351,171,1726,703,502,441,4705.0,1246,504,150.0,480,199,22.3,2014,0.0
Duke Mondy,1054,358,949,363,275,199,3167.0,420,129,240.0,529,234,20.4,2014,0.0
Mitch Baenziger,138,18,116,44,29,19,545.0,83,31,18.0,33,13,13.9,2014,0.0
Lloyd Neely II,65,11,57,25,23,12,317.0,8,3,19.0,49,22,13.9,2014,0.0
Joey Asbury,47,1,42,15,16,14,278.0,15,3,8.0,27,12,10.3,2014,0.0
LaQuinton Ross,858,47,662,299,242,181,1676.0,217,79,124.0,445,220,28.6,2014,0.0
Lenzelle Smith Jr.,1014,194,795,349,266,185,3104.0,372,131,136.0,423,218,17.9,2014,0.0
Aaron Craft,1314,694,958,440,464,342,4818.0,276,92,324.0,682,348,16.4,2014,0.0
Amedeo Della Valle,171,10,153,54,46,29,501.0,100,34,27.0,53,20,21.5,2014,0.0
Andrew Goldstein,0,0,1,0,0,0,2.0,0,0,0.0,1,0,26.6,2014,0.0
Nick Kellogg,1449,265,1084,479,238,201,3998.0,728,290,163.0,356,189,17.6,2014,0.0
Travis Wilkins,348,76,266,116,50,38,1255.0,183,78,32.0,83,38,13.5,2014,0.0
Jon Smith,620,74,414,257,161,106,2599.0,0,0,99.0,414,257,11.9,2014,0.0
T.J. Hall,670,135,632,232,170,115,2126.0,330,91,151.0,302,141,21.0,2014,0.0
Ricardo Johnson,431,92,347,139,206,133,1609.0,81,20,106.0,266,119,17.6,2014,0.0
Markel Brown,1655,308,1255,551,555,407,4088.0,421,146,239.0,834,405,22.2,2014,1.0
Marcus Smart,1064,287,760,314,465,349,2120.0,295,87,193.0,465,227,28.2,2014,1.0
Gary Gaskins,9,1,8,4,2,1,34.0,0,0,5.0,8,4,20.7,2014,0.0
Mason Cox,7,2,3,2,10,3,57.0,1,0,5.0,2,2,11.3,2014,0.0
Jackson Perez,4,0,2,2,0,0,4.0,0,0,0.0,2,2,25.2,2014,0.0
Cameron Clark,1284,122,1079,497,297,222,3385.0,171,68,160.0,908,429,20.5,2014,0.0
Tyler Neal,466,54,361,145,136,103,1410.0,210,73,86.0,151,72,18.2,2014,0.0
Anton Larsen,97,11,107,40,20,12,480.0,29,5,24.0,78,35,14.8,2014,0.0
Sean-Michael King,0,0,2,0,0,0,7.0,1,0,0.0,1,0,15.0,2014,0.0
Shawn Glover,1467,154,1255,586,290,224,3356.0,221,71,192.0,1034,515,24.5,2014,0.0
D.J. Jackson,307,186,245,83,116,96,1649.0,130,45,100.0,115,38,12.6,2014,0.0
Corbin Byford,41,6,28,14,17,10,136.0,11,3,13.0,17,11,18.8,2014,0.0
David Mason,14,14,13,6,2,1,58.0,3,1,7.0,10,5,18.9,2014,0.0
Roberto Nelson,1745,307,1270,540,614,486,3217.0,479,179,280.0,791,361,28.4,2014,0.0
Devon Collier,1489,181,935,539,668,411,3158.0,0,0,205.0,935,539,22.8,2014,0.0
Angus Brandt,918,126,703,344,239,166,2420.0,159,64,154.0,544,280,20.0,2014,0.0
Eric Moreland,640,116,445,238,294,156,2227.0,24,8,161.0,421,230,16.6,2014,1.0
Challe Barton,231,105,205,77,62,48,1336.0,97,29,98.0,108,48,12.3,2014,0.0
C.J. Mitchell,7,1,4,1,6,4,36.0,3,1,5.0,1,0,16.0,2014,0.0
Daniel Jones,10,0,12,4,3,1,42.0,4,1,0.0,8,3,15.6,2014,0.0
Michael Moyer,3,0,2,1,0,0,9.0,1,1,0.0,1,0,10.9,2014,0.0
Mike Moser,1149,177,995,430,226,172,2729.0,352,117,221.0,643,313,24.1,2014,0.0
Jason Calliste,1539,261,1024,425,560,447,3991.0,614,242,228.0,410,183,18.8,2014,0.0
Johnathan Loyd,723,458,615,229,258,192,3021.0,243,73,229.0,372,156,16.0,2014,0.0
Richard Amardi,219,13,171,89,72,40,546.0,3,1,39.0,168,88,22.3,2014,0.0
Waverly Austin,164,15,144,63,67,38,712.0,0,0,48.0,144,63,15.6,2014,0.0
Arik Armstead,2,0,1,1,0,0,4.0,0,0,0.0,1,1,12.5,2014,0.0
Brian Crow,0,0,3,0,0,0,16.0,3,0,0.0,0,0,9.4,2014,0.0
Nicholas Lucenti,5,4,16,2,2,1,50.0,10,0,1.0,6,2,18.1,2014,0.0
Tony Gill,640,64,456,237,148,106,1491.0,152,60,85.0,304,177,21.6,2014,0.0
Andrew Bock,557,176,387,138,275,235,1721.0,151,46,113.0,236,92,19.2,2014,0.0
Sama Taku,660,141,612,241,178,136,1834.0,139,42,117.0,473,199,23.5,2014,0.0
Ross Rivera,861,46,608,279,310,254,1910.0,132,49,99.0,476,230,23.9,2014,0.0
Trevin Harris,476,125,364,160,92,68,1575.0,222,88,62.0,142,72,15.9,2014,0.0
Khalil Kelley,629,57,507,252,301,125,2044.0,1,0,139.0,506,252,20.7,2014,0.0
Aaron Short,156,37,116,54,21,19,583.0,57,29,32.0,59,25,13.9,2014,0.0
Tim Thomas,140,12,120,59,37,22,432.0,2,0,28.0,118,59,20.0,2014,1.0
Spencer Llewellyn,38,3,38,14,1,1,168.0,29,9,9.0,9,5,15.2,2014,0.0
Tim Frazier,1543,641,1214,508,585,453,4132.0,239,74,355.0,975,434,24.0,2014,1.0
Allen Roberts,827,122,673,260,271,209,2295.0,311,98,172.0,362,162,23.1,2014,0.0
Zach Cooper,0,0,0,0,0,0,5.0,0,0,0.0,0,0,0.0,2014,0.0
Fran Dougherty,740,63,560,295,235,139,2057.0,43,11,150.0,517,284,21.0,2014,0.0
Miles Jackson-Cartwright,1401,353,1051,441,448,364,3896.0,449,155,325.0,602,286,21.8,2014,0.0
Steve Rennard,248,89,194,75,68,49,1329.0,143,49,70.0,51,26,11.8,2014,0.0
Dau Jok,169,17,166,51,34,27,668.0,140,40,20.0,26,11,15.7,2014,0.0
Tony Bagtas,41,40,45,16,8,6,271.0,11,3,25.0,34,13,13.6,2014,0.0
Cameron Gunter,97,6,78,36,50,25,566.0,2,0,38.0,76,36,13.0,2014,0.0
Patrick Lucas-Perry,161,25,134,53,20,16,557.0,95,39,14.0,39,14,14.8,2014,0.0
Preston Troutt,0,2,3,0,0,0,7.0,2,0,0.0,1,0,21.4,2014,0.0
Brendan Lane,585,65,447,241,145,83,1781.0,61,20,97.0,386,221,17.9,2014,0.0
Malte Kramer,138,22,108,46,24,14,439.0,78,32,18.0,30,14,16.4,2014,0.0
Nikolas Skouen,497,51,421,163,69,57,1567.0,304,114,75.0,117,49,18.0,2014,0.0
Jeff Van Dyke,15,4,21,5,0,0,116.0,20,5,6.0,1,0,12.1,2014,0.0
Allen Stevens,4,0,2,1,2,2,10.0,1,0,0.0,1,1,16.0,2014,0.0
Lamar Patterson,1410,427,1097,477,394,285,3628.0,463,171,244.0,634,306,22.5,2014,1.0
Talib Zanna,1117,56,743,411,454,295,2924.0,3,0,137.0,740,411,20.0,2014,0.0
Kyle Richardson,421,39,333,174,123,73,1439.0,2,0,113.0,331,174,18.4,2014,0.0
Dre' Winston,488,135,354,162,195,142,1620.0,88,22,101.0,266,140,18.1,2014,0.0
Aaron Moore,475,56,360,184,148,106,1119.0,8,1,75.0,352,183,24.1,2014,0.0
Alyx Foster,32,11,23,10,14,8,318.0,9,4,9.0,14,6,6.5,2014,0.0
Lamont Prosser,38,4,26,14,20,10,153.0,0,0,16.0,26,14,17.9,2014,0.0
Jacob Begin,0,2,4,0,0,0,23.0,3,0,0.0,1,0,9.4,2014,0.0
Ryan Nicholas,1238,113,968,450,364,270,3000.0,180,68,181.0,788,382,22.7,2014,0.0
Korey Thieleke,209,49,206,79,68,43,1015.0,40,8,58.0,166,71,15.1,2014,0.0
David Carr,244,118,265,88,60,28,1202.0,129,40,56.0,136,48,14.9,2014,0.0
Tanner Riley,458,64,455,166,44,38,1300.0,273,88,76.0,182,78,22.0,2014,0.0
John Bailey,67,16,72,25,26,15,295.0,6,2,19.0,66,23,18.0,2014,0.0
Demondre Chapman,918,39,704,352,466,214,2323.0,2,0,153.0,702,352,22.4,2014,0.0
Louis Munks,663,47,587,222,187,139,1466.0,251,80,106.0,336,142,25.8,2014,0.0
Hershey Robinson,162,18,149,59,20,12,600.0,91,32,30.0,58,27,15.7,2014,0.0
Jules Montgomery,585,69,623,248,119,68,2128.0,83,21,99.0,540,227,17.4,2014,0.0
Patrick Agho,56,3,47,22,32,12,224.0,0,0,19.0,47,22,17.6,2014,0.0
Rasi Jenkins,110,20,89,39,56,32,844.0,1,0,45.0,88,39,9.1,2014,0.0
Danny Herrera,216,16,178,80,50,35,675.0,60,21,28.0,118,59,18.3,2014,0.0
Bradford Allen,3,0,1,1,2,1,11.0,0,0,0.0,1,1,9.6,2014,0.0
Russell McCray,7,6,6,2,10,3,34.0,0,0,6.0,6,2,27.8,2014,0.0
Mac Lake,14,10,15,5,2,2,95.0,8,2,3.0,7,3,11.4,2014,0.0
T.J. Bray,1024,374,696,338,283,213,3293.0,348,135,174.0,348,203,17.1,2014,0.0
Will Barrett,686,114,517,222,152,113,2028.0,321,129,113.0,196,93,19.6,2014,0.0
Jimmy Sherburne,156,69,139,51,51,37,795.0,54,17,55.0,85,34,15.2,2014,0.0
Chris Clement,113,31,93,32,36,31,663.0,57,18,28.0,36,14,11.8,2014,0.0
Bryce Cotton,1975,384,1452,611,581,487,4314.0,736,266,193.0,716,345,22.7,2014,1.0
Kadeem Batts,1289,103,1019,455,521,366,3257.0,40,13,198.0,979,442,22.6,2014,0.0
Lee Goldsbrough,89,24,78,34,28,16,802.0,16,5,51.0,62,29,8.9,2014,0.0
Terone Johnson,1318,299,1207,496,376,206,3507.0,365,120,197.0,842,376,23.0,2014,0.0
Errick Peck,826,116,721,311,219,148,2150.0,158,56,156.0,563,255,23.6,2014,0.0
Sterling Carter,888,141,822,298,142,94,1982.0,553,198,170.0,269,100,24.4,2014,0.0
Jay Simpson,138,17,136,58,41,21,388.0,10,1,29.0,126,57,23.5,2014,0.0
Travis Carroll,229,40,189,100,45,25,1341.0,10,4,36.0,179,96,9.5,2014,0.0
Ike Azotam,1603,97,1240,628,561,347,3444.0,1,0,191.0,1239,628,23.2,2014,0.0
Umar Shannon,1307,226,1078,404,383,308,3033.0,528,191,216.0,550,213,24.8,2014,0.0
Shaq Shannon,387,145,321,119,139,91,1469.0,157,58,96.0,164,61,15.4,2014,0.0
Marquis Barnett,33,4,27,14,9,5,189.0,0,0,8.0,27,14,9.8,2014,0.0
T'ziah Wood-Smith,7,1,10,3,2,1,32.0,2,0,3.0,8,3,20.3,2014,0.0
Allen Dickerson,113,27,111,39,26,16,531.0,70,19,29.0,41,20,14.3,2014,0.0
Juwan Wells,31,8,43,13,3,1,147.0,21,4,11.0,22,9,18.6,2014,0.0
Xavier Munford,1045,134,884,352,297,211,2166.0,388,130,165.0,496,222,29.0,2014,1.0
Mike Powell,551,229,513,166,209,154,2128.0,212,65,189.0,301,101,19.3,2014,0.0
A.J. Kemp,1,1,1,0,2,1,12.0,0,0,0.0,1,0,0.0,2014,0.0
Jonathan Nazarko,0,0,4,0,0,0,13.0,3,0,0.0,1,0,16.3,2014,0.0
Austin Ramljak,615,62,493,193,95,68,1737.0,418,161,55.0,75,32,19.0,2014,0.0
Keith Washington,326,128,323,110,111,75,1200.0,116,31,125.0,207,79,23.2,2014,0.0
Nizar Kapic,70,12,75,25,10,6,296.0,43,14,13.0,32,11,17.3,2014,0.0
Ross Wilson,144,41,130,63,34,18,875.0,0,0,55.0,130,63,12.9,2014,0.0
Bahrom Firozgary,55,5,31,16,36,23,319.0,0,0,19.0,31,16,11.8,2014,0.0
Hunter Eggers,0,1,2,0,0,0,4.0,1,0,0.0,1,0,27.5,2014,0.0
Cedrick Lindsay,1276,355,937,403,489,372,3272.0,296,98,209.0,641,305,23.0,2014,0.0
Derrick Williams,816,80,477,250,372,277,2056.0,112,39,141.0,365,211,21.1,2014,1.0
Tim Singleton,0,0,1,0,0,0,3.0,1,0,0.0,0,0,18.1,2014,0.0
Anthony Myles,1417,196,1105,449,447,329,3519.0,531,190,251.0,574,259,22.9,2014,0.0
Danny Stewart,1414,98,907,456,665,476,3722.0,70,26,252.0,837,430,20.4,2014,0.0
Tommy Pereira,347,52,297,116,16,11,1297.0,273,104,35.0,24,12,13.5,2014,0.0
Brandon Channer,11,2,10,3,8,4,35.0,4,1,5.0,6,2,27.3,2014,0.0
Davis Graham,0,0,0,0,0,0,7.0,0,0,0.0,0,0,0.0,2014,0.0
Karvel Anderson,1123,85,787,391,166,140,1925.0,444,201,82.0,343,190,25.5,2014,0.0
Anthony Myers,805,449,677,263,268,197,3367.0,256,82,232.0,421,181,15.8,2014,0.0
Stephan Hawkins,247,16,224,103,57,41,1104.0,0,0,50.0,224,103,14.1,2014,0.0
Mike McFadden,777,67,589,300,293,176,2353.0,1,1,148.0,588,299,19.2,2014,0.0
Desjuan Newton,47,15,41,17,9,5,165.0,19,8,7.0,22,9,16.4,2014,0.0
Evan Grey,0,0,0,0,0,0,2.0,0,0,0.0,0,0,0.0,2014,0.0
Britton Lee,0,0,3,0,2,0,10.0,0,0,1.0,3,0,25.6,2014,0.0
Shaire Tolson-Ford,0,0,0,0,0,0,4.0,0,0,0.0,0,0,0.0,2014,0.0
J.J. Moore,1005,74,784,337,281,217,2380.0,360,114,103.0,424,223,22.1,2014,0.0
Wally Judge,667,81,533,256,298,155,2073.0,2,0,169.0,531,256,20.1,2014,0.0
D'Von Campbell,188,58,167,62,55,36,699.0,83,28,44.0,84,34,17.5,2014,0.0
Jordan Salley,242,8,155,96,79,50,671.0,0,0,37.0,155,96,18.7,2014,0.0
Joey Quigley,95,17,101,33,42,24,489.0,19,5,24.0,82,28,16.1,2014,0.0
Case Rada,31,3,38,11,4,1,85.0,32,8,2.0,6,3,27.0,2014,0.0
Ryan Okwudibonye,11,0,8,4,3,3,28.0,0,0,4.0,8,4,26.2,2014,0.0
Kendall Groom,34,27,50,14,13,5,276.0,6,1,19.0,44,13,14.5,2014,0.0
Louis Montes,1261,104,967,435,424,304,2952.0,264,87,201.0,703,348,23.3,2014,0.0
Chris Evans,747,140,574,244,329,230,2025.0,92,29,149.0,482,215,22.0,2014,0.0
Mostafa Abdel Latif,191,10,170,82,46,27,849.0,0,0,40.0,170,82,13.6,2014,0.0
Stephon Mosley,202,13,164,74,67,50,600.0,13,4,48.0,151,70,22.2,2014,0.0
Matthew Mazzara,0,0,2,0,0,0,18.0,2,0,3.0,0,0,15.4,2014,0.0
Langston Galloway,1991,296,1501,657,407,334,4720.0,806,343,156.0,695,314,21.0,2014,1.0
Ronald Roberts,1398,100,953,543,527,312,3541.0,0,0,190.0,953,543,21.1,2014,0.0
Halil Kanacevic,1163,407,980,444,364,227,3707.0,180,48,343.0,800,396,20.9,2014,0.0
Daryus Quarles,435,75,475,164,87,53,1849.0,193,54,67.0,282,110,16.9,2014,0.0
Colin Kelly,3,0,3,1,4,1,29.0,1,0,2.0,2,1,12.7,2014,0.0
Kyle Molock,2,1,1,0,3,2,28.0,0,0,6.0,1,0,15.9,2014,0.0
Eric Kindler,20,7,29,6,9,5,84.0,20,3,7.0,9,3,24.4,2014,0.0
Dwayne Evans,1499,126,1081,543,547,393,3616.0,66,20,232.0,1015,523,23.2,2014,0.0
Jordair Jett,1239,422,953,453,500,306,3497.0,109,27,295.0,844,426,22.6,2014,0.0
Rob Loe,973,153,809,342,224,156,2822.0,408,133,174.0,401,209,20.6,2014,0.0
Mike McCall Jr.,1212,339,998,413,285,225,3704.0,449,161,197.0,549,252,19.2,2014,0.0
Jake Barnett,717,119,637,228,166,123,2537.0,403,138,158.0,234,90,19.1,2014,0.0
Joey Lepak,2,1,1,0,2,2,14.0,1,0,0.0,0,0,7.4,2014,0.0
Royce Simpson,0,0,0,0,0,0,1.0,0,0,0.0,0,0,0.0,2014,0.0
Stephen Holt,1370,305,924,409,496,401,3962.0,396,151,184.0,528,258,17.8,2014,0.0
James Walker,587,104,473,186,174,122,1905.0,250,93,100.0,223,93,18.2,2014,0.0
Beau Levesque,829,135,595,276,240,186,2132.0,241,91,124.0,354,185,20.6,2014,0.0
Matt Hodgson,518,27,366,200,182,115,1731.0,12,3,154.0,354,197,18.1,2014,0.0
Jordan Giusti,197,84,173,64,63,41,1183.0,86,28,45.0,87,36,11.0,2014,0.0
Paul McCoy,612,161,510,220,198,128,1963.0,140,44,156.0,370,176,20.4,2014,0.0
Eividas Petrulis,72,11,56,23,14,8,176.0,46,18,18.0,10,5,24.1,2014,0.0
Chris Burke,604,124,536,222,135,94,2540.0,205,66,139.0,331,156,15.5,2014,0.0
Vic Adams,28,5,25,9,7,6,67.0,15,4,9.0,10,5,30.1,2014,0.0
Howard Sellars,26,5,35,10,7,5,145.0,11,1,5.0,24,9,16.1,2014,0.0
Markese Tucker,267,12,229,116,57,35,732.0,0,0,32.0,229,116,21.0,2014,0.0
James Thomas,617,63,463,227,268,163,1858.0,1,0,95.0,462,227,18.8,2014,1.0
Terrance Motley,504,25,424,202,155,96,1081.0,7,4,79.0,417,198,27.1,2014,0.0
Nathaniel Mason,351,38,273,113,135,99,906.0,78,26,63.0,195,87,22.5,2014,0.0
Will Bond,374,58,310,120,56,43,1193.0,237,91,39.0,73,29,16.0,2014,0.0
Raijon Kelly,1064,303,889,394,192,152,2795.0,341,124,213.0,548,270,23.6,2014,0.0
Connor Miller,475,168,440,155,92,58,2471.0,302,107,122.0,138,48,13.5,2014,0.0
Russell Wilson,188,139,156,69,90,48,1193.0,16,2,130.0,140,67,15.1,2014,0.0
Chris Longoria,251,56,233,82,81,63,859.0,96,24,66.0,137,58,21.1,2014,0.0
Hamilton Bailey,4,1,3,0,5,4,44.0,2,0,0.0,1,0,6.5,2014,0.0
Tony Thompson,0,0,2,0,0,0,7.0,0,0,1.0,2,0,23.1,2014,0.0
Xavier Thames,1374,354,1080,427,488,397,3581.0,353,123,211.0,727,304,22.0,2014,0.0
Desmond Maxwell,8,2,7,3,0,0,9.0,4,2,0.0,3,1,40.4,2014,0.0
Dennis Kramer,865,61,693,344,174,116,2409.0,186,61,156.0,507,283,20.8,2014,0.0
Therone Tillett,13,0,6,5,0,0,8.0,4,3,0.0,2,2,40.8,2014,0.0
Michael Marconi,2,1,3,1,0,0,12.0,2,0,1.0,1,1,18.1,2014,0.0
Cole Dickerson,1253,131,966,487,310,164,2852.0,304,115,191.0,662,372,23.8,2014,0.0
Tao Xu,92,7,80,34,36,24,427.0,0,0,39.0,80,34,17.0,2014,0.0
Chris Cunningham,689,71,516,235,290,213,2235.0,20,6,189.0,496,229,19.2,2014,0.0
Devante Wilson,251,20,238,76,56,44,731.0,171,55,37.0,67,21,21.8,2014,0.0
Dylan Alexander,69,15,60,25,12,7,218.0,37,12,8.0,23,13,17.9,2014,0.0
Mike VanKirk,12,0,9,4,7,4,65.0,0,0,3.0,9,4,11.7,2014,0.0
Evan Roquemore,1627,578,1258,469,600,484,4272.0,577,205,326.0,681,264,22.2,2014,0.0
Jerry Brown,789,75,552,272,409,244,2803.0,6,1,128.0,546,271,16.8,2014,0.0
John McArthur,392,49,400,157,96,72,2059.0,29,6,75.0,371,151,12.9,2014,0.0
Julian Clarke,131,28,132,45,25,15,556.0,88,26,25.0,44,19,15.5,2014,0.0
Robert Garrett,145,8,114,59,65,27,773.0,0,0,32.0,114,59,11.7,2014,0.0
Deven Williams,531,48,468,190,79,64,1003.0,239,87,76.0,229,103,30.7,2014,0.0
Joshua Montgomery,744,54,609,249,242,174,2163.0,250,72,116.0,359,177,20.4,2014,0.0
Jyles Smith,641,76,499,249,258,143,2984.0,7,0,200.0,492,249,14.5,2014,0.0
Jeremiah Hill,204,31,205,68,35,27,583.0,133,41,34.0,72,27,23.0,2014,0.0
Khiry White,203,69,170,70,85,53,1121.0,44,10,111.0,126,60,15.2,2014,0.0
Patrick Hendley,147,28,144,55,33,22,579.0,44,15,46.0,100,40,18.7,2014,0.0
Stephen Wilson,236,66,243,72,89,63,999.0,109,29,80.0,134,43,19.2,2014,0.0
Angelo Davis,39,5,26,8,32,23,122.0,1,0,13.0,25,8,23.3,2014,0.0
Marcus Hutchins,43,6,30,11,28,20,188.0,11,1,15.0,19,10,17.2,2014,0.0
Clarence Trent,815,97,702,300,236,158,1952.0,212,57,196.0,490,243,24.3,2014,0.0
D'Vonne Pickett,422,198,371,166,145,82,1371.0,42,8,133.0,329,158,20.1,2014,0.0
Luiz Bidart,129,42,98,36,41,32,651.0,71,25,38.0,27,11,11.5,2014,0.0
David Trimble,19,17,20,7,12,5,123.0,1,0,10.0,19,7,14.0,2014,0.0
Fuquan Edwin,1633,182,1358,606,366,249,3847.0,472,172,235.0,886,434,24.1,2014,0.0
Brian Oliver,1018,120,927,350,114,92,2687.0,617,226,152.0,310,124,21.5,2014,1.0
Gene Teague,1034,101,658,388,452,258,2593.0,0,0,240.0,658,388,22.9,2014,0.0
Patrik Auda,604,96,415,212,203,142,1970.0,111,38,103.0,304,174,16.4,2014,0.0
Aaron Geramipoor,126,6,104,55,45,16,783.0,0,0,34.0,104,55,10.7,2014,0.0
Tom Maayan,82,128,83,30,29,12,864.0,35,10,115.0,48,20,13.1,2014,0.0
Hakeem Harris,5,0,4,2,0,0,26.0,2,1,0.0,2,1,8.3,2014,0.0
Rich Audu,93,14,100,30,18,16,467.0,50,17,33.0,50,13,16.0,2014,0.0
Steven Cruz,11,2,7,3,7,4,27.0,3,1,7.0,4,2,32.6,2014,0.0
Augustine Rubit,1917,125,1359,673,763,550,3756.0,75,21,269.0,1284,652,26.2,2014,0.0
Antoine Allen,652,94,613,202,177,130,1797.0,368,118,128.0,245,84,22.9,2014,0.0
Mychal Ammons,901,108,724,312,319,209,2496.0,185,68,187.0,539,244,21.2,2014,0.0
T.J. Johnson,51,9,47,19,7,5,190.0,22,8,9.0,25,11,15.9,2014,0.0
Isaiah Maston,51,9,44,18,2,1,257.0,35,14,8.0,9,4,10.5,2014,0.0
E.J. Conley,0,1,1,0,0,0,16.0,0,0,1.0,1,0,6.4,2014,0.0
Matthew Hezekiah,763,37,591,326,158,111,1834.0,3,0,101.0,588,326,21.0,2014,0.0
Adama Adams,507,148,424,163,171,129,1462.0,166,52,164.0,258,111,23.0,2014,0.0
Theron Stephens,127,22,141,41,19,16,371.0,93,29,17.0,48,12,22.3,2014,0.0
Darrion Eastmon,35,35,22,10,20,12,257.0,8,3,32.0,14,7,12.4,2014,0.0
Shaquiell Mitchell,184,44,227,60,93,47,867.0,69,17,79.0,158,43,20.3,2014,0.0
Chasen Campbell,52,4,64,18,11,7,181.0,28,9,14.0,36,9,23.1,2014,0.0
Torrey Craig,2128,236,1808,747,502,337,4061.0,899,297,347.0,909,450,29.5,2014,1.0
Ricardo Glenn,1255,204,858,476,484,300,3046.0,13,3,213.0,845,473,21.3,2014,0.0
Jodd Maxey,878,138,693,356,267,166,2693.0,5,0,164.0,688,356,18.1,2014,0.0
Babatunde Olomuwiya,588,75,423,236,222,115,2068.0,5,1,140.0,418,235,16.1,2014,0.0
Brenton Williams,986,101,700,297,252,223,2005.0,410,169,97.0,290,128,23.1,2014,0.0
Bruce Ellington,893,238,957,322,184,123,2435.0,411,126,211.0,546,196,25.9,2014,0.0
Austin Constable,0,0,4,0,0,0,12.0,2,0,1.0,2,0,20.8,2014,0.0
Jordan Dykstra,1661,190,1171,568,428,332,3595.0,434,193,202.0,737,375,22.9,2014,0.0
Brayden Carlson,1132,287,805,363,330,249,3835.0,405,157,191.0,400,206,15.8,2014,0.0
Chad White,1169,203,852,389,242,176,3445.0,526,215,169.0,326,174,17.2,2014,0.0
Marcus Heemstra,414,83,309,162,123,87,1377.0,8,3,85.0,301,159,17.3,2014,0.0
Trevor Gruis,1340,191,920,512,486,316,3491.0,0,0,259.0,920,512,20.7,2014,0.0
Karim Rowson,396,39,287,126,189,135,1163.0,36,9,80.0,251,117,20.9,2014,0.0
Tavian Pomlee,81,8,71,29,12,10,239.0,44,13,19.0,27,16,21.2,2014,0.0
Jack Foley,6,1,11,1,4,3,43.0,9,1,5.0,2,0,22.0,2014,1.0
Victor Rudd,1254,140,1103,435,355,261,3197.0,440,123,187.0,663,312,25.1,2014,0.0
Martino Brock,1230,208,1002,445,464,276,3342.0,216,64,227.0,786,381,22.2,2014,0.0
Shemiye McLendon,446,129,461,156,113,82,1803.0,186,52,132.0,275,104,18.7,2014,0.0
Lucas Nutt,931,604,634,259,356,296,3576.0,312,117,272.0,322,142,15.2,2014,0.0
Paul McRoberts,77,15,56,31,13,6,228.0,24,9,9.0,32,22,15.0,2014,0.0
C.J. Reese,48,39,41,19,16,9,238.0,1,1,30.0,40,18,15.9,2014,0.0
Will Holifield,14,1,11,5,0,0,38.0,9,4,1.0,2,1,15.2,2014,0.0
Kyle Stroder,11,0,8,4,2,0,20.0,4,3,1.0,4,1,23.9,2014,0.0
Antonnio Benton,597,65,506,220,179,129,2025.0,112,28,132.0,394,192,18.8,2014,0.0
Dre Evans,617,165,516,212,112,79,2006.0,268,114,112.0,248,98,17.7,2014,0.0
Julian Chiera,190,22,125,61,43,38,614.0,68,30,32.0,57,31,15.3,2014,0.0
Jeffery Ricard,444,88,401,153,142,108,1470.0,113,30,113.0,288,123,20.8,2014,0.0
Quin Cooper,190,27,186,64,58,42,618.0,79,20,37.0,107,44,20.7,2014,0.0
Jeremy Campbell,316,55,303,115,132,78,1290.0,42,8,79.0,261,107,18.0,2014,0.0
Forrest Johnson,7,1,3,1,8,5,51.0,0,0,1.0,3,1,8.1,2014,0.0
Antonio Evans,5,2,3,2,0,0,13.0,1,1,0.0,2,1,12.2,2014,0.0
Pe'Shon Howard,721,410,631,230,223,169,2833.0,305,92,252.0,326,138,17.2,2014,0.0
Omar Oraby,698,33,444,267,256,164,1644.0,0,0,132.0,444,267,21.5,2014,0.0
JT Terrell,951,99,858,317,226,171,2220.0,437,146,166.0,421,171,25.7,2014,0.0
DJ Haley,315,17,247,135,110,45,1561.0,0,0,63.0,247,135,11.7,2014,0.0
Daniel Munoz,5,8,12,1,2,2,123.0,12,1,15.0,0,0,13.0,2014,0.0
Tim Johnson,579,99,524,214,135,96,1612.0,193,55,125.0,331,159,22.6,2014,0.0
Christian Salecich,509,164,457,169,122,88,2169.0,281,83,111.0,176,86,15.4,2014,0.0
Ray Lester,299,32,245,109,185,81,1216.0,2,0,103.0,243,109,18.2,2014,0.0
Cameron Craig,26,18,29,9,9,7,176.0,9,1,22.0,20,8,16.0,2014,0.0
Keaton Scheer,3,1,3,1,0,0,9.0,2,1,1.0,1,0,22.6,2014,0.0
Akintoye Okunrinboye,2,0,2,1,1,0,4.0,1,0,0.0,1,1,31.4,2014,0.0
Desmar Jackson,1884,251,1442,665,625,460,3545.0,333,94,369.0,1109,571,31.1,2014,0.0
Mike Balogun,78,10,68,24,15,13,214.0,57,17,5.0,11,7,20.1,2014,0.0
Davante Drinkard,232,26,224,92,100,48,1425.0,0,0,85.0,224,92,13.4,2014,0.0
Marcus Fillyaw,73,48,64,28,11,8,470.0,30,9,29.0,34,19,11.2,2014,0.0
Bronson Verhines,73,8,61,32,16,9,366.0,0,0,13.0,61,32,11.9,2014,0.0
Colby Long,26,8,28,9,3,1,128.0,21,7,12.0,7,2,17.5,2014,0.0
Nick Russell,951,293,852,339,251,196,2811.0,239,77,253.0,613,262,22.7,2014,0.0
Crandall Head,57,33,73,22,14,9,348.0,26,4,34.0,47,18,17.2,2014,0.0
Neil Watson,1157,473,823,329,393,335,3322.0,415,164,229.0,408,165,19.1,2014,0.0
Daveon Boardingham,684,36,421,242,299,200,1542.0,1,0,100.0,420,242,22.0,2014,0.0
Michael Craig,582,128,388,230,180,121,1277.0,7,1,124.0,381,229,23.9,2014,0.0
Jerrold Brooks,729,172,646,251,122,91,2071.0,392,136,107.0,254,115,20.0,2014,0.0
Deonte Houston,140,64,116,40,81,52,651.0,28,8,37.0,88,32,15.1,2014,0.0
Ude Ifeanyichukwu,9,1,7,3,5,3,51.0,0,0,2.0,7,3,11.4,2014,0.0
Jaren Jeffery,356,48,276,134,144,79,1315.0,30,9,68.0,246,125,17.0,2014,0.0
Jayson Cheesman,304,40,298,113,128,78,1001.0,0,0,83.0,298,113,22.5,2014,0.0
Chris Nsenki,126,56,164,46,15,12,799.0,89,22,51.0,75,24,14.4,2014,0.0
McKay Anderson,48,11,44,19,2,1,227.0,19,9,10.0,25,10,13.1,2014,0.0
Drake Thomas,12,22,25,5,6,1,198.0,6,1,14.0,19,4,11.0,2014,0.0
Taylor Jenson,9,1,10,3,0,0,26.0,9,3,1.0,1,0,23.0,2014,0.0
Yondarius Johnson,694,70,576,243,223,133,1879.0,233,75,109.0,343,168,21.5,2014,0.0
Javan Mitchell,628,54,504,236,251,156,1893.0,1,0,130.0,503,236,20.7,2014,0.0
Bryce Clark,104,11,114,39,37,23,356.0,33,3,26.0,81,36,22.5,2014,0.0
Matthew Wright,1073,292,890,352,254,213,3111.0,468,156,210.0,422,196,20.0,2014,0.0
Charlon Kloof,751,310,550,236,303,217,2504.0,193,62,173.0,357,174,17.5,2014,0.0
Marquise Simmons,617,46,457,249,196,118,2019.0,3,1,105.0,454,248,16.5,2014,0.0
Jean Yves Toupane,18,1,17,6,6,3,42.0,13,3,1.0,4,3,25.2,2014,0.0
Danny Farrell,3,0,7,1,2,0,12.0,4,1,4.0,3,0,50.7,2014,0.0
Matthias Runs,0,1,1,0,0,0,5.0,0,0,0.0,1,0,9.9,2014,0.0
Ben Mockford,1077,96,927,355,137,107,2752.0,688,260,97.0,239,95,19.8,2014,0.0
Sheldon Hagigal,199,25,171,67,57,43,465.0,73,22,44.0,98,45,26.5,2014,0.0
Anthony White,186,66,202,73,36,30,857.0,57,10,49.0,145,63,15.8,2014,0.0
Aleksandar Isailovic,181,25,202,61,20,16,888.0,159,43,28.0,43,18,13.5,2014,0.0
Matt Milk,215,22,176,93,47,29,1083.0,0,0,50.0,176,93,11.4,2014,0.0
PJ Santavenere,195,21,186,68,33,25,644.0,124,34,27.0,62,34,17.6,2014,0.0
JaKarr Sampson,915,74,816,383,244,148,1997.0,13,1,118.0,803,382,26.7,2014,1.0
Orlando Sanchez,238,44,180,92,56,43,714.0,44,11,43.0,136,81,17.8,2014,0.0
God'sgift Achiuwa,379,10,255,138,167,102,1246.0,7,1,67.0,248,137,16.2,2014,0.0
Marc-Antoine Bourgault,107,9,107,37,5,4,349.0,87,29,12.0,20,8,17.6,2014,0.0
Tyler Walston,0,0,0,0,0,0,8.0,0,0,0.0,0,0,0.0,2014,0.0
Dwight Powell,1465,240,1110,515,557,402,3569.0,114,33,283.0,996,482,23.8,2014,1.0
Josh Huestis,1019,113,870,392,277,169,3376.0,207,66,125.0,663,326,17.0,2014,1.0
John Gage,513,31,415,169,72,60,1305.0,297,115,58.0,118,54,19.8,2014,0.0
Robbie Lemons,156,24,147,55,24,14,742.0,93,32,17.0,54,23,12.1,2014,0.0
Jack Ryan,14,2,7,5,4,3,46.0,2,1,2.0,5,4,12.1,2014,0.0
Desmond Haymon,1159,191,896,376,408,269,3141.0,411,138,148.0,485,238,20.8,2014,0.0
Deshaunt Walker,473,49,441,169,51,41,957.0,281,94,37.0,160,75,27.1,2014,0.0
Nikola Gajic,380,71,278,133,96,67,955.0,126,47,60.0,152,86,20.7,2014,0.0
Reed Westbrook,17,3,17,4,8,7,44.0,12,2,2.0,5,2,26.4,2014,0.0
Sharife Sergeant,14,1,12,4,13,6,66.0,0,0,4.0,12,4,17.1,2014,0.0
Patrick Costello,3,1,3,1,1,1,37.0,0,0,7.0,3,1,14.4,2014,0.0
Ben Brown-White,0,0,1,0,0,0,27.0,0,0,4.0,1,0,9.4,2014,0.0
Willie Green,888,125,645,337,294,198,2282.0,65,16,136.0,580,321,20.8,2014,1.0
Raymone Andrews,689,285,554,200,299,211,2911.0,234,78,175.0,320,122,15.3,2014,0.0
Aaron Graham,1125,200,937,348,284,223,3007.0,599,206,238.0,338,142,22.1,2014,0.0
Hunter Miller,425,256,391,131,149,106,2236.0,187,57,188.0,204,74,14.8,2014,0.0
Glenn Baral,70,12,90,25,5,3,320.0,63,17,10.0,27,8,17.4,2014,0.0
Leke Solanke,32,6,23,12,14,8,265.0,3,0,13.0,20,12,8.4,2014,0.0
Tanner Plemmons,51,4,39,18,0,0,94.0,34,15,6.0,5,3,24.7,2014,0.0
Aidan Hadley,0,0,0,0,0,0,2.0,0,0,0.0,0,0,0.0,2014,0.0
Anthony Jackson,1048,177,876,357,185,164,2578.0,463,170,200.0,413,187,23.6,2014,0.0
Dave Coley,1228,198,1136,418,382,289,3373.0,312,103,256.0,824,315,24.5,2014,0.0
Eric McAlister,499,47,398,200,119,85,1867.0,49,14,71.0,349,186,14.7,2014,0.0
Anthony Mayo,202,18,210,78,66,46,1069.0,0,0,42.0,210,78,14.0,2014,0.0
Ben Resner,27,15,25,6,20,14,115.0,7,1,26.0,18,5,27.4,2014,0.0
C.J. Fair,1660,119,1367,631,466,337,4251.0,178,61,204.0,1189,570,22.0,2014,0.0
Tyler Ennis,440,187,360,148,149,114,1215.0,85,30,58.0,275,118,21.9,2014,1.0
Jerami Grant,541,62,385,187,251,161,1577.0,20,6,63.0,365,181,19.1,2014,1.0
Baye Moussa Keita,364,25,237,142,138,80,2110.0,0,0,78.0,237,142,9.3,2014,0.0
Nolan Hart,3,3,13,1,3,1,25.0,9,0,6.0,4,1,42.0,2014,0.0
Russ DeRemer,0,0,5,0,0,0,26.0,3,0,2.0,2,0,14.0,2014,0.0
Albert Nassar,5,0,5,2,0,0,11.0,2,1,0.0,3,1,24.1,2014,0.0
Dalton Pepper,843,122,756,305,113,94,2123.0,400,139,93.0,356,166,21.3,2014,0.0
Mike Liabo,1524,247,1421,529,285,220,3092.0,723,246,243.0,698,283,29.0,2014,0.0
Justin Childs,446,86,417,164,122,89,1378.0,109,29,123.0,308,135,21.2,2014,0.0
Bobby Jones,236,15,230,76,60,37,634.0,148,47,32.0,82,29,22.4,2014,1.0
Tobias Dowdell,122,8,107,54,20,13,595.0,1,1,23.0,106,53,11.4,2014,0.0
DeMarc Richardson,58,57,57,21,27,15,566.0,8,1,42.0,49,20,9.6,2014,0.0
Pierre Mopo,23,3,30,9,14,5,415.0,0,0,19.0,30,9,6.6,2014,0.0
Omari Minor,151,136,150,52,64,43,1418.0,18,4,104.0,132,48,10.1,2014,0.0
Patrick Miller,1900,520,1433,609,754,555,4451.0,392,127,375.0,1041,482,24.8,2014,0.0
Jamonte Graham,117,35,112,41,35,24,438.0,43,11,31.0,69,30,18.6,2014,0.0
Jacquan Nobles,686,63,556,237,80,66,1730.0,363,146,109.0,193,91,20.6,2014,0.0
Chaed Wellian,83,4,60,33,4,3,265.0,34,14,13.0,26,19,14.4,2014,0.0
Jordan Gaither,100,25,105,34,31,16,492.0,66,16,28.0,39,18,15.2,2014,0.0
Gerald Williams,22,2,24,7,10,8,86.0,11,0,1.0,13,7,17.7,2014,0.0
Michael Green,290,23,254,108,89,67,1343.0,40,7,68.0,214,101,13.8,2014,0.0
Dennis Ogbe,859,60,534,326,234,167,2116.0,125,40,129.0,409,286,18.2,2014,0.0
Jeremiah Samarrippas,1093,531,971,375,200,164,3947.0,515,179,352.0,456,196,19.4,2014,0.0
Ladon Carter,214,21,143,92,64,30,549.0,0,0,35.0,143,92,18.6,2014,0.0
Ty Allen,186,19,173,60,56,44,461.0,80,22,36.0,93,38,25.1,2014,0.0
Matt Marseille,490,47,381,170,188,113,1486.0,104,37,112.0,277,133,19.4,2014,0.0
Ammanuel Diressa,85,16,90,28,18,12,375.0,67,17,21.0,23,11,16.1,2014,0.0
Mitchell Hill,59,17,57,18,15,11,350.0,38,12,16.0,19,6,11.6,2014,0.0
Jarnell Stokes,1129,129,776,411,489,307,2587.0,3,0,180.0,773,411,24.2,2014,1.0
Jeronne Maymon,852,86,568,306,374,240,2248.0,8,0,170.0,560,306,21.3,2014,0.0
Antonio Barton,936,218,743,317,226,151,2966.0,390,151,145.0,353,166,17.1,2014,0.0
D'Montre Edwards,63,5,60,20,19,14,195.0,25,9,9.0,35,11,21.1,2014,0.0
Rawane Ndiaye,20,0,18,8,8,4,71.0,0,0,8.0,18,8,22.0,2014,0.0
Brandon Lopez,5,8,10,2,3,1,121.0,1,0,10.0,9,2,9.4,2014,0.0
Joy Williamson,479,67,358,162,169,123,1593.0,100,32,95.0,258,130,18.0,2014,0.0
Zane Knowles,390,21,302,168,115,54,1307.0,1,0,80.0,301,168,17.8,2014,0.0
James King,58,14,75,19,11,7,344.0,49,13,15.0,26,6,14.8,2014,0.0
Kevin Lynch,4,0,7,2,1,0,75.0,0,0,3.0,7,2,7.4,2014,1.0
Marcus Ellison,0,0,0,0,0,0,3.0,0,0,0.0,0,0,0.0,2014,0.0
Jamal Jones,463,45,416,151,104,78,970.0,229,83,55.0,187,68,29.2,2014,0.0
Fabyon Harris,572,94,437,195,130,105,1663.0,196,77,85.0,241,118,19.3,2014,0.0
Blake McDonald,18,19,18,5,8,6,193.0,6,2,12.0,12,3,9.5,2014,0.0
Don Thomas,1,0,3,0,2,1,9.0,3,0,2.0,0,0,36.0,2014,0.0
Payton Carrell,0,0,2,0,0,0,1.0,0,0,0.0,2,0,100.0,2014,0.0
Reger Dowell,813,116,647,267,215,161,1565.0,333,118,127.0,314,149,27.9,2014,0.0
Brandon Edwards,1078,75,705,387,341,252,3007.0,156,52,126.0,549,335,16.2,2014,0.0
Vincent Dillard,113,6,100,36,60,30,342.0,39,11,30.0,61,25,22.6,2014,0.0
Shaquille White-Miller,514,455,476,152,226,155,2745.0,182,55,294.0,294,97,15.6,2014,0.0
Kyle McElvain,40,3,45,14,2,2,177.0,34,10,6.0,11,4,14.4,2014,0.0
Stuart Lagerson,69,10,60,27,30,15,590.0,1,0,25.0,59,27,8.0,2014,0.0
Jarvis Ray,413,69,397,162,135,80,1428.0,64,9,103.0,333,153,21.1,2014,0.0
Thomas Montigel,36,7,37,10,16,13,312.0,19,3,7.0,18,7,8.9,2014,0.0
Clyde Smith III,31,21,44,11,13,6,282.0,13,3,22.0,31,8,14.1,2014,0.0
Kemal Dincer,5,1,11,2,2,1,28.0,5,0,1.0,6,2,25.1,2014,0.0
John Bohannon,1204,194,800,455,444,290,3063.0,25,4,252.0,775,451,22.7,2014,0.0
McKenzie Moore,360,81,253,114,133,102,911.0,84,30,89.0,169,84,24.7,2014,0.0
Justin Crosgile,516,147,485,168,113,81,1571.0,302,99,135.0,183,69,22.0,2014,0.0
Jalen Ragland,167,26,196,53,33,29,666.0,126,32,19.0,70,21,19.4,2014,0.0
Tyler Tafoya,4,0,12,1,2,2,32.0,5,0,1.0,7,1,23.0,2014,0.0
Alvin Jones,0,0,0,0,0,0,5.0,0,0,0.0,0,0,0.0,2014,1.0
Darnell Vandivort,0,0,0,0,0,0,3.0,0,0,0.0,0,0,0.0,2014,0.0
Javorn Farrell,1046,287,956,368,354,255,2937.0,200,55,238.0,756,313,22.7,2014,0.0
Justin Leathers,429,66,384,152,121,88,1499.0,109,37,98.0,275,115,18.8,2014,0.0
Josh Cleveland,518,55,413,206,219,106,1809.0,0,0,112.0,413,206,18.2,2014,0.0
Hurley Johnson,188,29,171,65,67,36,667.0,83,22,42.0,88,43,19.1,2014,0.0
Alex Majewski,101,8,86,32,22,15,328.0,63,22,18.0,23,10,18.0,2014,0.0
Lauri Toivonen,198,54,154,74,78,49,1213.0,9,1,44.0,145,73,10.1,2014,0.0
Jamal Dantzler,137,29,119,51,59,25,609.0,28,10,39.0,91,41,16.0,2014,0.0
L.J. McIntosh,56,16,73,19,11,7,246.0,52,11,12.0,21,8,18.9,2014,0.0
Christian Hildebrandt,29,9,34,8,9,7,139.0,23,6,4.0,11,2,15.7,2014,0.0
Blake Provost,13,6,19,4,4,3,146.0,13,2,9.0,6,2,10.2,2014,0.0
Jacob Raspopovich,0,9,5,0,0,0,63.0,1,0,3.0,4,0,6.5,2014,0.0
Marcel Simon,0,1,1,0,0,0,4.0,1,0,1.0,0,0,25.8,2014,0.0
Devon Agusi,366,70,248,108,175,129,830.0,65,21,90.0,183,87,25.3,2014,0.0
Jordan Sims,620,79,549,204,97,55,2426.0,462,157,71.0,87,47,14.0,2014,0.0
Hyjii Thomas,434,77,342,133,196,133,1444.0,111,35,124.0,231,98,19.7,2014,0.0
Edrico McGregor,351,44,234,145,106,60,1250.0,1,1,104.0,233,144,15.8,2014,0.0
James Williams,86,13,98,31,10,4,308.0,77,20,17.0,21,11,19.4,2014,0.0
Tyler Wood,169,34,152,56,43,27,945.0,101,30,36.0,51,26,11.2,2014,0.0
Keith Benford,11,0,6,4,0,0,11.0,4,3,0.0,2,1,27.2,2014,0.0
Trey Moore,0,6,2,0,0,0,13.0,0,0,1.0,2,0,11.5,2014,0.0
Aaric Murray,1859,146,1422,679,555,405,3433.0,277,96,271.0,1145,583,27.9,2014,0.0
D.D. Scarver,647,80,593,211,153,118,1511.0,346,107,86.0,247,104,24.4,2014,0.0
D'Angelo Scott,366,64,226,121,156,119,1440.0,28,5,102.0,198,116,14.2,2014,0.0
Lawrence Johnson-Danner,1109,134,913,362,187,155,3391.0,617,230,169.0,296,132,17.8,2014,0.0
Ray Penn,895,364,780,284,216,167,2792.0,452,160,217.0,328,124,20.4,2014,0.0
Aaron Clayborn,727,62,585,288,264,151,2489.0,5,0,154.0,580,288,17.8,2014,0.0
Vicktor Arnick,12,1,13,5,2,0,70.0,6,2,5.0,7,3,13.6,2014,0.0
Davonte Chaney,0,0,1,0,0,0,3.0,0,0,1.0,1,0,33.6,2014,0.0
Edward Chung,0,0,0,0,0,0,2.0,0,0,0.0,0,0,0.0,2014,0.0
Bobby Griffin,0,0,0,0,0,0,1.0,0,0,0.0,0,0,0.0,2014,0.0
Victor Haywood-Harris,0,0,0,0,0,0,7.0,0,0,0.0,0,0,0.0,2014,0.0
Joel Wright,1143,114,854,380,474,351,2001.0,115,32,266.0,739,348,34.3,2014,0.0
Phil Hawkins,427,145,379,137,135,104,1793.0,151,49,96.0,228,88,15.5,2014,0.0
Reid Koenen,684,69,550,228,172,134,2007.0,290,94,123.0,260,134,18.6,2014,0.0
Corey Stern,354,42,264,123,166,99,1112.0,33,9,62.0,231,114,18.6,2014,0.0
Gordon Ball,162,23,132,70,35,22,486.0,5,0,43.0,127,70,19.8,2014,0.0
Ray Dorsey,88,38,74,29,43,22,505.0,26,8,22.0,48,21,12.0,2014,0.0
Jeremiah Moore,0,0,5,0,2,0,11.0,2,0,0.0,3,0,29.4,2014,0.0
Nate Velasco,0,1,0,0,0,0,14.0,0,0,1.0,0,0,3.9,2014,0.0
Jaye Crockett,1232,111,933,466,338,251,2883.0,156,49,207.0,777,417,23.5,2014,0.0
Dejan Kravic,513,63,417,213,137,86,1345.0,2,1,94.0,415,212,22.1,2014,0.0
"Jamal Williams,",203,66,195,63,66,48,895.0,103,29,52.0,92,34,16.0,2014,0.0
Kader Tapsoba,122,8,70,44,50,34,439.0,0,0,24.0,70,44,13.9,2014,0.0
Rian Pearson,1794,197,1444,680,565,391,3668.0,128,43,251.0,1316,637,27.7,2014,0.0
Donald Beatty,0,0,1,0,0,0,6.0,0,0,0.0,1,0,8.3,2014,0.0
Jerrelle Benimon,1287,233,848,443,532,365,3101.0,110,36,294.0,738,407,23.1,2014,1.0
Rafriel Guthrie,664,63,507,214,297,188,1557.0,143,48,108.0,364,166,24.9,2014,0.0
Marcus Damas,1140,139,960,387,344,244,3140.0,378,122,210.0,582,265,21.9,2014,0.0
Mike Burwell,747,121,642,246,224,151,2269.0,323,104,139.0,319,142,20.1,2014,0.0
Marquis Marshall,34,2,31,11,9,6,105.0,24,6,3.0,7,5,18.8,2014,0.0
Jerome Hairston,333,86,316,121,70,51,1007.0,123,40,91.0,193,81,22.2,2014,0.0
Jonah Meredith,4,0,1,1,2,2,9.0,0,0,1.0,1,1,16.9,2014,0.0
Ben Mesuda,3,0,2,1,0,0,12.0,1,1,1.0,1,0,12.9,2014,0.0
Barrington Alston,7,0,12,3,7,1,103.0,1,0,6.0,11,3,10.6,2014,0.0
Larry McCollum,2,1,4,1,0,0,10.0,1,0,0.0,3,1,20.6,2014,0.0
Hunter Williams,772,208,721,265,122,82,2292.0,418,160,145.0,303,105,21.4,2014,0.0
Antoine Myers,638,167,442,212,332,213,1885.0,9,1,135.0,433,211,20.7,2014,0.0
Tevin Calhoun,507,32,458,174,133,85,1369.0,245,74,60.0,213,100,22.5,2014,0.0
Jeff Mullahey,382,72,335,116,108,83,1418.0,197,67,50.0,138,49,16.2,2014,0.0
Westley Hinton,276,18,246,98,59,41,819.0,122,39,45.0,124,59,20.6,2014,0.0
JC Bonny,82,8,60,23,39,28,303.0,30,8,26.0,30,15,17.8,2014,0.0
Phillip Coleman,2,0,4,1,0,0,6.0,1,0,0.0,3,1,34.5,2014,0.0
Hobie Hughes,0,1,0,0,0,0,8.0,0,0,0.0,0,0,0.0,2014,0.0
Tomas Bruha,247,10,181,94,95,59,1056.0,0,0,69.0,181,94,14.7,2014,0.0
Max Keenan,11,0,6,2,8,5,59.0,4,2,6.0,2,0,14.5,2014,0.0
Mikael Herbert,6,1,7,1,6,4,39.0,5,0,4.0,2,1,19.3,2014,0.0
Cole Currie,2,1,7,0,2,2,24.0,3,0,4.0,4,0,27.1,2014,0.0
Tim Peete,487,188,446,170,147,94,2456.0,175,53,140.0,271,117,13.8,2014,0.0
Patrick Swilling Jr.,482,90,438,158,98,59,1387.0,297,107,97.0,141,51,21.5,2014,0.0
Barrett Hunter,3,4,12,1,2,1,41.0,2,0,4.0,10,1,21.0,2014,0.0
Riley Kemmer,0,0,0,0,0,0,1.0,0,0,0.0,0,0,0.0,2014,0.0
Jordan Adams,1131,142,798,373,342,287,2081.0,296,98,94.0,502,275,25.3,2014,1.0
Zach LaVine,349,66,288,127,68,47,904.0,128,48,42.0,160,79,20.1,2014,1.0
Travis Wear,1052,85,843,425,228,182,2845.0,50,20,115.0,793,405,18.8,2014,1.0
David Wear,888,96,748,354,163,120,2832.0,142,60,120.0,606,294,16.8,2014,1.0
Spencer Butterfield,768,158,545,261,155,129,1827.0,263,117,102.0,282,144,21.5,2014,0.0
Preston Medlin,1368,320,966,445,329,265,3172.0,511,213,173.0,455,232,22.4,2014,0.0
Jarred Shaw,865,54,693,352,220,160,1897.0,10,1,134.0,683,351,26.7,2014,0.0
TeNale Roland,367,152,314,123,76,51,1399.0,180,70,73.0,134,53,16.5,2014,0.0
Danny Berger,331,105,282,108,87,68,1239.0,144,47,60.0,138,61,17.0,2014,0.0
Jordan Stone,224,20,136,77,124,70,1017.0,0,0,55.0,136,77,13.4,2014,0.0
Ben Clifford,380,49,264,125,136,108,1425.0,65,22,69.0,199,103,15.3,2014,0.0
Holton Hunsaker,1555,438,1220,427,531,463,4161.0,705,238,320.0,515,189,22.6,2014,0.0
Ben Aird,1535,162,1142,577,502,359,3766.0,65,22,175.0,1077,555,21.6,2014,0.0
Keawe Enos,391,101,304,123,73,63,1582.0,216,82,69.0,88,41,13.9,2014,0.0
Taylor Brown,201,66,193,62,55,30,1238.0,159,47,39.0,34,15,10.4,2014,0.0
Renan Lenz,211,25,160,83,56,42,615.0,13,3,30.0,147,80,19.0,2014,0.0
Marko Kovacevic,24,3,15,9,8,6,69.0,0,0,7.0,15,9,19.8,2014,0.0
Connor Van Brocklin,11,1,5,3,2,2,17.0,4,3,0.0,1,0,18.5,2014,0.0
Xan Ricketts,8,0,5,4,2,0,35.0,0,0,2.0,5,4,12.1,2014,0.0
LaVonte Dority,795,157,586,242,257,217,1880.0,242,94,145.0,344,148,24.1,2014,0.0
Jordan Coleman,378,45,283,118,161,118,1087.0,91,24,62.0,192,94,20.6,2014,0.0
Bobby Capobianco,481,74,348,172,166,104,1605.0,91,33,105.0,257,139,17.4,2014,0.0
Moussa Gueye,219,17,162,79,91,61,1209.0,0,0,136.0,162,79,15.1,2014,0.0
Clay Yeo,116,27,94,42,17,12,360.0,44,20,24.0,50,22,18.4,2014,0.0
Rod Odom,985,96,833,322,239,158,3165.0,492,183,143.0,341,139,18.7,2014,0.0
Kyle Fuller,706,267,629,229,270,190,2473.0,231,58,184.0,398,171,20.7,2014,0.0
Dai-Jon Parker,499,183,437,172,104,69,2177.0,237,86,125.0,200,86,15.3,2014,0.0
Rob Cross,0,1,0,0,0,0,2.0,0,0,0.0,0,0,0.0,2014,0.0
Clancy Rugg,991,64,565,290,497,386,2395.0,88,25,140.0,477,265,21.4,2014,0.0
Sandro Carissimo,1141,278,946,394,270,218,3610.0,345,135,176.0,601,259,18.7,2014,0.0
Candon Rusin,1071,84,894,371,203,141,3148.0,505,188,214.0,389,183,20.8,2014,0.0
Luke Apfeld,1048,53,734,358,372,290,2461.0,127,42,140.0,607,316,23.1,2014,0.0
Brian Voelkel,805,679,576,233,485,309,4134.0,108,30,295.0,468,203,14.3,2014,0.0
Josh Elbaum,165,123,122,60,89,44,1322.0,7,1,97.0,115,59,10.7,2014,0.0
Naasir Williams,24,15,27,8,9,6,104.0,11,2,7.0,16,6,20.0,2014,0.0
Harrison Taggart,9,3,7,3,2,2,56.0,4,1,1.0,3,2,8.7,2014,0.0
James Bell,1046,143,836,344,213,168,2866.0,522,190,170.0,314,154,19.6,2014,0.0
Tony Chennault,559,230,532,197,219,144,2315.0,90,21,184.0,442,176,18.4,2014,0.0
Nick McMahon,2,1,4,1,0,0,34.0,3,0,2.0,1,1,8.9,2014,0.0
Juvonte Reddic,1438,76,1091,574,452,286,3362.0,18,4,210.0,1073,570,22.3,2014,0.0
Rob Brandenberg,1219,191,1089,423,281,194,3242.0,525,179,148.0,564,244,21.1,2014,0.0
Terrance Shannon,432,38,357,160,201,112,1193.0,2,0,109.0,355,160,23.6,2014,0.0
Emerson Burk,0,0,0,0,0,0,8.0,0,0,0.0,0,0,0.0,2014,0.0
D.J. Covington,1516,66,1029,599,466,317,2927.0,9,1,185.0,1020,598,22.1,2014,0.0
Rodney Glasgow,1440,530,1102,489,314,259,3536.0,547,203,199.0,555,286,18.5,2014,0.0
Drew Absher,54,18,47,16,17,13,176.0,32,9,15.0,15,7,18.0,2014,0.0
Jarell Eddie,1182,139,995,383,276,224,3176.0,526,192,183.0,469,191,21.7,2014,1.0
C.J. Barksdale,433,40,331,164,121,94,1464.0,31,11,60.0,300,153,16.1,2014,0.0
Cadarian Raines,553,46,486,234,163,85,1947.0,0,0,90.0,486,234,17.5,2014,0.0
Joe Harris,1698,254,1276,568,414,299,4084.0,646,263,213.0,630,305,23.6,2014,1.0
Akil Mitchell,912,147,695,361,331,189,3164.0,11,1,155.0,684,360,18.2,2014,0.0
Teven Jones,101,42,96,31,43,28,531.0,37,11,28.0,59,20,15.5,2014,0.0
Thomas Rogers,10,4,21,3,4,1,82.0,16,3,8.0,5,0,21.5,2014,0.0
Kenneth Ortiz,1080,451,881,353,519,356,3077.0,72,18,318.0,809,335,23.3,2014,0.0
Latif Rivers,1513,244,1190,470,441,377,3314.0,547,196,259.0,643,274,25.2,2014,0.0
Orlando Parker,715,54,591,290,209,135,2417.0,6,0,113.0,585,290,16.8,2014,0.0
Naofall Folahan,485,25,353,192,154,101,2118.0,0,0,102.0,353,192,12.5,2014,0.0
Travis McKie,1687,146,1228,568,567,430,4020.0,367,121,234.0,861,447,22.2,2014,0.0
Coron Williams,1288,165,1021,442,158,123,3360.0,673,281,92.0,348,161,18.2,2014,0.0
Duke Antonelli,2,0,3,1,0,0,6.0,0,0,0.0,3,1,25.7,2014,0.0
D.J. Shelton,674,116,541,231,233,159,2314.0,191,53,147.0,350,178,19.0,2014,0.0
Will DiIorio,154,34,119,55,75,36,943.0,23,8,39.0,96,47,11.2,2014,0.0
Dominic Ballard,6,11,8,2,2,2,88.0,0,0,4.0,8,2,8.1,2014,0.0
C.J. Wilcox,1880,214,1478,640,356,299,3735.0,773,301,178.0,705,339,24.1,2014,1.0
Perris Blackwell,1245,99,872,477,511,291,3046.0,2,0,210.0,870,477,21.9,2014,0.0
Quinn Sterling,8,1,2,1,6,5,21.0,2,1,4.0,0,0,21.3,2014,0.0
Hikeem Stewart,24,15,36,10,3,2,237.0,16,2,13.0,20,8,10.5,2014,0.0
Connor Smith,2,0,1,1,0,0,7.0,0,0,0.0,1,1,7.2,2014,0.0
Davion Berry,1160,262,727,342,447,355,2217.0,302,121,161.0,425,221,27.0,2014,0.0
Kyle Tresnak,1214,64,866,489,346,236,2894.0,0,0,149.0,866,489,22.0,2014,0.0
Jordan Richardson,722,300,624,231,139,108,3058.0,407,152,160.0,217,79,15.0,2014,0.0
Royce Williams,147,37,112,52,27,18,552.0,57,25,32.0,55,27,15.4,2014,0.0
Byron Fulton,529,39,449,204,70,46,1463.0,169,75,65.0,280,129,20.0,2014,0.0
Josh Fuller,18,0,9,6,5,4,51.0,4,2,4.0,5,4,16.6,2014,0.0
Remi Dibo,235,21,200,79,31,26,621.0,136,51,20.0,64,28,18.9,2014,0.0
Kevin Noreen,226,62,138,74,109,70,1391.0,27,8,53.0,111,66,8.8,2014,0.0
Trey Sumler,1996,496,1490,645,599,489,4648.0,564,217,379.0,926,428,22.9,2014,0.0
Brandon Boggs,1370,150,1304,528,300,195,3593.0,379,119,224.0,925,409,23.0,2014,0.0
Tom Tankelewicz,779,73,662,256,101,88,2020.0,484,179,101.0,178,77,19.9,2014,0.0
Tawaski King,1009,73,816,393,359,223,3285.0,1,0,207.0,815,393,18.0,2014,0.0
Josh Mendenhall,76,10,70,32,17,12,394.0,0,0,26.0,70,32,13.1,2014,0.0
Ethan Freeman,5,3,4,1,2,2,15.0,1,1,0.0,3,0,16.3,2014,0.0
Adam Link,583,95,400,218,219,146,1883.0,6,1,103.0,394,217,19.1,2014,0.0
Michael Ochereobia,371,24,250,148,134,75,1031.0,0,0,75.0,250,148,21.9,2014,0.0
Jason Hawthorne,78,18,67,30,13,6,355.0,36,12,22.0,31,18,15.8,2014,0.0
Brandon Harris,462,99,419,136,117,85,1614.0,325,105,77.0,94,31,17.3,2014,0.0
Caden Dickerson,596,131,511,197,108,84,2927.0,335,118,127.0,176,79,11.8,2014,0.0
O'Karo Akamune,241,30,181,95,106,51,1058.0,1,0,61.0,180,95,13.9,2014,0.0
Daouda Soumaoro,10,0,3,0,10,10,52.0,0,0,0.0,3,0,7.5,2014,0.0
Shayne Whittington,1119,81,807,416,367,279,2574.0,48,8,150.0,759,408,22.9,2014,1.0
Hayden Hoerdemann,98,22,91,30,24,17,311.0,61,21,13.0,30,9,19.1,2014,0.0
Cleanthony Early,1135,50,790,371,342,280,1965.0,325,113,131.0,465,258,28.6,2014,1.0
Chadrack Lufile,259,17,180,100,106,59,836.0,0,0,53.0,180,100,17.7,2014,0.0
Nick Wiggins,358,31,296,117,112,71,1007.0,161,53,51.0,135,64,20.7,2014,0.0
Kadeem Coleby,387,31,282,149,178,89,1219.0,0,0,92.0,282,149,18.7,2014,0.0
Tim Rusthoven,1205,167,831,470,389,260,2624.0,32,5,167.0,799,465,25.1,2014,0.0
Brandon Britt,1254,199,947,407,444,312,2932.0,371,128,203.0,576,279,26.0,2014,0.0
Kyle Gaillard,756,169,594,285,177,106,2934.0,222,80,109.0,372,205,15.0,2014,0.0
Julian Boatner,605,135,497,196,66,52,2303.0,420,161,104.0,77,35,15.4,2014,0.0
Fred Heldring,104,43,96,36,43,29,859.0,20,3,50.0,76,33,10.8,2014,0.0
Ben Whitlatch,21,0,20,7,2,1,56.0,15,6,1.0,5,1,21.9,2014,0.0
Joab Jerome,907,216,648,291,393,276,2817.0,152,49,247.0,496,242,20.4,2014,0.0
Larry Brown,341,29,306,147,99,47,1401.0,4,0,89.0,302,147,16.9,2014,0.0
Brandon Vega,113,61,84,39,44,34,416.0,3,1,37.0,81,38,17.6,2014,0.0
Christian Farmer,256,21,239,82,46,34,624.0,185,58,27.0,54,24,25.0,2014,0.0
Carlin Bremner,89,20,109,33,12,7,311.0,57,16,17.0,52,17,19.5,2014,0.0
Donovan Carter,5,3,10,2,4,1,137.0,0,0,9.0,10,2,7.9,2014,0.0
Ivan Saicic,0,0,4,0,0,0,19.0,1,0,3.0,3,0,19.0,2014,0.0
Ben Brust,1148,156,952,392,156,129,3332.0,607,235,95.0,345,157,18.9,2014,0.0
Zach Bohannon,161,36,110,57,50,30,541.0,46,17,32.0,64,40,17.9,2014,0.0
Aerris Smith,283,11,225,121,74,41,1632.0,0,0,62.0,225,121,10.8,2014,0.0
Indiana Faithfull,174,150,167,57,50,40,1097.0,66,20,87.0,101,37,13.8,2014,0.0
Zac Grossenbacher,32,2,28,11,4,2,94.0,21,8,4.0,7,3,19.6,2014,0.0
A.J. Pacher,873,78,650,317,261,183,2127.0,182,56,172.0,468,261,24.8,2014,0.0
Miles Dixon,884,176,781,303,289,222,2564.0,187,56,177.0,594,247,22.2,2014,0.0
Jerran Young,594,75,432,218,185,119,1421.0,109,39,122.0,323,179,25.0,2014,0.0
Cole Darling,839,81,682,283,273,209,2258.0,185,64,133.0,497,219,23.4,2014,0.0
Matt Vest,619,206,461,226,168,101,2627.0,187,66,111.0,274,160,13.9,2014,0.0
Tavares Sledge,292,24,283,119,96,53,1222.0,10,1,79.0,273,118,18.7,2014,0.0
Stephen Gossard,20,0,9,8,6,4,48.0,0,0,1.0,9,8,14.9,2014,0.0
Nathan Sobey,439,88,340,145,161,109,1434.0,128,40,64.0,212,105,20.1,2014,0.0
Jerron Granberry,1273,167,978,365,378,310,3766.0,654,233,204.0,324,132,19.4,2014,0.0
Aaron Tyser,13,1,7,5,0,0,18.0,4,3,2.0,3,2,30.4,2014,0.0
Austin Haldorson,37,4,43,14,4,4,216.0,17,5,6.0,26,9,14.0,2014,0.0
Zane Stull,0,0,0,0,0,0,6.0,0,0,1.0,0,0,10.1,2014,0.0
Semaj Christon,1034,281,785,363,421,282,2227.0,77,26,198.0,708,337,28.2,2014,1.0
Isaiah Philmore,1169,69,819,412,441,321,3212.0,82,24,165.0,737,388,19.5,2014,0.0
Erik Stenger,84,8,63,34,45,16,440.0,0,0,22.0,63,34,13.0,2014,0.0
Kamall Richards,5,2,7,2,1,1,23.0,2,0,2.0,5,2,21.4,2014,0.0
Tim Whelan,1,0,4,0,2,1,18.0,0,0,4.0,4,0,26.8,2014,0.0
Landen Amos,9,3,12,1,14,7,183.0,0,0,6.0,12,1,7.3,2014,0.0
Jesse Pritchard,203,43,190,63,54,36,1215.0,129,41,39.0,61,22,10.9,2014,0.0
Isaiah Salafia,141,50,132,42,40,29,744.0,75,28,67.0,57,14,15.2,2014,0.0
J.T. Flowers,19,1,18,7,8,2,63.0,7,3,1.0,11,4,18.8,2014,0.0
Will Childs-Klein,39,6,36,17,8,4,96.0,5,1,11.0,31,16,27.5,2014,0.0
Kendrick Perry,1991,505,1374,643,670,504,4183.0,577,201,241.0,797,442,24.0,2014,0.0
Kamren Belin,728,99,623,244,154,123,1984.0,328,117,111.0,295,127,21.0,2014,0.0
Mike Podolsky,32,9,43,11,9,2,265.0,25,8,11.0,18,3,11.4,2014,0.0
Josh Chojnacki,100,20,85,37,34,23,696.0,17,3,33.0,68,34,10.1,2014,0.0
Harrison Hawkins,597,97,471,197,148,121,1222.0,218,82,121.0,253,115,28.7,2015,0.0
LaDarrien Williams,500,124,451,175,135,104,1221.0,137,46,98.0,314,129,26.5,2015,0.0
Riley Payne,187,32,154,72,72,43,1022.0,0,0,45.0,154,72,12.0,2015,0.0
Michael Grant,213,36,155,70,109,73,858.0,6,0,64.0,149,70,16.5,2015,0.0
Alexsander Milosavljevic,52,4,53,24,8,4,215.0,1,0,16.0,52,24,17.7,2015,0.0
David Hanson,3,5,6,1,2,0,35.0,3,1,2.0,3,0,13.7,2015,0.0
Max Yon,828,164,648,280,232,174,2206.0,289,94,154.0,359,186,23.1,2015,0.0
Marek Olesinski,750,121,578,265,134,97,2234.0,326,123,103.0,252,142,18.6,2015,0.0
Justin Hammonds,530,111,361,196,205,118,1758.0,50,20,110.0,311,176,18.1,2015,0.0
Kamryn Williams,554,157,465,204,159,105,1807.0,127,41,127.0,338,163,20.6,2015,0.0
DeLovell Earls,291,121,262,108,111,58,1207.0,64,17,100.0,198,91,19.1,2015,0.0
Lake Lutes,6,0,4,2,0,0,10.0,3,2,0.0,1,0,23.0,2015,0.0
Adedeji Ibitayo,598,68,453,192,209,138,1508.0,219,76,89.0,234,116,22.0,2015,0.0
Nyles Evans,346,106,322,114,72,48,1379.0,215,70,66.0,107,44,15.9,2015,0.0
Demetrius Treadwell,1101,143,875,424,454,252,2554.0,13,1,194.0,862,423,25.7,2015,0.0
Malcolm Walters,8,5,11,2,8,3,59.0,7,1,8.0,4,1,20.1,2015,0.0
Ricardo Hill Jr.,3,0,4,1,2,1,18.0,2,0,0.0,2,1,14.3,2015,0.0
Michael Hutchins,74,18,71,25,20,15,436.0,38,9,16.0,33,16,11.5,2015,0.0
Isaiah Cotton,44,5,35,16,34,12,213.0,0,0,20.0,35,16,17.3,2015,0.0
C.J. Washington,593,31,522,228,151,94,1365.0,140,43,83.0,382,185,24.2,2015,0.0
Denzel Collins,9,3,8,3,3,2,27.0,4,1,2.0,4,2,21.9,2015,0.0
Jarvis Calhoun,5,4,16,2,1,0,56.0,11,1,3.0,5,1,18.0,2015,0.0
DeMarcus Robinson,676,114,590,233,149,114,1769.0,288,96,75.0,302,137,20.3,2015,0.0
Wendell Lewis,628,53,487,264,166,100,2127.0,1,0,122.0,486,264,16.2,2015,0.0
Maurice Strong,525,56,452,203,213,119,1670.0,4,0,109.0,448,203,19.3,2015,0.0
Luther Page,660,89,502,227,381,206,2624.0,3,0,205.0,499,227,16.8,2015,0.0
Brandon Graham,432,45,338,151,137,93,1359.0,136,37,73.0,202,114,17.1,2015,0.0
Jamar Pope,15,2,10,5,4,3,57.0,5,2,2.0,5,3,11.7,2015,0.0
Billy Ingram,84,8,80,31,16,9,259.0,46,13,18.0,34,18,20.0,2015,0.0
Tony Jacob,18,3,10,7,13,4,36.0,0,0,8.0,10,7,32.7,2015,0.0
Darius Scott,14,4,15,6,1,1,61.0,4,1,3.0,11,5,14.7,2015,0.0
Trey Scott,0,0,0,0,0,0,4.0,0,0,1.0,0,0,12.0,2015,0.0
Darius Sizemore,0,0,1,0,0,0,0.0,0,0,0.0,1,0,0,2015,0.0
Levi Randolph,1336,243,1043,455,411,307,4139.0,360,119,177.0,683,336,18.7,2015,0.0
Rodney Cooper,1122,161,988,401,245,182,3514.0,443,138,182.0,545,263,20.0,2015,0.0
John Gibson,2,0,1,1,1,0,5.0,0,0,0.0,1,1,16.3,2015,0.0
Sam Rowley,1194,166,888,453,379,288,3202.0,6,0,268.0,882,453,23.1,2015,0.0
Wheeler Baker,168,11,143,56,29,21,417.0,93,35,27.0,50,21,24.8,2015,0.0
Tre Green,17,2,16,5,7,5,54.0,5,2,6.0,11,3,26.4,2015,0.0
Mike Wells,2,0,2,1,0,0,10.0,0,0,0.0,2,1,11.2,2015,0.0
Reece Williams,4,0,5,1,2,2,23.0,1,0,2.0,4,1,19.2,2015,0.0
George Thomas,135,19,134,43,43,27,766.0,81,22,38.0,53,21,12.7,2015,0.0
Omar Beauperthuy,18,5,21,7,6,4,182.0,2,0,11.0,19,7,9.6,2015,0.0
Corey Barnes Jr.,15,0,16,5,4,1,41.0,13,4,5.0,3,1,27.9,2015,0.0
Tavis Gibson,14,6,30,4,3,2,127.0,28,4,9.0,2,0,15.9,2015,0.0
Corey Young,24,2,26,9,0,0,123.0,20,6,2.0,6,3,11.4,2015,0.0
Bassel Harfouch,7,0,14,3,0,0,43.0,9,1,2.0,5,2,18.6,2015,0.0
George Gudadze,0,0,2,0,4,0,14.0,1,0,0.0,1,0,13.9,2015,0.0
John Schoof,1154,230,909,390,185,147,4062.0,553,227,187.0,356,163,17.6,2015,0.0
Darius Gardner,999,448,761,338,298,221,3862.0,261,102,297.0,500,236,18.3,2015,0.0
Kevin Panzer,454,88,433,162,120,76,1979.0,178,54,118.0,255,108,17.0,2015,0.0
Zach Elcano,72,24,57,28,30,16,443.0,0,0,39.0,57,28,15.7,2015,0.0
Justice Montgomery,14,16,22,4,16,5,160.0,7,1,16.0,15,3,16.8,2015,0.0
Langdon Neal,0,0,0,0,0,0,4.0,0,0,0.0,0,0,0.0,2015,0.0
Tommy Spagnolo,590,66,447,239,171,106,1813.0,17,6,130.0,430,233,18.4,2015,0.0
Milos Kostic,40,7,44,14,8,6,146.0,27,6,8.0,17,8,19.7,2015,0.0
Tab Hamilton,913,94,865,329,150,109,2593.0,435,146,116.0,430,183,20.4,2015,0.0
Rantavious Gilbert,79,6,69,32,23,15,262.0,0,0,15.0,69,32,18.2,2015,0.0
Logan Jackson,10,4,10,5,2,0,53.0,5,0,3.0,5,5,13.5,2015,0.0
Shaquielle McKissic,710,142,528,238,255,170,1978.0,191,64,77.0,337,174,19.1,2015,0.0
Bo Barnes,575,64,461,182,112,83,1841.0,339,128,67.0,122,54,16.3,2015,0.0
Jonathan Gilling,998,272,784,323,138,94,3579.0,638,258,184.0,146,65,15.2,2015,0.0
Roosevelt Scott,77,11,61,27,31,20,243.0,16,3,23.0,45,24,21.2,2015,0.0
Corban Murphy,0,1,1,0,0,0,3.0,1,0,0.0,0,0,17.4,2015,0.0
Stanley Johnson,523,63,390,174,178,132,1081.0,116,43,82.0,274,131,26.6,2015,1.0
Brandon Ashley,979,71,678,352,344,249,2383.0,68,26,146.0,610,326,21.5,2015,0.0
Rondae Hollis-Jefferson,774,114,522,259,356,248,2050.0,39,8,103.0,483,251,20.2,2015,1.0
T.J. McConnell,1414,751,1123,550,235,176,4425.0,363,138,281.0,760,412,17.4,2015,1.0
Matt Korcheck,50,5,26,18,18,14,178.0,0,0,7.0,26,18,12.2,2015,0.0
Trey Mason,8,3,6,3,0,0,34.0,2,2,3.0,4,1,13.8,2015,0.0
Drew Mellon,1,3,8,0,2,1,46.0,3,0,1.0,5,0,11.2,2015,0.0
Ben Dillard,801,119,584,223,307,253,2555.0,288,102,111.0,296,121,17.0,2015,0.0
J.T. Thomas,304,112,280,95,122,75,1366.0,124,39,75.0,156,56,16.1,2015,0.0
Gus Leeper,367,19,322,141,111,82,1502.0,4,3,89.0,318,138,15.9,2015,0.0
DeVonte Smith,220,135,187,76,80,49,1355.0,61,19,50.0,126,57,10.3,2015,0.0
Jerron Washington,15,3,23,5,10,5,126.0,2,0,7.0,21,5,14.6,2015,0.0
Andre Brown,4,0,6,2,1,0,78.0,0,0,4.0,6,2,7.1,2015,1.0
Marcel Mosley,1019,221,804,320,314,245,2664.0,368,134,259.0,436,186,23.8,2015,0.0
Tevin Hammond,892,365,755,255,354,257,3063.0,388,125,307.0,367,130,20.8,2015,0.0
DeAndre McIntyre,162,23,148,60,47,29,769.0,50,13,56.0,98,47,15.5,2015,0.0
Jaylon Floyd,170,14,138,67,65,34,1085.0,9,2,60.0,129,65,10.9,2015,0.0
Jared Young,8,0,5,3,3,1,23.0,2,1,3.0,3,2,21.2,2015,0.0
Sean Tingle,62,2,49,18,45,26,183.0,1,0,31.0,48,18,28.7,2015,0.0
Cameron Golden,870,224,809,288,215,146,2406.0,475,148,175.0,334,140,23.2,2015,0.0
Daijon Macklien,47,18,41,18,9,6,281.0,13,5,24.0,28,13,12.7,2015,0.0
Ronnie White,5,0,4,1,4,3,26.0,0,0,1.0,4,1,13.7,2015,0.0
Bobby Portis,1047,92,782,411,274,202,1994.0,63,23,97.0,719,388,24.2,2015,1.0
Michael Qualls,1100,147,851,364,372,269,2379.0,312,103,133.0,539,261,23.4,2015,0.0
Rashad Madden,1106,369,782,336,390,314,2997.0,353,120,246.0,429,216,19.5,2015,0.0
Alandise Harris,1215,149,888,429,480,321,2884.0,105,36,223.0,783,393,23.0,2015,0.0
Mo Williams,368,93,314,110,144,101,2002.0,163,47,103.0,151,63,12.3,2015,1.0
Milton Washington,161,57,115,58,58,41,473.0,8,4,57.0,107,54,21.5,2015,0.0
Tanner Omlid,220,61,200,85,35,23,634.0,98,27,36.0,102,58,20.1,2015,0.0
Sean Billerman,14,3,12,4,7,4,36.0,9,2,0.0,3,2,21.5,2015,0.0
Kieffer Jordan,17,7,19,6,9,4,152.0,6,1,7.0,13,5,10.0,2015,0.0
Travis Waldroup-Rodriguez,0,0,0,0,0,0,4.0,0,0,0.0,0,0,0.0,2015,0.0
K.T. Harrell,1497,152,1099,476,440,353,3032.0,488,192,212.0,611,284,26.3,2015,0.0
Antoine Mason,2308,192,1734,727,941,685,4282.0,543,169,288.0,1191,558,28.0,2015,0.0
K.C. Ross-Miller,656,256,476,181,302,240,2390.0,176,54,199.0,300,127,17.5,2015,0.0
Malcolm Canada,285,98,233,85,145,105,1130.0,54,10,73.0,179,75,16.9,2015,0.0
Trayvon Reed,597,29,358,235,197,121,1541.0,21,6,96.0,337,229,16.7,2015,0.0
C.J. Holmes,8,0,3,3,0,0,14.0,2,2,1.0,1,1,14.6,2015,0.0
Ed Dyson,551,89,416,183,189,125,1556.0,173,60,92.0,243,123,18.9,2015,0.0
Chris Freeman,612,46,439,246,177,120,1740.0,1,0,117.0,438,246,18.3,2015,0.0
Zavion Williams,591,185,522,207,191,137,1565.0,155,40,175.0,367,167,24.5,2015,0.0
Jeremy Purvis,136,85,122,41,30,21,831.0,96,33,36.0,26,8,10.3,2015,0.0
Demarius Smith,259,180,206,90,117,66,1060.0,51,13,147.0,155,77,18.9,2015,0.0
Serigne Mboup,69,9,46,19,52,31,302.0,0,0,29.0,46,19,16.2,2015,0.0
Matt Kamieniecki,431,71,300,156,228,118,1649.0,3,1,96.0,297,155,16.2,2015,0.0
Mading Thok,49,4,29,20,19,9,120.0,0,0,7.0,29,20,19.3,2015,0.0
Royce O'Neale,1268,400,862,411,401,301,4057.0,363,145,258.0,499,266,18.1,2015,1.0
Kenny Chery,754,293,619,250,190,163,2008.0,258,91,152.0,361,159,22.1,2015,0.0
Deng Deng,234,12,201,81,65,39,687.0,111,33,46.0,90,48,20.5,2015,0.0
Reece Chamberlain,789,454,559,251,304,211,2787.0,211,76,219.0,348,175,17.1,2015,0.0
Caleb Chowbay,178,67,158,62,33,28,735.0,78,26,60.0,80,36,16.4,2015,0.0
Spencer Turner,158,33,143,53,12,7,463.0,128,45,20.0,15,8,18.8,2015,0.0
Holden Mobley,77,40,56,23,29,19,683.0,33,12,35.0,23,11,7.9,2015,0.0
Mikel Trapp,833,105,745,278,137,95,2874.0,536,182,140.0,209,96,17.8,2015,0.0
Brandon Stewart,292,28,240,80,141,106,709.0,100,26,60.0,140,54,28.0,2015,0.0
Delino Dear,508,30,373,193,211,122,1828.0,0,0,104.0,373,193,17.1,2015,0.0
Travis Elliott,395,39,354,150,183,95,2198.0,0,0,115.0,354,150,13.4,2015,0.0
Tony Kynard,219,129,244,76,77,63,845.0,43,4,84.0,201,72,23.2,2015,0.0
Jeffon Powell,24,3,26,7,14,10,256.0,5,0,15.0,21,7,10.2,2015,0.0
Ugo Okam,24,6,21,10,11,4,179.0,0,0,18.0,21,10,13.6,2015,0.0
Magnus Richards,142,25,143,52,64,38,830.0,1,0,76.0,142,52,16.1,2015,0.0
Karon Waller,200,32,172,59,78,56,856.0,84,26,51.0,88,33,16.1,2015,0.0
Jabrille Williams,92,9,86,39,14,6,589.0,31,8,28.0,55,31,11.0,2015,0.0
Derrick Marks,1912,370,1417,669,580,458,3538.0,293,116,332.0,1124,553,30.6,2015,0.0
Igor Hadziomerovic,511,219,456,184,161,100,2365.0,140,43,150.0,316,141,15.5,2015,0.0
Robert Heyer,161,24,103,54,36,31,704.0,53,22,24.0,50,32,11.6,2015,0.0
Kevin Allen,74,1,47,30,23,14,164.0,0,0,11.0,47,30,23.7,2015,0.0
Joe Hanstad,145,42,118,47,33,25,727.0,82,26,30.0,36,21,12.1,2015,0.0
Dezmyn Trent,91,4,85,32,25,13,215.0,41,14,16.0,44,18,28.4,2015,0.0
Jake Ness,12,3,9,2,10,8,188.0,2,0,5.0,7,2,5.4,2015,0.0
Chris Nealey,2,1,1,0,2,2,19.0,1,0,1.0,0,0,8.8,2015,0.0
Olivier Hanlan,1727,303,1247,565,541,421,3493.0,487,176,236.0,760,389,27.9,2015,0.0
Patrick Heckmann,903,197,632,290,281,214,2691.0,320,109,194.0,312,181,19.9,2015,0.0
Dimitri Batten,1227,161,1048,425,324,211,3250.0,490,166,197.0,558,259,22.3,2015,0.0
Eddie Odio,351,70,288,131,92,57,1856.0,109,32,75.0,179,99,12.3,2015,0.0
John Cain Carney,17,5,22,8,3,0,240.0,4,1,8.0,18,7,7.3,2015,0.0
Alex Dragicevich,362,66,295,116,90,64,1272.0,193,66,51.0,102,50,17.1,2015,0.0
Sam Donahue,5,2,14,2,0,0,21.0,12,1,0.0,2,1,37.8,2015,0.0
Braiten Madrigal,3,0,5,1,0,0,22.0,5,1,0.0,0,0,12.3,2015,0.0
Richaun Holmes,1089,62,728,403,363,253,2518.0,85,30,143.0,643,373,21.8,2015,1.0
Jehvon Clarke,888,261,854,328,179,134,2423.0,313,98,227.0,541,230,25.2,2015,0.0
Anthony Henderson,736,123,630,261,167,104,2451.0,304,110,83.0,326,151,17.0,2015,0.0
Jovan Austin,117,87,95,36,60,38,545.0,22,7,63.0,73,29,18.4,2015,0.0
Chauncey Orr,305,63,233,104,83,65,1108.0,90,32,58.0,143,72,15.9,2015,0.0
Damarkeo Lyshe,62,14,59,19,20,13,241.0,36,11,11.0,23,8,17.1,2015,0.0
Auston Barnes,607,69,498,205,143,120,2239.0,221,77,93.0,277,128,16.0,2015,0.0
Tramique Sutherland,272,73,260,93,96,72,864.0,45,14,57.0,215,79,23.2,2015,0.0
Jermaine Morgan,55,4,62,21,28,13,267.0,1,0,20.0,61,21,19.7,2015,0.0
Jackson Kane,0,2,0,0,0,0,11.0,0,0,0.0,0,0,0.0,2015,0.0
Tyler Haws,2720,257,1916,917,820,724,4427.0,427,162,244.0,1489,755,27.6,2015,0.0
Anson Winder,808,170,582,267,248,174,2126.0,283,100,91.0,299,167,17.8,2015,0.0
Skyler Halford,545,113,389,178,125,108,1152.0,201,81,80.0,188,97,21.8,2015,0.0
Ryan Andrus,40,3,22,12,18,13,157.0,8,3,5.0,14,9,11.0,2015,0.0
Josh Sharp,250,63,168,93,90,59,1379.0,17,5,45.0,151,88,8.9,2015,0.0
Jordan Ellis,2,3,2,1,2,0,41.0,0,0,2.0,2,1,5.9,2015,0.0
Dockery Walker,568,35,459,234,202,99,1493.0,5,1,114.0,454,233,23.1,2015,0.0
Longi Yiljep,45,10,41,15,20,11,306.0,16,4,20.0,25,11,12.3,2015,0.0
Jon Schmidt,41,15,56,17,14,7,297.0,0,0,14.0,56,17,13.8,2015,0.0
Dyami Starks,1779,162,1464,600,319,279,3545.0,807,300,204.0,657,300,27.0,2015,0.0
Joe O'Shea,865,161,602,273,294,225,2846.0,274,94,109.0,328,179,15.7,2015,0.0
Blake McBride,3,1,7,1,0,0,31.0,4,1,0.0,3,0,12.3,2015,0.0
Ellis Williams,8,3,8,3,5,2,121.0,0,0,7.0,8,3,7.5,2015,0.0
Steven Kaspar,532,413,442,181,252,144,2610.0,90,26,205.0,352,155,16.1,2015,0.0
Cory Starkey,179,46,150,74,50,31,828.0,0,0,52.0,150,74,14.8,2015,0.0
Justin Moss,688,24,462,244,290,200,1255.0,4,0,92.0,458,244,27.2,2015,0.0
Xavier Ford,533,42,428,190,217,134,1474.0,56,19,113.0,372,171,21.9,2015,0.0
Will Regan,907,73,683,305,243,186,2669.0,304,111,107.0,379,194,17.3,2015,0.0
Bobby Frasco,0,0,4,0,0,0,14.0,3,0,0.0,1,0,14.0,2015,0.0
Alex Barlow,596,274,497,194,132,105,2931.0,290,103,146.0,207,91,12.7,2015,0.0
Kameron Woods,804,148,623,289,329,214,3315.0,65,12,188.0,558,277,15.4,2015,0.0
Jackson Aldridge,213,63,203,63,92,63,912.0,94,24,78.0,109,39,18.6,2015,0.0
Maliik Love,511,210,445,188,203,120,2567.0,49,15,133.0,396,173,14.6,2015,0.0
Michael Bolden,203,32,204,69,27,18,1012.0,141,47,17.0,63,22,12.9,2015,0.0
Anthony Silvestri,111,4,132,37,14,8,504.0,117,29,11.0,15,8,16.6,2015,0.0
Alberto Ganis,4,0,7,2,0,0,16.0,0,0,0.0,7,2,24.6,2015,0.0
KJ Logue,2,1,1,0,6,2,48.0,0,0,1.0,1,0,5.7,2015,0.0
Javonte Maynor,1065,107,904,343,163,108,3330.0,720,271,111.0,184,72,17.2,2015,0.0
Tyrell Corbin,529,229,430,151,241,189,1883.0,131,38,204.0,299,113,21.2,2015,0.0
Dashawn Richmond,180,19,147,59,50,36,463.0,67,26,30.0,80,33,24.0,2015,0.0
Cortez Conners,150,26,141,52,19,18,498.0,79,28,25.0,62,24,19.5,2015,0.0
Abdul Ahmed,202,32,205,72,42,29,792.0,93,29,48.0,112,43,18.4,2015,0.0
Kregg Jones,157,5,124,65,63,27,690.0,0,0,40.0,124,65,14.6,2015,0.0
Dee Wallace,9,0,12,3,0,0,27.0,12,3,0.0,0,0,23.2,2015,0.0
Alex Harris,1387,307,1120,457,465,318,3519.0,500,155,211.0,620,302,23.1,2015,0.0
Moses Morgan,796,94,800,276,135,93,2244.0,461,151,140.0,339,125,22.3,2015,0.0
Steve McClellan,721,68,544,288,211,141,2552.0,7,4,150.0,537,284,16.5,2015,0.0
Josh Gentry,425,73,318,140,142,113,1442.0,107,32,81.0,211,108,16.9,2015,0.0
Jordan Mason,128,15,125,47,28,19,308.0,60,15,18.0,65,32,26.5,2015,0.0
Joe Boyd,141,15,128,51,49,39,860.0,2,0,41.0,126,51,11.7,2015,0.0
Temjae Singleton,46,5,47,14,19,10,174.0,32,8,10.0,15,6,19.7,2015,0.0
Corey Walker,0,0,2,0,0,0,19.0,1,0,2.0,1,0,11.1,2015,0.0
Stephan Hicks,1959,137,1338,651,737,599,3938.0,185,58,227.0,1153,593,24.1,2015,0.0
Stephen Maxwell,1748,67,1199,635,657,478,3704.0,0,0,219.0,1199,635,23.3,2015,0.0
Devonte Elliott,539,54,487,199,202,133,2026.0,41,8,121.0,446,191,18.1,2015,0.0
Ajon Efferson,97,16,96,35,7,4,291.0,60,23,16.0,36,12,20.9,2015,0.0
Taelin Webb,78,52,86,27,25,16,457.0,22,8,43.0,64,19,16.2,2015,0.0
Robert Cid,10,0,9,2,6,5,24.0,4,1,2.0,5,1,30.1,2015,0.0
Corey Hawkins,1743,297,1200,561,555,445,3095.0,434,176,226.0,766,385,29.7,2015,0.0
Josh Ritchart,1333,116,1003,473,224,153,3014.0,568,234,168.0,435,239,22.9,2015,0.0
Tyler Les,751,147,533,235,85,72,2525.0,474,209,100.0,59,26,14.4,2015,0.0
Justin Dueck,20,4,16,8,12,4,272.0,0,0,10.0,16,8,6.3,2015,0.0
Will Davis II,1384,90,1083,593,306,198,3406.0,2,0,206.0,1081,593,21.9,2015,0.0
Travis Souza,540,122,398,163,89,72,1945.0,342,142,61.0,56,21,13.6,2015,0.0
John Ryan,357,76,269,146,117,65,1240.0,0,0,91.0,269,146,17.7,2015,0.0
Reed McConnell,28,7,29,10,4,3,110.0,15,5,3.0,14,5,16.3,2015,0.0
Steven Thornton,580,63,452,183,182,136,1864.0,233,78,78.0,219,105,17.2,2015,0.0
Nick Gruninger,373,176,296,118,103,92,1371.0,128,45,92.0,168,73,16.6,2015,0.0
Austin Quick,478,202,440,158,121,83,2074.0,260,79,162.0,180,79,16.7,2015,0.0
Charles Standifer,94,16,112,33,37,18,364.0,39,10,23.0,73,23,21.8,2015,0.0
Cheick Thiero,26,0,17,12,2,2,96.0,0,0,6.0,17,12,13.1,2015,0.0
Chris Tang,14,3,11,6,2,0,39.0,4,2,1.0,7,4,17.5,2015,0.0
Colin Gruber,155,22,175,53,29,26,649.0,85,23,34.0,90,30,17.7,2015,0.0
Kristopher Acevedo,4,0,5,2,0,0,8.0,2,0,0.0,3,2,32.6,2015,0.0
Brian Wright,0,1,1,0,0,0,22.0,1,0,1.0,0,0,4.8,2015,0.0
Alan Williams,1732,117,1295,637,649,458,3026.0,3,0,196.0,1292,637,32.0,2015,1.0
Zalmico Harmon,427,261,341,124,168,131,1906.0,135,48,82.0,206,76,14.4,2015,0.0
Hunter Ford,34,7,21,12,2,1,77.0,18,9,2.0,3,3,17.0,2015,0.0
David Kravish,1266,127,1065,554,213,152,3943.0,22,6,158.0,1043,548,17.6,2015,0.0
Christian Behrens,176,13,145,69,72,38,772.0,0,0,28.0,145,69,14.2,2015,0.0
Dwight Tarwater,437,59,419,159,71,48,1870.0,231,71,60.0,188,88,14.5,2015,0.0
Andrew Ryan,1041,227,834,361,164,120,3333.0,512,199,134.0,322,162,16.6,2015,0.0
Reco McCarter,953,183,744,335,320,206,2461.0,287,77,239.0,457,258,24.5,2015,0.0
Nehemiah Mabson,117,22,102,42,45,22,365.0,35,11,38.0,67,31,24.3,2015,0.0
Luke Moyer,237,46,174,76,32,23,641.0,135,62,45.0,39,14,19.7,2015,0.0
Jordan Faciane,23,12,22,8,5,4,66.0,13,3,4.0,9,5,22.9,2015,0.0
Lance Brown,4,2,7,0,6,4,25.0,3,0,3.0,4,0,28.0,2015,0.0
Josiah Heath,638,80,520,252,218,134,2442.0,6,0,97.0,514,252,15.2,2015,0.0
Jeremiah Williams,305,76,261,102,64,53,917.0,131,48,71.0,130,54,20.6,2015,0.0
Jan Grzelinski,65,60,84,25,10,6,501.0,37,9,42.0,47,16,13.7,2015,0.0
Joel Fiegler,54,13,50,22,13,10,304.0,3,0,35.0,47,22,14.9,2015,0.0
Faronte Drakeford,790,78,692,313,211,157,1741.0,31,7,171.0,661,306,28.4,2015,0.0
Greg Andrade,93,19,84,30,34,21,578.0,38,12,17.0,46,18,10.8,2015,0.0
Corey Barrett,58,3,68,25,16,8,282.0,0,0,12.0,68,25,16.6,2015,0.0
Kasey Wilson,892,64,688,308,248,160,2487.0,296,116,135.0,392,192,19.3,2015,0.0
Dylan Karell,59,16,43,24,35,11,487.0,0,0,25.0,43,24,9.1,2015,0.0
Marshall Holmes,0,0,0,0,0,0,2.0,0,0,0.0,0,0,0.0,2015,0.0
Austin Keel,571,71,522,199,123,90,1687.0,305,83,84.0,217,116,20.7,2015,0.0
Tony Larkins,6,1,3,3,0,0,16.0,0,0,1.0,3,3,13.1,2015,0.0
Spencer Krannitz,93,3,108,33,13,10,299.0,74,17,9.0,34,16,21.6,2015,0.0
Tanner Beachnau,4,3,5,1,2,1,19.0,3,1,1.0,2,0,19.1,2015,0.0
Saah Nimley,1866,511,1484,544,633,490,3717.0,838,288,302.0,646,256,27.7,2015,0.0
Arlon Harper,1633,256,1287,557,435,324,3464.0,535,195,214.0,752,362,24.3,2015,0.0
Will Saunders,714,54,532,220,141,105,1498.0,416,169,72.0,116,51,22.5,2015,0.0
Cedrick Bowen,754,51,523,312,203,129,2129.0,7,1,83.0,516,311,16.3,2015,0.0
Paul Gombwer,620,88,515,229,177,116,2770.0,135,46,157.0,380,183,13.5,2015,0.0
Jarryd Coleman,3,0,8,1,0,0,20.0,7,1,1.0,1,0,22.7,2015,0.0
Pierria Henry,1238,566,997,413,481,335,3947.0,273,77,339.0,724,336,19.7,2015,0.0
Terrence Williams,972,228,857,326,372,265,2930.0,195,55,244.0,662,271,21.6,2015,1.0
Ivan Benkovic,170,17,138,52,28,18,569.0,124,48,19.0,14,4,15.0,2015,0.0
Ronrico White,1100,285,822,304,429,336,2910.0,447,156,176.0,375,148,20.4,2015,0.0
Martynas Bareika,500,57,430,165,133,90,1323.0,243,80,105.0,187,85,22.0,2015,0.0
Lance Stokes,285,50,193,93,171,99,1609.0,2,0,86.0,191,93,11.0,2015,0.0
Clarke Rosenberg,1241,237,1041,428,411,298,3252.0,292,87,258.0,749,341,23.3,2015,0.0
Anthony Glover,218,38,204,74,47,31,679.0,116,39,43.0,88,35,20.7,2015,0.0
Sean Hill,180,46,180,65,38,29,547.0,75,21,43.0,105,44,23.0,2015,0.0
Joshua Meier,155,19,159,59,58,36,642.0,1,1,58.0,158,58,19.9,2015,0.0
Johnny Griffin,166,20,130,61,76,43,916.0,14,1,25.0,116,60,10.8,2015,0.0
Rahjan Muhammad,105,13,95,36,22,17,350.0,52,16,20.0,43,20,18.4,2015,0.0
Jesse Tesmer,17,0,22,6,6,5,161.0,0,0,7.0,22,6,10.3,2015,0.0
Elijah Robertson,6,1,5,2,4,2,26.0,1,0,2.0,4,2,17.9,2015,0.0
Michael Johnson,4,3,9,2,0,0,58.0,1,0,1.0,8,2,9.0,2015,0.0
Sharieff Medlock,3,0,1,1,0,0,9.0,1,1,0.0,0,0,5.8,2015,0.0
Jermaine Sanders,505,103,449,176,127,74,2114.0,249,79,69.0,200,97,14.5,2015,0.0
Rob Blissitt Jr.,4,1,2,1,2,1,7.0,1,1,1.0,1,0,31.9,2015,0.0
Jamaree Strickland,0,0,0,0,0,0,0.0,0,0,0.0,0,0,0,2015,0.0
Ashton Moore,1399,321,1197,462,337,268,3497.0,542,207,269.0,655,255,25.6,2015,0.0
P.J. Horgan,653,54,467,248,232,155,2027.0,2,2,107.0,465,246,20.3,2015,0.0
C.J. Bray,371,36,330,141,84,54,1382.0,108,35,64.0,222,106,17.2,2015,0.0
Marshall Harris III,668,438,472,186,266,207,2895.0,253,89,257.0,219,97,16.0,2015,0.0
Brandon Thompson,14,2,10,5,0,0,36.0,7,4,1.0,3,1,17.7,2015,0.0
Rod Hall,924,393,731,311,361,255,3697.0,141,47,224.0,590,264,16.8,2015,0.0
Damarcus Harrison,784,134,744,276,173,128,2468.0,334,104,130.0,410,172,20.9,2015,0.0
Patrick Rooks,20,6,22,6,5,2,52.0,19,6,0.0,3,0,25.2,2015,0.0
Charlie Lee,1147,458,889,359,299,262,3594.0,418,167,286.0,471,192,19.9,2015,0.0
Marlin Mason,773,98,594,283,188,137,2413.0,184,70,171.0,410,213,19.1,2015,0.0
Kaza Keane,311,233,304,111,112,61,1701.0,100,28,142.0,204,83,16.4,2015,0.0
Khyler Fields,2,1,5,1,0,0,22.0,1,0,4.0,4,1,17.8,2015,0.0
David Goodwater,0,0,0,0,0,0,4.0,0,0,0.0,0,0,0,2015,0.0
Warren Gillis,1352,286,1081,484,363,305,3416.0,251,79,271.0,830,405,22.4,2015,0.0
Josh Cameron,891,136,702,284,256,193,1665.0,346,130,141.0,356,154,28.9,2015,0.0
Kyle Buffkin,6,1,13,2,9,2,111.0,0,0,8.0,13,2,11.5,2015,0.0
Damon Sherman-Newsome,1030,147,807,357,232,176,2601.0,380,140,154.0,427,217,23.7,2015,0.0
Ethan Jacobs,780,57,595,293,136,103,1671.0,241,91,99.0,354,202,26.5,2015,0.0
Luke Roh,770,337,579,308,252,152,3516.0,7,2,224.0,572,306,14.9,2015,0.0
Matt McMullen,564,134,448,193,134,102,2169.0,191,76,115.0,257,117,16.6,2015,0.0
Pat Moore,923,144,753,313,142,109,2771.0,463,188,148.0,290,125,18.8,2015,0.0
John Fenton,53,1,54,22,25,9,335.0,0,0,14.0,54,22,14.1,2015,0.0
Anthony DeRiggs,5,0,4,2,0,0,13.0,3,1,0.0,1,1,18.4,2015,0.0
Nic Lane,2,1,2,1,0,0,10.0,1,0,2.0,1,1,23.4,2015,0.0
Wyatt Hagerty,0,0,5,0,2,0,33.0,0,0,1.0,5,0,12.5,2015,0.0
Adjehi Baru,1094,98,797,393,521,308,3606.0,0,0,200.0,797,393,18.5,2015,0.0
Anthony Stitt,1091,309,1004,381,263,163,3570.0,460,166,240.0,544,215,20.6,2015,0.0
Pat Branin,34,5,31,11,11,5,155.0,22,7,6.0,9,4,14.9,2015,0.0
J.J. Avila,1741,329,1345,639,477,356,3619.0,353,107,299.0,992,532,26.7,2015,0.0
Stanton Kidd,841,93,632,321,200,143,2020.0,143,56,114.0,489,265,22.0,2015,1.0
Daniel Bejarano,1125,231,1025,374,290,218,2902.0,481,159,140.0,544,215,23.0,2015,0.0
Marcus Holt,105,0,68,39,60,27,457.0,3,0,14.0,65,39,12.4,2015,0.0
Mike Burnett,8,0,6,2,4,4,26.0,0,0,1.0,6,2,17.6,2015,0.0
Askia Booker,1740,335,1551,595,480,380,3810.0,538,170,287.0,1013,425,28.1,2015,0.0
Geoffrey Bates,0,0,0,0,0,0,3.0,0,0,0.0,0,0,0.0,2015,0.0
Steve Frankoski,702,57,622,247,48,40,1953.0,421,168,73.0,201,79,20.1,2015,0.0
Cory Osetkowski,613,145,498,229,211,132,2142.0,79,23,124.0,419,206,19.1,2015,0.0
Noah Springwater,143,27,122,40,34,29,714.0,105,34,24.0,17,6,12.7,2015,0.0
Paddy Quinn,11,1,4,3,6,5,36.0,1,0,1.0,3,3,12.5,2015,0.0
Ryan Boatright,1786,491,1362,566,573,455,4322.0,524,199,302.0,838,367,24.3,2015,0.0
Dan Guest,64,49,75,23,19,16,382.0,12,2,37.0,63,21,16.5,2015,0.0
Terrance Ditimi,2,0,1,1,0,0,7.0,0,0,0.0,1,1,8.0,2015,0.0
Pat Lenehan,4,1,7,1,2,1,30.0,3,1,1.0,4,0,16.0,2015,0.0
Taariq Cephas,1084,451,921,366,280,200,3460.0,420,152,290.0,501,214,19.0,2015,0.0
Arnold Fripp,579,30,505,214,112,79,1443.0,193,72,66.0,312,142,21.0,2015,0.0
Dallas Gary,405,41,311,124,192,135,1033.0,89,22,85.0,222,102,22.9,2015,0.0
Daquan Brickhouse,336,112,280,99,119,101,1002.0,105,37,51.0,175,62,18.9,2015,0.0
Jahvari Josiah,130,11,120,42,65,40,389.0,41,6,41.0,79,36,23.5,2015,0.0
Shomari Triggs,96,18,108,33,27,17,323.0,56,13,25.0,52,20,21.5,2015,0.0
Brandon St. Louis,124,17,130,48,54,28,967.0,1,0,41.0,129,48,10.1,2015,0.0
Michael Oyefusi,10,1,7,3,3,2,19.0,6,2,3.0,1,1,29.0,2015,0.0
Devin Cherry,851,240,745,295,278,194,2512.0,230,67,252.0,515,228,24.0,2015,0.0
Dave LaMore,114,11,93,46,41,22,634.0,1,0,27.0,92,46,11.7,2015,0.0
Nenad Tomic,139,5,112,52,49,35,400.0,1,0,18.0,111,52,20.4,2015,0.0
Deion Giddens,81,4,62,33,23,15,508.0,0,0,11.0,62,33,8.8,2015,0.0
Braxston Bunce,3,0,4,1,2,1,42.0,0,0,3.0,4,1,10.1,2015,0.0
Austin Chatman,1013,493,832,323,313,246,3739.0,334,121,244.0,498,202,17.7,2015,0.0
Devin Brooks,478,196,406,158,190,136,1324.0,102,26,138.0,304,132,26.0,2015,0.0
Rick Kreklow,467,124,386,146,124,87,1819.0,258,88,106.0,128,58,15.8,2015,0.0
Will Artino,620,47,416,256,193,108,1498.0,0,0,81.0,416,256,21.2,2015,0.0
Avery Dingman,462,84,378,152,102,70,1800.0,244,88,75.0,134,64,15.0,2015,0.0
Mogboluwaga Oginni,15,1,14,6,7,3,62.0,0,0,3.0,14,6,17.8,2015,0.0
Gabriel Connealy,4,0,7,0,4,4,22.0,3,0,1.0,4,0,24.4,2015,0.0
Gabas Maldunas,1084,153,908,431,373,221,2761.0,9,1,225.0,899,430,25.8,2015,0.0
John Golden,780,153,662,266,241,157,3044.0,287,91,136.0,375,175,16.2,2015,0.0
Alex Wolf,1,0,0,0,2,1,4.0,0,0,0.0,0,0,13.0,2015,0.0
Tyler Kalinoski,1311,336,1026,450,221,168,3570.0,623,243,141.0,403,207,18.4,2015,0.0
Ali Mackay,38,9,24,15,11,6,194.0,7,2,5.0,17,13,9.1,2015,0.0
Jordan Sibert,1153,158,852,366,321,237,2660.0,506,184,138.0,346,182,23.2,2015,1.0
Devon Scott,256,27,159,91,124,74,930.0,0,0,66.0,159,91,16.3,2015,0.0
Jalen Robinson,373,30,312,138,151,91,1175.0,17,6,73.0,295,132,20.4,2015,0.0
Ryan Bass,608,194,542,207,176,143,1835.0,155,51,127.0,387,156,20.3,2015,0.0
William Dupuy,0,0,0,0,0,0,4.0,0,0,0.0,0,0,0.0,2015,0.0
Nick Haldes,0,0,0,0,0,0,3.0,0,0,0.0,0,0,0.0,2015,0.0
Amere May,985,119,853,346,227,170,1984.0,319,123,152.0,534,223,28.9,2015,0.0
Tyshawn Bell,1207,90,996,414,207,173,3154.0,544,206,103.0,452,208,20.3,2015,0.0
Kendall Gray,1020,77,696,377,415,266,3224.0,3,0,182.0,693,377,17.8,2015,0.0
Kendal Williams,525,177,477,188,108,81,1634.0,179,68,95.0,298,120,20.1,2015,0.0
Charles Burley,101,157,82,23,73,49,1014.0,23,6,108.0,59,17,11.5,2015,0.0
Larry Haley,28,3,30,9,4,4,74.0,21,6,1.0,9,3,23.2,2015,0.0
Kyle Anderson,1292,138,1152,435,198,153,4048.0,780,269,149.0,372,166,17.6,2015,1.0
Thomas Allshouse,0,0,0,0,0,0,11.0,0,0,0.0,0,0,0.0,2015,0.0
Matt Grassi,0,1,0,0,0,0,4.0,0,0,0.0,0,0,0.0,2015,0.0
Brett Olson,1468,336,1018,489,254,225,4296.0,607,265,212.0,411,224,19.2,2015,0.0
Cam Griffin,784,191,526,269,319,230,2552.0,63,16,158.0,463,253,20.2,2015,0.0
Jalen Love,678,169,565,246,125,85,2530.0,283,101,97.0,282,145,17.5,2015,0.0
Jamee Crockett,965,125,834,343,224,157,2483.0,378,122,133.0,456,221,21.4,2015,0.0
Forrest Robinson,310,22,268,109,28,23,1000.0,188,69,44.0,80,40,16.7,2015,0.0
Durrell McDonald,410,133,382,155,64,42,1766.0,159,58,112.0,223,97,15.0,2015,0.0
Greg Sequele,43,4,35,20,11,3,339.0,0,0,14.0,35,20,8.1,2015,0.0
Juwan Howard Jr.,1720,248,1501,620,365,302,3733.0,494,178,219.0,1007,442,25.4,2015,0.0
Brandan Kearney,301,99,268,109,70,46,1354.0,110,37,81.0,158,72,14.5,2015,0.0
Youssoupha Kane,50,7,51,21,19,8,311.0,0,0,19.0,51,21,13.0,2015,0.0
Patrick Ackerman,57,2,58,26,8,5,406.0,0,0,14.0,58,26,9.6,2015,0.0
Gary Ricks,501,118,415,174,58,46,1526.0,266,107,53.0,149,67,18.9,2015,0.0
Jordan Daniels,650,181,562,227,116,97,1987.0,258,99,135.0,304,128,21.7,2015,0.0
Chris Caird,478,72,363,157,79,68,1385.0,237,96,78.0,126,61,20.1,2015,0.0
Trevor Berkeley,305,34,211,113,73,56,1197.0,55,23,63.0,156,90,15.1,2015,0.0
Blake Danielak,63,11,67,23,6,3,261.0,41,14,12.0,26,9,17.4,2015,0.0
Freddie Wilson,279,90,281,98,56,35,1147.0,168,48,74.0,113,50,18.4,2015,0.0
Sooren Derboghosian,16,1,10,7,3,2,60.0,0,0,5.0,10,7,15.4,2015,0.0
Jahlil Okafor,657,49,420,279,194,99,1143.0,0,0,95.0,420,279,27.6,2015,1.0
Quinn Cook,1571,509,1235,534,313,267,4033.0,629,236,201.0,606,298,20.2,2015,1.0
Justise Winslow,492,82,356,173,156,100,1135.0,110,46,71.0,246,127,22.9,2015,1.0
Tyus Jones,461,217,324,135,162,144,1322.0,124,47,76.0,200,88,18.7,2015,1.0
Sean Kelly,0,2,1,0,0,0,12.0,1,0,0.0,0,0,4.3,2015,0.0
Dominique McKoy,618,78,477,264,178,90,2008.0,12,0,98.0,465,264,16.5,2015,0.0
Jordan Stevens,178,53,186,69,26,18,375.0,80,22,36.0,106,47,31.8,2015,0.0
Christian Johnston,2,0,7,1,0,0,17.0,1,0,1.0,6,1,24.0,2015,0.0
Terry Whisnant,616,90,510,202,116,92,1750.0,338,120,59.0,172,82,19.2,2015,0.0
Marshall Guilmette,295,49,244,111,93,62,935.0,37,11,67.0,207,100,19.9,2015,0.0
Paris Roberts-Campbell,872,212,734,275,222,162,3073.0,480,160,128.0,254,115,16.3,2015,0.0
Keith Armstrong,74,4,74,32,27,10,461.0,0,0,18.0,74,32,11.6,2015,0.0
Francis Edosomwan,14,3,10,5,10,4,61.0,1,0,4.0,9,5,15.7,2015,0.0
Jalen Riley,1056,141,769,290,416,346,1533.0,369,130,135.0,400,160,35.8,2015,0.0
Rashawn Rembert,1326,147,1019,425,268,216,3210.0,658,260,155.0,361,165,20.4,2015,0.0
Alex Bates,83,13,65,34,40,15,827.0,1,0,34.0,64,34,7.4,2015,0.0
Ron Giplaye,111,12,91,42,71,27,476.0,0,0,25.0,91,42,15.4,2015,0.0
Tommy Williams,18,0,23,6,13,6,93.0,0,0,7.0,23,6,19.6,2015,0.0
Tyler Ailshie,5,2,6,2,0,0,28.0,4,1,0.0,2,1,10.7,2015,0.0
Reggie Smith,655,155,500,197,272,193,1670.0,210,68,150.0,290,129,24.9,2015,1.0
Dylan Chatman,406,114,339,131,76,51,1650.0,249,93,77.0,90,38,14.8,2015,0.0
LeTrell Viser,197,34,194,71,21,11,730.0,132,44,39.0,62,27,18.8,2015,0.0
Josh Piper,721,121,606,268,102,85,2400.0,278,100,109.0,328,168,17.6,2015,0.0
Keenen Anderson,173,18,118,67,86,39,815.0,0,0,49.0,118,67,14.0,2015,0.0
Jake Verhagen,75,11,72,27,0,0,342.0,61,21,4.0,11,6,11.8,2015,0.0
Mat Piotrowski,42,8,57,17,5,4,281.0,23,4,12.0,34,13,13.6,2015,0.0
Corey Walden,1807,366,1164,585,562,471,3978.0,477,166,274.0,687,419,23.0,2015,0.0
Eric Stutz,1338,204,825,502,388,303,3392.0,76,31,217.0,749,471,19.8,2015,0.0
Timmy Knipp,641,93,519,213,101,77,1896.0,383,138,93.0,136,75,19.1,2015,0.0
Denzel Richardson,228,21,182,76,56,42,646.0,94,34,41.0,88,42,21.4,2015,0.0
Deverin Muff,159,14,123,60,65,39,814.0,0,0,37.0,123,60,12.8,2015,0.0
Mike Talley,1268,414,975,378,577,394,3471.0,375,118,239.0,600,260,21.8,2015,0.0
Karrington Ward,899,48,714,306,274,184,2178.0,298,103,67.0,416,203,21.7,2015,0.0
Anali Okoloji,355,37,308,115,152,106,1185.0,82,19,73.0,226,96,19.6,2015,0.0
Mike Samuels,91,7,60,32,42,27,385.0,0,0,27.0,60,32,14.2,2015,0.0
Jerome Hunter,345,44,296,139,110,66,1810.0,3,1,98.0,293,138,12.3,2015,0.0
Tyler Harvey,1564,197,1066,494,373,316,2635.0,602,260,151.0,464,234,26.7,2015,0.0
Drew Brandon,641,312,546,215,200,158,2141.0,185,53,136.0,361,162,18.3,2015,0.0
Ognjen Miljkovic,541,46,448,186,118,88,1277.0,219,81,95.0,229,105,23.7,2015,0.0
Parker Kelly,1006,119,744,309,213,178,3466.0,515,210,90.0,229,99,13.6,2015,0.0
Garrett Moon,71,6,66,32,15,5,361.0,6,2,20.0,60,30,13.0,2015,0.0
Frederik Jorg,38,4,24,15,15,8,110.0,0,0,5.0,24,15,16.7,2015,0.0
Daniel Hill,67,47,62,17,41,28,421.0,28,5,38.0,34,12,14.3,2015,0.0
Nate Galgalo,3,0,3,1,0,0,11.0,2,1,0.0,1,0,13.8,2015,0.0
Austin Hamilton,833,303,695,295,239,157,2390.0,268,86,182.0,427,209,21.0,2015,0.0
Kevin Blake,504,89,371,168,230,138,1756.0,101,30,88.0,270,138,16.4,2015,0.0
Ryan Winters,285,47,216,106,104,73,1230.0,0,0,59.0,216,106,13.5,2015,0.0
Jaylon Moore,430,17,287,177,141,76,1349.0,0,0,53.0,287,177,16.1,2015,0.0
Taylor Stafford,49,13,43,16,10,7,192.0,30,10,3.0,13,6,14.3,2015,0.0
K.J. Rose,371,188,337,130,158,87,1584.0,87,24,149.0,250,106,18.8,2015,0.0
Steve Johnston,236,37,209,65,72,50,973.0,182,56,41.0,27,9,15.9,2015,0.0
Malcolm Gilbert,102,13,103,44,30,14,636.0,0,0,28.0,103,44,12.1,2015,0.0
DeMarcus Threatt,11,3,5,3,7,4,21.0,1,1,1.0,4,2,24.9,2015,0.0
Doug Chappell,95,14,93,27,41,23,342.0,55,18,31.0,38,9,21.8,2015,0.0
Mustafaa Jones,877,135,763,278,142,126,2700.0,537,195,140.0,226,83,18.5,2015,0.0
Xavier Harris,411,37,337,171,128,69,1382.0,0,0,100.0,337,171,18.5,2015,0.0
Malachi Nix,223,82,182,54,130,95,904.0,67,20,91.0,115,34,19.0,2015,0.0
Darius Stokes,105,8,100,46,38,13,665.0,3,0,22.0,97,46,10.7,2015,0.0
Scott Kingsley,119,8,119,40,29,22,373.0,59,17,18.0,60,23,20.8,2015,0.0
Quentin Bastian,260,15,247,107,70,46,837.0,2,0,51.0,245,107,20.7,2015,0.0
Emanuel Pellot,98,29,121,40,32,18,752.0,1,0,40.0,120,40,12.4,2015,0.0
Dalvin Roberts,61,16,51,13,45,28,288.0,32,7,17.0,19,6,16.5,2015,0.0
Jayson Snearl,20,1,24,9,2,2,196.0,0,0,8.0,24,9,8.9,2015,0.0
Ernest Carter,6,0,5,2,0,0,10.0,4,2,0.0,1,0,26.6,2015,0.0
Justin Raffington,602,58,481,227,256,143,1957.0,26,5,167.0,455,222,20.5,2015,0.0
Kelvin Penn,382,57,309,168,109,46,2804.0,0,0,115.0,309,168,8.9,2015,0.0
Brian Hornstein,40,2,47,19,8,2,180.0,1,0,11.0,46,19,17.8,2015,0.0
Maceo Baston,4,0,9,2,0,0,45.0,4,0,4.0,5,2,15.7,2015,1.0
Anthony Graves,0,0,0,0,0,0,4.0,0,0,0.0,0,0,0.0,2015,0.0
Bernard Thompson,1835,246,1466,636,487,344,4031.0,601,219,278.0,865,417,24.8,2015,1.0
Brett Comer,1477,845,1247,536,459,304,4047.0,324,101,460.0,923,435,24.2,2015,0.0
Jamail Jones,645,78,596,240,160,102,2050.0,215,63,120.0,381,177,19.7,2015,0.0
Nate Hicks,323,22,231,131,105,61,1424.0,1,0,56.0,230,131,12.2,2015,0.0
Eric Moeller,48,6,41,17,27,13,253.0,4,1,25.0,37,16,16.2,2015,0.0
Logan Hovey,15,3,14,6,9,3,92.0,1,0,3.0,13,6,12.0,2015,0.0
Marcus Blake,45,10,43,14,28,17,284.0,1,0,18.0,42,14,13.3,2015,0.0
TeJai Allen,5,0,5,1,4,3,33.0,0,0,5.0,5,1,18.5,2015,0.0
Armand Shoon,6,4,13,2,6,2,80.0,5,0,3.0,8,2,12.1,2015,0.0
Nick Pellar,3,1,2,1,0,0,12.0,1,1,1.0,1,0,13.0,2015,0.0
Dennis Mavin,1242,201,1008,412,578,356,3002.0,210,62,266.0,798,350,27.1,2015,0.0
Kris Gulley,368,55,346,128,67,45,1610.0,224,67,89.0,122,61,14.9,2015,0.0
Tashawn Desir,97,62,98,33,30,20,533.0,36,11,56.0,62,22,16.9,2015,0.0
Marco Porcher Jimenez,464,42,416,161,62,47,1383.0,278,95,57.0,138,66,18.5,2015,0.0
Michael Phillip,20,6,13,7,15,6,194.0,0,0,3.0,13,7,6.4,2015,0.0
Jonas Page,13,0,10,4,2,2,30.0,8,3,1.0,2,1,20.9,2015,0.0
Kiel Turpin,347,13,264,141,98,65,948.0,2,0,61.0,262,141,20.6,2015,0.0
Aaron Thomas,815,116,628,277,271,209,1938.0,163,52,152.0,465,225,24.5,2015,0.0
Dayshawn Watkins,29,20,25,7,21,14,198.0,8,1,17.0,17,6,13.9,2015,0.0
Michael Frazier,998,114,718,318,158,135,2593.0,526,227,122.0,192,91,19.1,2015,1.0
Jon Horford,511,42,393,205,119,87,1706.0,61,14,66.0,332,191,16.7,2015,0.0
Chris Walker,179,3,146,80,51,19,540.0,3,0,34.0,143,80,20.6,2015,0.0
Jacob Kurtz,188,41,120,73,63,41,877.0,3,1,44.0,117,72,12.0,2015,0.0
Dillon Graham,11,5,22,5,0,0,92.0,12,1,4.0,10,4,15.4,2015,0.0
Bryan Smith,902,183,901,311,173,124,3053.0,535,156,173.0,366,155,18.6,2015,0.0
Dekeba Battee-Aston,4,3,11,1,3,2,109.0,2,0,8.0,9,1,9.6,2015,0.0
Erando Halilaj,2,1,2,1,0,0,7.0,0,0,1.0,2,1,22.0,2015,0.0
Nihad Musovic,2,1,2,0,2,2,22.0,2,0,3.0,0,0,13.2,2015,0.0
Zaire Thompson,0,2,0,0,0,0,23.0,0,0,3.0,0,0,6.7,2015,0.0
Alex Davis,344,39,254,121,159,100,1551.0,11,2,95.0,243,119,14.7,2015,0.0
Emmanuel Owootoah,159,83,136,47,55,39,991.0,83,26,61.0,53,21,12.2,2015,0.0
Darnell Taylor,77,43,76,31,19,8,485.0,28,7,21.0,48,24,12.0,2015,0.0
Jerrod Patton,12,1,8,6,1,0,27.0,0,0,2.0,8,6,21.3,2015,0.0
Kevin Chuisseu,63,7,59,22,51,19,445.0,1,0,28.0,58,22,13.6,2015,0.0
Aaron O'Neill,52,17,46,17,6,4,396.0,39,14,9.0,7,3,7.9,2015,0.0
Jerome Hill,1292,122,907,440,643,406,2703.0,40,6,200.0,867,434,26.5,2015,0.0
Jarvis Davis,522,74,397,165,131,113,1449.0,222,79,96.0,175,86,19.5,2015,0.0
Tyler Strange,927,651,825,319,180,117,3921.0,499,172,269.0,326,147,15.4,2015,0.0
Corey Hensley,135,8,121,60,27,15,573.0,0,0,29.0,121,60,14.7,2015,0.0
Adam Sweeney,13,4,23,5,2,2,62.0,10,1,3.0,13,4,22.1,2015,0.0
Corey Edwards,480,284,395,149,147,108,2316.0,206,74,207.0,189,75,14.9,2015,0.0
Vaughn Gray,289,23,288,100,77,40,1074.0,148,49,42.0,140,51,17.5,2015,0.0
Erik Copes,420,29,353,175,138,70,1836.0,0,0,101.0,353,175,14.5,2015,0.0
John Kopriva,430,45,351,163,149,85,1909.0,43,19,79.0,308,144,13.6,2015,0.0
Ryan McCoy,91,39,96,31,22,12,691.0,54,17,60.0,42,14,12.5,2015,0.0
Joshua Smith,1211,85,755,446,520,319,2283.0,1,0,210.0,754,446,27.7,2015,0.0
Jabril Trawick,851,205,579,270,334,237,2884.0,221,74,176.0,358,196,17.1,2015,0.0
Aaron Bowen,451,66,375,181,124,61,1410.0,110,28,91.0,265,153,19.9,2015,0.0
Mikael Hopkins,629,129,503,213,313,200,2268.0,12,3,196.0,491,210,20.2,2015,0.0
Tyler Adams,12,1,10,5,2,2,24.0,0,0,2.0,10,5,26.9,2015,0.0
David Allen,8,1,8,2,5,2,42.0,7,2,2.0,1,0,15.8,2015,0.0
Jelani Hewitt,1810,340,1488,573,490,394,4042.0,768,270,343.0,720,303,26.3,2015,0.0
Trent Wiedeman,1253,117,935,486,388,272,3349.0,40,9,203.0,895,477,20.3,2015,0.0
Curtis Diamond,459,59,465,159,107,66,1500.0,270,75,69.0,195,84,20.1,2015,0.0
Angel Matias,484,69,387,194,156,87,1543.0,51,9,97.0,336,185,18.6,2015,0.0
Eric Ferguson,1482,115,1117,556,499,318,3225.0,178,52,277.0,939,504,26.6,2015,0.0
Kyle Doyle,241,22,217,100,97,37,986.0,15,4,71.0,202,96,17.4,2015,0.0
Grayson Clark,20,1,18,7,4,2,52.0,8,4,3.0,10,3,22.7,2015,0.0
Zach Altany,3,0,16,1,0,0,26.0,11,1,1.0,5,0,33.7,2015,0.0
Scott Kelly,5,1,3,2,4,1,47.0,0,0,3.0,3,2,8.7,2015,0.0
R.J. Hunter,1819,240,1321,559,525,448,3438.0,715,253,168.0,606,306,27.5,2015,0.0
Ryan Harrow,1692,426,1423,636,396,314,3528.0,338,106,211.0,1085,530,27.3,2015,0.0
Curtis Washington,431,12,285,175,116,81,1360.0,0,0,49.0,285,175,15.5,2015,0.0
Ryann Green,141,60,119,43,50,36,931.0,74,19,34.0,45,24,10.4,2015,0.0
David Travers,59,24,52,20,14,8,250.0,27,11,14.0,25,9,15.7,2015,0.0
Michael Pickney,0,0,1,0,0,0,0.0,0,0,1.0,1,0,0,2015,0.0
Corey Tobin,0,0,0,0,0,0,13.0,0,0,0.0,0,0,0.0,2015,0.0
Demarco Cox,573,40,447,230,219,113,2110.0,0,0,97.0,447,230,15.5,2015,0.0
Chris Bolden,560,102,591,209,67,45,1997.0,312,97,100.0,279,112,18.7,2015,0.0
Robert Sampson,745,85,634,284,194,109,2687.0,228,68,150.0,406,216,16.6,2015,0.0
Brooks Doyle,12,3,15,4,4,2,72.0,10,2,3.0,5,2,14.3,2015,0.0
Aaron Peek,2,0,6,1,0,0,27.0,2,0,2.0,4,1,15.5,2015,0.0
Nemanja Djurisic,1123,147,910,399,312,219,3188.0,291,106,238.0,619,293,21.9,2015,0.0
Taylor Echols,68,12,65,22,8,2,288.0,62,22,21.0,3,0,16.4,2015,0.0
Kevin Pangos,1824,536,1306,566,439,370,4689.0,776,322,222.0,530,244,19.3,2015,0.0
Byron Wesley,1569,273,1273,583,516,345,4179.0,170,58,251.0,1103,525,22.4,2015,0.0
Gary Bell Jr.,1291,265,968,433,274,206,3823.0,536,219,162.0,432,214,17.2,2015,0.0
Connor Griffin,13,2,9,4,10,5,88.0,0,0,3.0,9,4,10.0,2015,0.0
A'Torri Shine,769,59,641,260,230,172,1852.0,241,77,127.0,400,183,24.5,2015,0.0
Mark Gary,304,20,217,91,139,105,783.0,43,17,84.0,174,74,24.9,2015,0.0
Richard Freeman,270,33,269,90,141,80,1036.0,50,10,87.0,219,80,21.3,2015,0.0
Isiah Patterson,42,8,42,13,10,7,175.0,27,9,10.0,15,4,16.6,2015,0.0
Robert Wiley,32,9,47,13,11,5,261.0,11,1,30.0,36,12,16.8,2015,0.0
Telvin Marshall,28,2,40,13,4,2,97.0,11,0,4.0,29,13,25.2,2015,0.0
Lonnie McElwain,15,1,19,6,4,3,186.0,2,0,13.0,17,6,9.7,2015,0.0
Royce Woolridge,924,251,724,305,347,240,2753.0,233,74,200.0,491,231,21.6,2015,0.0
Daniel Alexander,609,109,485,216,89,76,1731.0,284,101,105.0,201,115,19.4,2015,0.0
Jerome Garrison,745,104,488,215,326,244,1982.0,195,71,92.0,293,144,19.5,2015,0.0
Sam Daly,141,91,110,49,62,37,664.0,28,6,70.0,82,43,16.6,2015,0.0
Miroslav Jaksic,36,0,29,15,13,6,74.0,2,0,8.0,27,15,31.6,2015,0.0
Tobe Okafor,4,0,10,2,0,0,41.0,0,0,3.0,10,2,17.2,2015,0.0
Isaiah Juarez,2,1,2,1,0,0,7.0,1,0,0.0,1,1,15.5,2015,0.0
Keifer Sykes,2096,522,1570,713,712,557,4236.0,346,113,286.0,1224,600,27.0,2015,0.0
Greg Mays,989,69,735,387,308,198,2608.0,63,17,158.0,672,370,20.7,2015,0.0
Alfonzo McKinnie,689,23,536,271,193,120,1811.0,77,27,121.0,459,244,21.9,2015,1.0
Daeshon Francis,149,25,87,54,62,40,447.0,2,1,20.0,85,53,16.0,2015,0.0
Josh Humphrey,35,20,50,11,29,13,434.0,3,0,23.0,47,11,10.3,2015,0.0
Dwight Meikle,738,56,585,288,197,138,1836.0,82,24,184.0,503,264,22.9,2015,0.0
Ke'Ron Brown,454,128,448,151,234,131,2155.0,128,21,156.0,320,130,16.1,2015,0.0
Emmanuel Okoroba,565,33,452,188,313,189,1736.0,0,0,150.0,452,188,21.0,2015,0.0
Breon Key,198,49,139,63,81,56,722.0,61,16,38.0,78,47,14.6,2015,0.0
Phillip Reed,24,5,24,8,15,8,242.0,0,0,12.0,24,8,8.7,2015,0.0
Keith Carroll,6,5,4,2,4,2,58.0,0,0,6.0,4,2,10.1,2015,0.0
Mark Nwakamma,1550,203,1174,598,477,315,3235.0,120,39,342.0,1054,559,29.9,2015,0.0
Corban Wroe,641,181,475,228,137,103,2772.0,221,82,153.0,254,146,13.9,2015,0.0
Yolonzo Moore II,1078,289,846,349,340,250,3945.0,403,130,255.0,443,219,17.8,2015,0.0
Nate Sikma,752,228,703,265,148,103,2663.0,409,119,205.0,294,146,20.3,2015,0.0
Wes Cole,845,85,789,284,77,58,2300.0,612,219,108.0,177,65,22.6,2015,0.0
Jamie Schneck,250,48,200,104,95,42,1321.0,0,0,76.0,200,104,13.5,2015,0.0
Noah Arciero,4,1,5,1,4,2,28.0,2,0,4.0,3,1,21.6,2015,0.0
Andrew Crowley,0,0,0,0,0,0,1.0,0,0,0.0,0,0,0.0,2015,0.0
Wesley Saunders,1511,383,1032,496,620,468,3580.0,127,51,273.0,905,445,24.7,2015,0.0
Steve Moundou-Missi,1010,67,732,372,361,260,2749.0,18,6,151.0,714,366,21.3,2015,0.0
Jonah Travis,529,42,319,175,249,179,1492.0,1,0,85.0,318,175,19.5,2015,0.0
Kenyatta Smith,264,12,188,107,75,50,719.0,0,0,65.0,188,107,22.6,2015,0.0
Matt Brown,41,8,37,13,12,8,271.0,23,7,11.0,14,6,11.0,2015,0.0
Charlie Anastasi,4,2,5,1,2,2,30.0,0,0,2.0,5,1,14.5,2015,0.0
Alex Nesbitt,11,8,11,3,9,5,126.0,3,0,5.0,8,3,8.9,2015,0.0
Garrett Nevels,754,97,653,287,95,73,1969.0,282,107,65.0,371,180,18.9,2015,0.0
Negus Webster-Chan,347,72,332,119,46,29,1330.0,215,80,74.0,117,39,15.7,2015,0.0
Brandon Jawato,178,16,153,59,28,14,542.0,119,46,24.0,34,13,17.1,2015,0.0
Devante Wallace,973,137,779,334,158,121,2599.0,434,184,120.0,345,150,20.0,2015,0.0
Brian Richardson,709,118,645,238,159,112,2244.0,370,121,117.0,275,117,19.3,2015,0.0
Quincy Drye,29,2,32,12,9,5,79.0,4,0,3.0,28,12,26.3,2015,0.0
Tre Duncan,21,5,20,8,10,4,71.0,7,1,8.0,13,7,23.9,2015,0.0
Dion Nesmith,1308,330,1110,451,315,238,3587.0,478,168,230.0,632,283,20.8,2015,0.0
Moussa Kone,773,47,561,327,219,119,2475.0,0,0,110.0,561,327,15.9,2015,0.0
Daryl Fowlkes,7,1,5,2,2,2,19.0,1,1,1.0,4,1,18.1,2015,0.0
Malcolm Miller,1013,164,746,332,319,244,2917.0,284,105,175.0,462,227,20.1,2015,1.0
Justin Burrell,1143,414,1017,380,292,243,3439.0,406,140,253.0,611,240,22.3,2015,0.0
Taylor Abt,271,13,231,111,70,30,1359.0,65,19,66.0,166,92,13.2,2015,0.0
Christopher Morgan,102,2,68,43,24,16,454.0,0,0,21.0,68,43,12.1,2015,0.0
De'Vaughn Reid,55,26,54,17,24,17,293.0,13,4,23.0,41,13,16.5,2015,0.0
Patrick Kerrigan,3,0,1,1,0,0,25.0,1,1,1.0,0,0,4.3,2015,0.0
Chris Jayne,3,1,3,1,4,1,22.0,1,0,2.0,2,1,17.3,2015,0.0
Marcel Smith,762,276,603,248,178,148,2739.0,311,118,168.0,292,130,15.1,2015,0.0
Ricmonds Vilde,397,41,295,159,105,68,1090.0,30,11,114.0,265,148,20.9,2015,0.0
Tyler Russell,914,162,844,342,222,175,2322.0,180,55,188.0,664,287,23.4,2015,0.0
Mike Turner,87,7,70,29,11,7,189.0,54,22,13.0,16,7,22.9,2015,0.0
Will McQuitter,1,1,1,0,2,1,7.0,0,0,1.0,1,0,20.5,2015,0.0
Jherrod Stiggers,1077,142,928,351,183,132,2571.0,679,243,167.0,249,108,23.5,2015,0.0
J.C. Washington,76,11,74,33,19,8,457.0,2,2,19.0,72,31,11.6,2015,0.0
Mikhail McLean,245,25,183,87,130,71,1125.0,3,0,58.0,180,87,13.7,2015,0.0
Egi Gjikondi,6,2,9,2,4,2,38.0,0,0,4.0,9,2,20.4,2015,0.0
Adam Drexler,13,2,17,4,7,4,105.0,7,1,5.0,10,3,12.4,2015,0.0
Tyus Bowser,0,0,3,0,0,0,4.0,2,0,1.0,1,0,51.2,2015,0.0
James Carlton,546,39,445,199,172,128,1379.0,89,20,108.0,356,179,24.1,2015,0.0
Jared Norsworthy,143,14,113,45,74,42,598.0,38,11,38.0,75,34,16.3,2015,0.0
Brandon Ford,231,44,209,77,95,68,946.0,49,9,58.0,160,68,17.2,2015,0.0
Theodore Boyomo,92,10,64,36,39,20,744.0,0,0,42.0,64,36,8.7,2015,0.0
Chris Hansen,1355,157,1027,411,376,304,2962.0,595,229,141.0,432,182,24.9,2015,0.0
Jeffrey Solarin,669,54,507,292,148,85,1795.0,1,0,96.0,506,292,20.0,2015,0.0
Nnamdi Ezenwa,351,66,264,113,140,89,1495.0,88,36,79.0,176,77,15.2,2015,0.0
Marcus Bradley,173,8,177,75,38,18,399.0,27,5,20.0,150,70,28.7,2015,0.0
Ajak Magot,143,10,123,58,46,27,744.0,1,0,27.0,122,58,12.4,2015,0.0
Andre Slavik,22,1,14,10,7,2,196.0,0,0,10.0,14,10,7.5,2015,0.0
Connor Hill,1506,111,1152,503,201,160,3305.0,800,340,110.0,352,163,21.6,2015,0.0
Mike Scott,715,235,605,264,146,109,1663.0,226,78,87.0,379,186,23.5,2015,1.0
Sekou Wiggs,652,122,445,205,330,229,1514.0,41,13,110.0,404,192,24.2,2015,0.0
Bira Seck,375,57,306,162,90,50,1383.0,1,1,95.0,305,161,16.5,2015,0.0
Marc Brown,1022,158,842,300,415,323,3427.0,311,99,188.0,531,201,18.9,2015,0.0
Ahman Fells,331,22,272,134,54,30,1126.0,95,33,42.0,177,101,15.9,2015,0.0
Jason McClellan,116,9,114,44,20,16,419.0,45,12,14.0,69,32,17.2,2015,0.0
D'Juan Miller,93,80,115,35,27,16,514.0,28,7,43.0,87,28,17.5,2015,0.0
Marcus White,18,15,26,5,9,5,157.0,17,3,5.0,9,2,11.7,2015,0.0
Jay Parker,133,99,133,37,69,53,674.0,40,6,73.0,93,31,18.7,2015,0.0
Daishon Knight,951,159,793,320,267,218,2013.0,287,93,140.0,506,227,27.2,2015,0.0
Bobby Hunter,562,123,386,179,179,135,1527.0,184,69,82.0,202,110,18.7,2015,0.0
Mark Hall,14,8,15,6,2,2,57.0,5,0,4.0,10,6,19.2,2015,0.0
James Stawarz,6,0,4,3,2,0,14.0,0,0,1.0,4,3,22.2,2015,0.0
Rayvonte Rice,1934,200,1515,655,642,468,3902.0,501,156,230.0,1014,499,28.3,2015,0.0
Ahmad Starks,1246,289,1186,445,144,123,3478.0,652,233,167.0,534,212,20.3,2015,0.0
Nnanna Egwu,750,73,722,316,144,102,3246.0,62,16,134.0,660,300,15.1,2015,0.0
Ryan Schmidt,0,0,0,0,0,0,2.0,0,0,0.0,0,0,0.0,2015,0.0
Denzel Livingston,1172,187,767,364,435,344,1959.0,271,100,153.0,496,264,28.4,2015,0.0
Austin Henry,41,3,56,18,8,3,231.0,7,2,5.0,49,16,14.3,2015,0.0
John Baker,71,0,53,25,31,21,256.0,0,0,6.0,53,25,14.0,2015,0.0
Winslo Barry,79,3,74,34,40,11,296.0,0,0,10.0,74,34,16.7,2015,0.0
Marcus Brock,9,2,5,2,5,4,33.0,4,1,1.0,1,1,12.4,2015,0.0
Justin Gant,951,88,794,354,254,175,2797.0,187,68,149.0,607,286,20.4,2015,0.0
Charles Bennett,239,90,190,74,64,50,688.0,118,41,56.0,72,33,21.6,2015,0.0
Jake Kitchell,452,76,314,166,145,94,1766.0,66,26,95.0,248,140,14.5,2015,0.0
Alex Etherington,79,14,75,27,15,9,383.0,55,16,21.0,20,11,14.4,2015,0.0
Nick Amor,0,1,0,0,0,0,10.0,0,0,0.0,0,0,0.0,2015,0.0
Jeremiah April,6,1,3,3,0,0,17.0,0,0,1.0,3,3,11.9,2015,0.0
Nate Ritchie,2,2,1,0,2,2,15.0,0,0,0.0,1,0,6.6,2015,0.0
Jordan Fuchs,0,0,3,0,0,0,8.0,0,0,0.0,3,0,19.0,2015,0.0
David Laury,1465,222,1050,534,581,370,2930.0,72,27,213.0,978,507,26.0,2015,0.0
Jeylani Dublin,789,27,647,344,167,101,1797.0,0,0,122.0,647,344,23.3,2015,0.0
Vangelis Bebis,49,8,52,17,2,2,233.0,44,13,7.0,8,4,12.7,2015,0.0
Daniel Robinson,15,0,14,7,3,1,78.0,0,0,2.0,14,7,11.2,2015,0.0
Kristian Duravcevic,3,0,4,1,5,1,29.0,1,0,1.0,3,1,12.6,2015,0.0
Bryce Dejean-Jones,1266,272,1028,441,386,264,2888.0,357,120,212.0,671,321,25.0,2015,1.0
Dustin Hogue,734,74,472,267,243,150,1969.0,129,50,89.0,343,217,17.0,2015,0.0
Daniel Edozie,75,8,43,25,39,25,286.0,0,0,9.0,43,25,12.3,2015,0.0
Georgios Tsalmpouris,11,2,10,4,5,1,35.0,4,2,3.0,6,2,22.2,2015,0.0
Daniel Stensland,0,1,0,0,0,0,8.0,0,0,0.0,0,0,0.0,2015,0.0
Aaron White,1859,190,1142,590,800,618,3939.0,217,61,211.0,925,529,22.1,2015,0.0
Gabriel Olaseni,612,40,407,208,269,196,1672.0,0,0,89.0,407,208,18.8,2015,0.0
Josh Oglesby,633,154,615,211,84,65,2289.0,450,146,65.0,165,65,15.8,2015,0.0
Kyle Denning,31,8,24,12,2,2,100.0,17,5,5.0,7,7,15.0,2015,0.0
Steve Forbes,1073,62,686,393,407,286,2037.0,1,1,181.0,685,392,27.3,2015,0.0
Joseph Edwards,1020,218,771,386,264,156,3051.0,238,92,198.0,533,294,18.9,2015,0.0
Isaiah McCray,697,247,596,222,328,162,2672.0,268,91,161.0,328,131,18.0,2015,0.0
Jure Gunjima,79,13,71,33,7,5,243.0,32,8,14.0,39,25,19.8,2015,0.0
Herbert Graham,84,9,65,29,11,7,195.0,51,19,13.0,14,10,22.5,2015,0.0
Kevin Harden,108,30,127,41,21,10,493.0,50,16,32.0,77,25,18.0,2015,0.0
Nick Moschetti,0,0,1,0,0,0,7.0,1,0,1.0,0,0,15.6,2015,0.0
DavRon Williams,281,25,194,112,99,57,886.0,1,0,55.0,193,112,18.1,2015,0.0
Khufu Najee,479,88,421,184,110,89,1569.0,77,22,97.0,344,162,19.5,2015,0.0
Elijah Ray,214,12,165,77,60,45,561.0,48,15,47.0,117,62,23.0,2015,0.0
Justus Stanback,178,16,185,80,22,13,758.0,22,5,52.0,163,75,17.5,2015,0.0
Jalen McCallum,30,8,19,11,3,2,65.0,11,6,8.0,8,5,23.6,2015,0.0
Derrell Taylor,672,67,461,236,274,200,2464.0,2,0,135.0,459,236,15.0,2015,0.0
Dre'Sean Looney,71,25,70,24,16,14,265.0,33,9,23.0,37,15,19.2,2015,0.0
Jaleel Queary,182,64,171,72,85,37,981.0,5,1,73.0,166,71,14.7,2015,0.0
Dominique Street,46,4,64,14,7,6,152.0,51,12,5.0,13,2,23.7,2015,0.0
Pierre Crawford,112,7,107,48,38,16,349.0,0,0,31.0,107,48,21.2,2015,0.0
Gerrald Maddox,2,2,9,1,0,0,24.0,3,0,1.0,6,1,21.0,2015,0.0
Kenneth Wachira,2,0,3,1,0,0,45.0,1,0,5.0,2,1,8.9,2015,0.0
Darion Rackley,1326,201,945,361,646,480,2943.0,428,124,231.0,517,237,26.7,2015,0.0
D.J. Felder,561,40,479,222,148,105,1340.0,38,12,76.0,441,210,24.7,2015,0.0
Avery Moore,1096,175,1027,363,153,125,2783.0,750,245,178.0,277,118,23.0,2015,0.0
Jamal Hunter,303,39,223,124,86,55,1317.0,0,0,64.0,223,124,13.2,2015,0.0
Undra Mitchem,256,57,247,86,46,31,865.0,146,53,51.0,101,33,19.7,2015,0.0
Dontay Jackson,40,34,37,14,34,12,336.0,5,0,29.0,32,14,12.9,2015,0.0
Randall Smith,21,6,17,5,10,9,86.0,7,2,11.0,10,3,20.0,2015,0.0
Gabriel Dos Santos,12,3,11,5,4,1,36.0,1,1,5.0,10,4,24.9,2015,0.0
Dominique Miller,20,1,21,9,12,2,76.0,5,0,4.0,16,9,20.4,2015,0.0
Tim Gill,89,5,74,28,55,33,369.0,1,0,18.0,73,28,17.1,2015,0.0
Josh Murray,30,4,34,11,9,8,278.0,0,0,9.0,34,11,8.7,2015,0.0
BJ Edwards,14,32,40,5,10,4,342.0,2,0,18.0,38,5,9.8,2015,0.0
Jeremy Bogus,113,10,128,38,14,11,406.0,96,26,14.0,32,12,18.2,2015,0.0
Jaspin Canteen,0,0,3,0,0,0,6.0,2,0,0.0,1,0,26.8,2015,0.0
Hari Hall,110,6,96,40,26,18,283.0,34,12,22.0,62,28,25.2,2015,0.0
Andre Nation,648,98,517,222,236,157,1756.0,177,47,89.0,340,175,22.1,2015,0.0
Shawn Wilborne,5,0,3,2,0,0,6.0,2,1,1.0,1,1,36.5,2015,0.0
Thomas Gipson,1232,70,844,450,497,332,2972.0,0,0,214.0,844,450,22.6,2015,0.0
Nino Williams,712,73,560,267,225,172,1835.0,23,6,92.0,537,261,21.8,2015,0.0
Malek Harris,56,14,53,21,23,14,336.0,3,0,18.0,50,21,13.2,2015,0.0
Shawn Meyer,11,2,12,4,11,3,43.0,1,0,3.0,11,4,24.3,2015,0.0
Kelly Oubre,333,28,248,110,110,79,756.0,95,34,43.0,153,76,23.1,2015,0.0
Cliff Alexander,199,12,129,73,79,53,492.0,0,0,28.0,129,73,20.1,2015,1.0
Christian Garrett,2,4,9,1,2,0,67.0,1,0,11.0,8,1,15.8,2015,0.0
Josh Pollard,2,1,4,1,0,0,13.0,0,0,1.0,4,1,19.6,2015,0.0
Chris Huey,0,0,1,0,0,0,1.0,0,0,0.0,1,0,50.9,2015,0.0
Damien Wilson,310,54,293,118,93,67,871.0,53,7,89.0,240,111,24.9,2015,0.0
Delbert Love,1369,337,1208,463,316,226,4080.0,633,217,285.0,575,246,21.1,2015,0.0
Nate Rucker,417,21,293,150,205,117,1126.0,2,0,82.0,291,150,21.0,2015,0.0
Justin Diecker,13,1,13,5,6,3,78.0,0,0,7.0,13,5,15.1,2015,0.0
Tanner Wozniak,148,16,153,47,27,21,597.0,115,33,37.0,38,14,17.3,2015,0.0
Alijah Bennett,10,7,14,4,2,2,66.0,6,0,8.0,8,4,18.0,2015,0.0
Charlie Byers,31,12,34,14,4,2,177.0,3,1,9.0,31,13,12.8,2015,0.0
Devareaux Manley,970,55,753,300,170,133,2341.0,598,237,74.0,155,63,20.6,2015,0.0
Kris Brewer,1128,304,897,354,402,293,3291.0,362,127,226.0,535,227,21.0,2015,0.0
Derek Jackson,1305,293,1100,447,296,210,4092.0,541,201,195.0,559,246,18.5,2015,0.0
Gary Akbar,84,27,68,31,50,22,429.0,0,0,38.0,68,31,16.5,2015,0.0
Craig Brown,162,18,201,53,61,41,801.0,63,15,42.0,138,38,17.4,2015,0.0
Marquiez Lawrence,45,6,37,18,20,9,340.0,0,0,24.0,37,18,11.2,2015,0.0
Blake Vedder,19,0,19,7,4,3,71.0,6,2,3.0,13,5,17.1,2015,0.0
Aaron Harrison,979,129,781,320,277,218,2307.0,361,121,100.0,420,199,22.4,2015,1.0
Karl-Anthony Towns,401,44,256,145,134,109,822.0,8,2,53.0,248,143,23.7,2015,1.0
Devin Booker,381,42,287,135,64,53,816.0,141,58,37.0,146,77,22.8,2015,1.0
Andrew Harrison,798,298,597,222,367,285,2261.0,188,69,173.0,409,153,21.3,2015,1.0
Willie Cauley-Stein,843,90,583,346,297,151,2575.0,0,0,127.0,583,346,16.9,2015,1.0
Trey Lyles,313,38,240,117,102,75,828.0,29,4,41.0,211,113,20.8,2015,1.0
Dakari Johnson,450,40,300,161,229,128,1185.0,0,0,67.0,300,161,20.6,2015,1.0
Tod Lanter,3,0,4,1,0,0,17.0,3,1,2.0,1,0,18.1,2015,0.0
Sam Malone,7,1,7,3,2,1,30.0,0,0,7.0,7,3,25.5,2015,0.0
Brian Long,2,0,6,0,4,2,40.0,3,0,0.0,3,0,10.1,2015,0.0
Jerrell Wright,1512,123,1053,591,540,330,3196.0,0,0,242.0,1053,591,25.5,2015,0.0
Steve Zack,774,131,647,304,243,165,2875.0,8,1,177.0,639,303,17.2,2015,0.0
D.J. Peterson,451,174,373,148,84,65,2920.0,255,90,83.0,118,58,8.9,2015,0.0
Dan Trist,1491,141,1128,608,382,274,2825.0,5,1,271.0,1123,607,30.4,2015,0.0
Seth Hinrichs,1535,205,1075,520,352,286,3268.0,485,209,238.0,590,311,24.6,2015,0.0
Joey Ptasinski,1105,199,839,384,109,88,3419.0,581,249,119.0,258,135,16.0,2015,0.0
Alan Flannigan,178,38,164,65,56,41,928.0,24,7,50.0,140,58,14.1,2015,0.0
Jake Newman,18,9,13,6,10,4,126.0,5,2,7.0,8,4,10.6,2015,0.0
Anthony Holliday,602,145,392,191,249,191,1437.0,85,29,132.0,307,162,22.2,2015,0.0
Tyran de Lattibeaudiere,402,47,290,167,128,68,893.0,0,0,94.0,290,167,24.4,2015,0.0
Donovan Ross,603,49,412,221,201,160,1617.0,9,1,109.0,403,220,19.1,2015,0.0
Zachary Hollis,30,6,34,10,16,10,209.0,0,0,11.0,34,10,12.3,2015,0.0
Matt Hancock,50,17,63,20,4,2,425.0,36,8,21.0,27,12,10.0,2015,0.0
Benquan Petty,5,9,12,0,6,5,57.0,6,0,10.0,6,0,21.4,2015,0.0
Sebastian Norman,87,4,74,29,44,29,479.0,1,0,19.0,73,29,11.8,2015,0.0
Corey Schaefer,638,228,528,224,136,112,2825.0,211,78,110.0,317,146,13.2,2015,0.0
Miles Simelton,170,60,167,63,31,23,747.0,68,21,49.0,99,42,16.4,2015,0.0
Stefan Cvrkalj,363,44,335,124,34,25,1201.0,250,90,52.0,85,34,17.7,2015,0.0
Conroy Baltimore,136,10,110,52,46,32,545.0,0,0,32.0,110,52,15.7,2015,0.0
Khalid McCaskill,13,1,15,6,1,0,42.0,5,1,3.0,10,5,23.0,2015,0.0
Georgios Pilitsis,8,3,5,2,2,2,22.0,4,2,1.0,1,0,16.7,2015,0.0
Cole Renninger,7,2,9,2,5,3,32.0,1,0,0.0,8,2,18.7,2015,0.0
Theo Johnson,464,75,346,144,219,154,1434.0,90,22,98.0,256,122,20.0,2015,0.0
James Johnson,240,14,178,94,91,52,813.0,0,0,79.0,178,94,19.2,2015,1.0
Peter Moller,179,31,159,67,35,24,630.0,65,21,45.0,94,46,18.1,2015,0.0
Joe Retic,281,180,223,85,126,96,1150.0,48,15,139.0,175,70,18.9,2015,0.0
Ethan Layer,202,40,161,58,49,35,669.0,147,51,30.0,14,7,16.5,2015,0.0
Jordan Dembley,62,42,42,19,25,17,364.0,18,7,25.0,24,12,11.2,2015,0.0
Malcolm Smith,1360,114,882,415,761,515,2594.0,58,15,216.0,824,400,27.5,2015,0.0
Chad Lang,287,1,220,121,94,45,626.0,0,0,61.0,220,121,26.2,2015,0.0
Martin Smith,1095,177,856,344,337,265,2873.0,422,142,172.0,434,202,20.1,2015,0.0
Chad Johnson,89,50,82,23,34,27,727.0,59,16,39.0,23,7,9.2,2015,0.0
Dylan Greene,8,5,14,2,8,3,76.0,7,1,4.0,7,1,14.1,2015,0.0
Mike Caffey,1649,457,1429,595,422,282,4001.0,532,177,320.0,897,418,24.7,2015,0.0
David Samuels,550,63,458,213,178,112,1648.0,51,12,109.0,407,201,20.3,2015,0.0
Tyler Lamb,987,210,878,338,241,182,2803.0,379,129,211.0,499,209,22.1,2015,0.0
McKay LaSalle,280,33,248,93,19,15,1065.0,221,79,27.0,27,14,13.7,2015,0.0
Eric McKnight,506,24,343,210,175,86,1780.0,1,0,116.0,342,210,15.4,2015,0.0
Charles Lockett,4,0,5,1,4,2,21.0,0,0,3.0,5,1,24.5,2015,0.0
Gerrell Martin,834,59,660,277,158,133,2089.0,349,147,100.0,311,130,19.8,2015,0.0
Elvar Fridriksson,266,114,218,79,97,69,888.0,120,39,77.0,98,40,19.2,2015,0.0
Landon Atterberry,518,20,444,209,110,66,1236.0,103,34,65.0,341,175,22.7,2015,0.0
Jamil Hood,31,6,29,10,16,11,174.0,8,0,13.0,21,10,14.2,2015,0.0
Chris Carter,38,0,29,15,9,6,89.0,5,2,7.0,24,13,22.7,2015,0.0
Mark Parisi,0,0,0,0,0,0,4.0,0,0,0.0,0,0,0.0,2015,0.0
Quincy Taylor,926,295,794,324,171,118,3348.0,397,160,259.0,397,164,17.7,2015,0.0
Ryan Badowski,249,17,202,78,44,32,752.0,159,61,26.0,43,17,17.1,2015,0.0
Victor Dorsey,41,4,41,17,11,7,221.0,1,0,13.0,40,17,13.9,2015,0.0
Jason Pimentel,96,8,83,38,35,18,397.0,5,2,27.0,78,36,16.1,2015,0.0
Tyler Akers,17,2,11,4,10,7,49.0,9,2,4.0,2,2,20.7,2015,0.0
Brian Williams,850,95,664,310,267,190,2523.0,141,40,108.0,523,270,18.1,2015,0.0
Xavian Rimmer,710,129,525,211,231,187,2311.0,274,101,145.0,251,110,16.5,2015,0.0
J.J. Davenport,185,16,140,64,78,57,509.0,3,0,31.0,137,64,19.3,2015,0.0
Vieux Kande,49,2,28,19,24,11,185.0,0,0,11.0,28,19,12.9,2015,0.0
Donovan Williams,59,10,50,19,16,11,136.0,30,10,9.0,20,9,23.5,2015,0.0
Aaron Leblanc,28,3,26,13,6,1,141.0,2,1,9.0,24,12,12.9,2015,0.0
Tylor Ongwae,984,149,844,349,292,234,2210.0,203,52,144.0,641,297,27.1,2015,0.0
Marvin Williams,493,24,413,205,132,81,1372.0,9,2,95.0,404,203,21.6,2015,1.0
Chinedu Amajoyi,106,25,91,31,38,28,515.0,50,16,26.0,41,15,13.9,2015,0.0
Jarell Martin,889,88,654,323,293,202,1996.0,133,41,144.0,521,282,22.8,2015,1.0
Jordan Mickey,913,76,701,363,278,186,2197.0,14,1,179.0,687,362,22.4,2015,1.0
John Odo,48,2,32,19,17,10,259.0,0,0,12.0,32,19,9.7,2015,0.0
Antonio Robinson,0,0,0,0,0,0,4.0,0,0,1.0,0,0,12.3,2015,0.0
Carlton Speight,0,1,1,0,0,0,4.0,0,0,0.0,1,0,12.3,2015,0.0
Raheem Appleby,1770,188,1583,672,320,240,3476.0,560,186,170.0,1023,486,27.0,2015,0.0
Michale Kyser,858,56,644,350,283,158,2963.0,1,0,92.0,643,350,14.4,2015,0.0
Speedy Smith,865,858,718,279,280,193,4109.0,320,114,340.0,398,165,14.2,2015,0.0
Terry Rozier,874,175,753,307,228,176,1959.0,254,84,101.0,499,223,24.7,2015,1.0
Montrezl Harrell,1294,102,910,533,407,217,2961.0,40,11,145.0,870,522,21.0,2015,1.0
Wayne Blackshear,1046,95,838,342,278,206,2723.0,454,156,89.0,384,186,19.5,2015,0.0
Trent Gilbert,6,2,6,2,0,0,16.0,5,2,2.0,1,0,25.6,2015,0.0
Christian Thomas,1353,120,917,508,460,302,3593.0,87,35,186.0,830,473,20.8,2015,0.0
Joe Crisman,617,192,536,226,158,103,3044.0,192,62,144.0,344,164,14.0,2015,0.0
Jay Knuth,87,8,63,23,34,30,289.0,26,11,19.0,37,12,19.9,2015,0.0
Eric Porter,3,0,1,1,0,0,7.0,1,1,1.0,0,0,16.8,2015,0.0
London Dokubo,23,39,25,8,10,4,538.0,12,3,30.0,13,5,6.3,2015,0.0
Jay Jay Elvir,0,0,1,0,0,0,2.0,0,0,0.0,1,0,29.3,2015,0.0
Ayodeji Egbeyemi,849,143,764,305,223,149,2932.0,285,90,148.0,479,215,17.8,2015,0.0
Godwin Okonji,649,83,491,243,267,163,2879.0,2,0,141.0,489,243,13.6,2015,0.0
Patson Siame,137,6,139,63,28,11,481.0,1,0,33.0,138,63,20.8,2015,0.0
Chase Flint,264,227,264,97,42,28,1730.0,145,42,91.0,119,55,11.1,2015,0.0
Simon Krajcovic,46,36,41,18,12,6,256.0,12,4,30.0,29,14,16.1,2015,0.0
Casey Norris,5,6,5,1,4,2,47.0,5,1,6.0,0,0,14.8,2015,0.0
Connor Jean,2,0,1,1,0,0,16.0,0,0,0.0,1,1,3.4,2015,0.0
Denzel Brito,501,248,487,152,196,144,2489.0,206,53,178.0,281,99,16.7,2015,0.0
Colton Bishop,22,5,25,7,11,6,196.0,9,2,9.0,16,5,10.9,2015,0.0
Stefano Mancini,0,0,6,0,0,0,30.0,3,0,2.0,3,0,14.5,2015,0.0
Zarko Valjarevic,781,90,670,261,104,77,2213.0,488,182,89.0,182,79,18.6,2015,0.0
Christian Ejiga,104,8,91,39,39,26,443.0,1,0,29.0,90,39,15.8,2015,0.0
Ethan Mackey,190,15,148,86,38,18,604.0,0,0,28.0,148,86,15.9,2015,0.0
Erik Nissen,53,4,49,21,14,10,182.0,2,1,13.0,47,20,19.6,2015,0.0
Peter Westra,3,0,2,1,2,1,3.0,1,0,0.0,1,1,53.1,2015,0.0
Emmy Andujar,1345,367,1004,492,465,324,3505.0,116,37,369.0,888,455,23.2,2015,0.0
Ashton Pankey,827,51,542,284,421,259,2145.0,0,0,139.0,542,284,20.6,2015,0.0
Donovan Kates,570,105,475,146,251,201,2601.0,276,77,147.0,199,69,14.7,2015,0.0
Jermaine Lawrence,173,15,183,69,68,33,667.0,16,2,57.0,167,67,21.0,2015,0.0
Chavaughn Lewis,2119,308,1756,728,810,543,4140.0,386,120,407.0,1370,608,32.0,2015,0.0
Manny Thomas,611,133,519,188,185,137,2570.0,269,98,150.0,250,90,15.3,2015,0.0
T.J. Curry,461,162,385,142,123,89,2001.0,242,88,109.0,143,54,14.4,2015,0.0
Nick Colletta,46,3,59,17,1,1,210.0,46,11,6.0,13,6,16.8,2015,0.0
Tourron Whitfield,11,3,10,2,6,5,53.0,8,2,2.0,2,0,14.8,2015,0.0
Matt Carlino,1620,525,1397,557,359,266,3604.0,666,240,307.0,731,317,25.4,2015,0.0
Juan Anderson,464,120,406,171,150,89,1864.0,114,33,131.0,292,138,17.3,2015,0.0
Derrick Wilson,400,366,387,150,195,89,2789.0,63,11,127.0,324,139,11.4,2015,0.0
Matthew Mache,0,0,0,0,0,0,3.0,0,0,0.0,0,0,0.0,2015,0.0
J.P. Kambola,202,5,150,82,44,27,529.0,45,11,31.0,105,71,18.6,2015,0.0
Jay Johnson,172,18,179,61,45,20,508.0,111,30,34.0,68,31,22.4,2015,0.0
Cheikh Sane,251,34,203,89,132,72,1123.0,6,1,72.0,197,88,14.6,2015,0.0
Tamron Manning,280,125,270,88,111,75,1539.0,114,29,93.0,156,59,13.1,2015,0.0
Shawn Smith,310,24,246,108,99,65,839.0,95,29,43.0,151,79,19.4,2015,0.0
Wayne Sparrow,577,135,565,208,158,89,1990.0,242,72,139.0,323,136,21.5,2015,0.0
Devarick Houston,326,85,293,124,88,51,1710.0,109,27,114.0,184,97,14.0,2015,0.0
Aaron Morgan,255,110,251,73,97,67,1274.0,151,42,125.0,100,31,17.1,2015,0.0
Malik Garner,274,57,243,105,78,44,1244.0,72,20,60.0,171,85,13.8,2015,0.0
Josh Olabosipo,0,0,0,0,0,0,3.0,0,0,0.0,0,0,0.0,2015,0.0
Mike Myers,520,45,285,169,282,181,871.0,6,1,105.0,279,168,31.4,2015,0.0
Devon Walker,476,53,391,165,48,38,1317.0,276,108,52.0,115,57,18.3,2015,0.0
Ishaq Pitt,672,306,543,230,366,208,2686.0,25,4,245.0,518,226,18.2,2015,0.0
Travis Trim,79,68,92,31,30,13,689.0,14,4,50.0,78,27,11.8,2015,0.0
Issac Smith,186,100,211,57,75,51,913.0,79,21,81.0,132,36,18.5,2015,0.0
Jaiquan Manning,0,0,0,0,0,0,0.0,0,0,0.0,0,0,0,2015,0.0
Dez Wells,1710,294,1238,612,524,401,3756.0,227,85,321.0,1011,527,24.8,2015,0.0
Richaud Pack,734,92,492,203,315,245,2049.0,241,83,93.0,251,120,18.5,2015,0.0
Evan Smotrycz,951,140,790,322,200,150,2737.0,419,157,155.0,371,165,20.6,2015,0.0
Jonathan Graham,283,22,258,116,101,51,1551.0,0,0,72.0,258,116,12.9,2015,0.0
Spencer Barks,7,0,8,0,12,7,44.0,0,0,2.0,8,0,18.2,2015,0.0
Jacob Susskind,0,1,9,0,0,0,38.0,4,0,4.0,5,0,17.4,2015,0.0
Lance Crawford,280,66,205,83,113,87,830.0,79,27,58.0,126,56,21.3,2015,0.0
Chad Holley,619,187,515,179,228,178,2210.0,263,83,146.0,252,96,19.0,2015,0.0
Marco Banegas-Flores,363,131,315,113,141,97,1655.0,113,40,141.0,202,73,17.2,2015,0.0
Kerry Weldon,238,49,214,100,126,38,1215.0,1,0,84.0,213,100,16.2,2015,0.0
Brad Schaub,104,16,94,39,22,10,539.0,33,16,35.0,61,23,14.4,2015,0.0
Jordan Rhodes,5,0,5,2,2,1,21.0,0,0,0.0,5,2,15.8,2015,0.0
Cady Lalanne,1107,26,767,424,374,249,2799.0,47,10,206.0,720,414,19.9,2015,0.0
Maxie Esho,1019,68,764,383,383,243,2734.0,37,10,196.0,727,373,20.1,2015,0.0
Desharick Guidry,1352,123,1103,510,375,258,3504.0,216,74,195.0,887,436,21.2,2015,0.0
Kevin Hardy,1169,430,998,465,366,202,3750.0,109,37,220.0,889,428,18.6,2015,0.0
Keelan Garrett,548,66,534,193,69,51,1422.0,332,111,64.0,202,82,22.1,2015,0.0
Marcus Mathieu,34,16,40,11,14,8,196.0,18,4,18.0,22,7,16.4,2015,0.0
Jordan Wells,63,7,74,27,16,7,302.0,8,2,18.0,66,25,16.8,2015,0.0
Calvin Godfrey,708,52,506,267,268,174,1855.0,1,0,99.0,505,267,19.7,2015,0.0
D'Marnier Cunningham,55,33,59,22,11,8,217.0,10,3,22.0,49,19,20.3,2015,0.0
Chris Hawkins,50,10,41,20,14,8,205.0,4,2,10.0,37,18,14.3,2015,0.0
Darious Moten,585,75,417,208,201,142,1528.0,71,27,75.0,346,181,21.0,2015,0.0
T.J. Hallice,547,88,431,217,197,106,2264.0,38,7,87.0,393,210,14.8,2015,0.0
Matt Panaggio,18,9,18,6,7,4,149.0,5,2,13.0,13,4,12.8,2015,0.0
John Mosser,3,2,8,0,4,3,21.0,5,0,1.0,3,0,27.3,2015,0.0
Joe Thomas,332,37,271,151,99,30,1550.0,0,0,70.0,271,151,12.3,2015,1.0
Mike Fernandez,2,0,2,1,0,0,10.0,1,0,3.0,1,1,28.5,2015,0.0
Will Sullivan,793,130,587,265,166,127,2950.0,344,136,122.0,243,129,14.5,2015,0.0
Jaryd Eustace,299,28,273,96,70,47,898.0,194,60,51.0,79,36,21.3,2015,0.0
Joshua Oswald,155,22,157,61,26,20,590.0,60,13,28.0,97,48,17.8,2015,0.0
John Hawkins,37,3,38,16,9,5,165.0,1,0,11.0,37,16,17.2,2015,0.0
Tre Hawkins,0,1,0,0,0,0,1.0,0,0,0.0,0,0,0.0,2015,0.0
Travis Trice,1135,387,952,371,267,191,3164.0,512,202,177.0,440,169,21.1,2015,0.0
Branden Dawson,1309,181,1013,566,317,177,3456.0,9,0,219.0,1004,566,21.2,2015,1.0
Keenan Wetzel,16,1,22,6,2,1,71.0,14,3,3.0,8,3,19.4,2015,0.0
Trevor Bohnhoff,7,0,2,1,10,5,39.0,0,0,0.0,2,1,9.1,2015,0.0
Austin Hatch,1,0,2,0,3,1,5.0,2,0,1.0,0,0,51.5,2015,0.0
Ryan Kapustka,0,0,0,0,0,0,1.0,0,0,0.0,0,0,0.0,2015,0.0
Jon Rubenstein,0,0,0,0,1,0,1.0,0,0,0.0,0,0,27.6,2015,0.0
Jacquez Rozier,406,47,307,142,203,120,1572.0,11,2,96.0,296,140,17.0,2015,0.0
Marcus Tarrance,373,49,283,109,149,105,1214.0,154,50,57.0,129,59,18.1,2015,0.0
DeVante Jones,123,22,105,39,28,21,285.0,69,24,15.0,36,15,25.8,2015,0.0
Gavin Gibson,8,3,15,2,2,2,66.0,13,2,3.0,2,0,15.1,2015,0.0
Steve McWhorter,937,376,778,328,271,187,3581.0,283,94,208.0,495,234,16.6,2015,0.0
Trinson White,53,13,43,13,36,25,254.0,5,2,16.0,38,11,16.2,2015,0.0
Jimmy Stamas,5,2,4,1,2,2,25.0,2,1,4.0,2,0,19.3,2015,0.0
Evan Richard,137,20,140,46,36,31,638.0,59,14,31.0,81,32,15.5,2015,0.0
Andre Hollins,1765,359,1341,539,499,413,3907.0,701,274,284.0,640,265,24.9,2015,0.0
Maurice Walker,752,70,517,285,266,180,1704.0,5,2,145.0,512,283,23.9,2015,0.0
Deandre Mathieu,823,346,633,306,233,171,2453.0,96,40,194.0,537,266,20.2,2015,0.0
Elliott Eliason,451,116,351,184,162,83,2179.0,2,0,106.0,349,184,12.9,2015,0.0
Daquein McNeil,62,22,67,23,21,10,367.0,24,6,16.0,43,17,13.4,2015,0.0
Kendal Shell,17,10,21,7,2,1,86.0,7,2,6.0,14,5,16.8,2015,0.0
Roquez Johnson,862,46,609,289,448,279,2386.0,24,5,189.0,585,284,22.0,2015,0.0
Trivante Bloodman,532,221,371,152,285,206,2336.0,91,22,196.0,280,130,15.5,2015,0.0
Isaiah Butler,0,1,1,0,0,0,26.0,1,0,2.0,0,0,6.2,2015,0.0
Jeffery Johnson,0,0,1,0,0,0,12.0,0,0,1.0,1,0,9.0,2015,0.0
Jeffrey Simmons,607,110,556,255,129,80,1386.0,74,17,158.0,482,238,26.6,2015,0.0
DeAngelo Priar,648,111,582,218,236,143,1762.0,231,69,129.0,351,149,22.2,2015,0.0
Rakwan Kelly,134,27,118,47,66,39,577.0,2,1,31.0,116,46,15.0,2015,0.0
Billy Jackson,87,24,101,28,41,25,441.0,38,6,36.0,63,22,17.1,2015,0.0
Jurmelle Hall,49,7,57,17,6,4,173.0,40,11,10.0,17,6,19.2,2015,0.0
Tyler Corley,39,7,42,12,18,12,110.0,13,3,9.0,29,9,26.5,2015,0.0
Charles Bargman,22,5,32,6,6,4,192.0,17,6,9.0,15,0,11.0,2015,0.0
Ben Milshtein,24,3,29,9,14,6,125.0,1,0,7.0,28,9,16.2,2015,0.0
Mudiaga Okagbare,3,0,3,1,3,1,25.0,0,0,3.0,3,1,14.3,2015,0.0
Jarvis Summers,1629,530,1285,520,640,463,3885.0,354,126,291.0,931,394,23.9,2015,0.0
LaDarius White,964,175,844,336,243,170,2581.0,357,122,174.0,487,214,21.6,2015,0.0
M.J. Rhett,866,71,637,339,274,188,2968.0,1,0,196.0,636,339,16.4,2015,0.0
Terence Smith,1171,293,877,370,380,306,3096.0,320,125,202.0,557,245,20.0,2015,0.0
Aaron Jones,379,37,335,156,91,64,1777.0,20,3,56.0,315,153,12.0,2015,0.0
Roderick Lawrence,22,10,26,8,3,1,105.0,14,5,6.0,12,3,16.0,2015,0.0
Reese Holliday,1024,153,711,314,428,308,3134.0,244,88,212.0,467,226,19.0,2015,0.0
Frank Williams,506,88,503,187,51,37,1765.0,300,95,63.0,203,92,17.0,2015,1.0
Collin Jennings,122,27,99,44,19,14,443.0,49,20,26.0,50,24,15.9,2015,0.0
Kevin Franceschi,64,9,56,20,25,20,211.0,15,4,26.0,41,16,23.4,2015,0.0
Isaac Kreuer,115,7,98,41,51,33,620.0,2,0,29.0,96,41,12.3,2015,0.0
Juan Ramon Rivas,12,2,19,4,3,3,57.0,7,1,4.0,12,3,22.5,2015,0.0
Mason Wedel,50,27,62,18,7,5,384.0,41,9,16.0,21,9,11.3,2015,0.0
Gavin Thurman,536,55,570,202,89,68,1507.0,211,64,88.0,359,138,26.0,2015,0.0
Christian Kirk,718,64,570,301,195,116,2292.0,1,0,123.0,569,301,19.1,2015,0.0
Cameron Maes,0,3,3,0,0,0,10.0,2,0,1.0,1,0,22.5,2015,0.0
Keith Shamburger,1371,525,1125,399,475,382,4183.0,609,191,227.0,516,208,19.3,2015,0.0
Keanau Post,165,4,119,70,51,25,667.0,0,0,37.0,119,70,14.5,2015,0.0
Hayden Barnard,0,0,0,0,0,0,1.0,0,0,0.0,0,0,0.0,2015,0.0
Andrew Nicholas,1180,164,1129,431,218,149,2919.0,512,169,183.0,617,262,24.2,2015,0.0
Max DiLeo,490,107,367,155,174,128,1803.0,151,52,75.0,216,103,14.9,2015,0.0
Brice Kofane,335,29,248,124,157,87,1672.0,0,0,123.0,248,124,14.1,2015,0.0
Ba'shawn Mickens,8,1,5,3,0,0,14.0,4,2,1.0,1,1,23.3,2015,0.0
Mike DeLorenzo,2,0,3,1,0,0,10.0,0,0,1.0,3,1,21.7,2015,0.0
Michael Dison,804,162,733,282,196,132,2234.0,305,108,141.0,428,174,22.5,2015,0.0
Eric Norman,318,90,312,112,69,49,1441.0,159,45,90.0,153,67,15.9,2015,0.0
Blake Brumwell,149,16,121,65,43,19,911.0,0,0,44.0,121,65,10.6,2015,0.0
Ryan Shannon,8,2,10,4,0,0,38.0,0,0,2.0,10,4,16.7,2015,0.0
Bradley Fischer,0,0,5,0,0,0,59.0,0,0,3.0,5,0,7.1,2015,0.0
Deryk Pearsall,0,0,0,0,0,0,0.0,0,0,0.0,0,0,0,2015,0.0
Jordan Gregory,1234,210,903,380,340,282,3102.0,503,192,142.0,400,188,22.0,2015,0.0
Michael Weisner,652,93,474,213,110,96,2197.0,311,130,108.0,163,83,16.3,2015,0.0
Chris Kemp,166,6,118,70,49,26,553.0,0,0,35.0,118,70,18.2,2015,0.0
Jermaine Edmonds,79,12,68,28,15,10,225.0,41,13,9.0,27,15,20.9,2015,0.0
Daniel Nwosu,5,1,7,2,0,0,44.0,5,1,3.0,2,1,12.7,2015,0.0
Angelo Warner,1557,299,1105,488,520,417,3606.0,468,164,272.0,637,324,22.1,2015,0.0
Karam Mashour,417,41,316,156,126,82,883.0,77,23,60.0,239,133,24.9,2015,0.0
Billy Reader,517,51,417,217,123,82,1431.0,2,1,88.0,415,216,19.6,2015,0.0
Kareem Storey,592,399,479,178,252,186,2636.0,174,50,268.0,305,128,16.8,2015,0.0
Marquel Willis,98,9,70,27,43,35,236.0,29,9,16.0,41,18,22.7,2015,0.0
Marcus Fuggins,42,5,39,16,32,10,241.0,1,0,22.0,38,16,15.9,2015,0.0
Chad Donley,146,25,137,47,26,16,453.0,111,36,18.0,26,11,19.0,2015,0.0
Jalen Courtney,123,7,121,46,28,19,464.0,36,12,17.0,85,34,16.3,2015,0.0
Blake Bozeman,914,246,939,296,195,139,3717.0,601,183,202.0,338,113,16.4,2015,0.0
Zech Smith,173,4,134,72,63,29,817.0,0,0,38.0,134,72,12.4,2015,0.0
Torin Childs-Harris,146,12,146,47,60,41,470.0,57,11,28.0,89,36,21.3,2015,0.0
Cliff Cornish,144,21,142,54,56,36,634.0,1,0,42.0,141,54,17.0,2015,0.0
Emmanuel Matey,83,91,77,25,59,31,595.0,13,2,57.0,64,23,13.4,2015,0.0
Conrad Chambers,20,9,22,6,8,5,65.0,9,3,10.0,13,3,27.4,2015,0.0
Jeremiah Curtis,6,1,9,1,4,4,47.0,0,0,1.0,9,1,12.6,2015,0.0
Jordan Omogbehin,23,1,23,11,16,1,189.0,0,0,13.0,23,11,12.6,2015,0.0
Christopher Brown,0,0,0,0,0,0,3.0,0,0,0.0,0,0,0.0,2015,0.0
Anthony Vernon,0,0,1,0,0,0,7.0,0,0,1.0,1,0,14.2,2015,0.0
Kristijan Krajina,592,56,503,251,141,78,2035.0,69,12,160.0,434,239,19.0,2015,0.0
Andy Smeathers,185,18,183,58,32,26,490.0,145,43,34.0,38,15,25.4,2015,0.0
Maalik Howard,3,3,2,1,0,0,75.0,1,1,2.0,1,0,2.8,2015,0.0
Cameron Payne,1279,394,1007,435,324,253,2238.0,434,156,197.0,573,279,30.5,2015,1.0
Jarvis Williams,1055,54,635,383,436,289,2190.0,1,0,115.0,634,383,21.9,2015,0.0
T.J. Sapp,884,172,689,284,224,177,2301.0,382,139,148.0,307,145,20.9,2015,0.0
Jonathan Fairell,421,52,285,170,184,81,1493.0,0,0,104.0,285,170,16.0,2015,0.0
Tyler Rambo,279,43,176,95,152,89,985.0,0,0,53.0,176,95,15.4,2015,0.0
Kedrick Flomo,36,30,53,10,10,7,312.0,35,9,22.0,18,1,12.9,2015,0.0
Jeff Martin,17,2,18,5,6,4,36.0,9,3,3.0,9,2,33.3,2015,1.0
Brandon Venturini,1017,230,1008,374,97,62,2787.0,612,207,188.0,396,167,24.9,2015,0.0
Worth Smith,1172,89,1058,477,218,146,3205.0,231,72,180.0,827,405,23.4,2015,0.0
Earl McLaurin,84,80,73,23,40,25,644.0,37,13,42.0,36,10,11.5,2015,0.0
Kevin Alter,193,34,161,54,45,37,619.0,148,48,25.0,13,6,18.9,2015,0.0
Daniel Noe,28,3,34,11,3,2,93.0,21,4,6.0,13,7,25.1,2015,0.0
C.J. Carter,1199,267,957,422,322,241,2817.0,366,114,227.0,591,308,22.8,2015,0.0
Mike Rostampour,591,26,391,193,268,185,1371.0,51,20,87.0,340,173,20.9,2015,0.0
Rylan Murry,78,8,58,26,18,12,251.0,39,14,9.0,19,12,14.3,2015,0.0
Terran Petteway,1231,159,979,398,410,307,2468.0,404,128,227.0,575,270,31.0,2015,0.0
Walter Pitchford,519,31,454,192,82,50,1576.0,248,85,49.0,206,107,18.8,2015,0.0
David Rivers,411,59,377,160,138,81,2195.0,46,10,56.0,331,150,12.7,2015,1.0
Leslee Smith,320,52,261,126,107,62,1128.0,23,6,97.0,238,120,20.2,2015,0.0
Moses Abraham,141,25,99,52,79,37,919.0,0,0,62.0,99,52,11.8,2015,0.0
Trevor Menke,10,5,13,3,2,1,95.0,10,3,1.0,3,0,8.8,2015,0.0
Kye Kurkowski,6,0,4,3,1,0,34.0,0,0,2.0,4,3,10.6,2015,0.0
Christian Wood,654,53,493,235,198,148,1468.0,138,36,95.0,355,199,24.7,2015,1.0
Rashad Vaughn,410,36,328,144,98,68,742.0,141,54,50.0,187,90,30.8,2015,1.0
Jelan Kendrick,523,170,490,194,150,88,1882.0,141,47,125.0,349,147,18.9,2015,0.0
Cody Doolin,1217,579,966,416,328,253,4345.0,410,132,240.0,556,284,16.3,2015,0.0
Dantley Walker,26,1,24,9,0,0,64.0,20,8,0.0,4,1,20.2,2015,0.0
Charles Rushman,10,2,9,4,2,2,26.0,1,0,0.0,8,4,20.1,2015,0.0
Michael Perez,941,237,846,320,244,174,3164.0,380,127,190.0,466,193,19.5,2015,0.0
Ronnie Stevens,129,6,95,43,62,43,579.0,0,0,39.0,95,43,14.6,2015,0.0
Robyn Missa,60,2,54,23,19,11,318.0,10,3,18.0,44,20,13.0,2015,0.0
Patrick Conroy,3,4,6,1,2,1,19.0,5,0,2.0,1,1,24.1,2015,0.0
Stelios Papafloratos,3,1,9,1,2,0,24.0,7,1,4.0,2,0,29.6,2015,0.0
Matt Miller,286,34,211,100,31,23,662.0,131,63,21.0,80,37,20.3,2015,0.0
Frank Okeke,257,42,249,81,63,41,1161.0,175,54,49.0,74,27,15.4,2015,0.0
Tommy McDonnell,96,51,91,36,34,20,815.0,12,4,50.0,79,32,10.5,2015,0.0
John Edwards,102,20,82,28,61,44,383.0,18,2,34.0,64,26,20.8,2015,1.0
Williams Gabriel,64,2,49,23,30,18,444.0,0,0,31.0,49,23,11.6,2015,0.0
Logan Mortenson,28,7,33,9,6,5,140.0,19,5,7.0,14,4,16.5,2015,0.0
Remi Barry,656,56,504,224,200,149,1696.0,158,59,94.0,346,165,21.3,2015,0.0
DK Eldridge,681,146,570,246,172,110,1875.0,231,79,122.0,339,167,21.4,2015,0.0
Daniel Mullings,1677,342,1240,579,651,463,4008.0,178,56,322.0,1062,523,23.6,2015,0.0
Tshilidzi Nephawe,1087,67,692,359,550,369,2979.0,1,0,216.0,691,359,19.8,2015,0.0
Travon Landry,121,54,91,31,83,55,671.0,21,4,37.0,70,27,12.9,2015,0.0
Hugh Greenwood,1006,372,885,342,198,135,3843.0,547,187,166.0,338,155,16.0,2015,0.0
Deshawn Delaney,530,114,407,207,137,84,1551.0,91,32,74.0,316,175,19.2,2015,0.0
Jordan Goodman,119,17,124,45,31,19,255.0,39,10,15.0,85,35,33.1,2015,0.0
Terrance Syon,315,27,237,117,152,81,1100.0,1,0,78.0,236,117,16.8,2015,0.0
Rayvon Harris,372,39,239,119,193,124,1112.0,29,10,115.0,210,109,19.6,2015,0.0
DayJar Dickson,9,4,15,3,7,3,140.0,0,0,7.0,15,3,9.4,2015,0.0
Anders Skou Hansen,2,5,7,1,0,0,77.0,2,0,3.0,5,1,6.7,2015,0.0
Sam McBeath,698,138,577,240,202,127,1988.0,289,91,165.0,288,149,21.6,2015,0.0
Amin Torres,575,89,476,191,142,111,1222.0,237,82,122.0,239,109,28.0,2015,0.0
Richie Lewis,131,68,119,44,57,39,671.0,20,4,76.0,99,40,16.8,2015,0.0
Travis Julien,99,18,95,41,50,17,485.0,12,0,36.0,83,41,16.3,2015,0.0
JaMarkus Horace,259,26,238,111,92,37,927.0,0,0,85.0,238,111,20.4,2015,0.0
Denzel Flemings,5,2,6,2,2,1,32.0,1,0,2.0,5,2,14.2,2015,0.0
Daquan Holiday,470,58,310,179,180,112,1679.0,0,0,99.0,310,179,15.0,2015,0.0
Odera Nweke,329,71,261,112,167,104,1540.0,7,1,92.0,254,111,14.2,2015,0.0
Montana Mayfield,95,48,71,29,31,26,364.0,32,11,32.0,39,18,16.5,2015,0.0
Malik Thomas,838,152,739,312,195,129,2610.0,267,85,160.0,472,227,20.2,2015,0.0
Jamel Fuentes,565,552,499,178,361,205,3141.0,27,4,284.0,472,174,15.4,2015,0.0
LaTre'e Russell,119,23,97,42,49,35,551.0,3,0,48.0,94,42,16.0,2015,0.0
Malik Gray,56,4,47,18,16,6,172.0,35,14,11.0,12,4,20.1,2015,0.0
Hefeng Sun,16,3,12,6,4,4,79.0,0,0,3.0,12,6,11.2,2015,0.0
Kievyn Lila-St. Rose,151,17,173,56,29,18,630.0,81,21,44.0,92,35,18.5,2015,0.0
Paulius Vinogradovas,26,2,29,10,18,6,240.0,0,0,13.0,29,10,10.9,2015,0.0
Jaleel Roberts,373,24,265,154,100,65,1106.0,1,0,71.0,264,154,17.1,2015,0.0
Corey Littlejohn,424,135,353,140,139,105,1674.0,122,39,133.0,231,101,16.2,2015,0.0
Kem Ubaru,107,8,85,37,44,29,242.0,8,4,34.0,77,33,28.7,2015,0.0
Chudier Pal,106,25,80,45,31,16,380.0,0,0,24.0,80,45,15.4,2015,0.0
Ethan Wilmoth,31,10,28,11,9,4,159.0,21,5,6.0,7,6,11.9,2015,0.0
Jacob Casper,10,1,9,4,0,0,48.0,6,2,5.0,3,2,14.3,2015,0.0
Bryan Akinkugbe,237,16,200,87,107,63,886.0,1,0,74.0,199,87,19.0,2015,0.0
Trey Brown,38,3,36,15,6,3,110.0,19,5,7.0,17,10,22.3,2015,0.0
Jerome Simmons,81,2,67,35,20,11,401.0,0,0,16.0,67,35,11.9,2015,0.0
Ty'Shaun McCollum,2,0,1,1,0,0,6.0,0,0,0.0,1,1,8.9,2015,0.0
Jordan Parks,858,43,529,349,224,147,1687.0,28,13,97.0,501,336,23.6,2015,0.0
Anthony McDonald,807,69,634,252,158,124,1970.0,483,179,92.0,151,73,20.8,2015,0.0
Nimrod Hilliard,844,377,642,287,238,191,2396.0,212,79,189.0,430,208,20.9,2015,0.0
Karamo Jawara,620,213,479,222,191,133,2841.0,142,43,131.0,337,179,13.3,2015,0.0
Nate Maxey,266,8,178,116,77,34,1078.0,0,0,58.0,178,116,13.5,2015,0.0
Nicholas Paulos,1030,112,835,352,77,64,3147.0,666,262,127.0,169,90,15.6,2015,0.0
Ben Dickinson,610,104,548,239,182,121,1504.0,57,11,126.0,491,228,26.6,2015,0.0
Jamal Mitchell,22,4,17,6,10,8,92.0,4,2,0.0,13,4,12.1,2015,0.0
Trevor Lacey,1197,295,971,404,293,218,3199.0,468,171,202.0,503,233,22.0,2015,0.0
Ralston Turner,1473,164,1265,488,303,227,3841.0,749,270,190.0,516,218,21.5,2015,0.0
Desmond Lee,382,70,290,111,185,138,1089.0,86,22,77.0,204,89,21.8,2015,0.0
Staats Battle,19,2,25,7,3,0,39.0,23,5,1.0,2,2,35.9,2015,0.0
Addison Spruill,754,84,679,275,244,173,1683.0,132,31,111.0,547,244,27.6,2015,0.0
Freddie Jackson,932,206,833,352,232,148,3168.0,266,80,207.0,567,272,18.6,2015,0.0
Cedrick Williams,974,89,793,376,316,213,3319.0,37,9,139.0,756,367,16.7,2015,0.0
J.P. Tokoto,722,293,617,285,241,131,2383.0,79,21,180.0,538,264,18.3,2015,0.0
Jackson Simmons,129,19,89,53,42,23,562.0,0,0,14.0,89,53,10.3,2015,0.0
Desmond Hubert,84,14,73,36,53,12,729.0,0,0,35.0,73,36,8.6,2015,0.0
Sasha Seymore,7,0,4,2,4,3,11.0,0,0,3.0,4,2,39.0,2015,0.0
Luke Davis,241,171,219,75,68,48,1251.0,134,43,108.0,85,32,14.8,2015,0.0
Lawrence Alexander,1755,408,1362,587,491,374,4629.0,532,207,320.0,830,380,23.1,2015,0.0
Jake Showalter,18,0,12,6,2,2,38.0,10,4,2.0,2,2,22.5,2015,0.0
Matt Kourouma,3,0,3,1,2,1,5.0,0,0,0.0,3,1,45.3,2015,0.0
Zach Checkal,6,0,10,1,4,3,37.0,5,1,1.0,5,0,19.3,2015,0.0
Jaron Nash,783,42,632,318,256,115,1785.0,109,32,109.0,523,286,25.0,2015,0.0
Estan Tyler,796,238,653,259,192,156,2517.0,305,122,208.0,348,137,20.2,2015,0.0
Terrel de Rouen,449,127,409,157,123,79,1405.0,180,56,115.0,229,101,21.5,2015,0.0
Lenny Antwi,494,83,445,167,80,60,1796.0,277,100,74.0,168,67,16.0,2015,0.0
Josiah Coleman,124,13,110,43,25,19,397.0,63,19,24.0,47,24,19.3,2015,0.0
Chad Calcaterra,166,5,121,66,61,34,620.0,0,0,31.0,121,66,15.1,2015,0.0
Ryan Salmonson,97,2,81,39,24,19,375.0,2,0,32.0,79,39,16.9,2015,0.0
Kraig Shields,31,2,22,12,10,7,139.0,0,0,5.0,22,12,12.0,2015,0.0
Jalen Nesbitt,632,194,397,183,287,214,1890.0,145,52,146.0,252,131,18.2,2015,0.0
Jordan Williams,1501,126,1249,504,469,350,3389.0,477,143,253.0,772,361,25.6,2015,1.0
Colin Voss,538,83,448,207,166,121,1983.0,6,3,104.0,442,204,16.1,2015,0.0
Maurice Aniefiok,475,69,429,163,81,56,1612.0,258,93,82.0,171,70,17.3,2015,0.0
Armani Flannigan,203,9,151,81,93,41,739.0,1,0,35.0,150,81,15.8,2015,0.0
Muhammed Ahmed,105,2,112,40,44,22,288.0,22,3,16.0,90,37,26.6,2015,0.0
Scott Eatherton,1536,125,1002,581,494,341,3149.0,97,33,242.0,905,548,25.4,2015,0.0
Reggie Spencer,992,128,744,375,361,241,3192.0,2,1,186.0,742,374,18.6,2015,0.0
C.J. Hill,2,0,4,0,2,2,15.0,1,0,6.0,3,0,40.6,2015,0.0
Quinton Upshur,1203,97,940,383,359,263,2635.0,495,174,137.0,445,209,24.4,2015,0.0
Aaseem Dixon,837,155,755,284,160,124,2320.0,387,145,113.0,368,139,21.3,2015,0.0
Gaellen Bewernick,774,142,664,337,148,81,3329.0,76,19,185.0,588,318,14.4,2015,0.0
Len Springs,165,12,146,66,57,33,1102.0,1,0,55.0,145,66,10.8,2015,0.0
Zachary Reynolds,46,2,34,18,15,9,266.0,1,1,10.0,33,17,9.9,2015,0.0
Tate de Laveaga,21,4,27,6,10,8,138.0,14,1,9.0,13,5,15.1,2015,0.0
Jaran Hoover,3,0,4,1,0,0,6.0,4,1,0.0,0,0,34.1,2015,0.0
Geoffrey Frid,2,1,1,1,0,0,33.0,0,0,0.0,1,1,1.6,2015,0.0
Tevin Svihovec,1391,331,1080,474,473,359,3539.0,230,84,260.0,850,390,23.3,2015,0.0
Tim Huskisson,1058,165,731,378,335,222,2576.0,211,80,186.0,520,298,22.0,2015,0.0
Dominique Lee,520,37,324,201,179,107,1272.0,26,11,57.0,298,190,19.5,2015,0.0
Cody McDavis,264,12,215,110,61,43,873.0,3,1,39.0,212,109,17.3,2015,0.0
Corey Spence,251,123,234,87,86,63,1138.0,56,14,83.0,178,73,16.8,2015,0.0
Drew Bender,99,22,95,35,20,13,326.0,59,16,25.0,36,19,21.8,2015,0.0
Dwight Smith,260,62,186,85,114,75,1026.0,55,15,55.0,131,70,15.4,2015,0.0
Tanner Schmidt,0,0,0,0,0,0,2.0,0,0,0.0,0,0,0.0,2015,0.0
Jordan Threloff,692,47,443,231,335,230,2013.0,0,0,122.0,443,231,18.9,2015,0.0
Aaron Armstead,526,59,465,179,129,97,1661.0,216,71,97.0,249,108,19.6,2015,0.0
Pete Rakocevic,240,23,219,93,84,53,931.0,22,1,76.0,197,92,18.8,2015,0.0
Keith Gray,311,18,236,95,170,121,1206.0,0,0,93.0,236,95,18.0,2015,0.0
Seth Tuttle,1747,282,1041,600,675,508,3672.0,109,39,270.0,932,561,25.5,2015,0.0
Nate Buss,657,20,483,241,103,83,1427.0,208,92,52.0,275,149,23.6,2015,0.0
Deon Mitchell,1200,373,964,406,414,283,3207.0,285,105,283.0,679,301,25.5,2015,0.0
Marvin Singleton,301,40,230,119,87,57,1378.0,33,6,63.0,197,113,14.2,2015,0.0
Max Martino,95,12,97,34,12,5,627.0,67,22,26.0,30,12,11.4,2015,0.0
Chad Jackson,609,144,441,219,265,168,2156.0,19,3,151.0,422,216,18.3,2015,0.0
Anthony Monaco,227,69,202,68,67,58,1221.0,116,33,75.0,86,35,13.7,2015,0.0
Daniel Camps,248,37,178,95,82,54,638.0,19,4,46.0,159,91,22.2,2015,0.0
Marvin Frazier,546,57,454,202,176,119,1735.0,70,23,86.0,384,179,16.4,2015,0.0
Tony Dobbinson,149,19,139,52,18,12,365.0,91,33,36.0,48,19,23.1,2015,0.0
Ryan King,137,6,99,57,47,23,524.0,0,0,19.0,99,57,12.1,2015,0.0
Deji Adekunle,17,1,16,7,9,3,120.0,0,0,11.0,16,7,12.0,2015,0.0
Paxson Guest,2,0,4,1,0,0,13.0,3,0,2.0,1,1,21.2,2015,0.0
Matt LeBato,0,0,9,0,0,0,19.0,6,0,0.0,3,0,21.8,2015,0.0
JerShon Cobb,782,153,674,273,183,137,2390.0,295,99,122.0,379,174,20.9,2015,0.0
Dave Sobolewski,806,334,647,236,307,215,3194.0,379,119,158.0,268,117,16.9,2015,0.0
Jeremiah Kreisberg,602,87,440,218,225,162,2025.0,18,4,159.0,422,214,18.3,2015,0.0
Johnnie Vassar,109,22,102,38,45,22,326.0,30,11,50.0,72,27,26.3,2015,0.0
Nick Segura,2,0,2,0,2,2,3.0,1,0,0.0,1,0,57.0,2015,0.0
Jerian Grant,1739,690,1276,556,567,448,4337.0,519,179,266.0,757,377,23.1,2015,1.0
Pat Connaughton,1465,257,1145,515,215,167,4484.0,695,268,135.0,450,247,16.9,2015,1.0
Corey Petros,1636,174,1152,664,603,308,4516.0,1,0,195.0,1151,664,18.3,2015,0.0
Tommie McCune,397,59,323,140,132,96,1126.0,89,21,104.0,234,119,22.4,2015,0.0
Ralph Hill,218,31,168,75,40,28,690.0,112,40,23.0,56,35,15.7,2015,0.0
Alek Frascone,5,1,4,2,0,0,23.0,1,1,4.0,3,1,18.1,2015,0.0
Tom Cotter,13,2,15,5,5,3,111.0,0,0,5.0,15,5,9.9,2015,0.0
D'Angelo Russell,675,175,515,231,156,118,1188.0,231,95,102.0,284,136,30.2,2015,1.0
Sam Thompson,1001,155,801,378,260,172,3344.0,231,73,123.0,570,305,16.4,2015,0.0
Shannon Scott,786,528,730,296,201,133,3164.0,218,61,229.0,512,235,17.5,2015,0.0
Amir Williams,660,27,392,236,317,188,2254.0,0,0,123.0,392,236,15.5,2015,0.0
Trey McDonald,195,16,153,80,88,35,1016.0,0,0,49.0,153,80,12.6,2015,0.0
Anthony Lee,925,40,717,372,286,180,2438.0,5,1,119.0,712,371,20.1,2015,0.0
Jake Lorbach,8,0,9,3,7,2,31.0,1,0,3.0,8,3,26.2,2015,0.0
Maurice Ndour,977,106,695,346,317,240,2131.0,116,45,178.0,579,301,25.4,2015,1.0
Javarez Willis,1032,287,883,359,148,121,2997.0,528,193,255.0,355,166,21.3,2015,0.0
Stevie Taylor,755,246,737,269,167,111,2322.0,363,106,151.0,374,163,21.8,2015,0.0
Chandler Thomas,412,20,343,155,145,89,1190.0,34,13,73.0,309,142,20.3,2015,0.0
Reggie Williams,0,1,1,0,2,0,12.0,0,0,0.0,1,0,8.5,2015,1.0
Le'Bryan Nash,1839,217,1381,635,715,539,3893.0,144,30,322.0,1237,605,27.6,2015,0.0
Anthony Hickey,1219,469,1165,456,161,81,4007.0,652,226,209.0,513,230,18.3,2015,0.0
Michael Cobbins,613,57,469,251,178,111,2669.0,2,0,108.0,467,251,13.1,2015,0.0
Christien Sager,58,16,45,16,35,16,384.0,33,10,11.0,12,6,9.9,2015,0.0
Alex Budke,9,2,8,3,0,0,32.0,6,3,4.0,2,0,19.6,2015,0.0
Marek Soucek,48,13,45,19,10,5,277.0,21,5,16.0,24,14,12.5,2015,0.0
TaShawn Thomas,1793,226,1318,737,510,317,4001.0,20,2,258.0,1298,735,22.8,2015,0.0
D.J. Bennett,143,5,100,54,55,35,517.0,0,0,27.0,100,54,14.5,2015,0.0
Trey Slate,10,1,13,4,0,0,27.0,8,2,2.0,5,2,27.6,2015,0.0
James Fraschilla,8,3,5,1,10,6,41.0,3,0,5.0,2,1,17.8,2015,0.0
Jonathan Arledge,821,68,662,296,273,198,1991.0,103,31,135.0,559,265,24.5,2015,0.0
Richard Ross,981,110,772,424,242,127,3250.0,19,6,170.0,753,418,17.0,2015,0.0
Keenan Palmore,686,219,556,257,277,171,2159.0,19,1,173.0,537,256,20.7,2015,0.0
Javonte Douglas,89,19,74,33,38,21,255.0,7,2,17.0,67,31,23.3,2015,0.0
Deion Clark,104,21,98,39,24,16,438.0,38,10,23.0,60,29,15.3,2015,0.0
Joe Ebondo,55,10,53,22,26,11,641.0,0,0,23.0,53,22,7.2,2015,0.0
Denell Henderson,342,32,250,126,127,86,887.0,15,4,80.0,235,122,22.9,2015,0.0
Adrion Webber,224,20,187,64,66,58,806.0,129,38,24.0,58,26,15.7,2015,0.0
Drew Wilson,147,18,116,67,62,13,857.0,1,0,31.0,115,67,11.3,2015,0.0
Victor Robbins,248,32,196,82,104,67,682.0,56,17,39.0,140,65,22.4,2015,0.0
Dylan Livesay,6,4,9,2,0,0,68.0,7,2,2.0,2,0,9.1,2015,0.0
AJ Hedgecock,0,1,1,0,0,0,9.0,0,0,2.0,1,0,18.7,2015,0.0
Joe Young,2304,351,1718,778,519,460,4333.0,739,288,221.0,979,490,25.3,2015,1.0
Jalil Abdul-Bassit,320,29,261,110,46,34,805.0,154,66,40.0,107,44,20.4,2015,0.0
Theo Friedman,11,3,6,3,6,4,45.0,2,1,2.0,4,2,12.2,2015,0.0
Tim Jensen,0,0,3,0,0,0,23.0,0,0,1.0,3,0,8.9,2015,0.0
Anthony Piganelli,0,0,1,0,0,0,6.0,0,0,0.0,1,0,8.5,2015,0.0
Gabriel Aguirre,257,26,168,90,129,77,847.0,1,0,45.0,167,90,17.2,2015,0.0
Aaron Hendricks,9,1,10,3,0,0,22.0,9,3,1.0,1,0,26.8,2015,0.0
Thomas Peters,8,1,7,4,4,0,20.0,0,0,1.0,7,4,26.2,2015,0.0
Kaleb Warner,4,7,5,2,0,0,25.0,2,0,0.0,3,2,10.7,2015,0.0
D.J. Newbill,2105,340,1621,727,715,518,4542.0,395,133,342.0,1226,594,26.6,2015,0.0
Ross Travis,831,92,752,318,300,174,3391.0,108,21,162.0,644,297,16.4,2015,0.0
John Johnson,422,81,344,137,107,81,1309.0,187,67,78.0,157,70,18.9,2015,1.0
Alan Wisniewski,21,2,11,7,15,7,151.0,0,0,5.0,11,7,8.1,2015,0.0
Kevin Montminy,24,0,20,9,7,2,101.0,12,4,2.0,8,5,13.3,2015,0.0
Greg Louis,280,24,222,110,89,51,1051.0,27,9,70.0,195,101,17.0,2015,0.0
Camryn Crocker,121,105,109,36,59,37,902.0,42,12,85.0,67,24,13.2,2015,0.0
Matt Poplawski,25,5,26,7,12,7,106.0,20,4,7.0,6,3,20.0,2015,0.0
Matt Hanessian,2,0,2,1,0,0,18.0,0,0,5.0,2,1,21.5,2015,0.0
Marley Biyendolo,12,9,14,5,4,1,102.0,3,1,12.0,11,4,14.8,2015,0.0
Cameron Wright,834,225,754,341,217,131,2719.0,89,21,147.0,665,320,19.9,2015,0.0
Derrick Randall,251,4,185,99,102,53,1081.0,0,0,52.0,185,99,13.9,2015,0.0
Aron Phillips-Nwankwo,28,2,28,11,7,5,120.0,4,1,5.0,24,10,16.3,2015,0.0
DaShaun Wiggins,853,90,587,245,365,273,1532.0,229,90,100.0,358,155,29.6,2015,0.0
Gary Winston,1070,298,877,372,196,153,3122.0,400,173,211.0,477,199,19.8,2015,0.0
Tiegbe Bamba,313,30,202,111,112,77,822.0,39,14,46.0,163,97,18.9,2015,0.0
Tim Douglas,1048,354,892,352,297,237,3084.0,321,107,273.0,571,245,22.3,2015,0.0
Brandon Cataldo,235,13,179,101,52,33,680.0,0,0,36.0,179,101,18.6,2015,0.0
Sebastian Suarez,40,7,33,14,6,5,142.0,17,7,6.0,16,7,15.2,2015,0.0
Dorian Cason,149,9,123,48,66,42,587.0,41,11,35.0,82,37,16.4,2015,0.0
Kyler Shula,4,0,2,1,4,2,10.0,0,0,0.0,2,1,20.2,2015,0.0
Joel King,8,4,11,3,3,2,34.0,2,0,2.0,9,3,21.9,2015,0.0
Kevin Bailey,1362,156,1068,457,451,344,2750.0,289,104,256.0,779,353,28.9,2015,0.0
Thomas van der Mars,1252,98,893,497,392,258,3218.0,1,0,176.0,892,497,20.2,2015,0.0
Volodymyr Gerun,392,35,318,149,132,88,1181.0,29,6,82.0,289,143,20.4,2015,0.0
Bobby Sharp,416,58,387,135,51,38,1128.0,299,108,29.0,88,27,20.2,2015,0.0
Riley Barker,379,38,311,145,135,86,1593.0,10,3,79.0,301,142,14.8,2015,0.0
Aitor Zubizarreta,20,19,21,7,7,5,169.0,11,1,20.0,10,6,13.7,2015,0.0
Montrael Scott,1227,199,1018,428,300,218,3142.0,447,153,222.0,571,275,21.5,2015,0.0
Treshawn Hagood,672,303,596,237,286,175,2200.0,95,23,215.0,501,214,21.2,2015,0.0
John Brisco,829,113,720,292,186,140,1959.0,298,105,132.0,422,187,23.7,2015,0.0
Reggis Onwukamuche,252,10,193,94,111,64,1127.0,0,0,76.0,193,94,14.1,2015,0.0
Wesley Afolayan,38,2,45,16,17,6,166.0,3,0,15.0,42,16,19.9,2015,0.0
Stephen Walker,2,2,2,1,0,0,26.0,0,0,1.0,2,1,5.7,2015,0.0
Jordan Downing,1626,143,1414,595,273,211,3456.0,594,225,207.0,820,370,27.7,2015,0.0
William Truss,906,45,602,368,255,164,2666.0,13,6,154.0,589,362,18.1,2015,0.0
Austin Anderson,312,196,332,110,60,44,1942.0,184,48,117.0,148,62,13.6,2015,0.0
Jake Campbell,19,4,17,7,9,5,229.0,0,0,9.0,17,7,7.3,2015,0.0
Clay Wilson,398,42,321,132,58,42,1189.0,249,92,40.0,72,40,18.5,2015,0.0
Ben Hazel,353,48,284,102,110,85,1391.0,197,64,58.0,87,38,15.8,2015,0.0
Hashim Moore,15,1,9,6,5,3,28.0,0,0,4.0,9,6,30.8,2015,0.0
Daniel Edwards,19,1,16,7,8,3,62.0,4,2,9.0,12,5,25.9,2015,0.0
Bobby Garbade,30,17,27,9,13,10,164.0,8,2,15.0,19,7,16.6,2015,0.0
LaDontae Henton,2059,158,1655,724,560,424,4909.0,555,187,246.0,1100,537,22.6,2015,0.0
Carson Desrosiers,613,92,518,225,203,139,2742.0,72,24,104.0,446,201,13.6,2015,0.0
Ted Bancroft,55,17,69,19,22,9,563.0,45,8,25.0,24,11,9.4,2015,0.0
Jon Octeus,913,207,667,282,398,299,2739.0,159,50,126.0,508,232,18.4,2015,0.0
Anfernee Brown,7,2,8,3,0,0,20.0,4,1,1.0,4,2,22.8,2015,0.0
Neal Beshears,9,2,8,3,2,2,61.0,4,1,7.0,4,2,13.5,2015,0.0
Zaid Hearst,1610,224,1254,542,492,389,3764.0,402,137,193.0,852,405,21.2,2015,0.0
Ousmane Drame,1363,86,1022,497,535,368,3037.0,3,1,242.0,1019,496,23.7,2015,0.0
Evan Conti,740,228,654,251,190,130,2444.0,314,108,157.0,340,143,17.6,2015,0.0
Justin Harris,332,32,295,118,129,95,1112.0,19,1,63.0,276,117,18.2,2015,0.0
Kasim Chandler,302,136,248,84,171,128,910.0,42,6,97.0,206,78,22.0,2015,0.0
Emanuel Binyam,2,0,7,0,4,2,15.0,3,0,1.0,4,0,31.3,2015,0.0
Samir Kalil,0,0,1,0,0,0,17.0,1,0,1.0,0,0,5.7,2015,0.0
Javonte Green,1911,141,1350,701,739,485,3378.0,101,24,245.0,1249,677,29.0,2015,1.0
R.J. Price,1649,369,1477,544,367,260,3900.0,848,301,248.0,629,243,24.5,2015,0.0
Jalen Carethers,553,52,462,216,173,121,1611.0,3,0,63.0,459,216,19.0,2015,0.0
Kyle Noreen,498,183,442,189,97,50,3037.0,237,70,73.0,205,119,9.3,2015,0.0
Lucas Dyer,104,7,75,31,62,42,480.0,0,0,23.0,75,31,13.3,2015,0.0
Ty Cannaday,0,0,3,0,0,0,12.0,2,0,2.0,1,0,21.4,2015,0.0
Gilvydas Biruta,1225,139,901,455,437,296,3039.0,78,19,223.0,823,436,22.6,2015,0.0
T.J. Buchanan,591,233,433,192,288,186,2679.0,73,21,149.0,360,171,13.7,2015,0.0
Eric Youncofski,7,0,5,1,6,5,14.0,2,0,1.0,3,1,33.5,2015,0.0
Ifeanyi Onyekaba,100,2,67,33,63,34,420.0,0,0,27.0,67,33,15.0,2015,0.0
Seth Gearhart,875,142,653,267,255,203,2698.0,380,138,135.0,273,129,18.8,2015,0.0
Dan Peera,123,48,99,46,14,3,852.0,65,28,33.0,34,18,9.1,2015,0.0
Van Green,168,27,157,61,41,27,762.0,63,19,42.0,94,42,15.8,2015,0.0
J.T. Trauber,9,1,6,3,0,0,17.0,5,3,0.0,1,0,18.7,2015,0.0
Joey Burbach,3,0,5,1,1,0,15.0,3,1,0.0,2,0,20.3,2015,0.0
Denzel Davis,0,0,1,0,0,0,11.0,1,0,1.0,0,0,10.2,2015,0.0
Kendall Anthony,1909,236,1504,628,475,383,3918.0,689,270,193.0,815,358,27.3,2015,0.0
Zach Chu,14,2,6,4,2,2,15.0,6,4,2.0,0,0,33.4,2015,0.0
Matt Lopez,393,18,284,159,137,75,950.0,0,0,86.0,284,159,24.5,2015,0.0
Anthony D'Orazio,525,144,506,200,97,51,2075.0,232,74,100.0,274,126,16.4,2015,0.0
Junior Fortunat,415,18,315,164,213,87,1429.0,0,0,102.0,315,164,18.9,2015,0.0
Emerson Bursis,10,0,10,5,1,0,42.0,3,0,1.0,7,5,14.3,2015,0.0
Lucky Jones,1632,186,1219,494,562,448,3769.0,558,196,264.0,661,298,23.9,2015,0.0
David Appolon,381,91,322,130,142,101,1552.0,85,20,88.0,237,110,15.9,2015,0.0
Lionel Gomis,28,5,33,10,17,8,261.0,0,0,13.0,33,10,10.8,2015,0.0
Jafar Kinsey,62,21,82,22,25,11,418.0,46,7,26.0,36,15,14.5,2015,0.0
Ryan Skovranko,2,0,1,1,0,0,3.0,0,0,0.0,1,1,17.3,2015,0.0
Myles Mack,1658,425,1311,541,393,337,3931.0,648,239,278.0,663,302,23.1,2015,0.0
Kadeem Jack,1044,62,898,409,330,209,2581.0,51,17,181.0,847,392,24.4,2015,0.0
Malick Kone,267,49,255,105,78,47,1212.0,45,10,62.0,210,95,14.9,2015,0.0
Stephen Zurich,1,2,3,0,4,1,64.0,1,0,4.0,2,0,7.0,2015,0.0
Mikh McKinney,1468,369,1082,508,395,320,3105.0,339,132,197.0,743,376,25.9,2015,0.0
Dylan Garrity,1406,527,965,434,378,316,3991.0,532,222,261.0,433,212,19.1,2015,0.0
Zach Mills,388,39,325,146,50,39,1301.0,132,57,43.0,193,89,16.6,2015,0.0
Alex Tiffin,422,51,360,168,149,84,1834.0,15,2,138.0,345,166,16.8,2015,0.0
Evan Kelley,1194,243,1015,435,414,268,3327.0,229,56,259.0,786,379,22.1,2015,0.0
Steve Glowiak,1028,126,923,346,140,104,2868.0,672,232,100.0,251,114,18.9,2015,0.0
Phil Gaetano,661,730,558,198,150,130,3781.0,383,135,355.0,175,63,13.0,2015,0.0
Vince Fritz,5,1,7,2,0,0,32.0,6,1,2.0,1,1,13.8,2015,0.0
Earl Brown,1373,171,1000,527,478,299,3409.0,68,20,292.0,932,507,24.6,2015,0.0
Ollie Jackson,789,145,764,269,127,89,2658.0,504,162,191.0,260,107,21.0,2015,0.0
Dominique Major,550,72,500,177,85,49,1917.0,411,147,55.0,89,30,17.1,2015,0.0
Stephon Whyatt,574,181,493,203,150,100,2108.0,210,68,157.0,283,135,18.8,2015,0.0
Michael Clark,6,0,8,2,6,2,43.0,1,0,5.0,7,2,20.5,2015,0.0
Aric Gresko,3,2,6,1,0,0,32.0,4,1,3.0,2,0,15.5,2015,0.0
Dalton Cesarz,2,1,3,1,0,0,14.0,1,0,0.0,2,1,11.9,2015,0.0
Simon Pittman,2,0,0,0,4,2,6.0,0,0,2.0,0,0,36.1,2015,0.0
Chris Wilson,876,377,775,294,260,166,3815.0,388,122,219.0,387,172,15.6,2015,0.0
Evan Maschmeyer,64,26,70,20,26,19,353.0,27,5,31.0,43,15,17.0,2015,0.0
John Manning,186,25,152,71,74,43,972.0,5,1,47.0,147,70,12.9,2015,0.0
Tanner Lancona,92,17,88,34,32,16,393.0,40,8,18.0,48,26,16.5,2015,0.0
Grant Hollander,2,0,2,1,0,0,1.0,0,0,0.0,2,1,100.0,2015,0.0
Stephen Leazer,0,0,0,0,0,0,1.0,0,0,0.0,0,0,0.0,2015,0.0
Brad Waldow,1743,141,1162,683,632,377,3486.0,1,0,187.0,1161,683,25.3,2015,0.0
Kerry Carter,702,76,541,222,165,116,1970.0,359,142,101.0,182,80,19.8,2015,0.0
Aaron Bright,1241,428,1027,386,326,271,3626.0,556,198,247.0,471,188,20.4,2015,0.0
Garrett Jackson,686,80,581,267,153,103,2037.0,146,49,110.0,435,218,20.9,2015,0.0
Desmond Simmons,582,116,499,197,208,145,2757.0,136,43,116.0,363,154,13.2,2015,0.0
Treaven Duffy,29,5,20,8,20,12,95.0,4,1,13.0,16,7,24.3,2015,0.0
Joe Coleman,519,94,408,190,181,128,1623.0,38,11,121.0,370,179,19.8,2015,0.0
Marvin Dominique,1160,48,925,417,339,255,2882.0,203,71,158.0,722,346,23.3,2015,0.0
Desmond Washington,1596,126,1323,514,384,325,3883.0,695,243,192.0,628,271,24.1,2015,0.0
Tyler Gaskins,407,77,388,153,76,43,1324.0,171,58,88.0,217,95,21.5,2015,0.0
Jamel Fields,502,158,379,141,288,176,2059.0,148,44,140.0,231,97,17.0,2015,0.0
Travis Hester,71,11,54,21,8,8,165.0,51,21,13.0,3,0,24.1,2015,0.0
Kris Rolle,48,6,33,17,33,14,321.0,0,0,10.0,33,17,10.0,2015,0.0
Mohamed Farih,12,0,6,4,6,4,18.0,0,0,6.0,6,4,44.7,2015,0.0
Simeon Dennis,3,0,4,1,0,0,19.0,4,1,1.0,0,0,14.8,2015,0.0
DeMarcus Gatlin,903,196,684,287,432,278,2322.0,179,51,173.0,505,236,23.6,2015,0.0
Kaheem Ransom,754,267,592,216,264,203,2082.0,341,119,145.0,251,97,20.8,2015,0.0
Jabari Peters,830,242,603,238,372,250,2345.0,301,104,154.0,302,134,20.0,2015,0.0
Michael Holyfield,732,31,489,286,289,160,2165.0,1,0,181.0,488,286,19.0,2015,0.0
Marquel McKinney,353,82,319,109,117,71,1817.0,206,64,74.0,113,45,12.6,2015,0.0
Marcus Burwell,137,45,138,48,38,24,512.0,68,17,27.0,70,31,16.4,2015,0.0
Sean Goodwin,32,9,15,10,18,12,87.0,0,0,3.0,15,10,15.1,2015,0.0
Kyle McLeroy,17,11,12,4,7,6,64.0,10,3,7.0,2,1,17.4,2015,0.0
Tyler Hood,1161,128,898,409,241,175,2988.0,473,168,131.0,425,241,20.6,2015,0.0
Michael Bradley,311,19,218,121,92,69,963.0,1,0,64.0,217,121,17.5,2015,1.0
Brandon Roberts,313,49,294,115,58,42,760.0,140,41,58.0,154,74,25.9,2015,0.0
Brandon Hayman,244,28,206,113,50,16,846.0,15,2,41.0,191,111,17.4,2015,0.0
Emeka Ikezu,17,1,12,7,10,3,115.0,0,0,9.0,12,7,11.6,2015,0.0
J.J. O'Brien,1028,204,882,415,298,179,3686.0,77,19,189.0,805,396,17.3,2015,0.0
Aqeel Quinn,772,172,683,250,203,154,2274.0,342,118,145.0,341,132,21.0,2015,0.0
Dwayne Polee II,654,52,541,234,173,119,1737.0,200,67,87.0,341,167,21.5,2015,0.0
Kibret Woldemichael,17,4,7,5,4,2,32.0,7,5,5.0,0,0,23.2,2015,0.0
Ryan Staten,11,3,18,5,5,1,43.0,2,0,1.0,16,5,26.1,2015,0.0
Johnny Dee,2046,157,1542,666,419,381,4081.0,835,333,169.0,707,333,25.2,2015,0.0
Christopher Anderson,1181,757,935,390,462,300,4108.0,271,101,365.0,664,289,19.9,2015,0.0
Thomas Jacobs,378,35,289,142,128,90,1493.0,18,4,64.0,271,138,14.7,2015,0.0
Simi Fajemisin,319,19,221,109,167,101,1497.0,1,0,104.0,220,109,14.5,2015,0.0
Forrest Greenwalt,4,0,2,2,0,0,10.0,0,0,1.0,2,2,16.3,2015,0.0
Kruize Pinkins,849,78,595,298,350,220,1662.0,94,33,107.0,501,265,27.3,2015,0.0
Matt Glover,537,249,473,168,298,161,2529.0,150,40,175.0,323,128,16.3,2015,0.0
Chris Adams,419,89,391,143,16,11,1853.0,325,122,54.0,66,21,12.8,2015,0.0
Matt Christiansen,201,36,172,87,50,27,998.0,1,0,51.0,171,87,13.1,2015,0.0
Corey Hilliard,109,26,112,37,37,23,457.0,40,12,33.0,72,25,18.9,2015,0.0
Derrell Robertson,118,10,98,48,35,22,867.0,1,0,48.0,97,48,9.3,2015,0.0
Gavin Hoffmann,60,21,47,18,23,14,407.0,27,10,13.0,20,8,9.0,2015,0.0
David Irby,3,0,1,1,0,0,9.0,1,1,0.0,0,0,5.9,2015,0.0
Dominique Williams,5,1,4,2,0,0,13.0,2,1,1.0,2,1,20.2,2015,0.0
Rashad Muhammad,783,55,644,240,210,169,1744.0,354,134,90.0,290,106,25.7,2015,0.0
Jaleel Williams,699,59,626,252,142,88,1971.0,337,107,97.0,289,145,21.4,2015,0.0
Darryl Gaynor,260,58,280,88,67,52,705.0,113,32,82.0,167,56,30.4,2015,0.0
Andrew Vollert,9,0,7,4,0,0,56.0,1,1,2.0,6,3,8.8,2015,0.0
Matt Pollard,38,4,42,18,11,2,323.0,0,0,15.0,42,18,10.3,2015,0.0
Tyler Winston,4,1,3,1,2,1,21.0,2,1,0.0,1,0,10.3,2015,0.0
Brandon Clark,1549,410,1225,493,474,398,3437.0,486,165,240.0,739,328,26.3,2015,0.0
Denzel Johnson,609,111,608,229,127,93,2055.0,187,58,78.0,421,171,19.5,2015,0.0
Jalen Richard,172,58,160,57,62,40,802.0,69,18,46.0,91,39,15.8,2015,0.0
Stephen Edwards,27,5,26,9,14,8,130.0,8,1,18.0,18,8,22.1,2015,0.0
Dominic Romeo,6,0,2,1,8,4,18.0,0,0,0.0,2,1,18.3,2015,0.0
Yannick Atanga,295,18,230,112,140,71,1748.0,1,0,63.0,229,112,10.6,2015,0.0
Andrew Papenfus,10,2,12,3,2,2,98.0,8,2,5.0,4,1,9.9,2015,0.0
Terel Hall,460,179,352,159,217,135,1559.0,34,7,138.0,318,152,19.8,2015,0.0
Alante Fenner,914,141,775,313,290,210,2058.0,263,78,179.0,512,235,25.1,2015,0.0
Saadiq Muhammad,305,15,247,118,136,69,1155.0,2,0,73.0,245,118,17.4,2015,0.0
Demarcus Bryant,148,11,161,52,8,7,472.0,123,37,34.0,38,15,21.6,2015,0.0
Jamal Norman,131,26,135,49,53,25,557.0,31,8,45.0,104,41,19.2,2015,0.0
Hikeem Champaigne,104,7,96,47,24,10,384.0,0,0,34.0,96,47,19.3,2015,0.0
Keierre Richards,366,99,342,110,175,127,2029.0,73,19,157.0,269,91,15.0,2015,0.0
Whitley Carter,38,14,37,12,8,7,206.0,20,7,13.0,17,5,13.6,2015,0.0
Tyler Hagan,2,0,1,1,0,0,3.0,0,0,0.0,1,1,17.5,2015,0.0
Karandeep Malhi,0,0,1,0,0,0,1.0,1,0,0.0,0,0,52.4,2015,0.0
Isiah Umipig,1797,311,1411,582,345,285,3789.0,887,348,272.0,524,234,24.9,2015,0.0
Jarell Flora,999,104,864,363,134,99,2650.0,463,174,155.0,401,189,21.1,2015,0.0
Shore Adenekan,266,17,182,102,112,62,965.0,0,0,53.0,182,102,15.4,2015,0.0
Emerson Murray,266,155,250,86,98,55,1597.0,141,39,109.0,109,47,13.2,2015,0.0
Deshaun Sunderhaus,527,43,411,213,139,94,1204.0,23,7,95.0,388,206,23.1,2015,0.0
Theo Turner,22,3,23,9,14,4,150.0,1,0,15.0,22,9,16.7,2015,0.0
Lewis Cramer,39,4,34,15,15,9,185.0,0,0,6.0,34,15,13.2,2015,0.0
Brandon Mobley,890,77,715,313,217,171,2529.0,274,93,122.0,441,220,19.5,2015,0.0
Haralds Karlis,336,85,293,108,83,56,1806.0,208,64,78.0,85,44,11.9,2015,0.0
Stephane Manga,132,18,112,51,52,27,492.0,12,3,45.0,100,48,19.4,2015,0.0
Chier Ajou,11,3,11,3,5,4,70.0,1,1,4.0,10,2,13.6,2015,0.0
Rob Poole,1493,218,1208,469,441,340,4051.0,610,215,207.0,598,254,20.4,2015,0.0
Evan Hymes,1338,361,1138,422,403,314,3554.0,527,180,341.0,611,242,24.2,2015,0.0
Maurice White,223,26,244,73,113,76,704.0,17,1,59.0,227,72,25.2,2015,0.0
Mike Wilson,6,0,6,3,0,0,27.0,2,0,1.0,4,3,13.0,2015,1.0
Ryan Kelley,0,0,0,0,0,0,5.0,0,0,0.0,0,0,0.0,2015,0.0
Dionte Ferguson,525,27,337,178,250,169,1453.0,2,0,113.0,335,178,19.9,2015,0.0
Luka Andjusic,29,6,33,9,3,3,140.0,28,8,5.0,5,1,14.2,2015,0.0
Austin Karazsia,54,3,49,19,17,9,282.0,24,7,11.0,25,12,12.2,2015,0.0
Jermaine Williams,3,0,3,1,1,1,14.0,2,0,0.0,1,1,12.5,2015,0.0
Karon Wright,387,30,404,128,52,37,918.0,297,94,62.0,107,34,27.4,2015,0.0
Jalen White,353,114,316,120,139,97,1033.0,50,16,97.0,266,104,23.6,2015,0.0
Patrick Kirksey,176,19,152,62,146,52,875.0,1,0,47.0,151,62,15.7,2015,0.0
Devin Joint,366,94,382,150,94,45,1852.0,88,21,97.0,294,129,14.0,2015,0.0
Radin Hughes,14,7,17,5,9,4,83.0,1,0,11.0,16,5,20.2,2015,0.0
Patrick Myers,144,40,171,51,40,27,759.0,62,15,51.0,109,36,16.0,2015,0.0
Ty Greene,1884,329,1447,590,548,419,4213.0,755,285,190.0,692,305,22.5,2015,0.0
Fred Miller,889,346,836,322,207,153,2789.0,297,92,224.0,539,230,20.9,2015,0.0
ShunQuez Stephens,336,60,296,123,89,61,1203.0,115,29,62.0,181,94,17.0,2015,0.0
Mario Blessing,556,293,534,194,85,55,3213.0,339,113,187.0,195,81,11.8,2015,0.0
Daniel Bridges,28,6,33,11,2,1,80.0,19,5,7.0,14,6,26.2,2015,0.0
Karim Mawuenyega,140,44,134,51,23,12,462.0,77,26,27.0,57,25,18.9,2015,0.0
Tyrone Johnson,601,234,507,182,241,195,1978.0,141,42,151.0,366,140,19.7,2015,0.0
Brian Steele,99,27,110,34,12,8,476.0,79,23,18.0,31,11,14.2,2015,0.0
Shamiek Sheppard,11,1,18,5,2,0,48.0,1,1,2.0,17,4,22.5,2015,0.0
Cody Larson,921,129,667,337,342,243,2073.0,16,4,148.0,651,333,24.7,2015,0.0
Zach Horstman,347,51,284,121,98,67,1198.0,121,38,41.0,163,83,16.3,2015,0.0
Tyler Larson,624,130,472,205,229,169,1633.0,121,45,104.0,351,160,21.8,2015,0.0
Brandon Bos,1200,223,959,376,355,303,2895.0,382,145,184.0,577,231,23.8,2015,0.0
James Hunter,201,9,169,83,52,35,480.0,0,0,30.0,169,83,24.3,2015,0.0
Sekou Harris,203,86,203,71,59,40,691.0,60,21,87.0,143,50,23.7,2015,0.0
Adam Thoseby,332,36,311,111,92,69,920.0,141,41,56.0,170,70,23.7,2015,0.0
Corey Allen Jr.,721,159,587,249,204,161,1923.0,185,62,138.0,402,187,22.6,2015,0.0
Jarekious Bradley,1029,87,781,364,219,180,1771.0,342,121,107.0,439,243,27.6,2015,0.0
Nino Johnson,988,117,661,369,434,248,2755.0,9,2,207.0,652,367,19.6,2015,0.0
Aaron Adeoye,376,46,329,145,127,80,1610.0,25,6,113.0,304,139,16.1,2015,0.0
Josh Langford,481,40,399,189,129,78,1396.0,74,25,108.0,325,164,20.5,2015,0.0
Caleb Woods,32,4,26,11,10,6,64.0,10,4,1.0,16,7,24.5,2015,0.0
Darrian Gray,228,40,203,87,36,22,701.0,104,32,32.0,99,55,17.3,2015,0.0
Devonte Upson,594,45,402,241,195,112,1846.0,1,0,97.0,401,241,16.7,2015,0.0
Cedric Jenkins,586,96,538,213,113,79,1576.0,275,81,102.0,263,132,22.5,2015,0.0
Onochie Ochie,743,36,532,273,249,162,1795.0,95,35,123.0,437,238,22.5,2015,0.0
Andrew Guillory,145,37,101,46,67,48,486.0,21,5,26.0,80,41,16.7,2015,0.0
Jimmie Duplessis,154,75,150,54,64,34,652.0,43,12,74.0,107,42,19.3,2015,0.0
Dylon Maggio,52,7,45,19,5,2,249.0,23,12,24.0,22,7,14.7,2015,0.0
Bret Barclay,28,3,27,11,6,5,148.0,3,1,8.0,24,10,13.1,2015,0.0
Zach Rumph,0,3,3,0,0,0,46.0,1,0,6.0,2,0,10.0,2015,0.0
Chass Bryan,101,79,105,34,49,26,666.0,25,7,48.0,80,27,13.4,2015,0.0
Devon Pflueger,9,0,8,3,2,1,22.0,3,2,0.0,5,1,20.2,2015,0.0
Kris Davis,1305,278,1015,450,338,223,3493.0,418,182,263.0,597,268,21.3,2015,0.0
Keaton Jackson,510,26,313,202,161,104,1132.0,3,2,82.0,310,200,21.3,2015,0.0
Rozell Nunn,487,72,395,173,128,94,1348.0,122,47,102.0,273,126,21.2,2015,0.0
Michael Messer,887,149,688,307,258,184,2641.0,235,89,155.0,453,218,18.9,2015,0.0
Maurice Wiltz,462,79,347,138,143,105,1291.0,199,81,77.0,148,57,19.6,2015,0.0
Jalen Pendleton,643,121,510,227,283,173,1771.0,63,16,113.0,447,211,23.3,2015,0.0
K.C. Goodwin,58,21,63,16,21,14,418.0,37,12,33.0,26,4,14.1,2015,0.0
Dawson Verhines,62,24,51,17,29,20,566.0,26,8,22.0,25,9,8.4,2015,0.0
Yanick Moreira,515,42,365,197,187,121,1138.0,0,0,84.0,365,197,25.2,2015,0.0
Ryan Manuel,878,210,541,258,502,348,3083.0,43,14,177.0,498,244,16.8,2015,0.0
Cannen Cunningham,802,106,603,314,234,166,2425.0,41,8,187.0,562,306,20.1,2015,0.0
Justin Martin,769,82,589,262,215,153,2196.0,273,92,140.0,316,170,20.0,2015,0.0
Jean-Micheal Mudiay,3,0,10,0,9,3,28.0,5,0,3.0,5,0,32.8,2015,0.0
Kevin Dunleavy Jr.,4,0,9,2,3,0,38.0,6,0,5.0,3,2,21.6,2015,0.0
Chip Armelin,957,124,815,372,181,104,2356.0,333,109,128.0,482,263,23.5,2015,0.0
Matt Bingaya,596,78,465,215,214,140,1420.0,99,26,108.0,366,189,25.8,2015,0.0
Rasham Suarez,134,65,115,45,23,14,550.0,77,30,45.0,38,15,17.4,2015,0.0
Jeremiah Eason,253,37,214,92,140,69,1155.0,3,0,67.0,211,92,15.8,2015,0.0
Jamie Chapman,45,22,39,14,24,11,318.0,17,6,20.0,22,8,12.0,2015,0.0
Cal Hanks,354,21,278,121,178,112,1098.0,1,0,92.0,277,121,21.6,2015,0.0
Austin Waddoups,29,11,27,10,5,2,132.0,16,7,6.0,11,3,14.2,2015,0.0
Kyler Neilson,9,2,5,3,2,2,17.0,3,1,0.0,2,2,18.5,2015,0.0
Eric Rippetoe,66,5,54,23,13,8,184.0,30,12,12.0,24,11,21.3,2015,0.0
Tre Lynch,748,85,615,253,194,145,1534.0,293,97,93.0,322,156,26.3,2015,0.0
Joell Hopkins,227,9,160,84,107,59,625.0,5,0,37.0,155,84,19.1,2015,0.0
Keith Davis,288,23,237,115,109,58,1472.0,0,0,101.0,237,115,13.9,2015,0.0
Frank Snow,218,11,159,79,106,60,745.0,0,0,49.0,159,79,17.8,2015,0.0
Cameron Monroe,336,100,331,123,131,81,1678.0,42,9,141.0,289,114,16.8,2015,0.0
Elex Carter,9,0,10,4,2,1,55.0,0,0,8.0,10,4,17.8,2015,0.0
Mike Harrell,67,72,93,24,28,17,646.0,17,2,47.0,76,22,12.1,2015,0.0
Youssou Ndoye,971,58,660,335,447,301,2765.0,1,0,233.0,659,335,20.4,2015,0.0
Andell Cumberbatch,566,106,496,205,144,96,1705.0,175,60,102.0,321,145,19.8,2015,0.0
Iakeem Alston,69,42,67,24,39,20,307.0,7,1,30.0,60,23,19.5,2015,0.0
Chris Dees,87,9,98,41,13,5,566.0,1,0,17.0,97,41,10.8,2015,0.0
Xavier Smith,10,1,14,4,7,2,94.0,2,0,2.0,12,4,10.4,2015,0.0
Opeyemi Olomo,0,0,2,0,0,0,1.0,2,0,1.0,0,0,100.0,2015,0.0
Jalen Cannon,1720,115,1198,629,613,416,3789.0,153,46,162.0,1045,583,21.8,2015,0.0
Brent Jones,1142,616,985,380,399,286,3306.0,309,96,370.0,676,284,23.3,2015,0.0
Kevin Douglas,462,41,404,169,109,71,1488.0,173,53,97.0,231,116,18.5,2015,0.0
Lowell Ulmer,264,50,239,97,109,56,1137.0,58,14,65.0,181,83,15.7,2015,0.0
Edon Molic,5,0,8,2,0,0,9.0,7,1,1.0,1,1,50.1,2015,0.0
D'Angelo Harrison,2178,253,1686,660,732,594,4311.0,743,264,231.0,943,396,26.7,2015,0.0
Sir'Dominic Pointer,1078,299,852,406,360,245,3660.0,109,21,218.0,743,385,17.3,2015,0.0
Rysheed Jordan,718,183,569,243,261,172,1713.0,179,60,158.0,390,183,25.5,2015,0.0
Phil Greene,1243,281,1262,491,175,123,4041.0,424,138,154.0,838,353,18.9,2015,0.0
Chris Obekpa,425,78,361,175,164,75,2318.0,1,0,112.0,360,175,12.1,2015,0.0
Jamal Branch,436,198,392,170,107,74,1722.0,75,22,119.0,317,148,16.8,2015,0.0
Myles Stewart,28,2,33,10,0,0,96.0,27,8,3.0,6,2,19.3,2015,0.0
Joey De La Rosa,58,4,61,24,28,10,350.0,0,0,22.0,61,24,14.2,2015,0.0
David Lipscomb,0,3,5,0,0,0,44.0,3,0,2.0,2,0,8.1,2015,0.0
Khadim Ndiaye,2,0,5,1,0,0,37.0,0,0,1.0,5,1,8.3,2015,0.0
Chasson Randle,2375,354,1775,760,684,551,4791.0,787,304,324.0,988,456,25.9,2015,1.0
Stefan Nastic,875,107,645,307,365,259,2182.0,8,2,162.0,637,305,23.3,2015,0.0
Elliott Bullock,17,11,30,6,9,4,324.0,5,1,14.0,25,5,7.6,2015,0.0
Wade Morgan,4,7,15,1,8,2,58.0,4,0,7.0,11,1,22.7,2015,0.0
Jacob Parker,1251,201,898,439,335,267,3090.0,261,106,160.0,637,333,20.3,2015,0.0
Tanner Clayton,231,36,189,96,47,32,1002.0,17,7,32.0,172,89,12.3,2015,0.0
Connor Brooks,157,55,133,57,39,27,631.0,50,16,43.0,83,41,15.6,2015,0.0
Bobby King,222,23,169,94,68,34,847.0,0,0,59.0,169,94,14.5,2015,0.0
Justin Dotson,72,12,75,23,31,19,201.0,36,7,21.0,39,16,27.8,2015,0.0
Jaxon Holden,19,1,14,4,7,7,67.0,9,4,4.0,5,0,15.9,2015,0.0
Jason Martin,11,2,11,4,2,2,50.0,7,1,3.0,4,3,15.1,2015,0.0
Caleb Johnston,5,1,3,2,2,1,31.0,1,0,2.0,2,2,9.6,2015,0.0
Kentwan Smith,780,92,587,298,215,138,1900.0,157,46,152.0,430,252,23.4,2015,0.0
Kyle Sikora,215,7,154,88,84,39,1217.0,0,0,72.0,154,88,11.4,2015,0.0
Wyatt Sikora,89,5,72,33,32,21,365.0,14,2,15.0,58,31,14.6,2015,0.0
Jonathan Joseph,57,5,42,20,23,13,218.0,14,4,21.0,28,16,17.7,2015,0.0
Corey Mendez,11,6,18,3,2,2,82.0,15,3,8.0,3,0,17.1,2015,0.0
Chris Braley,62,14,64,23,11,6,355.0,38,10,20.0,26,13,12.9,2015,0.0
Ryan Burnett,45,10,47,17,8,5,174.0,25,6,8.0,22,11,17.4,2015,0.0
Rakeem Christmas,1046,86,731,409,335,228,3126.0,1,0,162.0,730,409,17.4,2015,1.0
Chris McCullough,149,18,113,54,71,40,450.0,1,1,35.0,112,53,20.7,2015,1.0
Carter Sanderson,352,65,315,112,121,72,1010.0,174,56,85.0,141,56,21.9,2015,0.0
Christian White,115,33,94,37,30,17,389.0,66,24,25.0,28,13,16.7,2015,0.0
Will Cummings,1245,357,942,392,499,386,3144.0,270,75,193.0,672,317,22.2,2015,0.0
Jesse Morgan,930,153,878,322,154,116,2304.0,485,170,128.0,393,152,22.8,2015,0.0
Jimmy McDonnell,49,15,45,15,18,12,363.0,18,7,22.0,27,8,10.4,2015,0.0
Chima Nwakpuda,3,0,1,1,2,1,8.0,0,0,1.0,1,1,19.1,2015,0.0
Nick Pendergast,13,1,14,6,2,0,52.0,6,1,3.0,8,5,17.6,2015,0.0
Deville Smith,887,289,761,317,210,139,2368.0,357,114,202.0,404,203,23.8,2015,0.0
Marshun Newell,770,198,646,254,233,167,2033.0,264,95,153.0,382,159,23.2,2015,0.0
Arkeem Joseph,146,6,132,69,27,8,466.0,0,0,31.0,132,69,20.7,2015,0.0
Khristian Taylor,105,66,96,38,59,24,663.0,20,5,57.0,76,33,13.5,2015,0.0
Harrison Hawks,2,3,5,1,0,0,14.0,2,0,1.0,3,1,23.5,2015,0.0
Jay Harris,721,161,636,238,214,145,2300.0,292,100,186.0,344,138,21.0,2015,0.0
Charles Tucker,159,71,107,43,74,59,668.0,42,14,54.0,65,29,15.8,2015,0.0
Zachary Lee,114,13,105,44,44,26,593.0,2,0,33.0,103,44,14.4,2015,0.0
Christian Crockett,36,3,38,11,38,14,165.0,3,0,8.0,35,11,20.9,2015,0.0
Dwan Caldwell,703,33,541,275,217,146,1611.0,19,7,115.0,522,268,23.2,2015,0.0
Javon McKay,513,111,378,171,199,146,2077.0,96,25,118.0,282,146,14.2,2015,0.0
DeOndre Haynes,117,42,110,39,53,37,445.0,15,2,41.0,95,37,19.5,2015,0.0
Josh Bougher,8,1,9,3,1,1,22.0,4,1,0.0,5,2,21.2,2015,0.0
Josh Richardson,1252,246,1005,458,314,238,3842.0,308,98,209.0,697,360,19.0,2015,1.0
Dominic Woodson,63,9,64,28,19,7,184.0,0,0,14.0,64,28,23.4,2015,0.0
Ian Chiles,773,108,645,272,219,161,1911.0,196,68,115.0,449,204,23.7,2015,0.0
Galen Campbell,7,0,6,3,1,1,21.0,2,0,0.0,4,3,16.2,2015,0.0
Johnathan Jordan,1576,652,1145,492,827,559,4341.0,138,33,335.0,1007,459,23.1,2015,0.0
Joel Engulu,1,0,1,0,2,1,3.0,0,0,1.0,1,0,53.1,2015,0.0
Paul Perez,0,0,1,0,0,0,3.0,1,0,0.0,0,0,18.0,2015,0.0
Kourtney Roberson,1077,96,718,435,359,207,3011.0,0,0,153.0,718,435,18.7,2015,0.0
Jordan Green,630,184,507,224,195,135,2553.0,165,47,140.0,342,177,15.7,2015,0.0
Peyton Allen,144,15,129,49,20,16,452.0,93,30,18.0,36,19,18.4,2015,0.0
Ramon White,0,0,0,0,0,0,1.0,0,0,0.0,0,0,0.0,2015,0.0
Lonnie McClanahan,808,205,596,267,368,273,1618.0,10,1,192.0,586,266,29.1,2015,0.0
Jamel Outler,890,66,746,274,235,161,2250.0,520,181,126.0,226,93,21.6,2015,0.0
Greg Gainey,456,21,366,177,101,73,1025.0,84,29,59.0,282,148,22.9,2015,0.0
Anthony Walker,226,10,144,97,54,32,784.0,0,0,37.0,144,97,12.9,2015,0.0
Brandon Williams,186,8,133,77,60,32,761.0,3,0,31.0,130,77,12.4,2015,1.0
Colten Gober,3,0,2,1,0,0,11.0,2,1,1.0,0,0,13.3,2015,0.0
Kyan Anderson,1624,480,1232,520,479,394,4126.0,529,190,328.0,703,330,22.8,2015,0.0
Trey Zeigler,1481,251,1312,572,548,300,3463.0,130,37,282.0,1182,535,28.0,2015,0.0
Amric Fields,1019,89,810,385,283,170,2496.0,241,79,134.0,569,306,22.3,2015,0.0
Charles Hill Jr.,218,43,239,78,57,35,798.0,94,27,50.0,145,51,21.4,2015,0.0
Christian Gore,174,43,135,46,85,59,760.0,65,23,41.0,70,23,15.2,2015,0.0
Vince Hunter,911,98,611,330,409,247,1816.0,12,4,159.0,599,326,28.3,2015,0.0
Cedrick Lang,938,118,573,333,453,272,3037.0,1,0,164.0,572,333,17.2,2015,0.0
Julian Washburn,1526,274,1360,592,319,223,4448.0,349,119,213.0,1011,473,21.3,2015,1.0
C.J. Cooper,844,275,692,254,221,178,3008.0,460,158,157.0,232,96,17.2,2015,0.0
Janari Joesaar,551,76,360,166,190,155,1105.0,172,64,89.0,188,102,25.8,2015,0.0
Shaquille Boga,812,211,750,291,199,144,2067.0,267,86,124.0,483,205,24.5,2015,0.0
Elijah Watson,72,89,61,24,51,24,581.0,9,0,48.0,52,24,12.2,2015,0.0
Andreas Bigum,33,17,40,12,22,9,329.0,1,0,24.0,39,12,12.0,2015,0.0
Shaun Noriega,423,34,344,125,90,72,1175.0,274,101,49.0,70,24,20.3,2015,0.0
Mike Lopez,0,1,3,0,0,0,5.0,2,0,0.0,1,0,31.8,2015,0.0
Jeromie Hill,1674,160,1420,637,379,235,3823.0,447,165,306.0,973,472,25.4,2015,0.0
Keon Lewis,801,159,578,220,361,300,1736.0,183,61,133.0,395,159,25.0,2015,0.0
Kaj-Bjorn Sherman,470,37,279,151,220,168,1340.0,0,0,89.0,279,151,17.6,2015,0.0
Larry Lewis,108,31,85,35,56,34,350.0,16,4,32.0,69,31,20.7,2015,0.0
Edwin Olympio,4,1,2,1,4,2,22.0,0,0,2.0,2,1,13.4,2015,0.0
Tyler Flores,3,0,3,1,0,0,9.0,3,1,0.0,0,0,16.7,2015,0.0
Madarious Gibbs,1186,469,904,404,474,311,3932.0,213,67,313.0,691,337,19.1,2015,0.0
Deverell Biggs,455,73,357,162,134,97,1061.0,89,34,103.0,268,128,26.3,2015,0.0
Tonnie Collier,242,9,175,73,76,59,521.0,109,37,33.0,66,36,24.8,2015,0.0
Nick Shepherd,162,12,123,57,81,48,1052.0,0,0,35.0,123,57,9.7,2015,0.0
Nevin Johnson,139,27,113,42,54,39,541.0,59,16,31.0,54,26,16.8,2015,0.0
Giovanni Mack,42,14,34,13,14,9,223.0,17,7,8.0,17,6,11.5,2015,0.0
Wesley Davis,877,182,789,322,238,147,3016.0,295,86,148.0,494,236,17.8,2015,0.0
D.J. Brown,898,347,748,256,311,231,3213.0,468,155,183.0,280,101,17.4,2015,0.0
Victor Bermudez,67,26,100,24,12,4,347.0,72,15,17.0,28,9,19.2,2015,0.0
Ed Seay,13,2,13,6,2,1,45.0,2,0,4.0,11,6,21.7,2015,0.0
Brian Herring,2,1,6,1,1,0,14.0,4,0,0.0,2,1,25.1,2015,0.0
Robert Turner,561,143,516,198,169,112,1686.0,183,53,106.0,333,145,22.2,2015,0.0
Justin Jamison,24,2,19,8,9,6,64.0,4,2,4.0,15,6,22.9,2015,0.0
Stan Mays,28,2,17,8,8,6,49.0,15,6,6.0,2,2,29.3,2015,0.0
Clark Lammert,108,26,76,31,55,35,529.0,28,11,20.0,48,20,12.3,2015,0.0
Luke Adams,133,43,109,32,53,42,600.0,80,27,48.0,29,5,16.3,2015,0.0
Myles Turner,345,20,257,117,112,94,755.0,62,17,47.0,195,100,25.1,2015,1.0
Brandon Allums,3,0,5,1,2,1,15.0,0,0,1.0,5,1,23.9,2015,0.0
Tarale Murry,3,0,12,1,6,1,16.0,8,0,1.0,4,1,50.5,2015,0.0
Julius Brown,1838,694,1512,635,459,369,4328.0,578,199,369.0,934,436,24.9,2015,0.0
Justin Drummond,1460,181,1087,489,516,386,2977.0,276,96,217.0,811,393,26.4,2015,0.0
J.D. Weatherspoon,880,76,569,316,379,228,2241.0,68,20,111.0,501,296,19.4,2015,0.0
Kurt Hall,86,4,53,25,42,35,208.0,2,1,14.0,51,24,21.4,2015,0.0
Angel Aparicio,1,2,4,0,2,1,15.0,1,0,1.0,3,0,20.3,2015,0.0
Alex Gavrilovic,360,21,287,139,88,58,1187.0,75,24,63.0,212,115,17.2,2015,0.0
Jamel Flash,38,2,42,13,26,12,399.0,0,0,15.0,42,13,9.0,2015,0.0
Musa Abdul-Aleem,551,31,463,185,113,88,1136.0,274,93,64.0,189,92,26.6,2015,0.0
Kevin Thomas,573,64,421,233,170,107,1773.0,2,0,166.0,419,233,19.5,2015,0.0
Chris Bilbo,244,85,221,83,89,57,1006.0,80,21,62.0,141,62,16.7,2015,0.0
Oskar Reinfelds,146,48,132,50,51,27,541.0,57,19,47.0,75,31,19.5,2015,0.0
Jordan Anderson,3,0,1,1,0,0,3.0,1,1,1.0,0,0,34.4,2015,0.0
Colin Edwards,0,0,0,0,0,0,1.0,0,0,0.0,0,0,0.0,2015,0.0
Jay Hook,955,62,724,290,229,187,2477.0,480,188,121.0,244,102,20.7,2015,0.0
Tre Drye,650,73,480,234,300,173,3072.0,36,9,153.0,444,225,13.4,2015,0.0
Aaron Liberman,12,2,8,6,2,0,54.0,0,0,2.0,8,6,10.9,2015,0.0
Stanley Roberts,2,0,1,1,0,0,6.0,0,0,0.0,1,1,8.9,2015,1.0
Micah Littlejohn,2,0,2,1,0,0,6.0,1,0,0.0,1,1,17.8,2015,0.0
Norman Powell,1376,214,1090,503,347,259,3555.0,354,111,180.0,736,392,20.3,2015,1.0
Kevon Looney,416,51,321,151,147,92,1113.0,53,22,45.0,268,129,19.7,2015,1.0
Wanaah Bail,38,5,36,15,17,8,159.0,1,0,5.0,35,15,15.5,2015,0.0
Kory Alford,9,2,10,2,6,4,74.0,6,1,3.0,4,1,11.1,2015,0.0
Nick Kazemi,0,1,5,0,0,0,34.0,0,0,2.0,5,0,10.3,2015,0.0
Sean Harris,67,17,59,29,17,9,420.0,0,0,20.0,59,29,11.8,2015,0.0
Viko Noma'aea,30,6,35,10,5,4,147.0,24,6,4.0,11,4,15.7,2015,0.0
Sam Orchard,4,7,9,2,3,0,53.0,3,0,4.0,6,2,15.6,2015,0.0
Bilal Begic,0,0,0,0,0,0,0.0,0,0,0.0,0,0,0,2015,0.0
Mitch Bruneel,812,87,594,302,208,143,2528.0,192,65,98.0,402,237,17.2,2015,0.0
Donte Williams,318,47,253,91,116,94,809.0,141,42,50.0,112,49,24.5,2015,0.0
Brenden Evans,218,30,177,77,96,62,855.0,10,2,52.0,167,75,17.7,2015,0.0
Chad Ross,96,13,98,37,25,15,486.0,23,7,33.0,75,30,16.2,2015,0.0
Boston Gubler,29,11,37,11,13,7,252.0,0,0,19.0,37,11,13.7,2015,0.0
Eli Robison,36,4,40,12,11,8,147.0,18,4,10.0,22,8,20.7,2015,0.0
Leland Miller,0,0,0,0,0,0,5.0,0,0,0.0,0,0,0.0,2015,0.0
Delon Wright,1022,352,634,339,376,306,2367.0,127,38,152.0,507,301,22.1,2015,1.0
Dallin Bachynski,550,50,358,193,229,158,1559.0,15,6,89.0,343,187,19.2,2015,0.0
Jeremy Olsen,282,15,228,123,60,36,803.0,0,0,59.0,228,123,21.2,2015,0.0
David Chadwick,143,14,122,61,22,10,536.0,38,11,24.0,84,50,15.2,2015,0.0
James Siakam,593,65,332,196,283,199,1829.0,8,2,101.0,324,194,16.9,2015,0.0
Shelby Moats,158,38,154,59,45,20,957.0,76,20,52.0,78,39,13.1,2015,0.0
Hector Harold,518,66,488,184,137,84,1669.0,215,66,122.0,273,118,22.0,2015,0.0
Brandon Hatton,121,13,111,41,22,15,447.0,76,24,11.0,35,17,16.4,2015,0.0
Ryan Pierson,401,38,362,154,117,91,1370.0,14,2,71.0,348,152,19.5,2015,0.0
Brendan Kilpatrick,165,23,140,58,58,36,596.0,48,13,40.0,92,45,19.2,2015,0.0
Darrun Hilliard,1511,248,1125,491,428,320,3537.0,569,209,206.0,556,282,22.4,2015,1.0
JayVaughn Pinkston,1590,182,1063,495,780,567,3571.0,115,33,288.0,948,462,24.6,2015,0.0
Treveon Graham,1882,199,1431,618,645,446,3558.0,565,200,191.0,866,418,26.8,2015,1.0
Briante Weber,862,378,695,296,299,230,2965.0,146,40,186.0,549,256,17.0,2015,1.0
Jarred Guest,198,20,204,86,45,24,1005.0,9,2,58.0,195,84,13.8,2015,0.0
Brian Brown,828,143,744,286,63,53,2540.0,569,203,111.0,175,83,15.6,2015,0.0
Jarid Watson,193,28,153,81,71,31,901.0,0,0,34.0,153,81,11.0,2015,0.0
Christian Burton,123,30,113,40,35,20,394.0,81,23,32.0,32,17,18.1,2015,0.0
Michael Donovan,14,2,12,4,2,2,57.0,11,4,2.0,1,0,11.4,2015,0.0
Niles Tate,4,1,5,2,0,0,12.0,3,0,0.0,2,2,18.1,2015,0.0
Conrad Jenne,2,0,5,1,2,0,9.0,4,0,0.0,1,1,28.7,2015,0.0
Tyrell Mason,9,3,15,3,2,2,60.0,6,1,6.0,9,2,16.1,2015,0.0
Malik Muller,203,47,184,72,32,18,661.0,107,41,44.0,77,31,20.4,2015,0.0
Christian Beyer,169,25,126,69,44,26,835.0,18,5,38.0,108,64,11.9,2015,0.0
Will Johnston,218,36,192,68,33,20,1206.0,172,62,21.0,20,6,10.1,2015,0.0
Justin Anderson,873,180,669,288,266,200,2364.0,272,97,125.0,397,191,22.3,2015,1.0
Darion Atkins,545,46,465,236,130,73,1857.0,1,0,89.0,464,236,19.1,2015,0.0
Rob Vozenilek,13,5,15,5,3,1,68.0,5,2,4.0,10,3,17.2,2015,0.0
Maleek Frazier,2,2,6,1,1,0,40.0,1,0,6.0,5,1,17.8,2015,0.0
Marcus Burton,1137,174,962,377,290,235,2580.0,451,148,160.0,511,229,23.9,2015,0.0
Stedman Allen,187,6,162,65,83,57,563.0,2,0,34.0,160,65,20.3,2015,0.0
Nolan Long,166,1,114,64,54,38,487.0,0,0,30.0,114,64,16.9,2015,0.0
Hugo Naurais,75,8,93,32,17,6,457.0,31,5,32.0,62,27,14.2,2015,0.0
Langston Burnett,39,10,55,12,22,9,292.0,39,6,16.0,16,6,13.7,2015,0.0
Darius Leonard,752,70,674,306,111,67,2177.0,214,73,83.0,460,233,19.2,2015,0.0
Doug Niedrich,0,1,7,0,0,0,16.0,0,0,0.0,7,0,21.9,2015,0.0
DaVonte Lacy,1548,217,1141,467,476,365,3516.0,693,249,202.0,448,218,24.1,2015,0.0
Dexter Kernich-Drew,665,94,559,227,117,84,2252.0,345,127,106.0,214,100,17.4,2015,0.0
Jordan Railey,354,57,319,147,138,59,1282.0,3,1,86.0,316,146,19.3,2015,0.0
Aaron Cheatum,12,3,14,4,15,4,92.0,1,0,4.0,13,4,14.3,2015,0.0
Trevor Dunbar,12,24,22,5,2,0,157.0,6,2,17.0,16,3,13.3,2015,0.0
Jackie Davis,6,0,12,2,7,2,56.0,8,0,6.0,4,2,19.9,2015,0.0
Shawn Kemp Jr.,620,13,455,259,163,102,1892.0,0,0,86.0,455,259,16.7,2015,0.0
Mike Anderson,436,134,305,134,166,119,1808.0,129,49,101.0,176,85,13.8,2015,0.0
Robert Upshaw,299,15,243,123,120,53,834.0,1,0,46.0,242,123,22.1,2015,0.0
Quevyn Winters,378,45,351,139,37,28,958.0,214,72,83.0,137,67,23.7,2015,0.0
Gilles Dierickx,93,18,102,42,13,9,642.0,0,0,50.0,102,42,12.9,2015,0.0
Chris Golden,297,38,262,95,58,44,797.0,182,63,42.0,80,32,22.4,2015,0.0
James Hajek,238,22,190,94,91,50,1049.0,0,0,51.0,190,94,14.5,2015,0.0
Jaelyn Johnson-Coston,97,8,71,36,40,25,304.0,1,0,27.0,70,36,20.7,2015,0.0
Hayden Hunter,34,59,28,5,28,20,387.0,12,4,35.0,16,1,10.6,2015,0.0
Jordan Brown,3,0,2,1,0,0,19.0,2,1,0.0,0,0,5.7,2015,0.0
Ryan Van Pelt,0,1,0,0,0,0,6.0,0,0,1.0,0,0,9.0,2015,0.0
Juwan Staten,1558,623,1269,542,628,443,4046.0,108,31,269.0,1161,511,22.4,2015,0.0
Gary Browne,804,241,614,236,359,259,2774.0,240,73,182.0,374,163,17.3,2015,0.0
Chase Connor,61,6,58,21,0,0,174.0,55,19,4.0,3,2,17.0,2015,0.0
BillyDee Williams,22,7,40,9,1,0,131.0,16,4,4.0,24,5,16.0,2015,0.0
Tyrone Hughes,11,3,11,4,5,2,35.0,8,1,3.0,3,3,22.9,2015,0.0
James Sinclair,1302,241,1162,465,323,244,3384.0,419,128,202.0,743,337,22.4,2015,0.0
Kenneth Hall,231,64,178,94,76,43,1506.0,0,0,72.0,178,94,9.5,2015,0.0
Dexter Jenkins,3,1,3,1,2,1,4.0,1,0,1.0,2,1,62.5,2015,0.0
Mohamed Conde,257,24,218,100,96,57,1220.0,1,0,52.0,217,100,14.1,2015,0.0
Remy Roberts-Burnett,379,105,400,173,54,26,1660.0,26,7,70.0,374,166,17.6,2015,0.0
Tyson Reynold,2,1,5,1,0,0,14.0,0,0,2.0,5,1,26.6,2015,0.0
Kam Rowan,0,0,0,0,0,0,5.0,0,0,1.0,0,0,10.6,2015,0.0
T.J. Price,1782,318,1425,581,440,334,3881.0,769,286,300.0,656,295,25.1,2015,0.0
George Fant,1621,123,1171,592,723,437,3671.0,3,0,273.0,1168,592,24.5,2015,0.0
Trency Jackson,657,143,544,210,238,154,1836.0,227,83,123.0,317,127,21.5,2015,0.0
Brandon Price,53,22,40,14,30,20,208.0,16,5,22.0,24,9,18.5,2015,0.0
Kevin Kaspar,351,108,316,113,71,53,1396.0,210,72,81.0,106,41,15.5,2015,0.0
Ayinde Sprewell,1,0,5,0,2,1,23.0,0,0,3.0,5,0,19.6,2015,0.0
David Brown,1536,176,1136,455,562,409,3279.0,671,217,220.0,465,238,26.0,2015,0.0
Austin Richie,943,279,696,270,341,243,3605.0,426,160,173.0,270,110,15.0,2015,0.0
Von Washington,49,2,50,17,9,4,135.0,39,11,5.0,11,6,23.3,2015,0.0
Khadim Dieng,10,1,7,4,6,2,53.0,0,0,3.0,7,4,13.0,2015,0.0
Charles Harris,47,7,40,20,10,4,106.0,11,3,6.0,29,17,25.1,2015,0.0
Tim Brennan,6,1,13,2,5,2,66.0,6,0,8.0,7,2,18.6,2015,0.0
Darius Carter,674,31,485,254,252,162,1389.0,7,4,53.0,478,250,25.4,2015,0.0
Tekele Cotton,1047,276,853,375,292,189,3403.0,319,108,151.0,534,267,17.7,2015,0.0
Jared Walker,13,3,8,4,2,2,37.0,5,3,2.0,3,1,16.1,2015,0.0
Marcus Thornton,2178,308,1649,709,551,435,4328.0,809,325,324.0,840,384,28.7,2015,1.0
Tom Schalk,174,41,129,70,47,32,848.0,11,2,40.0,118,68,12.6,2015,0.0
Tyler Johnson,2,0,5,1,0,0,17.0,0,0,0.0,5,1,16.3,2015,1.0
Keon Moore,1000,84,729,321,229,193,1855.0,397,165,101.0,332,156,26.2,2015,0.0
Andre Smith,1071,322,930,348,205,161,3258.0,581,214,185.0,349,134,19.7,2015,0.0
Frank Kaminsky,1458,188,1013,529,389,297,2943.0,279,103,121.0,734,426,25.5,2015,1.0
Sam Dekker,1363,148,1012,499,321,223,3153.0,408,142,114.0,604,357,22.9,2015,1.0
Josh Gasser,1075,284,693,313,349,292,4774.0,391,157,126.0,302,156,11.9,2015,0.0
Duje Dukan,298,37,248,106,64,42,970.0,134,44,36.0,114,62,18.6,2015,1.0
Traevon Jackson,839,307,683,273,285,223,2741.0,211,70,194.0,472,203,20.7,2015,0.0
Karl Cochran,1894,320,1814,701,262,180,4068.0,914,312,267.0,900,389,29.8,2015,0.0
Lee Skinner,1242,269,985,455,481,316,4074.0,81,16,227.0,904,439,19.4,2015,0.0
John Swinton,196,121,144,58,70,59,1215.0,62,21,55.0,82,37,10.5,2015,0.0
Jeremiah Tate,2,3,4,1,8,0,35.0,0,0,3.0,4,1,16.8,2015,0.0
Chrishawn Hopkins,748,197,627,246,241,181,2309.0,227,75,189.0,400,171,21.6,2015,0.0
Reggie Arceneaux,1049,296,975,369,181,138,3556.0,472,173,244.0,503,196,20.5,2015,0.0
Kendall Griffin,461,149,322,142,155,116,2077.0,180,61,122.0,142,81,13.9,2015,0.0
Grant Evans,38,15,57,14,4,1,241.0,37,9,15.0,20,5,17.1,2015,0.0
Mark Howell,61,33,62,19,23,18,393.0,25,5,21.0,37,14,13.2,2015,0.0
Larry Nance,1386,172,978,510,428,330,3631.0,117,36,193.0,861,474,22.8,2015,1.0
Riley Grabau,852,239,605,232,246,217,3457.0,465,171,143.0,140,61,15.1,2015,0.0
Derek Cooke Jr.,589,73,378,244,215,100,2109.0,3,1,96.0,375,243,16.6,2015,0.0
Charles Hankerson Jr.,539,157,485,183,161,93,2066.0,240,80,108.0,245,103,19.0,2015,0.0
Matt Sellers,77,11,62,31,25,15,280.0,0,0,22.0,62,31,20.8,2015,0.0
Jack Bentz,35,50,44,12,23,11,414.0,7,0,16.0,37,12,10.3,2015,0.0
Matt Stainbrook,1481,250,1055,601,410,274,3489.0,21,5,237.0,1034,596,22.0,2015,0.0
Dee Davis,874,493,722,284,249,185,3417.0,350,121,249.0,372,163,16.9,2015,0.0
Andrew Mitchell,0,0,0,0,0,0,4.0,0,0,0.0,0,0,0.0,2015,0.0
Javier Duren,1134,312,849,333,445,352,2724.0,341,116,267.0,508,217,25.8,2015,0.0
Matt Townsend,613,102,474,240,191,132,2218.0,8,1,122.0,466,239,16.4,2015,0.0
Armani Cotton,695,95,549,214,237,180,2379.0,266,87,118.0,283,127,17.3,2015,0.0
Greg Kelley,396,41,347,138,69,53,1149.0,196,67,45.0,151,71,19.6,2015,0.0
Shawn Amiker,777,91,580,289,288,186,2306.0,50,13,153.0,530,276,19.5,2015,0.0
DJ Cole,803,418,619,260,299,210,3071.0,211,73,227.0,408,187,16.6,2015,0.0
Osandai Vaughn,186,18,143,60,61,46,572.0,47,20,24.0,96,40,17.6,2015,0.0
Shaun Stewart,176,40,179,62,26,18,627.0,117,34,29.0,62,28,18.0,2015,0.0
Jalon Plummer,97,19,101,34,34,19,404.0,50,10,23.0,51,24,17.8,2015,0.0
Fletcher Larson,132,25,129,59,17,14,792.0,0,0,32.0,129,59,11.1,2015,0.0
Parker Wentz,1062,157,741,333,217,186,2852.0,480,210,132.0,261,123,17.9,2016,0.0
Duran Porter,379,28,280,155,115,69,1035.0,0,0,73.0,280,155,20.6,2016,0.0
Austin Cooke,741,108,565,239,162,127,2391.0,338,136,95.0,227,103,16.1,2016,0.0
Jalen Little,251,228,221,75,82,67,1540.0,100,34,100.0,121,41,12.2,2016,0.0
Zach Moer,359,47,280,133,102,77,897.0,48,16,84.0,232,117,24.5,2016,0.0
Dezmond James,90,26,101,31,36,22,419.0,36,6,23.0,65,25,17.5,2016,0.0
Joe Tuss,88,20,117,32,28,14,395.0,52,10,24.0,65,22,20.3,2016,0.0
Jace Chacon,7,0,4,3,1,1,11.0,1,0,1.0,3,3,25.7,2016,0.0
Malik Abbott,0,1,0,0,0,0,7.0,0,0,1.0,0,0,7.4,2016,0.0
Jason Anderson,0,0,0,0,0,0,1.0,0,0,0.0,0,0,0.0,2016,0.0
Dylan Clark,0,0,0,0,0,0,1.0,0,0,0.0,0,0,0.0,2016,0.0
David Cooper,0,0,0,0,0,0,0.0,0,0,0.0,0,0,0,2016,0.0
Reggie McAdams,975,76,735,314,139,99,2514.0,610,248,49.0,125,66,17.2,2016,0.0
Jake Kretzer,869,145,694,278,121,100,3034.0,571,213,96.0,123,65,14.3,2016,0.0
Pat Forsythe,815,72,615,327,267,160,2210.0,6,1,171.0,609,326,21.2,2016,0.0
Peter Agba,0,0,4,0,2,0,10.0,1,0,0.0,3,0,24.8,2016,0.0
Ladarius Tabb,1050,41,878,391,284,177,1926.0,312,91,99.0,566,300,29.8,2016,0.0
Nicholas West,957,92,733,307,381,274,2342.0,232,69,198.0,501,238,24.5,2016,0.0
Jacob Perry,171,43,126,49,77,54,431.0,68,19,35.0,58,30,23.7,2016,0.0
Arthur Wade,129,31,117,43,37,23,709.0,68,20,22.0,49,23,11.4,2016,0.0
Rashawn Green,85,9,72,30,6,3,248.0,57,22,9.0,15,8,17.4,2016,0.0
Zachary Jackson,55,8,56,21,17,8,205.0,21,5,10.0,35,16,18.7,2016,0.0
Baryn Houston,112,11,145,40,28,15,503.0,78,17,14.0,67,23,17.6,2016,0.0
Justin Colvin,317,53,311,104,87,53,1043.0,185,56,68.0,126,48,20.8,2016,0.0
Brontae Harris,0,0,0,0,0,0,0.0,0,0,1.0,0,0,0,2016,0.0
Robert Brown,1435,341,1318,511,317,225,3746.0,572,188,256.0,746,323,23.6,2016,0.0
Lionel Love,5,0,2,1,2,2,31.0,2,1,0.0,0,0,4.7,2016,0.0
Jamel Waters,1527,579,1248,509,482,362,3894.0,419,147,296.0,829,362,22.3,2016,0.0
Bobby Brown,925,92,888,337,205,133,2601.0,384,118,139.0,504,219,21.2,2016,1.0
Chidozie Omile,99,19,122,38,24,12,415.0,52,11,27.0,70,27,18.8,2016,0.0
Robert Ojeah,25,1,21,10,11,5,121.0,0,0,8.0,21,10,13.7,2016,0.0
Nicholas Barnes,12,0,13,4,2,0,57.0,11,4,3.0,2,0,14.5,2016,0.0
Joseff Smith,2,0,1,1,0,0,9.0,0,0,1.0,1,1,10.8,2016,0.0
Retin Obasohan,1176,182,877,380,479,327,2937.0,266,89,206.0,611,291,24.0,2016,0.0
Arthur Edwards,412,67,359,138,84,56,1328.0,234,80,98.0,125,58,19.9,2016,0.0
Evan Singletary,857,191,675,277,247,192,2251.0,297,111,139.0,378,166,22.0,2016,0.0
Peter Hooley,1519,337,1157,464,511,410,3905.0,555,181,257.0,602,283,22.8,2016,0.0
RaAnthony Sanders,723,151,539,236,231,178,1903.0,200,73,116.0,339,163,21.3,2016,0.0
Tamarcio Wilson,506,75,433,178,149,102,1383.0,165,48,112.0,268,130,22.3,2016,0.0
Octavius Brown,677,42,496,243,195,134,1643.0,150,57,80.0,346,186,21.3,2016,0.0
Patrick Onwenu,460,47,326,142,242,172,1474.0,35,4,114.0,291,138,19.0,2016,0.0
Devonte Hampton,605,159,583,215,138,85,2356.0,280,90,154.0,303,125,17.4,2016,0.0
Tyrel Hunt,474,43,376,166,208,135,1516.0,20,7,79.0,356,159,18.5,2016,0.0
Malachy Onwudiegwu,43,5,57,13,23,11,234.0,29,6,18.0,28,7,18.4,2016,0.0
Shawn Willett,19,7,31,6,12,6,104.0,12,1,10.0,19,5,22.5,2016,0.0
Keynan Pittman,96,3,76,42,33,12,433.0,0,0,20.0,76,42,12.8,2016,0.0
Jesse Reed,1405,171,1037,479,367,272,3927.0,448,175,207.0,589,304,21.8,2016,0.0
Paris Maragkos,268,31,231,111,54,36,611.0,26,10,68.0,205,101,30.0,2016,0.0
Marko Vasic,481,157,414,194,97,58,2081.0,135,35,96.0,279,159,16.2,2016,0.0
Gabe Brown,13,5,16,5,5,3,62.0,0,0,8.0,16,5,26.5,2016,0.0
Frank Eaves,1211,136,958,357,417,334,2388.0,466,163,160.0,492,194,27.3,2016,0.0
Chris Burgess,782,271,670,265,149,120,2712.0,365,132,159.0,305,133,16.6,2016,0.0
Jacob Lawson,425,41,323,167,139,91,1475.0,2,0,87.0,321,167,16.2,2016,0.0
Michael Obacha,495,53,310,156,342,183,2361.0,0,0,118.0,310,156,12.5,2016,0.0
Dustin Clarke,179,39,209,64,30,22,714.0,119,29,29.0,90,35,18.1,2016,0.0
Landon Goesling,128,25,117,35,76,50,427.0,50,8,32.0,67,27,22.0,2016,0.0
Dylan Hodson,3,0,4,1,0,0,7.0,1,1,0.0,3,0,27.4,2016,0.0
Hudson Terrell,3,0,1,0,6,3,12.0,0,0,2.0,1,0,23.3,2016,0.0
Mike Kobani,124,2,98,54,45,16,340.0,0,0,20.0,98,54,20.6,2016,0.0
Jalen Sanders,7,5,8,3,0,0,26.0,3,1,3.0,5,2,21.6,2016,0.0
Gerry Blakes,732,136,678,268,142,110,1828.0,279,86,146.0,399,182,24.6,2016,0.0
Willie Atwood,360,55,269,103,152,111,1225.0,133,43,46.0,136,60,15.7,2016,0.0
Savon Goodman,647,41,470,257,256,133,1486.0,8,0,113.0,462,257,23.8,2016,0.0
Eric Jacobsen,659,65,415,239,305,180,2258.0,2,1,125.0,413,238,15.4,2016,0.0
Andre Spight,1034,173,838,353,209,164,1811.0,434,164,132.0,404,189,28.5,2016,0.0
Shazier Lawson,0,0,0,0,0,0,6.0,0,0,0.0,0,0,0.0,2016,0.0
Gabe York,1143,191,915,379,208,156,2904.0,569,229,131.0,346,150,20.0,2016,0.0
Ryan Anderson,1787,151,1295,630,706,495,3906.0,120,32,235.0,1175,598,25.9,2016,1.0
Kaleb Tarczewski,1185,63,740,415,504,355,3489.0,0,0,204.0,740,415,17.4,2016,0.0
Mark Tollefsen,1253,166,885,474,240,171,3309.0,356,134,102.0,529,340,17.3,2016,0.0
Justin Simon,810,283,668,314,250,155,2488.0,77,27,182.0,591,287,19.5,2016,0.0
Jacob Hazzard,40,7,43,15,2,2,93.0,23,8,12.0,20,7,31.0,2016,0.0
Elliott Pitts,192,36,170,65,34,22,915.0,118,40,29.0,52,25,12.1,2016,0.0
Josh Hagins,1475,468,1224,525,306,250,3495.0,497,175,241.0,727,350,24.0,2016,0.0
Roger Woods,846,118,588,298,366,226,2195.0,65,24,149.0,523,274,22.2,2016,0.0
Jermaine Ruttley,618,116,510,221,195,136,1598.0,147,40,93.0,363,181,23.2,2016,0.0
Daniel Green,63,7,53,19,44,25,346.0,2,0,21.0,51,19,14.7,2016,0.0
Jovaughn Love,581,60,570,205,193,127,1603.0,159,44,100.0,411,161,25.4,2016,0.0
Trent Whiting,444,92,385,174,133,74,1860.0,78,22,105.0,307,152,15.7,2016,0.0
Thaddeus Handley,309,29,266,124,73,39,891.0,68,22,74.0,198,102,22.4,2016,0.0
Austin Cox,73,10,57,27,17,11,337.0,23,8,23.0,34,19,13.9,2016,0.0
Chauncy Parker,40,28,32,16,18,8,453.0,1,0,37.0,31,16,9.1,2016,0.0
Larry Johnson,16,6,21,7,3,0,157.0,7,2,19.0,14,5,14.1,2016,1.0
Sean Gardner,660,86,615,235,124,98,1869.0,282,92,95.0,333,143,20.5,2016,0.0
Nouhoum Bocoum,372,14,300,139,135,93,865.0,5,1,58.0,295,138,24.3,2016,0.0
Frederic Dure,245,70,194,69,116,77,915.0,91,30,73.0,103,39,17.3,2016,0.0
Charles Waters,209,14,182,82,61,45,747.0,3,0,40.0,179,82,16.6,2016,0.0
Kelvin Downs,325,28,283,126,110,72,1419.0,6,1,106.0,277,125,15.8,2016,0.0
Josh Pierre,40,4,52,10,16,11,337.0,46,9,6.0,6,1,9.6,2016,0.0
P.J. Hardwick,265,230,240,87,115,88,1676.0,15,3,137.0,225,84,13.0,2016,0.0
Anthlon Bell,1144,121,1012,394,149,119,2360.0,642,237,96.0,370,157,24.0,2016,0.0
Jabril Durham,264,256,234,79,91,72,1250.0,109,34,85.0,125,45,14.0,2016,0.0
Jimmy Whitt,1359,336,1185,558,346,227,3880.0,66,16,173.0,1119,542,20.1,2016,0.0
Keaton Miles,220,90,225,79,103,55,1280.0,31,7,62.0,194,72,13.0,2016,0.0
Willy Kouassi,368,14,282,144,168,80,1576.0,0,0,102.0,282,144,15.0,2016,0.0
Jake Mosiman,0,0,1,0,0,0,1.0,0,0,0.0,1,0,48.3,2016,0.0
Tristan Simmons,0,0,0,0,0,0,0.0,0,0,0.0,0,0,0,2016,0.0
Tanner Plomb,1359,130,1098,468,316,239,2449.0,515,184,151.0,583,284,28.1,2016,0.0
Kyle Wilson,2001,211,1676,686,446,355,3781.0,754,274,257.0,922,412,28.2,2016,0.0
Kevin Ferguson,1059,139,691,433,297,193,2802.0,0,0,196.0,691,433,18.1,2016,0.0
Dylan Cox,1030,479,716,381,361,231,3135.0,113,37,266.0,603,344,18.3,2016,0.0
Larry Toomey,666,197,587,225,187,128,2554.0,280,88,156.0,307,137,16.2,2016,0.0
Nathan Dodge,83,8,64,28,6,4,222.0,57,23,13.0,7,5,17.7,2016,0.0
Maxwell Lenox,290,175,218,102,123,76,1180.0,43,10,126.0,175,92,17.5,2016,0.0
Travis Rollo,48,21,48,21,17,6,572.0,1,0,21.0,47,21,6.7,2016,0.0
Tyler Harris,1196,131,942,408,437,318,3021.0,208,62,200.0,734,346,22.5,2016,0.0
Kareem Canty,922,291,816,313,221,162,1932.0,405,134,183.0,411,179,27.5,2016,0.0
Cinmeon Bowers,727,92,652,258,378,191,1877.0,89,20,173.0,563,238,26.6,2016,0.0
Jordon Granger,366,58,288,128,86,56,1815.0,158,54,76.0,130,74,11.2,2016,0.0
Tahj Shamsid-Deen,437,129,389,150,101,74,1472.0,201,63,58.0,188,87,17.1,2016,0.0
Jonathan Walker,6,0,6,2,0,0,19.0,5,2,0.0,1,0,15.1,2016,0.0
Cole Stockton,8,2,11,2,2,2,35.0,9,2,1.0,2,0,18.4,2016,0.0
Zach Allison,0,4,1,0,0,0,27.0,0,0,6.0,1,0,12.4,2016,0.0
Chris Horton,1719,144,1200,662,633,395,3932.0,1,0,270.0,1199,662,22.2,2016,0.0
Khalil Davis,697,174,557,219,309,201,2034.0,201,58,162.0,356,161,20.9,2016,0.0
Terrell Thompson,86,55,91,29,34,22,557.0,22,6,39.0,69,23,12.8,2016,0.0
Adam Pike,1,0,2,0,2,1,7.0,0,0,0.0,2,0,20.5,2016,0.0
Bo Calhoun,772,70,636,301,159,118,2207.0,153,52,140.0,483,249,20.4,2016,0.0
Jeremiah Davis,375,138,360,134,90,67,1249.0,143,40,110.0,217,94,21.8,2016,0.0
Naiel Smith,151,134,170,58,35,16,1106.0,67,19,90.0,103,39,13.4,2016,0.0
Nate Wells,136,16,128,56,40,21,633.0,14,3,27.0,114,53,14.9,2016,0.0
Bik Gill,35,4,27,8,19,15,144.0,15,4,16.0,12,4,19.5,2016,0.0
Rocco Belcaster,101,30,111,33,19,10,529.0,91,25,34.0,20,8,15.7,2016,0.0
Taurean Prince,1321,145,1017,468,355,255,2604.0,346,130,221.0,671,338,27.3,2016,1.0
Rico Gathers,1208,46,879,430,583,347,3127.0,1,1,136.0,878,429,20.9,2016,0.0
Lester Medford,562,328,471,185,147,103,2108.0,237,89,135.0,234,96,16.1,2016,0.0
Austin Mills,143,54,127,40,60,44,584.0,80,19,53.0,47,21,18.9,2016,0.0
John Heard,9,1,17,3,3,1,51.0,13,2,2.0,4,1,20.2,2016,0.0
Craig Bradshaw,1698,328,1235,591,350,267,3370.0,632,249,279.0,603,342,25.4,2016,0.0
Jeff Laidig,72,37,84,18,27,23,689.0,62,13,27.0,22,5,9.2,2016,0.0
Jordan Potts,792,240,666,240,225,176,2233.0,411,136,161.0,255,104,20.5,2016,0.0
Mario Moody,975,64,758,369,292,199,2289.0,117,38,166.0,641,331,22.9,2016,0.0
Ricky Johnson,1161,295,959,322,467,379,3574.0,464,138,242.0,495,184,20.6,2016,0.0
Randy Holmes,198,29,184,70,53,42,714.0,59,16,43.0,125,54,17.4,2016,0.0
Gus Navickas,4,1,2,2,0,0,13.0,0,0,2.0,2,2,15.1,2016,0.0
Jackie Saucer,0,0,2,0,0,0,12.0,2,0,3.0,0,0,20.5,2016,0.0
Romello Walker,309,38,323,111,105,61,1113.0,105,26,75.0,218,85,22.1,2016,0.0
James Webb,848,53,606,314,216,146,1830.0,224,74,80.0,382,240,22.6,2016,0.0
Anthony Drmic,1942,244,1463,634,529,399,4117.0,786,275,223.0,677,359,24.5,2016,0.0
Mikey Thompson,1138,298,864,363,436,336,3394.0,214,76,211.0,650,287,19.8,2016,0.0
Lonnie Jackson,960,214,751,293,186,145,3203.0,598,229,167.0,153,64,17.2,2016,0.0
Montigo Alford,239,82,210,80,62,42,769.0,105,37,64.0,105,43,21.0,2016,0.0
Eli Carter,1544,300,1384,525,375,292,3417.0,657,202,308.0,727,323,28.8,2016,0.0
Dennis Clifford,889,118,669,336,320,209,2934.0,31,8,212.0,638,328,19.4,2016,0.0
Matt Milon,1142,107,869,385,156,124,2995.0,608,248,125.0,261,137,18.5,2016,0.0
Sammy Barnes-Thompkins,149,18,137,53,21,12,457.0,79,31,25.0,58,22,20.2,2016,0.0
Darryl Hicks,69,19,78,27,7,3,349.0,41,12,23.0,37,15,16.0,2016,0.0
Steve Perpiglia,9,7,15,4,1,0,66.0,8,1,8.0,7,3,19.5,2016,0.0
Jordan Barros,3,0,2,1,0,0,7.0,2,1,0.0,0,0,15.3,2016,0.0
John Papale,1289,249,1058,447,138,108,4315.0,712,287,106.0,346,160,15.2,2016,0.0
Nathan Dieudonne,863,136,651,312,299,196,2888.0,155,43,199.0,496,269,18.3,2016,0.0
Spencer Parker,1160,135,882,395,438,312,3015.0,193,58,233.0,689,337,22.6,2016,0.0
David Joseph,310,209,326,111,78,58,1408.0,97,30,105.0,229,81,17.3,2016,0.0
J.D. Tisdale,175,67,174,60,98,52,980.0,29,3,95.0,145,57,16.5,2016,0.0
Garrett Mayleben,31,2,42,12,7,4,286.0,17,3,11.0,25,9,10.3,2016,0.0
Josh Gomez,95,7,89,40,23,12,409.0,9,3,28.0,80,37,16.2,2016,0.0
Brandon Busuttil,7,1,13,3,1,0,38.0,9,1,1.0,4,2,19.5,2016,0.0
Ka'Darryl Bell,478,128,441,155,176,120,2060.0,154,48,172.0,287,107,18.2,2016,0.0
Davante Cooper,89,12,74,39,27,11,436.0,0,0,35.0,74,39,14.5,2016,0.0
Joel Okafor,28,29,40,10,19,8,280.0,12,0,32.0,28,10,15.3,2016,0.0
D'Angelo McBride,6,0,5,0,9,6,34.0,2,0,5.0,3,0,22.2,2016,0.0
Mike Shaw,87,27,94,32,41,17,638.0,23,6,50.0,71,26,14.0,2016,0.0
Chase Fischer,1454,210,1156,465,292,235,3420.0,758,289,157.0,398,176,20.6,2016,0.0
Kyle Collinsworth,1707,703,1293,617,690,443,4330.0,107,30,367.0,1186,587,21.7,2016,1.0
Nate Austin,529,100,388,205,178,106,2780.0,49,13,99.0,339,192,9.7,2016,0.0
Jake Toolson,1492,327,1049,521,290,243,3501.0,478,207,215.0,571,314,20.4,2016,0.0
Jakob Hartsock,32,4,42,11,0,0,145.0,36,10,5.0,6,1,15.1,2016,0.0
Cory Calvert,80,40,98,29,20,14,375.0,49,8,29.0,49,21,17.6,2016,0.0
Cooper Ainge,0,0,1,0,0,0,4.0,1,0,0.0,0,0,11.6,2016,0.0
Cedric Kuakumensah,1181,119,1007,439,368,245,3135.0,150,58,229.0,857,381,22.9,2016,0.0
Shane McLaughlin,627,436,526,216,207,136,3313.0,165,59,249.0,361,157,13.8,2016,0.0
Curtis Oakley,352,49,342,127,71,44,1140.0,184,54,56.0,158,73,19.7,2016,0.0
Andrew Scocca,84,25,64,27,45,30,547.0,1,0,26.0,63,27,10.9,2016,0.0
Zach Chionuma,179,6,199,66,38,19,576.0,105,28,27.0,94,38,22.7,2016,0.0
Dennis Levene,9,3,8,4,3,0,50.0,3,1,3.0,5,3,12.7,2016,0.0
Chris Hass,1402,104,1076,460,351,292,2753.0,511,190,146.0,565,270,26.4,2016,0.0
Ryan Frazier,656,174,520,190,266,202,2677.0,234,74,111.0,286,116,14.9,2016,0.0
Dom Hoffman,543,97,475,220,110,80,1731.0,63,23,88.0,412,197,18.8,2016,0.0
Matt Banas,12,2,12,5,5,2,68.0,1,0,2.0,11,5,12.0,2016,0.0
Lamonte Bearden,1345,504,1008,434,540,413,3592.0,215,64,271.0,793,370,21.0,2016,0.0
Jarryn Skeete,912,247,858,292,192,143,3320.0,549,185,170.0,309,107,16.8,2016,0.0
Rodell Wigginton,466,54,396,175,159,99,1303.0,70,17,91.0,326,158,20.8,2016,0.0
Zac DiSalvo,2,1,3,1,0,0,6.0,2,0,0.0,1,1,23.6,2016,0.0
Mory Diane,5,2,6,2,3,0,46.0,2,1,4.0,4,1,12.0,2016,0.0
Kellen Dunham,1946,173,1457,598,537,451,4280.0,776,299,203.0,681,299,23.3,2016,0.0
Roosevelt Jones,1533,464,1297,589,595,354,4422.0,4,1,322.0,1293,588,22.2,2016,0.0
Jordan Gathers,547,180,481,189,119,86,2054.0,239,83,111.0,242,106,15.9,2016,0.0
Austin Etherington,280,50,205,88,86,64,1200.0,120,40,66.0,85,48,13.2,2016,0.0
David Nwaba,1047,180,788,373,457,297,2291.0,24,4,141.0,764,369,26.9,2016,1.0
Reese Morgan,814,119,577,206,286,248,2017.0,426,154,65.0,151,52,20.9,2016,0.0
Brian Bennett,1108,91,973,491,208,126,2849.0,5,0,110.0,968,491,22.8,2016,0.0
Joel Awich,673,66,625,248,164,120,2280.0,191,57,118.0,434,191,19.5,2016,0.0
Mark Patterson,5,0,9,2,0,0,19.0,3,1,0.0,6,1,26.0,2016,0.0
Sergine Athj,0,0,0,0,0,0,0.0,0,0,0.0,0,0,0,2016,0.0
Aly Ahmed,1075,94,852,409,364,254,2411.0,9,3,193.0,843,406,26.3,2016,0.0
Kevin Mays,967,92,770,367,328,224,2311.0,33,9,151.0,737,358,24.2,2016,0.0
Justin Hollins,54,3,44,23,20,8,383.0,0,0,24.0,44,23,10.0,2016,0.0
PJ Posey,8,0,5,4,3,0,19.0,0,0,2.0,5,4,21.9,2016,0.0
Darryl Geyen,1,0,3,0,2,1,16.0,2,0,0.0,1,0,12.2,2016,0.0
Malcolm Brooks,613,77,474,209,139,110,1427.0,222,85,63.0,252,124,21.4,2016,0.0
Lanerryl Johnson,692,100,607,232,168,133,1433.0,261,95,130.0,346,137,29.4,2016,0.0
Malcolm Henderson,87,4,63,33,40,21,453.0,0,0,17.0,63,33,10.8,2016,0.0
Kennedy Esume,214,14,199,85,89,44,990.0,0,0,49.0,199,85,15.0,2016,0.0
Rashard Todd,19,1,15,7,3,2,43.0,9,3,2.0,6,4,21.1,2016,0.0
Sheldon Blackwell,230,110,213,85,97,52,1366.0,37,8,67.0,176,77,12.4,2016,0.0
Tre Hale-Edmerson,813,303,682,325,177,128,3522.0,128,35,232.0,554,290,14.1,2016,0.0
Olalekan Ajayi,183,19,140,63,100,57,1328.0,0,0,65.0,140,63,9.5,2016,0.0
Landon Drew,585,393,545,208,109,79,2525.0,249,90,193.0,296,118,15.6,2016,0.0
Kelton Conway,4,1,4,0,6,4,17.0,1,0,2.0,3,0,25.6,2016,0.0
Josh Fox,964,129,724,375,332,209,2390.0,21,5,160.0,703,370,23.5,2016,0.0
Neal Monson,417,39,306,163,128,91,1301.0,3,0,71.0,303,163,18.3,2016,0.0
Nolan Berry,126,8,81,39,46,38,265.0,29,10,18.0,52,29,24.3,2016,0.0
Alex Young,1324,576,1143,466,355,262,4060.0,396,130,233.0,747,336,19.9,2016,0.0
Mike Best,760,59,687,314,165,120,2090.0,51,12,117.0,636,302,21.9,2016,0.0
Aaron Wright,508,235,397,154,254,159,2151.0,122,41,193.0,275,113,17.2,2016,0.0
Dominique Dunning,369,84,293,132,144,88,1456.0,48,17,66.0,245,115,15.5,2016,0.0
Haroldas Saprykinas,77,4,56,23,23,14,178.0,41,17,7.0,15,6,21.9,2016,0.0
Shawn Ray,6,1,10,3,1,0,59.0,0,0,1.0,10,3,10.2,2016,0.0
Jaylen Bland,1022,110,836,325,199,158,2297.0,547,214,135.0,289,111,24.0,2016,0.0
Taylor Johns,1383,163,1043,509,538,344,3229.0,86,21,299.0,957,488,25.7,2016,0.0
Robert Boezeman,172,13,139,61,38,23,680.0,68,27,35.0,71,34,14.6,2016,0.0
Steven Jones,376,184,393,144,92,49,1970.0,143,39,112.0,250,105,14.4,2016,0.0
Primitivo Gomez,26,3,23,6,14,11,101.0,7,3,9.0,16,3,19.5,2016,0.0
Michael Bryson,1620,219,1243,561,316,257,3758.0,651,241,253.0,592,320,23.2,2016,0.0
John Green,663,89,573,252,153,104,1441.0,155,55,103.0,418,197,27.5,2016,0.0
Sam Beeler,454,29,315,193,146,68,1572.0,0,0,92.0,315,193,16.0,2016,0.0
Mitch Brewe,458,52,353,170,136,97,1684.0,58,21,61.0,295,149,15.1,2016,0.0
DaJuan Smith,177,67,166,71,51,31,786.0,17,4,42.0,149,67,15.6,2016,0.0
T.J. Taylor,367,275,354,129,39,29,2053.0,231,80,120.0,123,49,12.6,2016,0.0
Grant Troutt,11,4,12,4,0,0,46.0,9,3,3.0,3,1,16.5,2016,0.0
Justin Burks,6,1,6,2,0,0,39.0,5,2,2.0,1,0,10.7,2016,0.0
Jaylen Brown,498,68,378,163,217,142,939.0,102,30,105.0,276,133,31.4,2016,1.0
Tyrone Wallace,1623,436,1417,588,537,329,4074.0,404,118,279.0,1013,470,24.9,2016,1.0
Nick Kerr,63,6,57,21,5,3,171.0,45,18,7.0,12,3,20.8,2016,0.0
Brenden Glapion,19,2,13,4,15,11,36.0,2,0,2.0,11,4,31.7,2016,0.0
Brandon Chauca,58,20,56,20,8,5,248.0,39,13,23.0,17,7,17.6,2016,0.0
D.J. Mason,932,148,755,371,254,145,2091.0,131,45,136.0,624,326,25.7,2016,0.0
Rod Days,339,58,300,115,99,60,1523.0,170,49,69.0,130,66,14.4,2016,0.0
Casey Perrin,40,6,33,12,6,6,77.0,28,10,5.0,5,2,27.6,2016,0.0
Malcolm McMillan,1133,462,842,348,457,343,4051.0,281,94,227.0,561,254,15.7,2016,0.0
Kevin Bleeker,475,81,410,178,112,81,1854.0,124,38,105.0,286,140,15.5,2016,0.0
Jamal Reynolds,401,85,266,130,204,139,1429.0,5,2,64.0,261,128,15.3,2016,0.0
Isaiah Gurley,202,37,198,63,66,49,738.0,104,27,34.0,94,36,18.1,2016,0.0
Cassidy Ryan,92,15,94,38,8,5,291.0,28,11,21.0,66,27,20.6,2016,0.0
Adam Weir,88,29,119,29,18,10,473.0,83,20,14.0,36,9,15.5,2016,0.0
Raven Owen,3,0,3,1,0,0,5.0,3,1,1.0,0,0,39.6,2016,0.0
Justin Foreman,432,61,326,136,190,111,1292.0,135,49,76.0,191,87,18.3,2016,0.0
Jake Zuilhof,481,50,336,180,204,121,1729.0,0,0,135.0,336,180,16.0,2016,0.0
Boo Milligan,259,57,239,88,83,55,848.0,102,28,67.0,137,60,19.8,2016,0.0
Mike Martin,359,139,307,126,82,63,1079.0,130,44,105.0,177,82,20.6,2016,0.0
Brandon Peel,958,126,815,390,247,174,3126.0,15,4,184.0,800,386,18.1,2016,0.0
Jahlil Nails,180,12,140,55,46,36,535.0,87,34,28.0,53,21,17.7,2016,0.0
JJ Cratit,134,9,139,44,44,27,346.0,54,19,22.0,85,25,26.2,2016,0.0
Evan Phoenix,117,11,110,46,40,25,409.0,0,0,34.0,110,46,19.9,2016,0.0
Malik Toppin,74,5,59,32,19,10,227.0,1,0,9.0,58,32,16.9,2016,0.0
Malcolm Simmons,1,0,1,0,2,1,12.0,0,0,1.0,1,0,12.3,2016,0.0
George Davis III,2,1,2,1,0,0,11.0,1,0,2.0,1,1,19.5,2016,0.0
Adonys Henriquez,585,115,469,193,116,85,1874.0,302,114,74.0,167,79,16.7,2016,0.0
Daiquan Walker,711,268,657,250,128,97,2619.0,310,114,184.0,347,136,17.7,2016,0.0
Justin McBride,431,10,301,170,149,91,882.0,0,0,95.0,301,170,27.4,2016,0.0
Shaheed Davis,284,28,276,101,100,52,914.0,106,30,80.0,170,71,22.9,2016,0.0
Staphon Blair,525,9,368,214,177,97,1776.0,1,0,91.0,367,214,15.7,2016,0.0
Chris Fowler,1736,686,1209,593,680,475,3927.0,226,75,327.0,983,518,24.7,2016,0.0
Rayshawn Simmons,833,360,679,289,293,205,2648.0,166,50,174.0,513,239,19.5,2016,0.0
John Simons,1279,111,893,398,294,227,3928.0,653,256,111.0,240,142,15.2,2016,0.0
Austin Stewart,592,54,411,204,200,147,1857.0,111,37,105.0,300,167,17.2,2016,0.0
Hunter Hale,454,60,365,149,90,70,860.0,242,86,68.0,123,63,25.8,2016,0.0
Milos Cabarkapa,38,1,22,13,19,12,112.0,0,0,8.0,22,13,18.2,2016,0.0
Tedaro France III,0,0,0,0,0,0,5.0,0,0,0.0,0,0,0.0,2016,0.0
Aaron Wheeler,576,129,474,233,184,97,1748.0,62,13,101.0,412,220,19.0,2016,0.0
Demetrius Pollard,707,145,630,230,173,119,2153.0,394,128,128.0,236,102,20.4,2016,0.0
Reuben King,181,31,165,76,39,21,691.0,38,8,44.0,127,68,16.5,2016,0.0
Danny Upchurch,154,78,176,46,50,31,705.0,130,31,65.0,46,15,18.8,2016,0.0
Wesley Johnson,85,7,51,27,61,31,458.0,0,0,15.0,51,27,10.4,2016,1.0
Melvin Brooks,33,1,29,13,10,7,168.0,0,0,3.0,29,13,10.9,2016,0.0
Jabbar Washington,42,17,44,15,16,7,175.0,18,5,10.0,26,10,17.7,2016,0.0
Jantzen Raymond,9,1,10,3,3,2,35.0,4,1,4.0,6,2,22.1,2016,0.0
Joseph Uchebo,469,34,351,197,134,75,1075.0,0,0,51.0,351,197,21.1,2016,0.0
Curran Scott,992,144,724,298,362,293,2690.0,284,103,164.0,440,195,20.0,2016,0.0
Ridell Camidge,113,22,135,40,18,9,404.0,95,24,25.0,40,16,20.1,2016,0.0
Bernard Sullivan,256,24,239,100,90,54,890.0,11,2,52.0,228,98,19.1,2016,0.0
Cameron Pappas,24,5,17,5,14,12,69.0,9,2,3.0,8,3,18.7,2016,0.0
Cameron Blakley,52,5,59,16,13,9,232.0,43,11,14.0,16,5,17.0,2016,0.0
Mitch Warner,0,0,4,0,0,0,4.0,2,0,0.0,2,0,49.3,2016,0.0
Gavin Wilson,3,0,11,1,0,0,17.0,8,1,3.0,3,0,40.8,2016,0.0
Chuck Ester,370,72,295,146,105,60,1262.0,46,18,91.0,249,128,17.6,2016,0.0
Dee Oldham,654,145,538,210,192,149,2119.0,251,85,100.0,287,125,17.1,2016,0.0
Duke Ethridge,401,19,281,139,137,99,892.0,79,24,59.0,202,115,23.2,2016,0.0
Alex Bran,211,27,181,76,21,16,542.0,118,43,47.0,63,33,21.6,2016,0.0
K.J. Bates,11,3,12,3,7,4,46.0,5,1,3.0,7,2,20.3,2016,0.0
Jackson White,9,2,7,3,4,3,41.0,1,0,1.0,6,3,12.2,2016,0.0
ZaQwaun Matthews,28,13,42,12,2,0,142.0,25,4,5.0,17,8,17.0,2016,0.0
Rich Kalina,4,0,4,2,1,0,14.0,0,0,2.0,4,2,23.4,2016,0.0
Elliott Cole,251,48,233,87,27,24,527.0,157,53,52.0,76,34,26.5,2016,0.0
Kieran Woods,211,60,177,75,92,55,475.0,28,6,51.0,149,69,26.9,2016,0.0
Jawad Adekoya,259,20,235,79,72,53,640.0,146,48,36.0,89,31,23.3,2016,0.0
Jordan Madrid-Andrews,121,10,98,48,46,24,504.0,7,1,41.0,91,47,15.1,2016,0.0
Quron Davis,167,17,142,63,76,41,762.0,0,0,46.0,142,63,14.3,2016,0.0
Devon Friend,67,4,57,28,26,11,304.0,0,0,23.0,57,28,14.3,2016,0.0
Jared Dimakos,209,26,163,77,59,34,689.0,68,21,45.0,95,56,17.6,2016,0.0
Charles Dent,0,0,0,0,0,0,0.0,0,0,0.0,0,0,0,2016,0.0
Farad Cobb,769,140,722,271,96,75,2126.0,446,152,93.0,276,119,21.3,2016,0.0
Octavius Ellis,667,83,438,241,278,185,1835.0,1,0,151.0,437,241,21.1,2016,0.0
Coreontae DeBerry,349,10,232,129,139,91,845.0,0,0,42.0,232,129,21.5,2016,0.0
Shaq Thomas,723,106,635,283,220,132,2473.0,80,25,138.0,555,258,18.8,2016,0.0
Derrick Henry,999,104,797,308,391,291,2234.0,323,92,129.0,474,216,24.3,2016,0.0
Quinton Marshall,824,133,715,313,224,132,2574.0,207,66,185.0,508,247,19.6,2016,0.0
P.J. Boutte,486,328,468,163,171,115,1986.0,174,45,192.0,294,118,17.9,2016,0.0
Connor Schroeder,177,15,175,63,21,13,305.0,130,38,8.0,45,25,26.9,2016,0.0
Tim Broom,89,70,79,28,45,24,439.0,32,9,47.0,47,19,15.3,2016,0.0
Qwandell Newton,5,2,15,2,2,1,50.0,10,0,3.0,5,2,16.1,2016,0.0
Garrett Mullis,3,0,2,1,0,0,11.0,1,1,1.0,1,0,11.6,2016,0.0
Tommy Olds,3,2,8,1,0,0,10.0,2,1,2.0,6,0,42.6,2016,0.0
Jordan Roper,971,238,897,337,207,156,2974.0,409,141,143.0,488,196,21.0,2016,0.0
Landry Nnoko,744,65,573,300,229,144,2632.0,0,0,146.0,573,300,17.2,2016,0.0
Josh Smith,172,11,154,65,64,39,882.0,11,3,48.0,143,62,14.5,2016,1.0
Andre Yates,503,109,497,187,116,71,1727.0,194,58,109.0,303,129,22.9,2016,0.0
Vinny Zollo,446,74,435,158,98,69,1620.0,207,61,105.0,228,97,18.4,2016,0.0
Jeron Rogers,41,7,47,12,18,12,228.0,23,5,11.0,24,7,15.2,2016,0.0
Myles Hamilton,348,149,331,121,107,78,1304.0,103,28,119.0,228,93,19.9,2016,0.0
Jonothan Janssen,9,0,7,2,4,4,37.0,5,1,0.0,2,1,12.6,2016,0.0
Badou Diagne,1071,97,843,386,313,201,3102.0,290,98,206.0,553,288,19.4,2016,0.0
Tristian Curtis,456,35,312,181,185,92,2069.0,6,2,87.0,306,179,11.8,2016,0.0
Marcus Freeman,307,15,248,124,100,59,844.0,0,0,39.0,248,124,20.0,2016,0.0
Aaron Law,26,12,29,10,6,4,121.0,12,2,6.0,17,8,15.7,2016,0.0
Austin Tillotson,1393,484,1023,502,338,244,3871.0,368,145,251.0,655,357,20.6,2016,0.0
Alex Ramon,314,77,230,110,73,51,1217.0,109,43,78.0,121,67,15.6,2016,0.0
James Bourne,489,23,309,170,244,149,2189.0,2,0,116.0,307,170,13.2,2016,0.0
Harrison Bowne,6,1,7,2,5,1,47.0,3,1,0.0,4,1,10.7,2016,0.0
Tim Branin,0,0,1,0,1,0,6.0,0,0,2.0,1,0,31.3,2016,0.0
John Eck,0,1,2,0,0,0,8.0,0,0,0.0,2,0,13.1,2016,0.0
Antwan Scott,939,168,693,298,254,199,1879.0,356,144,152.0,337,154,25.4,2016,0.0
Joe De Ciman,917,157,749,301,226,165,2987.0,402,150,119.0,347,151,16.4,2016,0.0
Dantiel Daniels,943,78,587,355,460,233,2898.0,0,0,132.0,587,355,16.6,2016,0.0
Fred Richardson III,181,26,150,57,56,44,677.0,76,23,30.0,74,34,15.2,2016,0.0
Toby Van Ry,54,16,52,20,17,10,252.0,19,4,24.0,33,16,15.8,2016,0.0
Josh Scott,1711,128,1157,600,657,506,3761.0,16,5,151.0,1141,595,21.7,2016,0.0
Tre'Shaun Fletcher,1078,219,825,365,322,237,2568.0,316,111,174.0,509,254,22.5,2016,0.0
Xavier Talton,525,190,475,171,134,101,2417.0,230,82,152.0,245,89,14.4,2016,0.0
Kenan Guzonjic,20,1,19,7,7,4,53.0,4,2,6.0,15,5,25.5,2016,0.0
Brett Brady,15,2,11,5,2,1,43.0,9,4,3.0,2,1,17.1,2016,0.0
Eli Stalzer,105,27,92,35,30,18,584.0,56,17,38.0,36,18,12.7,2016,0.0
Maodo Lo,1756,264,1329,623,304,233,3678.0,692,277,235.0,637,346,25.7,2016,0.0
Alex Rosenberg,1430,204,992,409,628,478,3352.0,371,134,207.0,621,275,24.7,2016,0.0
Isaac Cohen,371,303,276,159,97,42,2592.0,28,11,132.0,248,148,9.8,2016,0.0
Daniel Hamilton,831,298,777,298,184,142,2247.0,276,93,166.0,501,205,25.0,2016,1.0
Shonn Miller,1507,92,1124,541,455,359,3341.0,237,66,161.0,887,475,23.9,2016,0.0
Sterling Gibbs,1413,349,997,411,522,393,3358.0,501,198,209.0,496,213,22.7,2016,0.0
Omar Calhoun,750,100,641,243,193,148,2355.0,361,116,131.0,280,127,19.9,2016,0.0
Phillip Nolan,269,24,215,108,82,53,1670.0,0,0,66.0,215,108,10.4,2016,0.0
Nnamdi Amilo,6,0,3,1,4,4,22.0,0,0,0.0,3,1,11.8,2016,0.0
James Sylvester,281,45,215,81,133,91,610.0,65,28,40.0,150,53,24.8,2016,0.0
Trevon Seymore,245,95,230,79,91,66,748.0,81,21,58.0,149,58,21.1,2016,0.0
Lawrence Fejokwu,67,8,64,25,44,17,552.0,1,0,34.0,63,25,10.3,2016,0.0
Jerimyjah Batts,135,13,132,52,55,31,775.0,0,0,35.0,132,52,12.1,2016,0.0
Derek Armstrong,7,1,7,3,0,0,33.0,4,1,0.0,3,2,10.1,2016,0.0
Robert Mischler,67,11,42,22,10,6,267.0,34,17,10.0,8,5,10.9,2016,0.0
Pat Smith,33,6,33,11,8,6,112.0,20,5,1.0,13,6,18.3,2016,0.0
Xavier Eaglin,6,1,4,3,4,0,21.0,0,0,1.0,4,3,15.8,2016,0.0
Geoffrey Groselle,593,27,339,232,191,129,1220.0,0,0,83.0,339,232,21.4,2016,0.0
James Milliken,637,118,498,204,181,134,1732.0,259,95,59.0,239,109,19.1,2016,0.0
Malik Albert,70,27,59,26,24,17,220.0,14,1,18.0,45,25,19.7,2016,0.0
Marlon Stewart,1268,335,951,404,431,334,2674.0,381,126,218.0,570,278,25.9,2016,0.0
Connor Boehm,1127,137,906,457,256,163,3007.0,139,50,193.0,767,407,21.4,2016,0.0
Kevin Crescenzi,412,97,417,144,87,60,1736.0,197,64,84.0,220,80,16.5,2016,0.0
Brandon McDonnell,248,31,202,95,65,51,857.0,32,7,46.0,170,88,16.9,2016,0.0
Malik Gill,491,252,410,146,208,148,1659.0,163,51,176.0,247,95,21.9,2016,0.0
Tommy Carpenter,224,86,181,95,59,32,978.0,14,2,78.0,167,93,15.6,2016,0.0
Cole Harrison,132,13,119,56,37,20,454.0,0,0,36.0,119,56,19.9,2016,0.0
Quinten Payne,61,24,73,23,9,6,408.0,48,9,24.0,25,14,12.5,2016,0.0
Matt Rennie,60,15,53,19,41,22,395.0,1,0,18.0,52,19,12.1,2016,0.0
Michael Stones,5,0,5,2,4,1,15.0,1,0,2.0,4,2,29.2,2016,0.0
Eli Harrison,101,5,83,34,9,5,202.0,63,28,10.0,20,6,25.4,2016,0.0
Brian Sullivan,1565,335,1304,517,227,180,4053.0,890,351,176.0,414,166,20.5,2016,0.0
Jordan Barham,866,67,590,340,289,175,1643.0,31,11,75.0,559,329,25.0,2016,0.0
Jake Belford,247,32,173,88,62,46,710.0,63,25,54.0,110,63,18.6,2016,0.0
Dyshawn Pierre,1423,276,1041,501,435,307,3772.0,297,114,220.0,744,387,20.7,2016,0.0
Steve McElvene,196,15,141,86,38,24,588.0,0,0,43.0,141,86,17.5,2016,0.0
Bobby Wehrli,86,15,67,32,15,8,529.0,35,14,18.0,32,18,9.5,2016,0.0
Michael Schwieterman,0,0,0,0,0,0,1.0,0,0,0.0,0,0,0.0,2016,0.0
Todd Hughes,280,29,283,112,64,42,843.0,56,14,60.0,227,98,22.3,2016,0.0
Aric Dickerson,194,23,191,66,18,12,711.0,147,50,42.0,44,16,17.1,2016,0.0
Scott Sill,114,6,139,45,9,2,458.0,86,22,21.0,53,23,18.4,2016,0.0
Jason Owens,134,18,154,56,39,21,631.0,4,1,41.0,150,55,18.0,2016,0.0
Cahli Thomas,67,35,63,20,25,18,410.0,38,9,29.0,25,11,13.4,2016,0.0
Malik Carter,26,13,36,9,10,6,106.0,12,2,12.0,24,7,25.5,2016,0.0
Kory Holden,1200,350,1008,402,312,236,2811.0,394,160,252.0,614,242,25.8,2016,0.0
Marvin King-Davis,849,52,661,309,330,231,2152.0,2,0,92.0,659,309,21.6,2016,0.0
Sean Locke,9,1,13,2,5,3,39.0,13,2,2.0,0,0,22.5,2016,0.0
Nate Engesser,849,145,590,302,117,98,2014.0,344,147,87.0,246,155,22.2,2016,0.0
Marcus Byrd,893,152,667,318,120,94,2679.0,389,163,119.0,278,155,19.1,2016,0.0
Bryant Rucker,521,126,367,180,121,90,1752.0,172,71,97.0,195,109,18.1,2016,0.0
Myke Henry,991,76,808,384,209,147,2344.0,228,76,178.0,580,308,23.9,2016,1.0
Tommy Hamilton IV,1005,110,791,355,286,197,2798.0,238,98,225.0,553,257,21.0,2016,0.0
Aaron Simpson,331,85,291,110,69,47,1262.0,169,64,65.0,122,46,15.9,2016,0.0
Rashaun Stimage,249,2,176,95,114,58,778.0,6,1,38.0,170,94,17.7,2016,0.0
Cory Dolins,10,4,9,4,5,2,48.0,0,0,3.0,9,4,15.1,2016,0.0
David Molinari,8,4,8,1,9,6,44.0,4,0,4.0,4,1,19.0,2016,0.0
Oumar Barry,326,31,244,126,127,66,1059.0,39,8,71.0,205,118,17.8,2016,0.0
Frederick Scott,1203,114,863,415,477,265,2521.0,279,108,181.0,584,307,23.7,2016,0.0
Anton Wilson,1005,183,748,325,174,150,2755.0,499,205,140.0,249,120,17.0,2016,0.0
Paris Bass,852,112,675,311,279,185,1545.0,132,45,165.0,543,266,30.4,2016,0.0
Carlton Brundidge,658,153,534,230,240,165,1726.0,118,33,117.0,416,197,21.4,2016,0.0
Jalen Gibson,7,0,7,1,10,5,32.0,1,0,4.0,6,1,22.5,2016,0.0
Karl Madison,326,258,311,101,147,100,2238.0,87,24,170.0,224,77,13.7,2016,0.0
Tavon Allen,1249,220,1206,434,291,221,3146.0,490,160,188.0,716,274,26.7,2016,0.0
Kazembe Abif,552,42,422,201,226,148,2087.0,15,2,86.0,407,199,15.9,2016,0.0
Ahmad Fields,81,11,61,25,41,25,190.0,15,6,14.0,46,19,26.3,2016,0.0
Chandler Fraser-Pauls,0,1,1,0,2,0,7.0,1,0,0.0,0,0,14.7,2016,0.0
Brandon Ingram,624,72,484,214,170,116,1246.0,195,80,72.0,289,134,25.5,2016,1.0
Marshall Plumlee,427,59,233,155,209,116,1777.0,1,1,68.0,232,154,11.4,2016,1.0
Derryck Thornton,963,359,913,347,250,186,3090.0,286,83,253.0,627,264,20.9,2016,0.0
Derrick Colter,1695,526,1383,550,472,356,3948.0,675,239,326.0,708,311,24.2,2016,0.0
Micah Mason,1431,376,1001,487,174,146,3366.0,671,311,162.0,330,176,18.4,2016,0.0
TySean Powell,364,41,249,145,115,72,849.0,3,2,75.0,246,143,22.1,2016,0.0
Jeremiah Jones,761,209,661,260,247,164,2755.0,243,77,139.0,418,183,16.7,2016,0.0
Mar'Qywell Jackson,92,9,80,29,24,15,263.0,56,19,12.0,24,10,18.8,2016,0.0
Nick Foschia,6,1,15,3,2,0,47.0,5,0,2.0,10,3,18.8,2016,0.0
Marshall Macheledt,2,0,2,1,0,0,11.0,0,0,0.0,2,1,9.3,2016,0.0
Prince Williams,704,280,533,232,264,193,2147.0,136,47,180.0,397,185,20.4,2016,0.0
Michael Zangari,580,51,465,211,212,143,2045.0,71,15,99.0,394,196,17.0,2016,0.0
Kanu Aja,147,13,139,62,59,23,636.0,0,0,34.0,139,62,16.8,2016,0.0
Charles Foster,46,6,39,17,6,3,116.0,27,9,13.0,12,8,24.6,2016,0.0
Grant Bryant,26,2,19,11,7,4,103.0,0,0,7.0,19,11,14.9,2016,0.0
Drew Bost,3,2,5,1,0,0,14.0,5,1,0.0,0,0,18.6,2016,0.0
Peyton Robbins,3,1,5,1,2,1,20.0,0,0,1.0,5,1,17.8,2016,0.0
Ge'Lawn Guyn,963,135,831,333,213,153,2488.0,394,144,141.0,437,189,21.6,2016,0.0
Deuce Bello,555,78,428,194,222,128,1739.0,135,39,142.0,293,155,19.4,2016,0.0
Lester Wilson,1388,60,1194,487,197,142,3234.0,753,272,117.0,441,215,21.9,2016,0.0
Abednego Lufile,97,9,80,37,34,23,315.0,6,0,19.0,74,37,17.9,2016,0.0
Petey McClain,332,412,282,107,157,101,2579.0,74,17,187.0,208,90,10.6,2016,0.0
Nigel Holley,24,5,22,10,7,4,125.0,0,0,8.0,22,10,13.1,2016,0.0
Stetson Moore,11,2,12,4,0,0,36.0,10,3,0.0,2,1,16.4,2016,0.0
Toriano Stokes,9,0,8,4,4,1,47.0,0,0,1.0,8,4,11.4,2016,0.0
Trae Anderson,837,108,664,319,271,178,1460.0,74,21,155.0,590,298,34.8,2016,0.0
A.J. Riley,296,60,224,93,128,90,629.0,64,20,64.0,160,73,28.4,2016,0.0
Luke Piotrowski,292,30,238,115,89,62,1027.0,3,0,60.0,235,115,17.8,2016,0.0
Luke Norman,63,24,40,21,11,7,459.0,30,14,16.0,10,7,7.2,2016,0.0
Aleksa Novakovic,5,4,11,1,3,2,26.0,9,1,4.0,2,0,32.4,2016,0.0
Justin Earls,4,1,1,1,4,2,6.0,0,0,0.0,1,1,24.8,2016,0.0
Jarelle Reischel,1011,158,701,325,414,289,2337.0,201,72,230.0,500,253,24.0,2016,0.0
Ja'Mill Powell,422,54,338,133,124,92,1157.0,185,64,70.0,153,69,21.4,2016,0.0
K.J. Bluford,108,10,101,36,10,5,216.0,92,31,9.0,9,5,25.8,2016,0.0
Anthony Pratt,81,10,52,34,28,13,304.0,1,0,18.0,51,34,13.3,2016,0.0
Jonathan Hood,57,6,52,19,6,5,160.0,39,14,4.0,13,5,19.6,2016,0.0
Tommy Matthews,33,15,37,9,20,11,238.0,17,4,13.0,20,5,13.3,2016,0.0
Brandon Nazione,443,52,314,154,169,122,1429.0,37,13,82.0,277,141,16.3,2016,0.0
Ethan Alvano,153,67,141,36,90,72,584.0,59,9,35.0,82,27,18.7,2016,0.0
Trent Perry,68,10,81,24,7,3,286.0,63,17,6.0,18,7,15.5,2016,0.0
LaMonta Stone II,8,5,10,3,4,2,35.0,3,0,7.0,7,3,25.7,2016,0.0
Austin McBroom,1492,314,1149,461,376,313,3508.0,643,257,238.0,506,204,23.1,2016,0.0
Venky Jois,1803,276,1232,718,660,363,3927.0,22,4,302.0,1210,714,23.7,2016,0.0
Bear Henderson,40,6,23,12,21,14,150.0,4,2,8.0,19,10,13.7,2016,0.0
Will Ferris,39,17,33,11,9,9,174.0,24,8,12.0,9,3,14.2,2016,0.0
Kyle Reid,69,10,48,27,30,15,347.0,1,0,14.0,47,27,11.1,2016,0.0
Enrico Nuno,10,7,12,3,3,2,108.0,8,2,4.0,4,1,8.1,2016,0.0
Tanner Samson,1320,220,1008,390,262,216,3616.0,862,324,116.0,146,66,17.4,2016,0.0
Sam Hershberger,19,6,11,4,11,10,49.0,7,1,1.0,4,3,17.6,2016,0.0
Wes Brewer,12,1,9,6,2,0,33.0,0,0,8.0,9,6,27.3,2016,0.0
Tony Sabato,199,51,207,84,60,31,1067.0,1,0,66.0,206,84,14.4,2016,0.0
D.J. Balentine,2464,472,1910,824,698,553,4644.0,702,263,295.0,1208,561,29.0,2016,0.0
Egidijus Mockevicius,1504,43,893,551,548,402,3497.0,0,0,178.0,893,551,20.2,2016,0.0
Mislav Brzoja,507,194,395,166,165,124,1648.0,154,51,138.0,241,115,19.7,2016,0.0
Adam Wing,804,240,632,293,216,169,3328.0,124,49,186.0,508,244,14.7,2016,0.0
Harris Brown,34,17,35,8,19,13,187.0,18,5,12.0,17,3,15.7,2016,0.0
Marcus Gilbert,1661,154,1246,531,468,357,3820.0,675,242,271.0,571,289,23.9,2016,0.0
Kevin Degnan,449,46,393,166,56,32,1598.0,226,85,49.0,167,81,16.4,2016,0.0
Scott King,349,43,305,125,48,34,1028.0,186,65,50.0,119,60,18.9,2016,0.0
Coleman Johnson,452,72,440,183,131,86,1972.0,2,0,101.0,438,183,16.2,2016,0.0
Mike Kirkland,264,35,233,92,94,70,846.0,38,10,55.0,195,82,21.9,2016,0.0
Steve Smith,138,15,144,45,9,7,528.0,134,41,18.0,10,4,16.5,2016,0.0
Matt Hill,0,1,0,0,1,0,7.0,0,0,1.0,0,0,10.4,2016,0.0
Myles Mann,34,2,38,15,13,4,211.0,0,0,11.0,38,15,13.3,2016,0.0
Francois Lewis,930,84,701,330,215,141,1958.0,344,129,101.0,357,201,23.7,2016,0.0
Isaiah Omoregie,145,2,101,61,56,23,296.0,1,0,26.0,100,61,25.7,2016,0.0
Jerran Foster,145,64,177,49,41,20,858.0,97,27,69.0,80,22,15.9,2016,0.0
Mario Karailiev,115,8,109,52,28,11,788.0,1,0,54.0,108,52,11.5,2016,0.0
Johnathan Spicer,61,12,62,21,28,18,400.0,11,1,35.0,51,20,14.2,2016,0.0
Chris Wise,1,0,6,0,2,1,15.0,4,0,2.0,2,0,29.6,2016,0.0
Jonathan Tshminga,0,0,1,0,0,0,1.0,0,0,0.0,1,0,49.6,2016,0.0
Marquan Botley,1018,272,868,319,270,214,2552.0,456,166,131.0,412,153,23.3,2016,0.0
Jackson Trapp,926,168,804,313,167,127,3323.0,479,173,161.0,325,140,16.5,2016,0.0
Solomon Poole,591,140,622,220,90,54,1608.0,313,97,184.0,309,123,28.0,2016,0.0
C.J. Turman,276,16,194,107,98,62,842.0,1,0,65.0,193,107,19.4,2016,0.0
Matthew Reed,39,0,30,17,5,5,161.0,0,0,4.0,30,17,11.8,2016,0.0
Javier Lacunza,175,9,157,58,39,30,698.0,94,29,32.0,63,29,15.8,2016,0.0
Connor Shorten,8,4,7,4,0,0,67.0,0,0,1.0,7,4,6.2,2016,0.0
Julian DeBose,1081,148,949,410,236,156,3284.0,319,105,161.0,630,305,19.5,2016,0.0
Filip Cvjeticanin,699,43,617,235,71,47,2129.0,496,182,85.0,121,53,17.3,2016,0.0
Alvin Cunningham,0,0,1,0,1,0,8.0,0,0,0.0,1,0,9.1,2016,0.0
Daviyon Draper,762,103,655,295,183,130,1925.0,109,42,148.0,546,253,24.3,2016,0.0
Adrian Diaz,1061,88,653,401,436,259,2418.0,0,0,190.0,653,401,22.8,2016,0.0
Jason Boswell,290,129,264,99,81,61,1703.0,106,31,114.0,158,68,12.7,2016,0.0
Ray Rodriguez,306,102,275,100,45,31,1260.0,213,75,108.0,62,25,16.9,2016,0.0
Nate Brown Bull,0,0,1,0,0,0,6.0,0,0,0.0,1,0,8.7,2016,0.0
Malik Beasley,529,51,393,185,128,104,1014.0,142,55,59.0,251,130,24.2,2016,1.0
Devon Bookert,1120,347,856,359,270,214,3567.0,449,188,246.0,407,171,17.7,2016,0.0
Boris Bojanovsky,683,60,423,244,282,195,2257.0,4,0,127.0,419,244,15.5,2016,0.0
Benji Bell,126,29,99,39,45,25,342.0,54,23,22.0,45,16,19.9,2016,0.0
Montay Brandon,899,196,669,311,409,252,3509.0,95,25,221.0,574,286,16.0,2016,0.0
Michael Saxton,20,0,17,8,0,0,34.0,10,4,1.0,7,4,25.7,2016,0.0
Dorian Finney-Smith,1429,256,1168,480,432,284,3834.0,511,185,240.0,657,295,21.9,2016,1.0
Brandone Francis,493,98,508,182,74,42,1793.0,277,87,70.0,231,95,17.5,2016,0.0
Lexx Edwards,4,2,7,1,2,1,53.0,5,1,1.0,2,0,8.5,2016,0.0
Zach Hodskins,2,0,7,1,1,0,15.0,3,0,1.0,4,1,28.5,2016,0.0
Jhonny Victor,0,1,1,0,0,0,5.0,0,0,1.0,1,0,19.3,2016,0.0
Ryan Rhoomes,953,94,631,389,308,175,3178.0,0,0,138.0,631,389,14.4,2016,0.0
Mandell Thomas,1385,274,1227,483,363,255,3607.0,460,164,212.0,767,319,22.2,2016,0.0
Nych Smith,628,151,506,220,169,125,1227.0,192,63,96.0,314,157,26.3,2016,0.0
Ryan Canty,323,15,259,138,108,47,1267.0,0,0,59.0,259,138,14.2,2016,0.0
Matt Massimino,2,1,4,1,0,0,23.0,0,0,1.0,4,1,11.0,2016,0.0
Marvelle Harris,2031,396,1595,667,678,506,4524.0,568,191,264.0,1027,476,25.3,2016,0.0
Julien Lewis,1276,155,1202,476,248,187,3437.0,423,137,192.0,779,339,22.6,2016,0.0
Cezar Guerrero,1147,309,938,373,287,232,3004.0,478,169,197.0,460,204,22.3,2016,0.0
Torren Jones,284,19,216,113,84,58,796.0,0,0,53.0,216,113,19.4,2016,0.0
Lionel Ellison III,51,34,45,10,42,28,433.0,18,3,18.0,27,7,9.4,2016,0.0
Ountae Campbell,77,26,77,29,17,9,559.0,41,10,22.0,36,19,9.6,2016,0.0
Grant Shell,2,1,5,1,0,0,13.0,3,0,4.0,2,1,34.1,2016,0.0
Stephen Croone,1936,385,1294,573,872,651,3744.0,463,139,365.0,831,434,29.6,2016,0.0
Kendrec Ferrara,893,83,756,357,227,129,2998.0,163,50,204.0,593,307,19.2,2016,0.0
Larry Wideman,723,115,679,246,154,105,2686.0,389,126,162.0,290,120,18.3,2016,0.0
Gene Langan,19,0,13,7,6,5,45.0,1,0,3.0,12,7,22.4,2016,0.0
Isaiah Watkins,22,1,24,7,11,8,96.0,2,0,7.0,22,7,18.6,2016,0.0
Harold McBride,703,212,589,226,186,147,1784.0,290,104,121.0,299,122,21.8,2016,0.0
Dylan Poston,502,52,464,165,75,54,1345.0,348,118,56.0,116,47,20.2,2016,0.0
Isaiah Ivey,572,85,485,183,152,122,1889.0,239,84,66.0,246,99,16.2,2016,0.0
Adonis Burbage,920,100,808,318,124,89,2897.0,524,195,141.0,284,123,17.1,2016,0.0
Herve Aholode,48,6,44,18,19,12,255.0,1,0,9.0,43,18,11.8,2016,0.0
Shevon Thompson,695,23,480,271,259,153,1635.0,1,0,157.0,479,271,23.6,2016,0.0
Marko Gujanicic,715,130,622,258,200,140,2326.0,205,59,162.0,417,199,19.2,2016,0.0
Patrick Holloway,786,62,746,286,97,72,1912.0,395,142,91.0,351,144,23.7,2016,0.0
Julian Royal,244,25,244,95,56,40,892.0,57,14,63.0,187,81,19.6,2016,0.0
Michael Rudy,5,0,5,2,2,1,26.0,0,0,1.0,5,2,13.5,2016,0.0
Patricio Garino,1550,221,1116,567,468,314,3877.0,280,102,289.0,836,465,21.3,2016,1.0
Kevin Larsen,1470,282,1093,559,497,328,4209.0,59,24,226.0,1034,535,18.8,2016,0.0
Joe McDonald,1154,447,930,378,465,305,3965.0,270,93,273.0,660,285,18.3,2016,0.0
Alex Mitola,1207,276,979,375,253,217,3390.0,625,240,172.0,354,135,20.0,2016,0.0
D'Vauntes Smith-Rivera,1919,386,1419,600,565,469,4257.0,691,250,215.0,728,350,23.6,2016,0.0
Paul White,887,157,696,311,200,155,2471.0,302,110,112.0,394,201,19.1,2016,0.0
Riyan Williams,8,4,10,2,9,4,56.0,4,0,4.0,6,2,16.7,2016,0.0
DeVince Boykins,343,99,317,132,119,34,1701.0,125,45,119.0,192,87,14.0,2016,0.0
D.J. Suter,12,1,11,5,0,0,31.0,7,2,0.0,4,3,18.1,2016,0.0
Kevin Ware,816,220,674,287,267,191,2839.0,154,51,195.0,520,236,18.7,2016,0.0
Markus Crider,824,132,598,330,249,164,3069.0,7,0,158.0,591,330,15.5,2016,0.0
T.J. Shipes,355,18,247,144,142,67,1809.0,0,0,71.0,247,144,11.6,2016,0.0
Alario Harris,0,0,2,0,0,0,3.0,0,0,1.0,2,0,54.7,2016,0.0
Marcus Georges-Hunt,1728,287,1314,569,625,468,4017.0,371,122,220.0,943,447,23.3,2016,1.0
Adam Smith,1562,178,1358,549,242,192,3384.0,696,272,137.0,662,277,24.8,2016,0.0
Nick Jacobs,1057,22,895,454,229,149,2691.0,1,0,149.0,894,454,22.7,2016,0.0
Charles Mitchell,1085,59,893,462,298,161,2786.0,0,0,227.0,893,462,22.9,2016,0.0
James White,863,78,706,357,240,146,2188.0,15,3,157.0,691,354,22.6,2016,1.0
Travis Jorgenson,180,168,209,67,30,20,1059.0,91,26,81.0,118,41,14.7,2016,0.0
Kenny Gaines,1324,125,1091,444,302,223,3138.0,569,213,154.0,522,231,23.0,2016,0.0
Charles Mann,1411,400,925,365,895,618,3645.0,192,63,399.0,733,302,25.1,2016,0.0
Osahen Iduwe,9,0,7,2,10,5,80.0,0,0,2.0,7,2,8.7,2016,0.0
Kyle Wiltjer,1909,190,1417,690,341,281,3504.0,583,248,186.0,834,442,26.0,2016,1.0
Domantas Sabonis,1002,97,608,384,314,229,1971.0,14,5,151.0,594,379,23.9,2016,1.0
Eric McClellan,846,190,622,278,321,228,2177.0,191,62,200.0,431,216,23.5,2016,0.0
Kyle Dranginis,703,298,548,255,153,98,2960.0,267,95,141.0,281,160,13.3,2016,0.0
Mark Gray,212,16,162,65,89,63,830.0,65,19,52.0,97,46,16.2,2016,0.0
Michael Bethea Jr.,163,20,174,52,32,26,589.0,129,33,24.0,45,19,19.0,2016,0.0
Arnold Richmond,153,35,123,47,77,52,420.0,36,7,57.0,87,40,27.0,2016,0.0
Ugur Hortum,75,11,79,26,27,17,410.0,20,6,26.0,59,20,15.1,2016,0.0
Valerio Altheimer,99,14,92,39,40,19,445.0,17,2,21.0,75,37,15.6,2016,0.0
Jack Ocwieja,24,0,24,11,2,2,148.0,1,0,5.0,23,11,10.6,2016,0.0
Jefkins Agyeman-Budu,37,7,53,13,13,5,263.0,15,6,33.0,38,7,18.6,2016,0.0
Grandy Glaze,670,52,521,289,154,92,1639.0,11,0,96.0,510,289,21.2,2016,0.0
De'Andre Davis,378,119,268,131,164,110,1077.0,38,6,87.0,230,125,20.6,2016,0.0
Ryan Majerle,455,46,354,144,83,67,1564.0,266,100,37.0,88,44,14.3,2016,0.0
Dominic Magee,703,107,571,245,214,135,1572.0,232,78,96.0,339,167,25.5,2016,0.0
Uros Ljeskovic,248,13,188,98,123,52,959.0,0,0,82.0,188,98,17.0,2016,0.0
Boubacar Toure,642,33,415,265,243,112,1741.0,2,0,140.0,413,265,19.6,2016,0.0
Grant White,259,65,226,85,105,64,965.0,92,25,90.0,134,60,19.9,2016,0.0
Jevon Estelle,23,6,24,8,9,6,109.0,9,1,7.0,15,7,16.3,2016,0.0
Carrington Love,1289,356,1052,421,444,287,3575.0,502,160,205.0,550,261,20.0,2016,0.0
Jordan Fouse,1136,397,924,421,396,242,4171.0,187,52,248.0,737,369,16.1,2016,0.0
Anthony Brown,74,19,53,22,36,24,324.0,12,6,19.0,41,16,12.2,2016,1.0
Avery Brown,28,6,29,10,8,2,81.0,15,6,4.0,14,4,20.2,2016,0.0
Henry Uwadiae,25,2,17,11,12,3,118.0,0,0,15.0,17,11,15.8,2016,0.0
Reggie Johnson,1254,225,1124,418,434,292,2917.0,427,126,211.0,697,292,26.1,2016,1.0
Quinton Chievous,891,93,666,335,313,173,2069.0,178,48,159.0,488,287,22.7,2016,0.0
Brian Darden,1152,140,947,330,315,261,2762.0,672,231,157.0,275,99,21.8,2016,0.0
Jervon Pressley,632,62,535,229,322,174,2207.0,2,0,210.0,533,229,19.8,2016,0.0
Dionte Adams,226,29,191,86,85,54,1027.0,3,0,48.0,188,86,12.9,2016,0.0
Gregory Hayden,25,7,18,6,21,11,57.0,6,2,15.0,12,4,36.2,2016,0.0
Justin Graham,442,119,377,139,158,112,1761.0,162,52,112.0,215,87,17.2,2016,0.0
Taylor Dyson,773,56,670,244,144,118,1968.0,460,167,90.0,210,77,23.1,2016,0.0
Evan Cooper,634,135,486,199,162,125,2020.0,297,111,116.0,189,88,18.4,2016,0.0
Dougal Weir,22,7,23,10,2,2,246.0,1,0,8.0,22,10,7.0,2016,0.0
Agunwa Okolie,530,101,392,208,187,107,1997.0,26,7,109.0,366,201,15.7,2016,0.0
Evan Cummins,323,88,232,137,86,49,1269.0,0,0,77.0,232,137,14.5,2016,0.0
Hunter Myers,3,0,1,1,0,0,4.0,1,1,1.0,0,0,26.6,2016,0.0
Stefan Jankovic,856,67,558,283,301,227,1531.0,175,63,109.0,383,220,25.8,2016,0.0
Roderick Bobbitt,745,367,571,219,292,225,2280.0,272,82,188.0,299,137,19.2,2016,0.0
Aaron Valdes,975,122,728,349,304,199,2137.0,231,78,113.0,497,271,22.5,2016,0.0
Quincy Smith,585,199,461,202,281,153,2013.0,99,28,135.0,362,174,17.7,2016,0.0
Sai Tummala,259,33,214,91,41,26,724.0,138,51,35.0,76,40,18.3,2016,0.0
Niko Filipovich,44,14,40,11,19,18,206.0,29,4,19.0,11,7,16.1,2016,0.0
Dyrbe Enos,49,7,59,16,6,2,190.0,51,15,11.0,8,1,18.7,2016,0.0
Jakob Cornelissen,0,0,4,0,0,0,7.0,3,0,0.0,1,0,27.8,2016,0.0
Adam Weary,1258,297,940,449,386,289,2987.0,212,71,221.0,728,378,23.5,2016,0.0
Lorenzo Cugini,1045,140,838,390,117,92,3137.0,420,173,112.0,418,217,16.8,2016,0.0
Haiishen McIntyre,401,226,324,130,176,128,1735.0,53,13,100.0,271,117,15.4,2016,0.0
Jorge Perez-Laham,248,196,235,92,46,30,1315.0,88,34,95.0,147,58,14.2,2016,0.0
DeAndre Barber,31,26,25,11,8,4,293.0,12,5,11.0,13,6,7.3,2016,0.0
K.J. James,50,13,37,19,29,12,228.0,2,0,15.0,35,19,15.7,2016,0.0
Juan'ya Green,2317,773,1752,695,842,681,5002.0,719,246,391.0,1033,449,25.0,2016,0.0
Ameen Tanksley,1750,174,1380,574,534,384,4193.0,599,218,220.0,781,356,21.7,2016,0.0
Denton Koon,982,132,777,367,244,169,2956.0,223,79,171.0,554,288,19.3,2016,0.0
Malik Nichols,310,68,242,124,122,57,939.0,24,5,75.0,218,119,19.7,2016,0.0
Cullen Hamilton,827,125,784,289,167,128,2677.0,378,121,109.0,406,168,20.0,2016,0.0
Eric Green,553,108,518,234,131,76,2047.0,42,9,99.0,476,225,18.1,2016,0.0
Marcellis Perkins,10,0,14,4,8,2,47.0,4,0,2.0,10,4,23.2,2016,0.0
Isaiah Baker,7,2,8,2,10,3,72.0,0,0,5.0,8,2,13.5,2016,0.0
Derek Mountain,2,0,3,1,0,0,7.0,0,0,1.0,3,1,31.5,2016,0.0
Anthony Odunsi,999,208,590,273,536,429,2136.0,76,24,234.0,514,249,25.0,2016,0.0
Jourdan Stickler,421,55,362,144,77,57,1179.0,186,76,65.0,176,68,19.0,2016,0.0
Caleb Crayton,635,102,546,225,204,136,2082.0,183,49,172.0,363,176,19.2,2016,0.0
Trey Patterson,147,55,93,54,80,38,573.0,13,1,56.0,80,53,15.8,2016,0.0
Isaiah Robinson,87,20,60,37,23,13,351.0,1,0,13.0,59,37,11.6,2016,0.0
Evan Anderson,11,3,6,3,6,4,21.0,2,1,4.0,4,2,29.7,2016,0.0
Devonta Pollard,954,113,755,340,377,271,2572.0,19,3,164.0,736,337,22.2,2016,0.0
LeRon Barnes,553,96,472,202,130,85,2411.0,181,64,83.0,291,138,13.1,2016,0.0
Eric Weary,217,28,242,77,35,24,735.0,169,39,38.0,73,38,20.9,2016,0.0
Keon Hill,248,129,288,88,51,32,1146.0,134,40,105.0,154,48,18.2,2016,0.0
Oliver Ellison,265,23,184,104,116,57,1861.0,0,0,75.0,184,104,8.6,2016,0.0
Saleem Little,8,0,8,2,4,3,28.0,4,1,2.0,4,1,20.0,2016,0.0
Patrick Speller,6,0,4,2,4,2,20.0,1,0,0.0,3,2,13.9,2016,0.0
Ali Faruq-Bey,222,15,183,73,61,44,402.0,98,32,41.0,85,41,31.1,2016,0.0
Ben Wilson,407,171,335,152,158,102,1961.0,3,1,103.0,332,151,13.6,2016,0.0
Clint Nwosuh,65,17,61,20,12,10,251.0,42,15,14.0,19,5,15.9,2016,0.0
Evann Hall,351,45,315,123,145,89,1095.0,56,16,92.0,259,107,23.0,2016,0.0
Spencer Nicolds,2,2,2,1,4,0,15.0,1,0,0.0,1,1,12.9,2016,0.0
Chris Sarbaugh,365,180,287,133,130,88,1805.0,37,11,128.0,250,122,13.9,2016,0.0
Nahshon George,166,16,142,61,67,44,589.0,1,0,68.0,141,61,20.9,2016,0.0
Skyler White,33,7,33,12,7,4,71.0,17,5,2.0,16,7,27.3,2016,0.0
Paulin Mpawe,142,11,123,52,78,38,782.0,0,0,43.0,123,52,13.3,2016,0.0
Najeal Young,169,23,150,67,57,35,622.0,3,0,41.0,147,67,16.3,2016,0.0
Jake Wiegand,687,27,535,239,278,200,1871.0,47,9,115.0,488,230,21.4,2016,0.0
Paris Burns,402,108,351,142,114,87,1016.0,103,31,85.0,248,111,24.4,2016,0.0
Gabe Snider,289,38,271,102,13,7,890.0,200,78,32.0,71,24,17.5,2016,0.0
Julian Torres,110,10,100,41,40,24,341.0,8,4,29.0,92,37,20.5,2016,0.0
Markese McGuire,283,48,284,88,110,71,1145.0,107,36,62.0,177,52,17.7,2016,0.0
Drew Hackett,29,11,36,8,15,10,184.0,22,3,16.0,14,5,14.9,2016,0.0
Hans Christian Lauer,21,0,14,4,16,13,84.0,4,0,2.0,10,4,14.5,2016,0.0
DeVaughn Akoon-Purcell,808,97,642,275,283,209,1629.0,163,49,140.0,479,226,29.0,2016,1.0
Justin McCloud,220,41,204,74,9,6,897.0,186,66,21.0,18,8,13.2,2016,0.0
Quintin Brewer,377,30,298,144,115,82,1388.0,20,7,93.0,278,137,17.3,2016,0.0
Kendrick Nunn,1795,262,1473,631,291,239,3796.0,762,294,213.0,711,337,24.7,2016,1.0
Khalid Lewis,573,277,579,205,178,120,2988.0,158,43,189.0,421,162,15.0,2016,0.0
Kyle Hittle,1339,173,903,453,334,242,2904.0,461,191,134.0,442,262,20.4,2016,0.0
Mitchell Badillo,737,390,510,245,226,174,2471.0,184,73,175.0,326,172,15.9,2016,0.0
Tavin Askew,15,0,16,7,4,1,67.0,0,0,1.0,16,7,14.2,2016,0.0
Devonte Brown,1170,281,824,339,623,431,3309.0,214,61,312.0,610,278,22.5,2016,0.0
Khristian Smith,1172,172,1014,415,376,266,3402.0,276,76,174.0,738,339,21.0,2016,0.0
Brandon Burnett,149,22,139,48,49,38,619.0,70,15,44.0,69,33,17.3,2016,0.0
Grant Prusator,115,12,101,37,14,7,361.0,91,34,7.0,10,3,16.6,2016,0.0
Kalen Alexander,3,1,3,1,0,0,14.0,1,1,0.0,2,0,11.5,2016,0.0
Yogi Ferrell,1986,633,1475,637,530,440,4496.0,681,272,312.0,794,365,22.7,2016,1.0
Troy Williams,1115,163,789,412,359,253,2486.0,117,38,221.0,672,374,23.7,2016,1.0
Max Bielfeldt,478,42,389,190,89,58,1241.0,105,40,64.0,284,150,21.1,2016,0.0
Nick Zeisloft,801,101,613,259,80,67,2620.0,532,216,59.0,81,43,13.7,2016,0.0
Ryan Burton,22,4,13,9,1,0,126.0,7,4,1.0,6,5,5.7,2016,0.0
Harrison Niego,11,6,13,4,3,1,110.0,8,2,4.0,5,2,8.3,2016,0.0
Jackson Tharp,0,0,0,0,0,0,5.0,0,0,1.0,0,0,9.9,2016,0.0
A.J. English,2004,510,1447,612,590,467,3855.0,836,313,330.0,611,299,26.3,2016,1.0
Aaron Rountree III,390,150,322,151,139,80,1885.0,31,8,99.0,291,143,12.8,2016,0.0
Ibn Muhammad,243,151,192,82,44,29,1503.0,127,50,61.0,65,32,8.9,2016,0.0
Ryden Hines,155,23,110,56,36,20,756.0,58,23,18.0,52,33,9.5,2016,0.0
Benjamin Nwokeabia,3,0,7,1,0,0,16.0,7,1,0.0,0,0,21.1,2016,0.0
Saren Westrop,0,1,3,0,0,0,24.0,3,0,0.0,0,0,6.0,2016,0.0
Georges Niang,2228,421,1697,849,448,342,4110.0,502,188,318.0,1195,661,26.9,2016,1.0
Abdel Nader,1207,127,1106,432,294,215,2845.0,420,128,267.0,686,304,27.5,2016,1.0
Jameel McKay,630,42,411,245,246,140,1654.0,0,0,77.0,411,245,18.4,2016,0.0
Jarrod Uthoff,1298,121,1018,458,308,245,2648.0,358,137,104.0,660,321,24.0,2016,1.0
Anthony Clemmons,701,344,567,235,237,159,2654.0,209,72,180.0,358,163,16.2,2016,0.0
Mike Gesell,1072,557,973,384,290,210,3490.0,302,94,227.0,671,290,19.2,2016,0.0
Adam Woodbury,851,108,651,332,295,187,2718.0,0,0,173.0,651,332,17.8,2016,0.0
Okey Ukah,13,1,13,6,4,1,71.0,0,0,3.0,13,6,12.5,2016,0.0
Michael Soukup,3,3,4,1,1,0,15.0,3,1,0.0,1,0,14.8,2016,0.0
Steven Soukup,0,1,4,0,0,0,14.0,2,0,0.0,2,0,14.2,2016,0.0
Max Landis,1477,287,1133,466,340,276,3730.0,721,269,184.0,412,197,20.4,2016,0.0
Joe Reed,1037,150,700,379,383,245,3241.0,113,34,136.0,587,345,16.3,2016,0.0
Michael Calder,486,121,401,158,144,96,1364.0,193,74,127.0,208,84,22.4,2016,0.0
Andrew Poulter,28,0,27,14,2,0,56.0,0,0,1.0,27,14,25.8,2016,0.0
Marcellus Barksdale,950,275,758,308,408,295,3544.0,161,39,228.0,597,269,17.4,2016,0.0
Nick Osborne,478,38,421,194,97,68,1437.0,64,22,83.0,357,172,20.3,2016,0.0
Jordan Pickett,248,50,220,83,72,59,717.0,77,23,39.0,143,60,20.6,2016,0.0
Mason Archie,406,69,385,137,103,77,1595.0,182,55,92.0,203,82,17.3,2016,0.0
John Hubler,15,0,19,4,5,3,87.0,15,4,7.0,4,0,16.8,2016,0.0
Leo Svete,148,9,161,48,28,19,476.0,122,33,23.0,39,15,22.3,2016,0.0
Raeford Worsham,952,131,716,342,414,248,2340.0,91,20,155.0,625,322,22.8,2016,0.0
Kaven Bernard,558,46,478,212,150,106,1210.0,105,28,75.0,373,184,25.8,2016,0.0
Troy Stancil,96,5,96,34,19,10,322.0,66,18,14.0,30,16,18.3,2016,0.0
Jonathan Thomas,30,6,17,9,20,12,272.0,0,0,17.0,17,9,8.1,2016,0.0
Jalen Manumaleuga,1,1,3,0,4,1,22.0,1,0,1.0,2,0,13.2,2016,0.0
Haudrick Hilaire,0,0,0,0,0,0,0.0,0,0,0.0,0,0,0,2016,0.0
Lindsey Hunter IV,0,0,0,0,0,0,2.0,0,0,0.0,0,0,0.0,2016,0.0
Marcus Love,118,29,125,40,46,28,547.0,53,10,30.0,72,30,16.3,2016,0.0
Kenneth Taylor,4,1,8,2,0,0,74.0,0,0,4.0,8,2,8.1,2016,0.0
JaQuail Townser,490,194,442,167,120,89,1615.0,184,67,118.0,258,100,20.0,2016,0.0
Jeremy Watson,405,22,301,118,209,154,1376.0,49,15,70.0,252,103,17.9,2016,0.0
DelFincko Bogan,753,222,604,272,110,93,2205.0,300,116,137.0,304,156,18.0,2016,0.0
Cam Biedscheid,240,38,227,81,45,37,670.0,137,41,36.0,90,40,23.2,2016,0.0
Ousmane Ba,3,3,6,1,8,1,87.0,0,0,5.0,6,1,8.9,2016,0.0
Deitrich Cole,27,6,29,11,11,5,196.0,1,0,11.0,28,11,12.1,2016,0.0
Kori Babineaux,1104,265,990,466,271,161,2375.0,61,11,222.0,929,455,28.7,2016,0.0
Josh Adeyeye,543,36,444,180,85,65,1258.0,299,118,62.0,145,62,22.2,2016,0.0
Marcellous Bell,337,40,314,104,68,56,876.0,225,73,26.0,89,31,21.6,2016,0.0
Cartree Pettis,16,28,11,5,10,5,206.0,1,1,13.0,10,4,6.8,2016,0.0
Shea Jones,48,19,46,15,15,6,242.0,28,12,19.0,18,3,15.7,2016,0.0
Daniel Terpin,0,0,3,0,0,0,6.0,1,0,1.0,2,0,32.4,2016,0.0
Ron Curry,1550,417,1222,493,518,373,4205.0,564,191,209.0,658,302,21.3,2016,0.0
Winston Grays,424,91,340,141,105,76,1410.0,184,66,66.0,156,75,17.3,2016,0.0
Devontae Morgan,83,25,65,30,52,21,317.0,8,2,14.0,57,28,17.1,2016,0.0
Kevin Kangni,9,3,19,3,3,2,58.0,11,1,3.0,8,2,20.7,2016,0.0
Matt Risse,7,0,3,3,0,0,19.0,1,1,0.0,2,2,8.1,2016,0.0
Justin Edwards,1508,342,1272,544,459,317,3573.0,352,103,312.0,920,441,25.7,2016,0.0
Stephen Hurt,678,63,527,250,222,157,1748.0,73,21,153.0,454,229,22.3,2016,0.0
Brian Rohleder,16,11,20,7,10,2,173.0,5,0,7.0,15,7,9.4,2016,0.0
Ron Freeman,92,9,103,32,30,19,270.0,50,9,16.0,53,23,23.5,2016,0.0
Perry Ellis,1798,148,1286,653,576,436,3604.0,130,56,174.0,1156,597,24.2,2016,0.0
Wayne Selden Jr.,1202,282,969,422,310,196,3217.0,443,162,211.0,526,260,20.7,2016,0.0
Brannen Greene,425,62,271,121,117,102,1079.0,192,81,73.0,79,40,18.6,2016,0.0
Jamari Traylor,516,88,370,197,193,122,2122.0,0,0,159.0,370,197,14.7,2016,0.0
Cheick Diallo,81,1,58,33,27,15,202.0,0,0,17.0,58,33,21.7,2016,1.0
Hunter Mickelson,442,45,414,192,82,56,1397.0,12,2,77.0,402,190,18.7,2016,0.0
Evan Manning,26,5,22,9,2,1,108.0,18,7,9.0,4,2,14.9,2016,0.0
Yonel Brown,1344,277,1107,433,366,303,3749.0,502,175,256.0,605,258,20.8,2016,0.0
Bernard Morena,564,76,463,209,208,125,1705.0,62,21,161.0,401,188,21.3,2016,0.0
Nigel Pruitt,950,106,794,306,252,188,2448.0,445,150,166.0,349,156,22.5,2016,0.0
Tracy Hector,301,180,296,110,125,68,1714.0,54,13,140.0,242,97,15.0,2016,0.0
Xavier Pollard,989,302,829,373,307,196,2452.0,190,47,221.0,639,326,24.1,2016,0.0
Chris Ortiz,633,54,534,215,236,155,2274.0,175,48,117.0,359,167,17.4,2016,0.0
Khaliq Spicer,568,33,398,227,224,114,2120.0,0,0,80.0,398,227,14.3,2016,0.0
Galal Cancer,812,288,711,266,297,207,2881.0,211,73,217.0,500,193,19.5,2016,0.0
Jamal Murray,720,79,538,244,152,119,1267.0,277,113,84.0,261,131,27.3,2016,1.0
Tyler Ulis,815,381,607,259,247,209,2170.0,237,88,107.0,370,171,19.3,2016,1.0
Alex Poythress,966,51,646,356,328,225,2480.0,96,29,149.0,550,327,19.3,2016,1.0
Skal Labissiere,237,11,190,98,62,41,567.0,2,0,33.0,188,98,22.2,2016,1.0
EJ Floreal,3,0,3,1,4,1,40.0,0,0,5.0,3,1,12.7,2016,0.0
Rohan Brown,226,29,178,86,70,41,1175.0,49,13,52.0,129,73,11.8,2016,0.0
Karl Harris,432,39,393,152,121,93,1145.0,131,35,66.0,262,117,22.7,2016,0.0
O.J. Lewis,23,3,22,7,12,5,62.0,7,4,5.0,15,3,27.8,2016,0.0
Bryce Scott,1240,270,944,419,231,189,3606.0,523,213,139.0,421,206,17.7,2016,0.0
Zach Rufer,464,141,406,152,96,60,1974.0,273,100,86.0,133,52,14.5,2016,0.0
Ben Freeland,137,13,118,61,26,15,718.0,0,0,52.0,118,61,13.5,2016,0.0
Nathaniel Musters,99,27,86,46,21,7,930.0,0,0,43.0,86,46,7.9,2016,0.0
Tyler Barlow,23,2,24,9,8,5,143.0,0,0,2.0,24,9,10.7,2016,0.0
Billy Murphy,26,3,28,11,1,0,67.0,16,4,2.0,12,7,24.5,2016,0.0
Kevin Booze,433,199,353,138,135,102,1140.0,157,55,122.0,196,83,22.3,2016,0.0
Dontavious Sears,412,28,343,154,75,49,827.0,181,55,40.0,162,99,23.9,2016,0.0
Preston Mattingly,275,67,205,94,131,80,1213.0,29,7,39.0,176,87,12.0,2016,0.0
Quan Jones,270,77,204,74,128,93,923.0,80,29,84.0,124,45,17.9,2016,0.0
LeMon Gregory,213,13,156,93,56,27,714.0,0,0,59.0,156,93,16.0,2016,0.0
Christian Kennedy,9,0,17,4,8,1,85.0,1,0,5.0,16,4,13.9,2016,0.0
Jesse Chuku,754,80,652,268,135,94,2481.0,331,124,93.0,321,144,17.2,2016,0.0
Justin Goldsborough,568,42,407,233,171,102,2034.0,0,0,127.0,407,233,16.0,2016,0.0
Tyler Jenkins,77,30,61,26,15,11,298.0,35,14,31.0,26,12,17.3,2016,0.0
John Ross Glover,171,21,155,62,55,36,488.0,33,11,42.0,122,51,22.7,2016,0.0
Evan Maxwell,380,17,241,151,125,78,863.0,0,0,85.0,241,151,24.6,2016,0.0
Anthony Fields,222,127,209,83,62,41,1229.0,56,15,90.0,153,68,14.8,2016,0.0
Hansel Atencia,28,17,27,8,19,11,165.0,6,1,10.0,21,7,15.6,2016,0.0
Sam Worman,8,0,8,4,0,0,29.0,1,0,4.0,7,4,23.1,2016,0.0
Calvin Hoffman,8,4,15,2,2,2,67.0,11,2,7.0,4,0,18.1,2016,0.0
David Wishon,210,8,166,81,93,48,771.0,0,0,75.0,166,81,18.9,2016,0.0
J.J. Butler,128,109,130,49,40,19,986.0,50,11,86.0,80,38,11.6,2016,0.0
Charles Smith,29,1,20,8,21,13,146.0,0,0,4.0,20,8,11.4,2016,1.0
Nick Faust,1553,304,1279,518,471,323,3827.0,581,194,299.0,698,324,23.5,2016,0.0
Travis Hammonds,611,75,462,206,155,113,1534.0,220,86,97.0,242,120,20.7,2016,0.0
A.J. Spencer,573,105,509,229,100,71,1796.0,143,44,68.0,366,185,17.3,2016,0.0
Branford Jones,560,173,479,187,158,120,1984.0,198,66,120.0,281,121,17.2,2016,0.0
Martin Hermannsson,805,246,566,244,296,259,2061.0,180,58,141.0,386,186,19.8,2016,0.0
Aakim Saintil,586,203,471,167,254,199,1611.0,200,53,135.0,271,114,21.8,2016,0.0
Trevin Woods,235,20,239,82,34,26,930.0,156,45,35.0,83,37,15.1,2016,0.0
Trevon Woods,86,7,108,31,12,7,326.0,66,17,21.0,42,14,20.1,2016,0.0
Lotanna Nwogbo,830,29,540,314,306,200,1767.0,5,2,151.0,535,312,24.0,2016,0.0
Tra'Vaughn White,569,104,516,194,148,116,1353.0,200,65,69.0,316,129,24.2,2016,0.0
Shaquille Johnson,865,230,741,318,246,169,2352.0,240,60,245.0,501,258,24.0,2016,0.0
Leron Fisher,695,202,570,207,273,200,2126.0,222,81,163.0,348,126,20.7,2016,0.0
Al Burge,16,1,13,7,2,2,32.0,2,0,2.0,11,7,24.8,2016,0.0
Aron Petros,0,0,0,0,0,0,0.0,0,0,0.0,0,0,0,2016,0.0
Shawn Long,2342,148,1732,871,722,488,4017.0,328,112,328.0,1404,759,28.4,2016,1.0
Kasey Shepherd,1013,192,789,331,222,189,2190.0,441,162,177.0,348,169,23.1,2016,0.0
Hayward Register,466,24,464,155,38,27,1040.0,377,129,25.0,87,26,22.9,2016,0.0
Devonta Walker,526,51,339,175,225,172,1204.0,13,4,103.0,326,171,21.5,2016,0.0
Steven Wronkoski,579,86,469,186,147,110,2448.0,281,97,137.0,188,89,13.2,2016,0.0
Jay Hedgeman,114,26,81,32,63,44,326.0,29,6,18.0,52,26,18.4,2016,0.0
Tyrone Wooten,65,16,56,23,26,16,175.0,17,3,18.0,39,20,22.9,2016,0.0
Tiremone Williams,55,32,52,18,29,16,395.0,19,3,21.0,33,15,10.3,2016,0.0
Elijah McGuire,10,3,14,4,5,1,59.0,7,1,1.0,7,3,13.7,2016,0.0
Matt Marlin,6,3,7,2,2,1,35.0,4,1,2.0,3,1,13.2,2016,0.0
Justin Roberson,832,198,717,314,218,154,2187.0,144,50,147.0,573,264,23.3,2016,0.0
Jamaal Samuel,652,40,615,268,75,43,1891.0,226,73,85.0,389,195,20.5,2016,0.0
DeMondre Harvey,474,67,306,175,197,124,1765.0,0,0,80.0,306,175,14.3,2016,0.0
Mack Foster,247,54,238,93,51,32,1061.0,111,29,43.0,127,64,15.3,2016,0.0
Ben Simmons,632,158,386,216,297,199,1151.0,3,1,111.0,383,215,26.4,2016,1.0
Tim Quarterman,830,302,683,271,288,190,2461.0,316,98,168.0,367,173,19.4,2016,1.0
Keith Hornsby,1291,213,1015,446,269,223,3217.0,451,176,158.0,564,270,19.7,2016,0.0
Josh Gray,684,275,668,262,189,123,2094.0,171,37,228.0,497,225,23.2,2016,1.0
Henry Shortess,8,2,8,3,0,0,28.0,5,2,3.0,3,1,18.9,2016,0.0
Alex Hamilton,1986,501,1387,636,834,604,3895.0,391,110,316.0,996,526,26.1,2016,0.0
LeAntwan Luckett,1533,214,1351,520,603,404,3384.0,342,89,264.0,1009,431,28.6,2016,0.0
Branden Sheppard,74,8,52,35,18,4,411.0,0,0,17.0,52,35,9.0,2016,0.0
Damion Lee,2016,244,1468,636,578,487,4104.0,710,257,217.0,758,379,26.0,2016,1.0
Trey Lewis,1448,297,1153,482,342,259,3480.0,587,225,229.0,566,257,22.7,2016,0.0
Chinanu Onuaku,411,70,294,182,86,47,1385.0,1,0,109.0,293,182,16.1,2016,1.0
Montel James,691,35,527,256,258,176,1529.0,16,3,102.0,511,253,27.8,2016,0.0
Devon Turk,1205,96,973,413,143,117,3046.0,650,262,147.0,323,151,21.9,2016,0.0
Earl Peterson,594,142,430,202,195,150,1783.0,100,40,120.0,330,162,20.4,2016,0.0
Jeff White,656,312,579,242,168,127,2954.0,135,45,202.0,444,197,16.3,2016,0.0
Julius Rajala,108,11,79,46,25,15,420.0,2,1,32.0,77,45,16.4,2016,0.0
Cal Kennedy,20,0,16,9,0,0,44.0,6,2,2.0,10,7,22.6,2016,0.0
Adom Jacko,414,16,305,170,100,73,683.0,2,1,45.0,303,169,29.3,2016,0.0
Marin Mornar,662,60,504,245,162,118,2176.0,158,54,93.0,346,191,16.0,2016,0.0
David Humphries,350,84,304,117,71,50,1324.0,179,66,65.0,125,51,16.0,2016,0.0
Joshua Spiers,150,23,121,49,19,15,481.0,95,37,21.0,26,12,16.1,2016,0.0
Matt Hayes,141,26,138,47,12,10,507.0,98,37,19.0,40,10,17.1,2016,0.0
Eric Laster,892,121,845,330,217,126,2706.0,316,106,134.0,529,224,21.1,2016,0.0
Tyler Hubbard,879,84,776,273,194,144,2655.0,553,189,92.0,223,84,19.0,2016,0.0
Franz Rassman,745,71,626,299,178,122,2375.0,79,25,132.0,547,274,18.7,2016,0.0
Josh Forney,18,0,9,7,16,4,115.0,0,0,10.0,9,7,12.3,2016,0.0
Sean Tuohy Jr.,10,3,16,3,5,3,78.0,11,1,4.0,5,2,15.1,2016,0.0
Kevin Little,807,205,775,285,117,89,1896.0,424,148,160.0,351,137,25.6,2016,0.0
Devine Eke,669,74,444,275,333,115,2065.0,13,4,103.0,431,271,16.4,2016,0.0
Issac Vann,1105,187,903,386,303,237,2772.0,304,96,168.0,599,290,21.4,2016,0.0
Till Gloger,911,37,699,376,222,159,2256.0,3,0,137.0,696,376,20.8,2016,0.0
Shaun Lawton,787,303,624,255,309,221,2647.0,185,56,259.0,439,199,19.3,2016,0.0
Lavar Harewood,404,49,345,126,118,85,1195.0,192,67,70.0,153,59,19.0,2016,0.0
Troy Reid-Knight,438,132,368,141,125,87,1517.0,198,69,134.0,170,72,18.0,2016,0.0
Garet Beal,272,62,239,85,90,67,959.0,131,35,77.0,108,50,18.5,2016,0.0
Walter King,10,3,11,4,5,2,39.0,1,0,2.0,10,4,17.8,2016,0.0
Shane Richards,1472,149,1103,443,330,274,3569.0,801,312,158.0,302,131,20.5,2016,0.0
RaShawn Stores,768,314,592,223,258,179,3127.0,364,143,173.0,228,80,14.7,2016,0.0
Samson Akilo,30,3,24,13,6,4,239.0,0,0,14.0,24,13,8.9,2016,0.0
Carlton Allen,48,2,35,17,22,14,357.0,0,0,17.0,35,17,8.9,2016,0.0
Jason Camus,0,0,0,0,0,0,1.0,0,0,0.0,0,0,0.0,2016,0.0
Chris Rivera,0,1,0,0,0,0,6.0,0,0,0.0,0,0,0.0,2016,0.0
Eric Truog,298,114,283,127,75,33,1643.0,39,11,88.0,244,116,13.1,2016,0.0
K.J. Lee,198,73,175,70,54,37,1115.0,55,21,63.0,120,49,12.6,2016,0.0
Phillip Lawrence-Ricks,417,51,345,150,115,74,1533.0,137,43,60.0,208,107,15.9,2016,0.0
Kyle Daugherty,9,1,7,2,5,5,16.0,5,0,1.0,2,2,33.4,2016,0.0
Courtney Clyburn,5,2,7,0,9,5,24.0,2,0,2.0,5,0,28.5,2016,0.0
James Griffin,38,4,44,12,14,11,203.0,27,3,29.0,17,9,21.3,2016,0.0
Henry Ellenson,561,59,435,194,191,143,1107.0,104,30,78.0,331,164,26.7,2016,1.0
Wally Ellenson,89,14,99,35,22,11,364.0,38,8,14.0,61,27,17.1,2016,0.0
Michael Mache,3,0,3,1,2,1,16.0,0,0,0.0,3,1,12.7,2016,0.0
James Kelly,826,53,613,325,153,112,1491.0,196,64,95.0,417,261,25.2,2016,0.0
Justin Edmonds,380,63,330,123,108,61,949.0,213,73,80.0,117,50,23.3,2016,0.0
Brett Bowling,35,1,37,11,10,8,90.0,28,5,4.0,9,6,24.3,2016,0.0
Noah Frampton,5,3,11,2,0,0,64.0,9,1,2.0,2,1,9.2,2016,0.0
Cody Joyce,1048,71,778,400,392,248,2756.0,1,0,164.0,777,400,21.3,2016,0.0
Jakob Stenhede,51,1,40,19,26,13,284.0,0,0,9.0,40,19,11.6,2016,0.0
Devin Martin,925,105,732,310,230,179,1883.0,334,126,136.0,398,184,26.8,2016,0.0
Dominique Elliott,701,88,510,261,269,173,1660.0,31,6,164.0,479,255,24.9,2016,0.0
Shane Randall,161,15,121,52,67,55,779.0,9,2,55.0,112,50,13.7,2016,0.0
Mark Blackmon,188,36,148,58,73,51,714.0,61,21,37.0,87,37,15.9,2016,0.0
Joshu'a Warren,18,0,17,7,8,4,93.0,0,0,12.0,17,7,18.0,2016,0.0
Stephen Spurlock,26,3,29,10,10,6,153.0,2,0,4.0,27,10,12.7,2016,0.0
Maurice Coleman,7,1,3,1,6,5,33.0,2,0,2.0,1,1,12.2,2016,0.0
Robert Carter,1012,123,792,391,252,172,2383.0,195,58,170.0,597,333,23.6,2016,0.0
Diamond Stone,436,15,294,167,134,102,807.0,0,0,53.0,294,167,26.7,2016,1.0
Jake Layman,1436,156,1083,482,361,274,3938.0,547,198,204.0,536,284,19.3,2016,1.0
Rasheed Sulaimon,1307,309,991,425,373,285,3491.0,429,172,173.0,562,253,19.9,2016,0.0
Varun Ram,39,19,39,7,25,19,291.0,29,6,21.0,10,1,12.9,2016,0.0
Trevor Anzmann,3,2,3,1,0,0,28.0,3,1,3.0,0,0,11.3,2016,0.0
Mark Cornelius,386,116,319,143,99,63,1468.0,106,37,101.0,213,106,16.5,2016,0.0
Keith Hayes II,140,16,92,41,54,44,320.0,38,14,16.0,54,27,20.2,2016,0.0
DJ Mlachnik,324,50,288,103,71,53,1194.0,190,65,61.0,98,38,17.2,2016,0.0
Jabarie Hinds,1204,326,1111,461,225,155,3318.0,384,127,232.0,727,334,21.8,2016,0.0
Antwan Space,451,72,425,170,158,85,1619.0,111,26,104.0,314,144,19.5,2016,0.0
Tyler Bergantino,160,18,114,73,41,14,1136.0,1,0,21.0,113,73,6.7,2016,0.0
Chris Lydon,0,0,0,0,0,0,3.0,0,0,0.0,0,0,0.0,2016,0.0
Craig McFerrin,834,67,686,353,224,128,2484.0,7,0,185.0,679,353,19.5,2016,0.0
Tevin Jackson,165,45,163,67,31,20,512.0,37,11,43.0,126,56,21.1,2016,0.0
Austin Lewis,406,16,319,175,107,56,1609.0,1,0,63.0,318,175,13.4,2016,0.0
Matthew Moss,208,17,205,76,26,16,767.0,135,40,33.0,70,36,16.2,2016,0.0
Shaun Johnson,324,62,363,104,44,35,1038.0,280,81,37.0,83,23,20.2,2016,0.0
Derrell Joubert,17,0,13,6,0,0,30.0,11,5,2.0,2,1,24.9,2016,0.0
Andrija Milovanovic,19,3,19,5,4,4,79.0,14,5,2.0,5,0,14.4,2016,0.0
Shaq Goodwin,1440,206,1003,518,602,395,3504.0,36,9,266.0,967,509,21.5,2016,0.0
Ricky Tarrant,1658,375,1205,468,658,525,3760.0,611,197,242.0,594,271,23.9,2016,0.0
Trahson Burrell,602,146,502,219,159,115,1507.0,160,49,80.0,342,170,21.2,2016,0.0
Nick Marshall,97,7,79,43,20,11,274.0,0,0,13.0,79,43,17.2,2016,0.0
Sam Craft,37,16,44,14,6,5,211.0,15,4,8.0,29,10,12.1,2016,0.0
Kedren Johnson,758,260,628,249,225,170,2293.0,275,90,199.0,353,159,22.1,2016,0.0
Caleb Wallingford,5,3,9,2,2,1,30.0,5,0,2.0,4,2,18.5,2016,0.0
Phillip Leonard,770,337,535,247,421,268,2166.0,53,8,144.0,482,239,21.6,2016,0.0
Jestin Lewis,472,64,384,163,88,64,1097.0,222,82,54.0,162,81,23.1,2016,0.0
Lawrence Brown,152,14,114,60,46,31,627.0,2,1,25.0,112,59,13.5,2016,0.0
James Bento,41,9,45,18,15,5,292.0,1,0,8.0,44,18,10.9,2016,0.0
Jibri Bryan,513,69,441,164,130,93,1706.0,280,92,86.0,161,72,18.8,2016,0.0
Niklas Ney,39,1,22,9,25,21,145.0,0,0,10.0,22,9,16.5,2016,0.0
Tyre Moore,16,0,11,3,10,8,54.0,9,2,2.0,2,1,17.6,2016,0.0
Sheldon McClellan,1963,180,1392,634,632,517,4237.0,523,178,180.0,869,456,23.2,2016,0.0
Angel Rodriguez,1462,558,1193,449,488,373,3585.0,583,191,326.0,610,258,25.7,2016,0.0
Tonye Jekiri,769,97,623,312,225,144,3053.0,5,1,142.0,618,311,15.7,2016,0.0
Ivan Cruz Uceda,276,10,219,96,27,24,782.0,149,60,32.0,70,36,18.3,2016,0.0
Geovonie McKnight,1215,237,1101,452,400,285,3510.0,116,26,277.0,985,426,23.9,2016,0.0
Eric Washington,1251,560,892,389,469,380,3498.0,282,93,340.0,610,296,22.8,2016,1.0
Chris Bryant,320,24,238,114,142,91,1179.0,4,1,64.0,234,113,16.8,2016,0.0
L.J. Livingston,302,4,188,120,98,62,991.0,0,0,33.0,188,120,14.4,2016,0.0
Willie Moore,596,118,502,188,205,154,1937.0,219,66,181.0,283,122,21.4,2016,0.0
Kalif Wright,158,2,158,68,39,21,495.0,1,1,25.0,157,67,21.9,2016,0.0
Ali Barnes,52,5,48,17,8,7,195.0,33,11,10.0,15,6,16.8,2016,0.0
Jere Vucica,41,1,32,15,16,10,86.0,6,1,3.0,26,14,26.3,2016,0.0
Brian Oddo,30,3,28,11,5,3,147.0,18,5,6.0,10,6,13.2,2016,0.0
Denzel Valentine,1645,639,1309,579,285,222,4182.0,650,265,317.0,659,314,22.1,2016,1.0
Bryn Forbes,1742,182,1258,565,351,288,4010.0,745,324,164.0,513,241,20.9,2016,1.0
Matt Costello,828,107,573,325,247,176,2281.0,12,2,98.0,561,323,18.0,2016,1.0
Deyonta Davis,261,26,199,119,38,23,650.0,0,0,30.0,199,119,19.3,2016,1.0
Marvin Clark Jr.,1062,97,817,367,202,159,2773.0,450,169,155.0,367,198,19.6,2016,0.0
Javon Bess,1115,170,856,342,462,339,3017.0,303,92,134.0,553,250,20.4,2016,0.0
Colby Wollenman,80,26,56,32,29,16,442.0,0,0,30.0,56,32,11.8,2016,0.0
Caris LeVert,1070,275,843,366,265,204,2721.0,334,134,136.0,509,232,22.8,2016,1.0
Aubrey Dawkins,960,75,718,341,149,122,2289.0,370,156,94.0,348,185,20.8,2016,0.0
Andrew Dakich,123,93,100,44,21,17,849.0,49,18,50.0,51,26,9.9,2016,0.0
Perrin Buford,702,89,530,267,206,143,1639.0,57,25,112.0,473,242,23.6,2016,0.0
Darnell Harris,649,65,532,224,164,111,1572.0,232,90,77.0,300,134,22.8,2016,0.0
Jaqawn Raymond,684,181,557,214,181,134,2641.0,334,122,158.0,223,92,16.0,2016,0.0
Jacob Ivory,135,52,95,34,78,65,525.0,17,2,44.0,78,32,17.8,2016,0.0
Matt Tiby,1332,191,900,390,574,455,2811.0,282,97,245.0,618,293,26.3,2016,0.0
J.J. Panoske,826,103,692,312,133,109,2227.0,278,93,151.0,414,219,21.2,2016,0.0
J.R. Lyle,359,61,293,126,100,62,1242.0,147,45,64.0,146,81,17.1,2016,0.0
JayQuan McCloud,1153,247,900,371,300,253,2338.0,440,158,177.0,460,213,24.6,2016,0.0
Scotty Tyler,61,10,52,26,10,7,303.0,5,2,14.0,47,24,12.2,2016,0.0
Joey King,1140,146,829,372,268,223,3250.0,447,173,153.0,382,199,17.7,2016,0.0
Carlos Morris,603,104,515,219,152,108,1459.0,159,57,113.0,356,162,24.4,2016,0.0
Kevin Dorsey,178,37,161,58,75,54,484.0,43,8,36.0,118,50,24.6,2016,0.0
Mike Lukashewich,5,0,2,2,0,0,35.0,1,1,2.0,1,1,5.8,2016,0.0
Gavin Ware,1362,52,943,532,435,298,3328.0,1,0,185.0,942,532,20.5,2016,0.0
Craig Sword,1492,305,1152,517,603,383,3354.0,285,75,391.0,867,442,27.9,2016,0.0
Fred Thomas,1050,143,931,340,274,204,3229.0,551,166,153.0,380,174,19.4,2016,0.0
Travis Daniels,358,40,309,133,72,48,1309.0,133,44,79.0,176,89,16.8,2016,0.0
Johnny Zuppardo,129,9,118,50,16,11,527.0,50,18,34.0,68,32,15.3,2016,0.0
Reggie Patterson,6,0,5,2,3,2,14.0,1,0,1.0,4,2,26.2,2016,0.0
Carter Holmes,0,0,2,0,0,0,9.0,2,0,1.0,0,0,16.5,2016,0.0
Jett Jobe,0,1,3,0,0,0,14.0,0,0,0.0,3,0,10.6,2016,0.0
Damian Young,270,32,259,93,63,50,680.0,105,34,54.0,154,59,24.6,2016,0.0
Latrell Love,398,26,328,132,201,134,1052.0,4,0,59.0,324,132,22.3,2016,0.0
Dusan Langura,29,0,34,10,0,0,88.0,30,9,2.0,4,1,20.1,2016,0.0
John Sanders,21,6,19,8,2,2,132.0,7,3,8.0,12,5,10.3,2016,0.0
Bennett Davis,12,0,7,6,2,0,43.0,0,0,5.0,7,6,14.7,2016,0.0
Amir Savon,2,0,4,1,0,0,34.0,0,0,0.0,4,1,5.7,2016,0.0
Stefan Moody,1749,278,1301,527,545,462,2955.0,641,233,277.0,660,294,31.0,2016,0.0
Tomasz Gielo,1041,143,878,370,214,168,3109.0,368,133,176.0,510,237,18.8,2016,0.0
Anthony Perez,564,68,456,175,204,139,1860.0,224,75,111.0,232,100,17.3,2016,0.0
Martavious Newby,403,158,317,122,182,130,2062.0,116,29,120.0,201,93,12.4,2016,0.0
Sam Finley,460,32,359,141,196,149,883.0,113,29,64.0,246,112,29.6,2016,0.0
J.T. Escobar,1080,119,872,366,112,89,2794.0,665,259,143.0,207,107,18.4,2016,0.0
Jake Coddington,5,0,2,2,0,0,26.0,1,1,0.0,1,1,3.7,2016,0.0
Shayok M. Shayok,430,38,371,175,143,68,1684.0,38,12,109.0,333,163,16.8,2016,0.0
Thaddeus Smith,113,5,98,48,49,17,849.0,0,0,49.0,98,48,10.4,2016,0.0
Noah Knight,142,35,105,43,73,43,456.0,50,13,29.0,55,30,19.3,2016,0.0
Ikem Eriobuna,13,1,11,3,6,5,44.0,7,2,2.0,4,1,18.2,2016,0.0
Wyatt Voorhes,0,0,0,0,0,0,1.0,0,0,0.0,0,0,0.0,2016,0.0
Camyn Boone,647,60,461,244,232,159,1485.0,0,0,86.0,461,244,23.3,2016,0.0
Dorrian Williams,663,373,656,231,196,135,3102.0,235,66,207.0,421,165,16.8,2016,0.0
Loomis Gerring,224,22,235,81,80,55,869.0,38,7,58.0,197,74,20.6,2016,0.0
Ryan Rosburg,530,40,353,213,204,104,2106.0,0,0,92.0,353,213,13.4,2016,0.0
D'Angelo Allen,150,29,136,60,41,20,721.0,24,10,27.0,112,50,13.5,2016,0.0
Jimmy Barton,100,61,108,36,18,12,562.0,58,16,48.0,50,20,14.5,2016,0.0
Deon Jones,1452,160,1112,487,533,405,3636.0,235,73,278.0,877,414,22.8,2016,0.0
Tyler Robinson,0,0,0,0,0,0,1.0,0,0,0.0,0,0,0.0,2016,0.0
Marcus Colbert,1372,453,1108,468,343,260,3400.0,460,176,269.0,648,292,23.1,2016,0.0
Danny Robison,554,37,402,181,212,144,1948.0,148,48,95.0,254,133,15.7,2016,0.0
Stephan Holm,578,33,486,205,59,44,1465.0,321,124,74.0,165,81,20.6,2016,0.0
Nahjee Matlock,59,30,73,19,20,13,311.0,28,8,33.0,45,11,18.0,2016,0.0
Shikei Blake,56,1,45,19,24,18,219.0,0,0,13.0,45,19,15.3,2016,0.0
Tyson Kanseyo,22,7,14,7,17,8,209.0,0,0,20.0,14,7,9.7,2016,0.0
Quinn Price,23,3,27,10,6,3,197.0,0,0,11.0,27,10,10.8,2016,0.0
Martin Breunig,1195,112,759,457,383,275,2143.0,29,6,164.0,730,451,27.8,2016,0.0
Bryden Boehning,28,6,28,13,7,2,135.0,0,0,10.0,28,13,16.1,2016,0.0
Riley Bradshaw,140,46,145,49,25,20,802.0,74,22,39.0,71,27,13.5,2016,0.0
Brent Arrington,1366,303,1157,447,461,339,3657.0,432,133,265.0,725,314,21.9,2016,0.0
Anthony Elechi,407,20,307,163,104,80,1057.0,4,1,58.0,303,162,19.3,2016,0.0
Lyonell Gaines,718,101,572,296,181,115,2419.0,46,11,103.0,526,285,16.0,2016,0.0
Jared Ravenscraft,37,9,27,13,7,3,77.0,21,8,2.0,6,5,20.5,2016,0.0
Cedric Blossom,1084,76,879,403,414,272,2886.0,31,6,126.0,848,397,20.5,2016,0.0
Rasean Simpson,455,32,384,157,188,127,1343.0,51,14,67.0,333,143,19.8,2016,0.0
Andre Horne Jr.,248,34,213,83,63,49,583.0,98,33,38.0,115,50,23.7,2016,0.0
Donte Pretlow,538,340,659,199,184,109,2789.0,157,31,202.0,502,168,16.7,2016,0.0
Jamar Redmond,111,9,122,36,29,15,351.0,87,24,20.0,35,12,22.0,2016,0.0
Andrew Hampton,108,7,92,38,7,4,254.0,65,28,2.0,27,10,19.0,2016,0.0
Anthony Tate,0,1,0,0,0,0,4.0,0,0,0.0,0,0,0.0,2016,0.0
Gregory Graves,827,77,662,275,339,229,2606.0,153,48,135.0,509,227,19.0,2016,0.0
Taylor Danaher,685,47,482,263,206,152,2375.0,31,7,120.0,451,256,15.1,2016,0.0
Troy Henderson,16,0,19,5,3,2,121.0,16,4,4.0,3,1,10.2,2016,0.0
Liam McManimon,27,8,33,7,10,8,114.0,25,5,7.0,8,2,20.4,2016,0.0
Chris Manning,0,0,1,0,0,0,47.0,0,0,0.0,1,0,1.1,2016,0.0
Jeffery Moss,1409,249,1047,469,309,253,4057.0,538,218,152.0,509,251,17.0,2016,0.0
Wayne Langston,500,48,309,193,174,114,1331.0,0,0,67.0,309,193,18.1,2016,0.0
Chad Culbreath,92,32,92,35,18,10,254.0,43,12,24.0,49,23,26.0,2016,0.0
A.J. Patty,30,0,29,10,12,10,93.0,5,0,4.0,24,10,22.0,2016,0.0
Charles Brown,27,4,18,9,13,9,127.0,0,0,5.0,18,9,12.2,2016,0.0
Terron Gilmore,55,4,38,18,31,19,338.0,0,0,25.0,38,18,11.6,2016,0.0
Tilman Dunbar,1094,434,926,379,450,310,3240.0,83,26,259.0,843,353,23.8,2016,0.0
Will Kelly,770,86,532,298,319,174,2676.0,0,0,174.0,532,298,17.4,2016,0.0
Kendall Knorr,498,138,446,169,96,80,2100.0,265,80,75.0,181,89,14.8,2016,0.0
Nathan Messer,3,1,1,1,0,0,3.0,1,1,0.0,0,0,17.5,2016,0.0
Devin Patterson,1215,311,897,379,422,341,2709.0,328,116,247.0,569,263,23.2,2016,0.0
Jake White,872,32,622,314,281,212,1790.0,105,32,99.0,517,282,22.7,2016,0.0
Tim Smallwood,302,43,279,104,55,32,901.0,188,62,48.0,91,42,18.2,2016,0.0
Randy Reed,292,27,198,106,101,75,829.0,16,5,49.0,182,101,16.5,2016,0.0
Devin Newsome,20,21,32,7,6,2,234.0,15,4,13.0,17,3,9.5,2016,0.0
Shavon Shields,1630,223,1236,562,565,429,3861.0,260,77,254.0,976,485,24.5,2016,0.0
Benny Parker,459,226,416,159,137,103,2910.0,135,38,134.0,281,121,11.4,2016,0.0
Jake Hammond,66,7,58,24,42,18,347.0,0,0,15.0,58,24,13.8,2016,0.0
Bakari Evelyn,811,226,706,272,176,140,2573.0,388,127,203.0,318,145,19.8,2016,0.0
Patrick McCaw,793,214,622,273,162,122,2060.0,341,125,125.0,281,148,20.0,2016,1.0
Ike Nwamu,1256,150,951,404,377,272,2815.0,472,176,198.0,479,228,24.6,2016,0.0
Derrick Jones Jr.,345,24,219,129,133,79,646.0,39,8,36.0,180,121,23.2,2016,1.0
Jerome Seagears,987,385,850,335,225,174,3235.0,394,143,203.0,456,192,17.8,2016,0.0
Stephen Zimmerman Jr.,272,22,214,102,101,63,680.0,17,5,54.0,197,97,21.9,2016,0.0
Jordan Cornish,979,306,913,325,267,174,3106.0,460,155,254.0,453,170,20.7,2016,0.0
Goodluck Okonoboh,197,23,165,83,91,31,918.0,0,0,35.0,165,83,14.0,2016,0.0
Austin Starr,144,30,145,40,38,30,570.0,121,34,24.0,24,6,15.6,2016,0.0
Barry Cheaney,32,3,27,11,10,7,95.0,12,3,3.0,15,8,18.5,2016,0.0
Bryan Glenn,0,0,0,0,0,0,3.0,0,0,0.0,0,0,0.0,2016,0.0
Marqueze Coleman,1098,226,837,333,505,379,2694.0,186,53,226.0,651,280,24.1,2016,0.0
Tyron Criswell,791,130,576,274,297,210,1884.0,105,33,137.0,471,241,22.2,2016,0.0
Eric Cooper Jr.,1193,128,1051,386,249,203,3151.0,640,218,127.0,411,168,20.5,2016,0.0
AJ West,601,27,425,210,289,181,1626.0,1,0,116.0,424,210,21.2,2016,0.0
Lucas Stivrins,120,14,88,41,49,30,502.0,17,8,25.0,71,33,13.7,2016,0.0
Kaileb Rodriguez,64,13,70,24,31,16,586.0,0,0,35.0,70,24,10.2,2016,0.0
Juwan Anderson,6,11,8,2,4,2,121.0,3,0,5.0,5,2,5.9,2016,0.0
Justin Botteri,2,1,2,1,0,0,11.0,0,0,2.0,2,1,17.3,2016,0.0
Ronnel Jordan,440,56,409,170,79,45,1294.0,168,55,62.0,241,115,20.2,2016,0.0
Joe Bramanti,304,178,243,91,158,97,2028.0,80,25,133.0,163,66,11.7,2016,0.0
Andrew Dotson,9,2,15,3,5,2,29.0,6,1,1.0,9,2,31.7,2016,0.0
Pascal Siakam,1126,103,800,441,339,241,2224.0,17,3,131.0,783,438,25.4,2016,1.0
Rashawn Browne,75,36,63,20,38,26,408.0,33,9,26.0,30,11,13.4,2016,0.0
Rene Esparza,27,9,30,9,9,4,113.0,16,5,10.0,14,4,19.9,2016,0.0
Jose Campo,11,2,7,5,4,1,48.0,0,0,3.0,7,5,12.6,2016,0.0
Harold Givens,31,7,24,13,8,5,178.0,0,0,8.0,24,13,10.2,2016,0.0
Tim Jacobs,129,126,99,47,51,29,856.0,26,6,50.0,73,41,10.9,2016,0.0
Nikola Scekic,98,6,112,43,19,8,619.0,14,4,30.0,98,39,12.7,2016,0.0
Michael Nesbitt,4,0,4,2,1,0,8.0,1,0,0.0,3,2,27.2,2016,0.0
Devon Williams,214,21,166,76,82,57,737.0,19,5,48.0,147,71,18.9,2016,0.0
Connor Joy,3,0,1,1,0,0,4.0,1,1,2.0,0,0,36.5,2016,0.0
Kevin Hill,928,61,687,330,363,268,2176.0,0,0,200.0,687,330,22.9,2016,0.0
Travis Avery,56,13,48,21,29,14,196.0,0,0,12.0,48,21,17.7,2016,0.0
Lamine Mbodj,11,2,15,4,4,3,64.0,0,0,4.0,15,4,14.8,2016,0.0
Corey Vinson,0,0,0,0,0,0,3.0,0,0,0.0,0,0,0.0,2016,0.0
Justin Satchell,213,20,207,87,26,17,613.0,77,22,41.0,130,65,21.4,2016,0.0
Cameron Fowler,189,136,240,75,52,20,1364.0,81,19,96.0,159,56,13.1,2016,0.0
Romero Collier,2,3,12,1,0,0,36.0,6,0,3.0,6,1,21.0,2016,0.0
Thomas Fleming,0,0,1,0,0,0,3.0,1,0,0.0,0,0,16.8,2016,0.0
T.J. Carpenter,1221,219,1094,403,317,218,3271.0,637,197,241.0,457,206,23.1,2016,0.0
Schane Rillieux,730,322,608,231,411,228,3594.0,154,40,266.0,454,191,15.2,2016,0.0
Kyle Caudill,277,45,200,99,111,78,858.0,10,1,81.0,190,98,20.3,2016,0.0
Quinton Thomas,287,46,226,88,121,76,984.0,132,35,60.0,94,53,17.5,2016,0.0
Marquis Nelson,55,12,65,21,8,2,294.0,33,11,25.0,32,10,16.1,2016,0.0
Robert Bissant,3,0,3,1,2,1,3.0,1,0,0.0,2,1,65.1,2016,0.0
Ky Howard,1139,416,795,380,479,333,3172.0,124,46,319.0,671,334,21.3,2016,0.0
Terrence Smith,621,44,469,275,111,71,1613.0,0,0,77.0,469,275,18.7,2016,0.0
Winfield Willis,729,157,535,239,173,148,1863.0,251,103,109.0,284,136,20.0,2016,0.0
Emmanuel Tselentakis,190,98,195,72,32,19,1310.0,95,27,57.0,100,45,10.4,2016,0.0
Vlad Shustov,128,18,123,58,17,9,548.0,10,3,40.0,113,55,15.9,2016,0.0
Seth Callahan,10,0,4,4,0,0,16.0,2,2,1.0,2,2,15.6,2016,0.0
Derek McKnight,4,0,4,1,4,2,17.0,0,0,1.0,4,1,20.3,2016,0.0
Jeff Short,1338,173,988,426,392,317,2670.0,469,169,214.0,519,257,26.5,2016,0.0
D'Shon Taylor,880,96,649,292,281,202,2028.0,265,94,120.0,384,198,22.9,2016,0.0
Charles Oliver,652,48,501,192,212,172,1470.0,294,96,72.0,207,96,23.3,2016,0.0
Devonte Banner,120,34,103,41,31,13,442.0,64,25,23.0,39,16,16.4,2016,0.0
Brian Kelley,48,31,52,18,13,11,318.0,13,1,29.0,39,17,13.8,2016,0.0
Justin Peebles-Jennings,10,1,8,3,2,1,25.0,8,3,1.0,0,0,20.0,2016,0.0
Moses Toriola,4,0,9,1,5,2,105.0,0,0,6.0,9,1,8.3,2016,0.0
Sam Hughes,904,127,749,340,249,177,2568.0,138,47,181.0,611,293,20.0,2016,0.0
John Cannon,172,7,140,73,34,26,480.0,2,0,30.0,138,73,20.5,2016,0.0
Bruce Beckford,1443,107,1115,509,477,361,3473.0,231,64,286.0,884,445,24.2,2016,0.0
Ahmad Abdullah,554,198,492,188,148,113,2194.0,181,65,127.0,311,123,16.2,2016,0.0
Ede Egharevba,255,26,232,98,52,32,656.0,89,27,47.0,143,71,23.6,2016,0.0
Joshea Singleton,223,26,184,71,100,65,670.0,58,16,59.0,126,55,22.6,2016,0.0
Steven Burrough,337,25,235,123,162,91,1400.0,0,0,71.0,235,123,14.1,2016,0.0
Khary Doby,421,28,408,153,121,68,1485.0,158,47,77.0,250,106,19.0,2016,0.0
Jamin Lackey,34,7,31,17,4,0,169.0,0,0,14.0,31,17,14.0,2016,0.0
Arturs Bremers,171,34,166,52,19,17,763.0,154,50,36.0,12,2,14.7,2016,0.0
Julien Johnson,13,0,13,3,7,6,48.0,6,1,3.0,7,2,20.9,2016,0.0
Dante Holmes,1105,158,934,391,274,177,2711.0,409,146,189.0,525,245,24.0,2016,0.0
Jeremiah Ingram,490,49,349,168,223,134,1394.0,55,20,126.0,294,148,21.5,2016,0.0
Enoch Hood,385,25,320,160,122,65,1485.0,1,0,70.0,319,160,15.9,2016,0.0
Jamal Ferguson,180,32,162,73,51,33,629.0,4,1,42.0,158,72,19.2,2016,0.0
Jay Copeland,523,16,343,187,240,149,1613.0,0,0,114.0,343,187,18.6,2016,0.0
Jeremiah Worthem,201,24,154,66,79,57,558.0,27,12,33.0,127,54,20.7,2016,0.0
Nate Allen,23,2,35,9,4,0,81.0,24,5,5.0,11,4,25.8,2016,0.0
A.J. Lynch,83,59,118,30,27,12,488.0,50,11,54.0,68,19,19.0,2016,0.0
Kevin Crawford,38,30,23,14,12,10,127.0,2,0,13.0,21,14,17.7,2016,0.0
Kayel Locke,1522,134,1261,569,512,341,3557.0,162,43,226.0,1099,526,24.4,2016,0.0
Asad Lamot,233,40,187,78,33,24,1105.0,135,53,36.0,52,25,11.0,2016,0.0
Clay Byrd,229,28,205,72,19,17,835.0,193,68,25.0,12,4,14.6,2016,0.0
Michael Adams,10,2,8,3,2,2,26.0,6,2,1.0,2,1,19.6,2016,1.0
Anthony Barber,1507,403,1169,500,536,425,3256.0,236,82,220.0,933,418,25.5,2016,0.0
Chase Cannon,7,2,14,3,2,0,32.0,8,1,2.0,6,2,27.0,2016,0.0
Craig Ponder,1160,257,965,393,367,252,3216.0,321,122,222.0,644,271,21.3,2016,0.0
Dylan Sherwood,462,26,402,170,60,42,1325.0,238,80,49.0,164,90,18.2,2016,0.0
Mark Matthews,76,13,68,28,17,12,204.0,28,8,11.0,40,20,20.5,2016,0.0
Trey Grundy,42,4,38,16,14,9,123.0,10,1,9.0,28,15,21.0,2016,0.0
Kevin Hickson,23,0,18,10,9,3,145.0,0,0,7.0,18,10,10.2,2016,0.0
Brice Johnson,1716,133,1242,714,407,288,3102.0,0,0,188.0,1242,714,24.9,2016,1.0
Marcus Paige,1844,602,1471,599,411,347,4570.0,798,299,274.0,673,300,20.2,2016,1.0
Joel James,293,18,272,123,75,47,1188.0,0,0,73.0,272,123,15.2,2016,0.0
Justin Coleman,4,4,10,1,4,2,36.0,6,0,2.0,4,1,18.5,2016,0.0
Spenser Dalton,2,0,9,1,0,0,23.0,7,0,1.0,2,1,20.6,2016,0.0
Toby Egbuna,0,0,7,0,0,0,19.0,3,0,1.0,4,0,19.9,2016,0.0
Kory Brown,934,244,687,349,293,204,3344.0,106,32,203.0,581,317,17.1,2016,0.0
Malik Clements,190,13,191,69,36,22,490.0,103,30,27.0,88,39,25.6,2016,0.0
Chris Kading,499,39,379,197,126,77,2350.0,113,28,37.0,266,169,11.3,2016,0.0
Brian Ishola,25,4,20,8,12,9,190.0,1,0,8.0,19,8,9.8,2016,0.0
Trey Miller,1,0,0,0,2,1,5.0,0,0,0.0,0,0,10.2,2016,0.0
Adam McDermott,229,21,175,71,30,26,803.0,149,61,17.0,26,10,12.8,2016,0.0
Dustin Hobaugh,224,25,191,70,87,59,1035.0,87,25,45.0,104,45,13.0,2016,0.0
Bryce Cashman,76,6,54,29,43,18,399.0,0,0,29.0,54,29,13.4,2016,0.0
Shane Benton,138,28,130,45,57,32,638.0,59,16,31.0,71,29,15.1,2016,0.0
James Richman,3,0,3,1,2,1,10.0,0,0,1.0,3,1,24.4,2016,0.0
Beau Beech,1557,184,1193,505,322,245,3817.0,769,302,227.0,424,203,20.8,2016,0.0
BaeBae Daniels,1022,111,780,375,251,178,2601.0,275,94,126.0,505,281,19.9,2016,0.0
Trent Mackey,1181,175,879,381,140,116,3589.0,681,303,144.0,198,78,15.7,2016,0.0
Ismaila Dauda,34,1,27,11,17,12,178.0,0,0,15.0,27,11,14.5,2016,0.0
Eric Katenda,221,8,157,82,82,56,560.0,1,1,38.0,156,81,20.3,2016,0.0
Khalil Fuller,86,3,67,34,45,18,374.0,1,0,28.0,66,34,15.0,2016,0.0
Todd Eaglin,59,35,56,19,18,12,453.0,36,9,35.0,20,10,11.2,2016,0.0
Chris Campbell,0,2,6,0,2,0,30.0,3,0,0.0,3,0,11.3,2016,0.0
David Walker,1631,420,1200,517,418,347,4710.0,653,250,244.0,547,267,18.8,2016,0.0
Quincy Ford,1617,245,1277,526,478,361,4148.0,585,204,269.0,692,322,23.1,2016,0.0
Zach Stahl,1030,198,787,397,327,226,3125.0,39,10,253.0,748,387,20.6,2016,0.0
Caleb Donnelly,247,30,188,79,31,21,904.0,155,68,25.0,33,11,13.7,2016,0.0
Kris Yanku,1245,419,956,336,639,518,2819.0,169,55,282.0,787,281,28.2,2016,0.0
Brady Twombly,62,3,52,21,8,6,232.0,40,14,9.0,12,7,14.1,2016,0.0
Junior Searcy,20,1,12,7,6,5,55.0,2,1,2.0,10,6,15.4,2016,0.0
Austin Lee,3,1,1,1,0,0,10.0,1,1,7.0,0,0,40.5,2016,0.0
Alex Stecca,8,1,3,2,8,4,26.0,0,0,0.0,3,2,13.6,2016,0.0
Anthony Johnson,1020,61,779,334,238,196,2009.0,412,156,122.0,367,178,25.1,2016,1.0
Jordan Wilson,910,234,734,318,165,130,2541.0,371,144,117.0,363,174,18.9,2016,0.0
Dallas Anglin,319,60,231,95,121,99,738.0,95,30,65.0,136,65,24.1,2016,0.0
Jeremy Verhagen,288,19,203,111,97,61,1045.0,25,5,67.0,178,106,15.4,2016,0.0
Cam Michael,527,61,408,182,93,72,1166.0,230,91,53.0,178,91,23.0,2016,0.0
Spencer Mathis,72,17,74,28,29,14,345.0,13,2,15.0,61,26,15.0,2016,0.0
Jamal Evans,58,1,45,21,11,6,128.0,18,10,10.0,27,11,23.4,2016,0.0
Miles Seward,58,5,41,18,14,13,136.0,23,9,12.0,18,9,21.8,2016,0.0
Travon Baker,996,356,866,293,362,265,3306.0,469,145,257.0,397,148,20.1,2016,0.0
Chuks Iroegbu,312,34,168,105,167,98,887.0,22,4,49.0,146,101,16.9,2016,0.0
Andrew Zelis,70,5,59,31,21,8,261.0,0,0,11.0,59,31,15.2,2016,0.0
Jordan Thomas,9,1,10,3,0,0,24.0,8,3,2.0,2,0,24.7,2016,0.0
Jay DeHaan,3,1,8,1,3,1,25.0,2,0,1.0,6,1,20.6,2016,0.0
Wes Washpun,1051,422,759,350,428,298,3092.0,165,53,248.0,594,297,22.5,2016,0.0
Matt Bohannon,1092,115,846,351,156,122,3837.0,690,268,74.0,156,83,14.8,2016,0.0
Paul Jesperson,789,78,649,268,88,76,2848.0,459,177,96.0,190,91,16.2,2016,0.0
Aarias Austin,49,7,43,17,5,5,120.0,26,10,8.0,17,7,25.7,2016,0.0
Jalen Billups,1061,48,710,438,282,184,1959.0,5,1,169.0,705,437,27.4,2016,0.0
Tyler White,1114,216,1061,394,190,140,3084.0,566,186,175.0,495,208,22.9,2016,0.0
Dean Danos,236,75,173,76,44,36,888.0,109,48,66.0,64,28,15.4,2016,0.0
Deontae Cole,254,40,246,86,13,10,1027.0,214,72,13.0,32,14,13.6,2016,0.0
Todd Johnson,505,136,422,160,94,64,1839.0,326,121,90.0,96,39,16.4,2016,0.0
Jake Giesler,284,40,268,117,76,37,1164.0,59,13,52.0,209,104,16.2,2016,0.0
Jared Bryant,183,15,120,66,87,51,689.0,0,0,45.0,120,66,14.8,2016,0.0
Skyler Kolli,0,0,1,0,2,0,4.0,1,0,1.0,0,0,37.4,2016,0.0
Ta'Jon Welcome,332,58,297,125,69,44,940.0,145,38,54.0,152,87,18.9,2016,0.0
Matt Killian,258,34,244,93,68,44,1285.0,88,28,63.0,156,65,12.2,2016,0.0
Levi Yancy,38,14,36,14,10,10,235.0,2,0,16.0,34,14,11.3,2016,0.0
Jalan West,1690,652,1158,522,474,410,3191.0,579,236,248.0,579,286,23.2,2016,0.0
Daniel Hazlewood,3,1,4,1,0,0,15.0,4,1,1.0,0,0,15.6,2016,0.0
Will Poole,0,0,0,0,0,0,6.0,0,0,0.0,0,0,0.0,2016,0.0
Tre Demps,1518,292,1404,554,297,199,3867.0,619,211,149.0,785,343,24.6,2016,0.0
Alex Olah,1161,171,902,439,367,253,3225.0,112,30,181.0,790,409,22.0,2016,0.0
Joey van Zegeren,524,21,396,216,233,92,1711.0,2,0,117.0,394,216,19.5,2016,0.0
Demetrius Jackson,1204,335,888,415,308,241,3243.0,349,133,170.0,539,282,20.1,2016,1.0
Zach Auguste,1274,80,894,507,424,260,2726.0,1,0,194.0,893,507,25.6,2016,0.0
Austin Burgett,160,29,123,58,38,28,709.0,66,16,31.0,57,42,13.1,2016,0.0
Chad Holtz,0,0,0,0,0,0,1.0,0,0,0.0,0,0,0.0,2016,0.0
Kay Felder,1765,788,1300,554,625,514,3626.0,415,143,350.0,885,411,26.5,2016,1.0
Percy Gibson,689,32,522,283,187,122,1545.0,5,1,78.0,517,282,21.4,2016,0.0
Max Hooper,651,33,490,208,38,33,1709.0,479,202,38.0,11,6,15.6,2016,0.0
Treg Setty,810,106,655,295,251,168,2418.0,173,52,166.0,482,243,20.1,2016,0.0
James Gollon,267,50,185,83,67,56,850.0,115,45,60.0,70,38,16.2,2016,0.0
Jeff Newberry,561,93,463,183,165,135,1641.0,182,60,71.0,281,123,20.1,2016,0.0
Chris Olivier,831,47,625,327,295,177,1566.0,1,0,105.0,624,327,30.2,2016,0.0
Tyree Griffin,1167,586,976,403,327,234,3497.0,373,127,250.0,603,276,21.0,2016,0.0
Joe Burton,157,19,121,52,46,27,409.0,70,26,21.0,51,26,21.5,2016,0.0
Anthony Allen,133,18,87,49,66,35,524.0,0,0,56.0,87,49,17.9,2016,0.0
Igor Ibaka,6,0,2,1,8,4,23.0,0,0,2.0,2,1,18.1,2016,0.0
Codey McElroy,0,0,2,0,0,0,5.0,2,0,1.0,0,0,32.1,2016,0.0
Ford Stuen,15,5,13,6,1,1,53.0,7,2,3.0,6,4,16.2,2016,0.0
Buddy Hield,2291,254,1748,783,450,376,4182.0,894,349,285.0,854,434,26.6,2016,1.0
Isaiah Cousins,1326,365,1162,474,284,202,3794.0,432,176,254.0,730,298,20.2,2016,0.0
Ryan Spangler,1087,167,739,420,310,202,3414.0,132,45,153.0,607,375,15.0,2016,0.0
Dinjiyl Walker,235,47,238,84,47,26,797.0,130,41,54.0,108,43,19.7,2016,0.0
Akolda Manyang,469,25,289,174,176,121,868.0,0,0,87.0,289,174,26.4,2016,0.0
Austin Mankin,13,5,16,4,4,3,105.0,6,2,2.0,10,2,9.4,2016,0.0
Trey Freeman,2304,541,1969,858,554,450,4619.0,372,138,266.0,1597,720,28.2,2016,0.0
Aaron Bacote,1609,354,1233,495,560,446,3773.0,525,173,283.0,708,322,24.8,2016,0.0
Nik Biberaj,229,49,227,87,55,39,942.0,61,16,22.0,166,71,15.5,2016,0.0
Martin Shaw,21,5,32,7,10,7,102.0,7,0,8.0,25,7,23.3,2016,0.0
Payton Pervier,4,0,8,1,5,2,27.0,0,0,2.0,8,1,24.2,2016,0.0
Obi Emegano,1798,171,1269,580,684,550,3406.0,225,88,213.0,1044,492,28.2,2016,0.0
Brandon Conley,631,74,432,249,219,133,2243.0,0,0,167.0,432,249,16.0,2016,0.0
DaQuan Jeffries,841,100,570,302,204,157,2009.0,212,80,107.0,358,222,19.6,2016,1.0
Adam Glenville,15,3,12,4,6,5,30.0,6,2,2.0,6,2,28.3,2016,0.0
Chris Crawford,8,2,4,3,3,2,40.0,1,0,2.0,3,3,9.2,2016,1.0
Tre Vance,8,2,7,2,7,4,41.0,0,0,1.0,7,2,13.7,2016,0.0
Gary Payton,927,259,756,367,221,144,2221.0,162,49,133.0,594,318,23.8,2016,1.0
Olaf Schaftenaar,623,130,537,201,110,89,2335.0,373,132,95.0,164,69,15.4,2016,0.0
Langston Morris-Walker,613,86,547,201,178,121,2259.0,272,90,80.0,275,111,16.8,2016,0.0
Derrick Bruce,759,149,622,236,197,155,1890.0,356,132,132.0,266,104,21.5,2016,0.0
Jarmal Reid,412,84,358,144,187,123,1634.0,7,1,99.0,351,143,17.8,2016,0.0
Daniel Gomis,218,25,158,81,102,56,1064.0,0,0,74.0,158,81,14.3,2016,0.0
Justin Stangel,3,0,2,1,2,1,34.0,0,0,4.0,2,1,11.3,2016,0.0
Noah Togiai,0,0,0,0,0,0,3.0,0,0,0.0,0,0,0.0,2016,0.0
Elgin Cook,1259,162,864,437,487,357,2838.0,96,28,189.0,768,409,22.7,2016,0.0
Dwayne Benjamin,582,68,502,213,127,75,1615.0,244,81,65.0,258,132,19.5,2016,0.0
Kendall Small,299,114,279,110,135,75,1334.0,19,4,85.0,260,106,16.6,2016,0.0
Max Heller,7,20,14,2,3,2,162.0,5,1,14.0,9,1,9.4,2016,0.0
Troy Norris,0,2,1,0,2,0,11.0,0,0,2.0,1,0,17.7,2016,0.0
Phil Richmond,0,0,0,0,0,0,5.0,0,0,0.0,0,0,0.0,2016,0.0
Alec Kobre,475,33,335,151,74,68,1126.0,259,105,36.0,76,46,18.9,2016,0.0
Eric Thompson,373,31,237,127,194,119,979.0,1,0,64.0,236,127,21.2,2016,0.0
Jason Braden,2,4,2,1,2,0,11.0,0,0,0.0,2,1,13.8,2016,0.0
Donovon Jack,524,42,415,193,164,104,1671.0,118,34,69.0,297,159,17.7,2016,0.0
Devin Foster,176,47,128,62,67,40,831.0,28,12,40.0,100,50,12.6,2016,0.0
Jordan Dickerson,226,25,168,84,99,58,1540.0,2,0,64.0,166,84,9.5,2016,0.0
Sam Halle,0,0,0,0,0,0,1.0,0,0,0.0,0,0,0.0,2016,0.0
Darien Nelson-Henry,1054,110,745,414,346,224,2443.0,6,2,237.0,739,412,24.4,2016,0.0
Antonio Woods,941,311,847,336,249,147,3279.0,383,122,176.0,464,214,18.2,2016,0.0
Jamal Lewis,232,133,233,81,79,47,1288.0,85,23,102.0,148,58,14.8,2016,0.0
Mike Auger,162,12,105,59,60,43,527.0,3,1,46.0,102,58,18.5,2016,0.0
Dylan Jones,140,9,103,54,72,32,486.0,0,0,37.0,103,54,18.5,2016,0.0
Jared Ertel,0,0,1,0,0,0,1.0,1,0,0.0,0,0,50.9,2016,0.0
Brett Paul,0,0,0,0,0,0,1.0,0,0,1.0,0,0,50.9,2016,0.0
Stacy Davis,1786,211,1318,607,654,503,3941.0,196,69,301.0,1122,538,25.8,2016,0.0
Jett Raines,1037,44,781,398,303,222,2739.0,76,19,100.0,705,379,19.7,2016,0.0
Kameron Edwards,1346,115,1112,498,419,289,2975.0,197,61,201.0,915,437,25.6,2016,0.0
Shawn Olden,492,103,400,146,166,122,1637.0,245,78,89.0,155,68,17.9,2016,0.0
A.J. Lapray,163,22,156,56,14,10,592.0,113,41,34.0,43,15,17.0,2016,0.0
Jake Johnson,12,3,7,4,11,4,101.0,0,0,3.0,7,4,7.7,2016,0.0
Hakeem Anchrum,7,2,7,3,2,1,38.0,0,0,1.0,7,3,11.9,2016,0.0
Jamani Spencer,1,2,2,0,4,1,16.0,0,0,2.0,2,0,18.6,2016,0.0
John Yi,0,2,3,0,1,0,11.0,2,0,3.0,1,0,30.7,2016,0.0
James Robinson,1115,604,937,353,381,303,4204.0,332,106,175.0,605,247,16.4,2016,1.0
Sterling Smith,1082,166,850,367,197,153,3166.0,498,195,126.0,352,172,16.6,2016,0.0
Rafael Maia,865,131,622,313,425,228,2661.0,37,11,184.0,585,302,19.6,2016,0.0
Alonzo Nelson-Ododa,556,84,447,195,220,132,2414.0,124,34,118.0,323,161,15.3,2016,0.0
Mike Lecak,7,4,17,2,2,2,58.0,13,1,4.0,4,1,19.9,2016,0.0
Cameron Forte,831,128,599,347,256,136,1600.0,4,1,149.0,595,346,26.7,2016,0.0
Isaiah Pineiro,1583,181,1129,557,495,393,2912.0,225,76,241.0,904,481,28.6,2016,0.0
Donivine Stewart,796,367,673,283,218,141,2861.0,261,89,150.0,412,194,16.3,2016,0.0
Collin Spickerman,286,46,260,128,41,28,1110.0,8,2,53.0,252,126,14.9,2016,0.0
Bryce White,273,48,222,86,98,75,681.0,80,26,35.0,142,60,22.1,2016,0.0
Namdi Okonkwo,183,12,117,75,53,33,719.0,0,0,31.0,117,75,12.3,2016,0.0
Evan Garrison,15,8,17,6,2,2,119.0,5,1,4.0,12,5,8.8,2016,0.0
Bryce Pressley,1104,314,882,388,234,173,3372.0,388,155,163.0,494,233,17.2,2016,0.0
Jason Todd,293,78,237,108,52,35,1321.0,107,42,50.0,130,66,11.9,2016,0.0
Max Livingston,59,21,57,20,7,5,244.0,45,14,5.0,12,6,13.0,2016,0.0
Jayrn Johnson,528,49,454,181,133,101,1207.0,181,65,73.0,273,116,24.3,2016,0.0
Karim York,549,43,480,217,135,80,1526.0,119,35,143.0,361,182,22.3,2016,0.0
Charleston Dobbs,85,2,89,35,29,15,599.0,1,0,17.0,88,35,9.9,2016,0.0
Dominique Shaw,15,2,16,4,13,7,59.0,3,0,1.0,13,4,19.6,2016,0.0
Xavion Turnage,0,0,0,0,0,0,1.0,0,0,0.0,0,0,0.0,2016,0.0
Markus Terry,757,124,631,265,227,161,2344.0,209,66,121.0,422,199,19.5,2016,0.0
Janeil Jenkins,249,90,155,79,93,70,945.0,54,21,80.0,101,58,15.6,2016,0.0
John Majors II,98,4,78,40,39,18,297.0,0,0,25.0,78,40,20.6,2016,0.0
Harrison Burton,2,0,2,1,2,0,5.0,0,0,1.0,2,1,39.7,2016,0.0
Mike Washington Jr.,21,9,32,10,3,0,113.0,14,1,10.0,18,9,20.5,2016,0.0
Ben Bentil,954,61,705,321,330,251,1928.0,188,61,107.0,517,260,25.1,2016,1.0
Kris Dunn,1214,552,943,424,423,293,2997.0,206,73,315.0,737,351,24.6,2016,1.0
Quadree Smith,33,1,19,10,17,13,96.0,0,0,5.0,19,10,16.5,2016,0.0
Tyree Chambers,2,4,3,1,0,0,29.0,2,0,3.0,1,1,10.3,2016,0.0
A.J. Hammons,1593,104,1138,613,523,361,3201.0,23,6,271.0,1115,607,26.2,2016,0.0
Rapheal Davis,1009,231,766,333,376,273,3224.0,219,70,176.0,547,263,17.6,2016,0.0
Johnny Hill,697,271,468,231,290,217,2225.0,68,18,183.0,400,213,17.8,2016,0.0
Jacquil Taylor,369,32,239,155,81,54,1149.0,14,5,55.0,225,150,15.0,2016,0.0
Stephen Toyra,24,5,19,6,18,12,102.0,8,0,11.0,11,6,18.9,2016,0.0
James Ford Jr.,498,92,453,157,136,93,1725.0,262,91,86.0,191,66,16.5,2016,0.0
Ayron Hutton,265,118,283,86,56,32,1060.0,170,61,92.0,113,25,18.0,2016,0.0
Dimitri Floras,168,78,211,55,41,27,701.0,111,31,48.0,100,24,18.8,2016,0.0
Samuel Dingba,188,14,138,67,95,54,979.0,1,0,47.0,137,67,11.9,2016,0.0
Will Simonton,182,25,183,75,59,31,977.0,3,1,54.0,180,74,14.1,2016,0.0
Jemaa Yuori,0,0,0,0,0,0,1.0,0,0,0.0,0,0,0.0,2016,0.0
Rashun Davis,1304,457,1062,441,449,336,3237.0,301,86,323.0,761,355,24.7,2016,0.0
Brandon Holcomb,681,86,517,273,208,135,2566.0,0,0,176.0,517,273,15.5,2016,0.0
Ya Ya Anderson,1141,213,961,392,194,135,3336.0,615,222,120.0,346,170,17.6,2016,0.0
Kion Brown,614,39,495,245,227,124,1908.0,0,0,146.0,495,245,19.6,2016,0.0
Taj Owens,206,91,174,68,71,59,764.0,34,11,46.0,140,57,16.6,2016,0.0
Kyle Gonzalez,23,4,12,8,9,5,82.0,6,2,8.0,6,6,14.8,2016,0.0
Four McGlynn,1518,166,1107,425,442,398,3753.0,719,270,183.0,388,155,21.1,2016,0.0
Earl Watson,257,13,165,98,106,61,922.0,0,0,41.0,165,98,14.6,2016,1.0
Rory Temkin,4,0,3,2,1,0,10.0,0,0,0.0,3,2,18.4,2016,0.0
Shane Plunkett,3,1,7,1,2,0,23.0,5,1,1.0,2,0,20.5,2016,0.0
Rex Sunahara,0,0,0,0,0,0,3.0,0,0,0.0,0,0,0.0,2016,0.0
Max Guercy,1115,503,893,338,366,304,4035.0,428,135,282.0,465,203,18.3,2016,0.0
Oliver Xu,7,2,9,2,4,2,34.0,3,1,6.0,6,1,24.7,2016,0.0
Nate Pollard,17,3,15,6,11,5,155.0,0,0,17.0,15,6,13.4,2016,0.0
Terry Allen,1491,168,1080,547,471,333,3409.0,214,64,209.0,866,483,24.3,2016,0.0
Trey Davis,531,256,457,200,219,107,3410.0,93,24,153.0,364,176,11.5,2016,0.0
Deion Taylor,460,135,388,164,160,76,2696.0,198,56,99.0,190,108,11.5,2016,0.0
Josh Jones,105,23,94,36,22,13,454.0,63,20,15.0,31,16,15.0,2016,0.0
KoVien Dominaus,0,0,1,0,0,0,1.0,0,0,0.0,1,0,52.1,2016,0.0
Teddy Okereafor,833,351,659,255,306,223,2700.0,331,100,223.0,328,155,20.1,2016,0.0
Khalil Alford,535,54,481,208,101,69,1507.0,154,50,87.0,327,158,21.5,2016,0.0
Zedric Sadler,816,250,731,286,208,140,3085.0,313,104,182.0,418,182,17.2,2016,0.0
Kealen Ives,152,62,147,47,45,35,583.0,66,23,41.0,81,24,19.0,2016,0.0
Shawn Valentine,487,125,448,166,138,90,2359.0,211,65,144.0,237,101,14.6,2016,0.0
Kenny Grant,46,2,39,20,13,6,207.0,0,0,17.0,39,20,16.0,2016,0.0
Lacey James,748,49,629,269,274,181,2385.0,83,29,162.0,546,240,19.8,2016,0.0
Andre Frederick,92,5,71,42,22,8,540.0,0,0,27.0,71,42,10.3,2016,0.0
Anthony Pugh,3,0,1,1,0,0,7.0,1,1,0.0,0,0,7.2,2016,0.0
Bishop Daniels,530,146,503,198,147,104,1613.0,98,30,162.0,405,168,23.1,2016,0.0
D.J. Foreman,813,88,604,308,363,191,2689.0,17,6,207.0,587,302,18.5,2016,0.0
Omari Grier,964,94,796,302,237,195,2533.0,466,165,106.0,330,137,21.1,2016,0.0
Greg Lewis,350,64,340,139,133,72,1833.0,0,0,114.0,340,139,14.3,2016,0.0
Justin Goode,66,20,55,20,17,14,431.0,39,12,10.0,16,8,8.4,2016,0.0
Jalen Hyde,9,2,12,4,5,1,67.0,5,0,4.0,7,4,13.8,2016,0.0
Cody Demps,914,286,695,317,344,242,3055.0,143,38,200.0,552,279,18.6,2016,0.0
Dreon Barlett,415,45,330,135,62,51,1484.0,232,94,48.0,98,41,14.5,2016,0.0
Mason Stuteville,45,3,51,18,7,3,113.0,24,6,7.0,27,12,28.2,2016,0.0
Jordan Allen,935,171,666,360,425,214,3018.0,6,1,193.0,660,359,17.4,2016,0.0
Tevin Falzon,749,87,641,237,339,252,2273.0,103,23,129.0,538,214,19.9,2016,0.0
Eyimofe Edukugho,169,11,140,69,65,31,473.0,0,0,46.0,140,69,21.9,2016,0.0
Jermaine Ukaegbu,186,35,118,75,73,36,918.0,1,0,56.0,117,75,10.8,2016,0.0
Filip Nowicki,107,8,88,49,17,9,430.0,0,0,36.0,88,49,14.9,2016,0.0
Ronnie Drinnon,971,131,795,388,296,172,3005.0,77,23,144.0,718,365,19.2,2016,0.0
Ben Millaud-Meunier,989,117,737,289,237,199,2243.0,548,212,130.0,189,77,23.3,2016,0.0
Greg Brown,855,292,766,312,222,156,3221.0,234,75,187.0,532,237,17.5,2016,0.0
Malik Harmon,907,327,806,272,320,223,3321.0,435,140,186.0,371,132,18.4,2016,0.0
Basil Thompson,275,18,236,92,116,86,732.0,42,5,66.0,194,87,25.3,2016,0.0
Isaiah Miles,1097,69,810,375,250,210,2529.0,376,137,113.0,434,238,21.2,2016,0.0
DeAndre Bembry,1590,364,1270,580,494,310,3645.0,385,120,248.0,885,460,24.9,2016,0.0
Aaron Brown,816,111,692,290,242,166,2303.0,202,70,119.0,490,220,20.6,2016,0.0
Papa Ndao,319,71,275,107,44,33,1383.0,205,72,86.0,70,35,14.3,2016,0.0
Pierfrancesco Oliva,387,173,310,135,161,81,1645.0,122,36,107.0,188,99,15.1,2016,0.0
Ash Yacoubou,791,124,727,297,192,114,2443.0,276,83,164.0,451,214,21.3,2016,0.0
Miles Reynolds,996,230,675,273,538,411,2609.0,141,39,181.0,534,234,22.2,2016,0.0
Marcus Bartley,617,261,516,200,95,70,2560.0,374,147,167.0,142,53,15.2,2016,0.0
Brett Jolly,86,16,76,23,54,38,483.0,21,2,30.0,55,21,14.7,2016,0.0
Austin Eagleton,0,0,0,0,0,0,7.0,0,0,2.0,0,0,14.8,2016,0.0
Franklin Porter,525,123,433,182,136,99,1768.0,171,62,113.0,262,120,18.4,2016,0.0
Jack Biebel,6,17,5,2,5,2,91.0,3,0,5.0,2,2,7.7,2016,0.0
Rodney Hawkins,240,26,227,97,63,36,782.0,33,10,49.0,194,87,20.8,2016,0.0
Cameron Jones,499,88,467,163,81,62,1842.0,332,111,96.0,135,52,17.2,2016,0.0
Elias Desport,281,46,250,98,128,83,1638.0,8,2,99.0,242,96,13.5,2016,0.0
Elisha Boone,171,24,156,74,54,20,629.0,11,3,44.0,145,71,19.2,2016,0.0
Jaquan Robertson,0,0,0,0,0,0,2.0,0,0,1.0,0,0,26.0,2016,0.0
Jalin Barnes,146,61,148,55,25,16,642.0,60,20,49.0,88,35,16.0,2016,0.0
Andre Sands,119,8,82,51,32,17,271.0,2,0,20.0,80,51,21.3,2016,0.0
Marc Andre Fortin,49,11,47,20,18,9,185.0,0,0,14.0,47,20,18.5,2016,0.0
Ameer Jackson,44,6,37,12,25,14,99.0,17,6,6.0,20,6,27.3,2016,0.0
Mitch McCormick,26,4,29,8,5,3,99.0,24,7,2.0,5,1,16.8,2016,0.0
Darius Jones-Gibson,885,183,593,286,435,292,1934.0,68,21,159.0,525,265,25.2,2016,0.0
Marcus Johnson,442,121,373,152,104,71,1397.0,210,67,82.0,163,85,18.3,2016,0.0
Jamal Shabazz,361,34,298,117,115,82,1151.0,141,45,63.0,157,72,18.3,2016,0.0
Iman Johnson,277,74,240,108,93,53,1316.0,31,8,82.0,209,100,14.2,2016,0.0
Dakota Quinn,71,3,58,32,15,7,204.0,2,0,13.0,56,32,19.1,2016,0.0
Ryan Dickey,5,1,9,2,0,0,14.0,5,1,0.0,4,1,32.8,2016,0.0
Winston Shepard,1403,315,1165,467,653,428,3583.0,169,41,308.0,996,426,26.1,2016,0.0
Angelo Chol,455,27,355,184,142,87,1649.0,0,0,113.0,355,184,17.2,2016,0.0
Skylar Spencer,546,45,389,226,204,94,3104.0,0,0,93.0,389,226,9.8,2016,0.0
Ben Perez,369,58,317,121,68,49,1496.0,238,78,47.0,79,43,13.5,2016,0.0
Niksha Federico,19,2,18,7,0,0,30.0,15,5,0.0,3,2,31.3,2016,0.0
Parker U'u,47,11,57,15,9,7,241.0,42,10,24.0,15,5,19.4,2016,0.0
Duda Sanadze,991,85,872,335,274,207,2125.0,386,114,156.0,486,221,29.2,2016,0.0
Vasa Pusica,1454,395,1004,473,418,335,3332.0,437,173,284.0,567,300,23.9,2016,0.0
Jito Kok,645,52,475,234,312,177,2935.0,2,0,188.0,473,234,14.8,2016,0.0
Marcus Harris,855,139,726,270,263,196,2706.0,393,119,125.0,333,151,18.4,2016,0.0
Brandon Perry,435,26,306,153,243,129,982.0,0,0,83.0,306,153,26.1,2016,0.0
Alex Floresca,544,129,415,193,204,136,2105.0,85,22,136.0,330,171,16.0,2016,0.0
Christian Oshita,29,4,34,10,9,4,152.0,19,5,12.0,15,5,17.3,2016,0.0
Hunter Summy,36,8,44,13,3,1,149.0,36,9,6.0,8,4,18.2,2016,0.0
Khalil Bedart-Ghani,17,3,25,7,8,3,91.0,5,0,8.0,20,7,21.4,2016,0.0
Devin Watson,1816,490,1413,572,612,453,3959.0,609,219,297.0,804,353,25.1,2016,0.0
Tim Derksen,1434,197,1005,497,442,294,3355.0,358,146,179.0,647,351,21.2,2016,0.0
Dont'e Reynolds,152,23,101,53,72,46,705.0,3,0,45.0,98,53,12.2,2016,0.0
Montray Clemons,114,8,102,42,45,30,411.0,6,0,33.0,96,42,18.6,2016,0.0
Sean Grennan,134,53,118,39,39,31,655.0,79,25,45.0,39,14,14.0,2016,0.0
Stokley Chaffee,305,34,202,113,118,78,1188.0,2,1,72.0,200,112,13.6,2016,0.0
Randy Cruzet,2,0,2,1,0,0,5.0,0,0,1.0,2,1,28.7,2016,0.0
Stefan Cox,0,0,2,0,0,0,11.0,2,0,0.0,0,0,8.7,2016,0.0
Frank Rogers,514,65,416,187,146,92,1357.0,142,48,95.0,274,139,21.6,2016,0.0
Princeton Onwas,472,98,354,167,218,120,1346.0,88,18,110.0,266,149,21.1,2016,0.0
Leon Bahner,63,8,48,19,41,25,369.0,0,0,25.0,48,19,12.8,2016,0.0
Ivo Basor,97,11,75,36,41,18,545.0,15,7,29.0,60,29,12.1,2016,0.0
Danny Mahoney,48,32,77,18,6,6,346.0,47,6,30.0,30,12,17.2,2016,0.0
Brendyn Taylor,113,34,102,39,46,22,539.0,45,13,25.0,57,26,14.5,2016,0.0
Werner Nistler,8,8,8,0,10,8,74.0,4,0,9.0,4,0,15.7,2016,0.0
Chris Martin,652,99,620,219,134,95,1831.0,380,119,101.0,240,100,22.2,2016,0.0
Lenjo Kilo,304,14,251,117,120,62,828.0,28,8,65.0,223,109,23.3,2016,0.0
Brian Pearson,351,35,265,146,126,59,1429.0,2,0,86.0,263,146,15.0,2016,0.0
Khalen Pinkett,310,101,299,112,146,76,1508.0,44,10,177.0,255,102,18.5,2016,0.0
Javaris Jenkins,631,69,576,216,125,95,1673.0,335,104,78.0,241,112,19.9,2016,0.0
Teslim Idris,62,10,52,25,16,7,333.0,12,5,14.0,40,20,11.4,2016,0.0
Novian Cherry,18,1,20,7,8,4,95.0,1,0,10.0,19,7,18.4,2016,0.0
Jason Baxter,2,0,1,1,0,0,15.0,0,0,2.0,1,1,10.3,2016,0.0
Treyvon Francis,45,20,79,17,15,7,483.0,39,4,35.0,40,13,12.5,2016,0.0
Jack Crook,770,148,652,306,255,156,2739.0,11,2,212.0,641,304,18.5,2016,0.0
Jadon Cohee,839,180,709,277,252,199,2345.0,236,86,152.0,473,191,21.5,2016,0.0
Jake Spurgeon,110,15,120,37,24,15,445.0,92,21,17.0,28,16,16.8,2016,0.0
Isaiah Whitehead,883,251,760,285,259,196,1710.0,326,117,192.0,434,168,30.8,2016,1.0
Derrick Gordon,1305,280,1127,463,518,338,3819.0,164,41,294.0,963,422,21.3,2016,0.0
Braeden Anderson,72,7,65,18,59,36,466.0,1,0,21.0,64,18,13.1,2016,0.0
Ryan Oliver,684,125,583,236,112,76,2410.0,368,136,98.0,215,100,15.0,2016,0.0
Kinnon LaRose,930,98,730,336,119,84,2790.0,473,174,94.0,257,162,15.2,2016,0.0
Cameron Gottfried,178,77,149,66,29,20,966.0,75,26,52.0,74,40,10.8,2016,0.0
Imoh Silas,267,38,225,118,69,31,1243.0,0,0,102.0,225,118,14.7,2016,0.0
Nick Cunningham,12,2,2,1,12,10,15.0,0,0,2.0,2,1,30.6,2016,0.0
Jimmy Paige,79,8,52,24,42,31,336.0,9,0,13.0,43,24,12.7,2016,0.0
Barrington Stevens III,758,300,690,259,179,130,3481.0,317,110,198.0,373,149,13.9,2016,0.0
John Brown,364,58,314,134,84,61,1163.0,113,35,72.0,201,99,18.2,2016,1.0
Devin Epps,17,4,9,4,10,6,67.0,5,3,6.0,4,1,14.7,2016,0.0
Gabe McCray,540,41,444,204,182,108,1372.0,78,24,91.0,366,180,23.1,2016,0.0
Darryl Palmer,968,122,901,391,264,159,3307.0,125,27,145.0,776,364,18.0,2016,0.0
Najee Pritchett,66,10,68,22,26,10,259.0,51,12,4.0,17,10,16.4,2016,0.0
Jacob Schulte,340,34,225,140,131,60,1218.0,1,0,51.0,224,140,13.9,2016,0.0
Tristan Thomas,121,36,104,40,7,3,359.0,95,38,17.0,9,2,17.3,2016,0.0
Damian Goodwin,244,46,228,87,117,60,783.0,50,10,52.0,178,77,21.5,2016,0.0
Michael Carrera,1143,86,860,368,462,330,2743.0,215,77,182.0,645,291,22.6,2016,0.0
Laimonas Chatkevicius,890,71,703,361,213,150,2234.0,65,18,167.0,638,343,21.4,2016,0.0
Mindaugas Kacinas,879,82,618,328,280,188,3129.0,118,35,167.0,500,293,14.4,2016,0.0
Raymond Doby,29,4,27,10,15,9,108.0,1,0,6.0,26,10,17.4,2016,0.0
John Ragin,2,0,3,1,0,0,8.0,1,0,0.0,2,1,17.6,2016,0.0
Deondre Parks,984,117,779,331,257,202,2182.0,340,120,118.0,439,211,23.9,2016,0.0
George Marshall,907,172,769,300,194,144,2429.0,420,163,110.0,349,137,20.7,2016,0.0
Jake Bittle,829,225,630,289,226,174,2674.0,223,77,180.0,407,212,17.8,2016,0.0
Keaton Moffitt,280,106,215,104,102,66,1225.0,19,6,64.0,196,98,13.6,2016,0.0
Connor Devine,160,15,102,57,91,46,646.0,0,0,26.0,102,57,13.6,2016,0.0
Logan Doyle,19,2,13,5,12,9,44.0,1,0,2.0,12,5,24.2,2016,0.0
Cory Jacobsen,59,12,53,19,13,6,276.0,46,15,11.0,7,4,13.3,2016,0.0
Tre Burnette,680,74,649,282,115,56,1422.0,196,60,97.0,453,222,28.5,2016,0.0
Casey Kasperbauer,1163,168,891,379,163,148,3378.0,610,257,101.0,281,122,16.3,2016,0.0
D.J. Davis,353,97,269,136,83,59,1243.0,63,22,81.0,206,114,15.7,2016,0.0
Shy McClelland,264,82,203,100,102,52,663.0,32,12,42.0,171,88,22.0,2016,0.0
Eric Robertson,566,39,490,214,159,118,1892.0,76,20,63.0,414,194,17.0,2016,0.0
Trey Norris,703,379,560,243,201,152,2961.0,181,65,188.0,379,178,14.6,2016,0.0
Duol Mayot,50,8,44,19,25,12,240.0,0,0,14.0,44,19,14.8,2016,0.0
Zach Dickerson,90,45,80,33,20,15,609.0,33,9,33.0,47,24,10.4,2016,0.0
Tyler Borchers,0,0,0,0,0,0,0.0,0,0,0.0,0,0,0,2016,0.0
Angel Nunez,501,50,430,180,152,106,1365.0,136,35,106.0,294,145,22.6,2016,0.0
Nehemias Morillo,590,106,559,215,117,89,1744.0,231,71,132.0,328,144,22.2,2016,0.0
Jaleel Cousins,373,18,278,127,222,119,1192.0,1,0,105.0,277,127,21.0,2016,0.0
Chris Perry,764,57,625,302,263,160,1803.0,7,0,126.0,618,302,25.1,2016,0.0
Tre' Bryant,0,0,3,0,0,0,17.0,2,0,2.0,1,0,14.8,2016,0.0
Justin David,0,0,1,0,0,0,3.0,0,0,0.0,1,0,16.7,2016,0.0
Isiah Jones,656,172,587,221,118,81,1833.0,378,133,137.0,209,88,20.8,2016,0.0
Eric McGill,870,221,740,299,241,155,2873.0,320,117,142.0,420,182,18.4,2016,0.0
Tony Anderson II,146,8,120,49,55,41,426.0,20,7,32.0,100,42,20.3,2016,0.0
Jaylin Stewart,46,2,52,18,8,3,210.0,27,7,7.0,25,11,14.5,2016,0.0
Ladarius Coleman,68,13,67,22,25,20,234.0,16,4,17.0,51,18,20.2,2016,0.0
Kyle Gullett,40,14,45,14,5,3,285.0,23,9,9.0,22,5,9.6,2016,0.0
J.T. Jones,37,12,40,13,10,6,145.0,18,5,6.0,22,8,18.7,2016,0.0
Robby Dosier,6,4,9,2,2,1,99.0,6,1,8.0,3,1,8.8,2016,0.0
Zay Jackson,959,349,837,343,239,171,2583.0,331,102,268.0,506,241,23.9,2016,0.0
JaMichael Hawkins,787,80,698,256,166,134,2058.0,400,141,129.0,298,115,22.7,2016,0.0
Keith Charleston,376,85,333,145,107,56,1735.0,94,30,122.0,239,115,14.7,2016,0.0
Daniel Grieves,394,51,330,136,92,59,1267.0,193,63,74.0,137,73,18.2,2016,0.0
Justin Lobell,38,4,28,13,0,0,162.0,25,12,5.0,3,1,10.4,2016,0.0
Malcolm Reid,0,1,2,0,0,0,10.0,2,0,0.0,0,0,9.9,2016,0.0
Byron Smith,0,0,0,0,0,0,7.0,0,0,0.0,0,0,0.0,2016,0.0
Nikola Jovanovic,1063,43,783,406,347,233,2440.0,59,18,162.0,724,388,22.2,2016,0.0
Julian Jacobs,842,397,661,307,263,186,2730.0,136,42,254.0,525,265,18.5,2016,0.0
Malik Martin,550,57,448,223,152,81,1831.0,82,23,134.0,366,200,17.9,2016,0.0
Strahinja Gavrilovic,248,8,200,86,105,68,773.0,30,8,41.0,170,78,18.6,2016,0.0
C.J. Carr,385,149,370,130,98,78,1228.0,156,47,103.0,214,83,21.5,2016,0.0
Yemi Makanjuola,181,17,132,63,90,55,491.0,2,0,54.0,130,63,23.4,2016,0.0
Grant Fiorentinos,286,23,227,107,109,71,938.0,3,1,56.0,224,106,18.2,2016,0.0
Jake Newton,236,36,236,76,40,27,781.0,151,57,48.0,85,19,19.8,2016,0.0
Michael Chandler,74,9,54,34,21,6,451.0,1,0,9.0,53,34,8.2,2016,0.0
Connor Wheeler,45,22,63,14,13,9,251.0,39,8,12.0,24,6,16.3,2016,0.0
Anthony Beane,1917,189,1563,679,474,366,4272.0,537,193,255.0,1026,486,25.4,2016,0.0
Ibby Djimde,126,17,113,51,43,24,643.0,0,0,41.0,113,51,14.3,2016,0.0
Deng Leek,26,2,17,12,9,2,114.0,0,0,5.0,17,12,11.9,2016,0.0
Jeremy Postell,10,0,9,4,0,0,9.0,7,2,2.0,2,2,60.5,2016,0.0
Bobby Mannie,1,0,1,0,2,1,12.0,1,0,0.0,0,0,8.0,2016,0.0
Aaron Siler,11,4,9,3,3,2,43.0,7,3,2.0,2,0,15.0,2016,0.0
Nic Moore,1811,643,1338,571,464,388,4363.0,678,281,319.0,660,290,22.7,2016,0.0
Jordan Tolbert,1354,80,934,506,499,330,3096.0,38,12,229.0,896,494,23.6,2016,0.0
Markus Kennedy,1097,167,855,446,349,201,2579.0,14,4,185.0,841,442,24.2,2016,0.0
David Nelson,4,1,2,2,0,0,6.0,0,0,0.0,2,2,16.8,2016,0.0
Jake Brudish,3,1,1,1,0,0,3.0,1,1,0.0,0,0,16.8,2016,0.0
Courtland Sutton,3,0,3,1,0,0,4.0,2,1,1.0,1,0,50.5,2016,0.0
Kourtlin Jackson,412,36,278,126,136,104,806.0,131,56,49.0,147,70,26.8,2016,0.0
Michael O'Donnell,143,23,122,51,27,14,621.0,66,27,37.0,56,24,15.3,2016,0.0
Travon Langston,480,91,356,160,193,135,1230.0,82,25,106.0,274,135,23.8,2016,0.0
Trey Kennedy,735,187,611,240,266,198,2109.0,181,57,168.0,430,183,23.0,2016,0.0
Casey Oliverson,679,44,524,297,150,83,2025.0,7,2,96.0,517,295,18.2,2016,0.0
Juwan Major,428,109,370,162,154,98,1810.0,28,6,162.0,342,156,17.9,2016,0.0
Chris Thompson,188,16,184,67,32,24,552.0,90,30,45.0,94,37,23.4,2016,0.0
Paris Davis,77,4,55,26,39,25,193.0,0,0,19.0,55,26,25.4,2016,0.0
Daniel Melifonwu,34,1,31,14,15,6,259.0,0,0,17.0,31,14,11.3,2016,0.0
Adrian Rodgers,1597,226,1406,585,346,260,3554.0,502,167,257.0,904,418,25.8,2016,0.0
Christopher Hyder,599,476,456,204,241,173,3321.0,74,18,174.0,382,186,11.5,2016,0.0
Tony Nunn,127,3,101,55,42,17,416.0,0,0,28.0,101,55,17.9,2016,0.0
D'Arian Allen,101,4,71,42,35,16,307.0,1,1,24.0,70,41,18.2,2016,0.0
Thomas Pierre-Louis,29,1,25,13,13,3,120.0,0,0,8.0,25,13,16.8,2016,0.0
Grant Ellis,21,3,24,8,0,0,82.0,18,5,4.0,6,3,17.0,2016,0.0
Marcus Posley,1321,265,1121,435,334,261,2942.0,577,190,196.0,544,245,25.5,2016,0.0
Dion Wright,1263,102,1020,509,280,214,3042.0,101,31,120.0,919,478,21.1,2016,0.0
Tyreek Jewell,739,106,724,264,212,137,2074.0,298,74,110.0,426,190,22.7,2016,0.0
Chris Hooper,560,74,391,217,219,126,1182.0,2,0,117.0,389,217,26.1,2016,0.0
Antonio Jenifer,388,41,343,132,121,80,1108.0,146,44,70.0,197,88,21.4,2016,0.0
Amdy Fall,534,50,369,171,288,192,2001.0,0,0,121.0,369,171,15.8,2016,0.0
Dagur Jonsson,132,43,149,42,34,24,542.0,93,24,38.0,56,18,19.0,2016,0.0
Jon Doss,96,13,97,34,11,5,344.0,76,23,11.0,21,11,16.7,2016,0.0
Marlon Alcindor,17,0,14,5,4,3,30.0,9,4,1.0,5,1,28.6,2016,0.0
Miles Rockafeler,0,1,1,0,2,0,4.0,0,0,1.0,1,0,37.5,2016,0.0
Durand Johnson,659,92,573,222,149,112,1572.0,301,103,90.0,272,119,23.4,2016,0.0
Ron Mvouika,494,112,398,163,151,94,1438.0,191,74,105.0,207,89,20.2,2016,0.0
Felix Balamou,267,80,263,107,81,52,1085.0,7,1,70.0,256,106,16.7,2016,0.0
Abdul Dial,58,7,49,22,16,11,174.0,15,3,7.0,34,19,18.8,2016,0.0
Rosco Allen,811,105,641,255,283,202,2288.0,292,99,126.0,349,156,20.2,2016,0.0
Ayo Adedeji,3,0,3,0,4,3,6.0,2,0,0.0,1,0,41.9,2016,0.0
Ian Proulx,0,0,0,0,0,0,4.0,0,0,0.0,0,0,0.0,2016,0.0
Alex Seutin,0,0,1,0,0,0,10.0,0,0,0.0,1,0,5.1,2016,0.0
Thomas Walkup,1744,395,1114,633,577,438,3532.0,131,40,215.0,983,593,22.9,2016,0.0
Demetrious Floyd,700,96,566,259,49,31,1329.0,359,151,63.0,207,108,24.2,2016,0.0
Clide Geffrard,1088,105,771,372,322,230,2244.0,309,114,159.0,462,258,25.2,2016,0.0
Jared Johnson,462,78,366,158,69,52,809.0,237,94,70.0,129,64,28.7,2016,0.0
Trey Pinkney,358,422,266,97,212,141,2911.0,98,23,164.0,168,74,9.2,2016,0.0
C.J. Williams,73,31,62,27,38,19,299.0,1,0,28.0,61,27,17.7,2016,1.0
Lasani Johnson,191,19,159,67,25,18,475.0,81,39,19.0,78,28,19.8,2016,0.0
JaQuan Smith,19,1,20,8,8,3,45.0,0,0,3.0,20,8,29.2,2016,0.0
Grant Lozoya,528,83,472,190,95,68,1374.0,264,80,95.0,208,110,22.4,2016,0.0
Drew Romich,24,19,32,9,13,6,438.0,0,0,18.0,32,9,6.5,2016,0.0
Jameel Warney,2132,220,1482,884,615,364,4140.0,0,0,184.0,1482,884,24.2,2016,1.0
Carson Puriefoy,1572,345,1242,494,517,398,3651.0,503,186,296.0,739,308,24.9,2016,0.0
Rayshaun McGrew,731,80,639,309,201,113,2087.0,5,0,110.0,634,309,20.5,2016,0.0
Ahmad Walker,574,209,455,195,255,167,1779.0,87,17,165.0,368,178,20.9,2016,0.0
Deshaun Thrower,202,58,231,67,59,46,900.0,91,22,38.0,140,45,16.8,2016,0.0
Michael Gbinije,1177,310,900,409,313,200,3061.0,411,159,194.0,489,250,21.1,2016,1.0
Malachi Richardson,496,77,412,152,157,113,1272.0,224,79,79.0,188,73,23.2,2016,1.0
Trevor Cooney,1437,211,1285,466,281,224,4034.0,835,281,145.0,450,185,20.2,2016,0.0
Quenton DeCosey,1513,251,1260,499,494,349,3574.0,477,166,206.0,783,333,24.3,2016,0.0
Jaylen Bond,756,87,723,339,166,64,2590.0,78,14,104.0,645,325,18.0,2016,0.0
Devin Coleman,511,64,498,185,72,47,1488.0,266,94,58.0,232,91,20.9,2016,0.0
Trey Lowe,134,16,129,51,19,15,342.0,66,17,11.0,63,34,22.7,2016,0.0
Devontae Watson,191,9,183,84,47,23,1009.0,0,0,32.0,183,84,12.0,2016,0.0
Twymond Howard,1006,143,786,359,339,245,2378.0,124,43,140.0,662,316,24.2,2016,0.0
Alex Anderson,876,154,674,283,134,117,2488.0,469,193,104.0,205,90,17.9,2016,0.0
Myles Taylor,1734,96,1128,588,705,534,3186.0,81,24,222.0,1047,564,26.5,2016,0.0
Richard Lee,634,60,543,225,59,41,1818.0,362,143,66.0,181,82,17.9,2016,0.0
Jalen Variste,80,36,78,31,28,16,383.0,8,2,14.0,70,29,14.1,2016,0.0
Terrence Durham,99,82,93,31,45,26,699.0,45,11,48.0,48,20,12.2,2016,0.0
Keron DeShields,1100,233,860,374,328,243,2741.0,312,109,148.0,548,265,22.8,2016,0.0
Marcus Roper,522,32,453,175,99,68,1245.0,305,104,57.0,148,71,23.4,2016,0.0
Demontez Loman,287,33,238,117,102,53,1529.0,1,0,68.0,237,117,12.1,2016,0.0
Xavier Richards,347,63,259,138,131,70,1171.0,4,1,75.0,255,137,17.8,2016,0.0
Christian Griggs-Williams,151,10,128,57,44,24,651.0,27,13,33.0,101,44,13.9,2016,0.0
Johnny Woodard,42,5,33,13,5,4,117.0,29,12,8.0,4,1,18.4,2016,0.0
Neville Fincher,22,1,21,8,8,5,106.0,3,1,7.0,18,7,14.9,2016,0.0
Torrance Rowe,895,215,711,284,231,194,1942.0,390,133,139.0,321,151,24.7,2016,0.0
Ryan Martin,435,36,254,132,197,154,895.0,57,17,61.0,197,115,23.0,2016,0.0
Anthony Morse,418,27,299,157,182,104,1479.0,2,0,78.0,297,157,15.7,2016,0.0
Tre Hansbrough,66,21,47,20,27,20,184.0,20,6,10.0,27,14,19.1,2016,0.0
Josiah Moore,560,74,440,187,189,125,1426.0,179,61,104.0,261,126,22.0,2016,0.0
Conner Hall,10,0,8,3,2,1,25.0,7,3,3.0,1,0,24.0,2016,0.0
Kevin Punter,905,151,650,288,294,228,1878.0,279,101,122.0,371,187,24.6,2016,0.0
Armani Moore,907,245,804,343,319,186,2892.0,131,35,200.0,673,308,20.5,2016,0.0
Devon Baulkman,471,79,410,154,93,75,1390.0,254,88,69.0,156,66,18.8,2016,0.0
Derek Reese,408,71,352,143,113,75,1915.0,142,47,71.0,210,96,13.0,2016,0.0
Ray Kasongo,31,1,23,12,11,7,121.0,0,0,6.0,23,12,13.6,2016,0.0
Hameed Ali,983,363,963,341,251,191,3322.0,345,110,181.0,618,231,19.7,2016,0.0
Bryce Douvier,707,54,491,235,225,177,1858.0,153,60,131.0,338,175,20.2,2016,0.0
Brandon Pye,916,103,792,324,112,88,3049.0,449,180,83.0,343,144,15.9,2016,0.0
Jelani Currie,447,79,361,151,164,107,1842.0,107,38,87.0,254,113,14.8,2016,0.0
Dale Francis,197,12,197,78,14,8,1276.0,103,33,46.0,94,45,10.3,2016,0.0
Viktor Juricek,125,8,109,40,39,27,510.0,56,18,40.0,53,22,16.9,2016,0.0
Emmanuel Toney,424,172,351,144,126,87,2007.0,140,49,117.0,211,95,13.6,2016,0.0
Danuel House,1683,238,1315,547,554,387,3587.0,598,202,228.0,717,345,25.4,2016,0.0
Alex Caruso,1090,649,840,382,343,235,3933.0,268,91,346.0,572,291,18.1,2016,1.0
Anthony Collins,987,724,813,346,298,236,4374.0,156,59,344.0,657,287,16.2,2016,0.0
Kyle Dobbins,25,11,16,7,24,11,55.0,1,0,10.0,15,7,35.0,2016,0.0
Juan Aparicio,5,1,9,2,2,0,24.0,3,1,1.0,6,1,23.0,2016,0.0
T.J. Distefano,0,0,3,0,0,0,14.0,1,0,2.0,2,0,17.6,2016,0.0
Kennedy Eubanks,432,44,379,159,127,70,1331.0,160,44,71.0,219,115,18.6,2016,0.0
Nick Pallas,118,32,99,42,55,34,455.0,2,0,45.0,97,42,17.1,2016,0.0
Courtney Austin,27,10,25,9,10,6,131.0,12,3,13.0,13,6,15.3,2016,0.0
Chauncey Collins,482,86,353,130,180,139,1234.0,229,83,81.0,124,47,20.9,2016,0.0
Devonta Abron,623,50,440,204,351,215,1732.0,1,0,102.0,439,204,21.1,2016,0.0
Lee Moore,508,116,345,156,198,147,1053.0,133,49,70.0,212,107,23.7,2016,0.0
Earvin Morris,806,97,611,276,218,148,1677.0,284,106,112.0,327,170,25.1,2016,0.0
Hooper Vint,439,43,341,181,104,64,1376.0,55,13,83.0,286,168,17.5,2016,0.0
Tevin Caldwell,108,26,64,38,41,32,461.0,1,0,14.0,63,38,10.6,2016,0.0
Brodricks Jones,31,6,38,8,20,14,208.0,8,1,12.0,30,7,14.0,2016,0.0
Christian Romine,12,0,10,5,4,2,50.0,0,0,8.0,10,5,19.5,2016,0.0
Victor Mbachu,11,2,7,2,10,7,36.0,1,0,2.0,6,2,19.4,2016,0.0
Shaquille Hines,1325,184,1112,542,310,194,3514.0,161,47,223.0,951,495,22.0,2016,0.0
Dakota Slaughter,393,70,308,139,65,49,1099.0,179,66,53.0,129,73,18.5,2016,0.0
J.J. Thompson,771,373,682,266,237,165,2845.0,218,74,238.0,464,192,18.3,2016,0.0
Everett Osborne,281,47,278,96,83,62,977.0,106,27,67.0,172,69,20.6,2016,0.0
Christopher Ikuenobe,58,7,44,23,22,12,209.0,0,0,10.0,44,23,15.9,2016,0.0
Joaquin Pistokache,4,0,4,1,4,2,37.0,0,0,2.0,4,1,11.1,2016,0.0
Rafiki Muhamad,0,0,0,0,0,0,6.0,0,0,2.0,0,0,17.1,2016,0.0
Ryan Bowie,965,107,742,328,221,166,2120.0,371,143,114.0,371,185,22.1,2016,0.0
Christian Wilson,515,147,446,159,252,172,1180.0,112,25,96.0,334,134,27.2,2016,0.0
A.J. Cockrell,107,8,90,42,40,23,421.0,1,0,19.0,89,42,14.6,2016,0.0
George Matthews,158,13,160,60,28,19,466.0,86,19,44.0,74,41,23.5,2016,0.0
Malcolm Riley,871,48,621,292,242,185,2074.0,268,102,78.0,353,190,20.0,2016,0.0
David Blanks,556,203,420,179,236,155,1860.0,137,43,139.0,283,136,18.3,2016,0.0
Jose Rodriguez,659,96,486,226,228,154,1496.0,128,53,112.0,358,173,23.7,2016,0.0
Orlando Coleman,703,97,649,288,96,61,2415.0,221,66,151.0,428,222,17.7,2016,0.0
Brian Carey,145,82,126,40,74,51,826.0,42,14,65.0,84,26,13.4,2016,0.0
Jermaine Davis,22,2,14,5,17,11,101.0,2,1,12.0,12,4,17.1,2016,0.0
Joshua Friar,10,3,8,4,8,2,87.0,0,0,2.0,8,4,8.1,2016,0.0
Christian McCoggle,12,2,13,3,14,6,128.0,0,0,3.0,13,3,9.1,2016,0.0
Dewayne Washington,0,0,1,0,0,0,4.0,0,0,1.0,1,0,24.9,2016,0.0
Emani Gant,1055,128,823,415,341,224,2448.0,3,1,180.0,820,414,25.6,2016,0.0
Ethan Montalvo,541,75,467,168,116,94,1513.0,334,111,70.0,133,57,20.9,2016,0.0
Cameron Naylor,567,41,508,217,180,127,1661.0,37,6,106.0,471,211,22.5,2016,0.0
Anthony Roberson,135,19,94,50,64,33,620.0,8,2,22.0,86,48,12.4,2016,1.0
K.J. Malveau,55,17,52,16,15,12,250.0,34,11,23.0,18,5,17.3,2016,0.0
Kendell Ramlal,185,24,150,76,65,33,930.0,0,0,57.0,150,76,13.1,2016,0.0
D'Angelo West,84,18,104,26,18,12,341.0,84,20,15.0,20,6,19.2,2016,0.0
Austin Evans,21,1,11,7,16,7,61.0,0,0,4.0,11,7,19.9,2016,0.0
Toddrick Gotcher,952,219,732,293,310,228,3220.0,377,138,120.0,355,155,16.4,2016,0.0
Devaugntah Williams,682,103,573,226,182,141,1622.0,251,89,111.0,322,137,25.1,2016,0.0
C.J. Williamson,397,88,373,136,96,74,1305.0,176,51,93.0,197,85,19.4,2016,0.0
Jordan Jackson,515,133,354,165,268,178,1319.0,34,7,110.0,320,158,24.1,2016,0.0
Donovan Ham,2,0,1,1,0,0,8.0,0,0,0.0,1,1,6.5,2016,0.0
Andrew Sorrells,14,6,21,4,5,4,92.0,14,2,4.0,7,2,15.5,2016,0.0
Isaiah Taylor,1254,415,1019,412,499,395,2831.0,119,35,207.0,900,377,26.1,2016,1.0
Javan Felix,1249,366,1159,448,232,183,3427.0,485,170,217.0,674,278,21.9,2016,0.0
Connor Lammert,763,135,639,281,144,98,3119.0,330,103,111.0,309,178,13.3,2016,0.0
Cameron Ridley,943,37,634,346,462,251,2458.0,0,0,179.0,634,346,21.1,2016,0.0
Prince Ibeh,400,14,282,157,199,86,1769.0,1,0,105.0,281,157,13.8,2016,0.0
Demarcus Holland,707,212,606,257,228,137,3033.0,177,56,194.0,429,201,15.1,2016,0.0
Danny Newsome,16,0,14,6,4,1,40.0,6,3,3.0,8,3,23.9,2016,0.0
Nathan Boothe,1494,249,1235,599,297,247,3523.0,137,49,185.0,1098,550,22.4,2016,0.0
Chandler White,6,0,8,3,0,0,28.0,0,0,6.0,8,3,25.0,2016,0.0
Timajh Parker-Rivera,751,100,536,271,382,209,3120.0,8,0,141.0,528,271,14.1,2016,0.0
Walter Foster,386,42,353,152,148,82,1832.0,1,0,89.0,352,152,14.3,2016,0.0
Josh Ivory,104,61,125,34,16,6,777.0,99,30,48.0,26,4,12.0,2016,0.0
Mike Davis,4,0,2,2,2,0,7.0,0,0,2.0,2,2,35.0,2016,1.0
John Walton III,782,55,607,272,374,237,2513.0,4,1,162.0,603,271,19.2,2016,0.0
Kelton Ford,389,119,334,116,203,121,1365.0,152,36,103.0,182,80,20.0,2016,0.0
Damion Ottman,5,2,12,1,6,3,61.0,5,0,5.0,7,1,16.1,2016,0.0
Louis Dabney,1471,201,1225,468,511,387,3372.0,461,148,213.0,764,320,26.2,2016,0.0
Dylan Osetkowski,1435,165,1188,516,455,309,4018.0,312,94,236.0,876,422,21.1,2016,0.0
Jernard Jarreau,344,61,302,129,118,74,1307.0,29,12,90.0,273,117,17.5,2016,0.0
T.J. Oliver,36,2,41,16,5,2,101.0,9,2,9.0,32,14,26.1,2016,0.0
Shaquille Harrison,1481,461,1156,513,654,422,4017.0,153,33,306.0,1003,480,22.7,2016,1.0
James Woodard,1881,236,1410,595,579,430,4272.0,733,261,221.0,677,334,23.0,2016,0.0
Rashad Smith,915,95,711,361,310,176,2486.0,67,17,137.0,644,344,20.7,2016,0.0
Brandon Swannegan,550,24,395,201,252,148,1893.0,0,0,87.0,395,201,16.3,2016,0.0
Marquel Curtis,482,128,408,176,144,96,1815.0,125,34,108.0,283,142,16.8,2016,0.0
D'Andre Wright,861,62,663,303,340,236,2282.0,72,19,164.0,591,284,22.3,2016,0.0
Rashad Ray,840,298,682,270,280,213,2867.0,273,87,161.0,409,183,17.6,2016,0.0
Nick Wood,27,0,21,9,5,4,42.0,13,5,3.0,8,4,32.3,2016,0.0
Emmanuel Ezechinonso,4,0,2,1,3,2,76.0,0,0,3.0,2,1,4.5,2016,0.0
Tony Parker,1128,41,822,456,419,216,2485.0,0,0,159.0,822,456,23.4,2016,1.0
Jonah Bolden,144,33,123,51,45,33,672.0,36,9,26.0,87,42,12.1,2016,1.0
Prince Ali,841,120,698,290,244,160,2223.0,308,101,141.0,390,189,20.9,2016,0.0
Alex Olesinski,248,28,185,82,84,58,1158.0,84,26,34.0,101,56,10.9,2016,0.0
Chris Smith,855,143,593,289,200,151,1956.0,273,126,96.0,320,163,21.6,2016,1.0
Darius Perkins,502,157,419,171,78,54,1672.0,256,106,104.0,163,65,18.3,2016,0.0
Grayson Moore,55,21,48,17,21,14,252.0,25,7,13.0,23,10,14.3,2016,0.0
John Middleton,14,0,13,4,8,5,49.0,4,1,1.0,9,3,18.5,2016,0.0
Trace Cureton,27,6,29,8,15,8,117.0,11,3,7.0,18,5,20.2,2016,0.0
Henry Bolton,33,32,29,12,13,8,326.0,6,1,23.0,23,11,10.1,2016,0.0
Jaden Jackson,594,115,548,212,109,86,1543.0,247,84,57.0,301,128,21.4,2016,0.0
Marcel Davis,996,453,809,342,345,234,3223.0,234,78,252.0,575,264,19.8,2016,0.0
Dayon Goodman,210,20,135,77,87,56,617.0,4,0,34.0,131,77,16.7,2016,0.0
Darrious Hamilton,151,7,122,60,47,31,462.0,0,0,32.0,122,60,19.2,2016,0.0
Cory Cardwell,109,33,97,35,15,13,396.0,80,26,14.0,17,9,14.7,2016,0.0
Alex Carr,79,23,105,28,9,2,682.0,78,21,30.0,27,7,10.5,2016,0.0
Tyler Ott,36,1,35,12,7,4,76.0,26,8,5.0,9,4,27.9,2016,0.0
Jerron Jones,0,0,2,0,0,0,5.0,1,0,0.0,1,0,0,2016,0.0
Jakob Poeltl,931,93,541,356,362,219,1885.0,1,0,129.0,540,356,23.8,2016,1.0
Jordan Loveridge,1568,231,1264,513,399,319,3993.0,586,223,211.0,678,290,22.4,2016,0.0
Brandon Taylor,1270,428,992,419,233,188,3877.0,620,244,259.0,372,175,18.9,2016,0.0
Dakarai Tucker,717,79,557,247,98,78,2234.0,372,145,72.0,185,102,16.3,2016,0.0
Brekkott Chapman,1064,152,803,375,242,176,2718.0,333,138,186.0,470,237,21.2,2016,0.0
Isaiah Wright,1003,426,735,321,310,234,3135.0,352,127,246.0,383,194,19.2,2016,0.0
Austin Montgomery,26,2,13,10,6,5,36.0,1,1,4.0,12,9,28.6,2016,0.0
Austin Eastman,13,5,13,2,10,7,78.0,10,2,5.0,3,0,15.7,2016,0.0
Keith Carter,707,304,568,247,156,98,2146.0,293,115,140.0,275,132,18.6,2016,0.0
Darien Walker,652,97,598,232,137,94,1649.0,269,94,95.0,329,138,23.6,2016,0.0
Vashil Fernandez,612,38,442,242,264,128,2596.0,0,0,131.0,442,242,13.9,2016,0.0
E. Victor Nickerson,614,162,550,195,287,191,2291.0,149,33,197.0,401,162,19.5,2016,0.0
Wade Baldwin IV,792,327,543,234,300,240,2011.0,199,84,158.0,344,150,22.0,2016,1.0
Damian Jones,1313,71,897,508,524,296,2684.0,8,1,197.0,889,507,26.6,2016,1.0
Josh Henderson,416,56,341,164,148,86,1400.0,6,2,90.0,335,162,19.5,2016,0.0
Samir Sehic,731,52,520,256,233,165,1588.0,167,54,80.0,353,202,22.2,2016,0.0
Carter Josephs,6,46,3,2,8,2,316.0,0,0,18.0,3,2,4.1,2016,0.0
Nathan Watkins,25,1,23,7,13,8,106.0,18,3,7.0,5,4,18.4,2016,0.0
Ethan O'Day,1233,104,944,523,291,187,3098.0,1,0,181.0,943,523,21.9,2016,0.0
Everett Duncan,773,97,527,236,176,150,2906.0,389,151,59.0,138,85,12.2,2016,0.0
Dylan Sinnickson,26,1,20,11,1,0,84.0,9,4,5.0,11,7,15.4,2016,0.0
Ryan Arcidiacono,1604,535,1228,487,461,369,4592.0,729,261,253.0,499,226,19.2,2016,1.0
Daniel Ochefu,1015,185,673,404,333,207,3060.0,4,0,220.0,669,404,17.9,2016,1.0
Patrick Farrell,11,2,10,3,5,2,73.0,10,3,4.0,0,0,11.8,2016,0.0
Kevin Rafferty,8,0,8,4,2,0,54.0,2,0,3.0,6,4,11.7,2016,0.0
Henry Lowe,8,3,10,3,5,0,74.0,8,2,9.0,2,1,15.1,2016,0.0
Melvin Johnson,1657,218,1459,598,224,176,3482.0,774,285,171.0,685,313,24.4,2016,0.0
Korey Billbury,1524,294,1276,543,480,336,3855.0,284,102,269.0,992,441,23.5,2016,0.0
Jordan Riullano,2,1,4,0,2,2,12.0,2,0,2.0,2,0,28.1,2016,0.0
Phillip Anglade,726,53,562,315,241,96,2401.0,2,0,96.0,560,315,14.9,2016,0.0
Tim Marshall,914,101,875,306,132,87,2072.0,681,215,106.0,194,91,23.1,2016,0.0
Jordan Weethee,736,101,645,253,114,84,2081.0,432,146,107.0,213,107,17.7,2016,0.0
Chase Jones,2,0,2,1,0,0,6.0,1,0,0.0,1,1,16.7,2016,0.0
Kerry Blackshear Jr.,1548,193,1020,519,609,445,3394.0,211,65,203.0,809,454,23.5,2016,0.0
Devin Wilson,659,414,470,195,368,238,3298.0,108,31,204.0,362,164,13.8,2016,0.0
Shane Henry,132,5,119,56,56,20,605.0,0,0,34.0,119,56,15.8,2016,0.0
Satchel Pierce,169,23,134,62,71,45,725.0,1,0,67.0,133,62,17.3,2016,0.0
Malcolm Brogdon,1809,335,1399,601,482,422,4157.0,507,185,207.0,892,416,25.3,2016,1.0
Anthony Gill,1458,108,949,528,572,389,3412.0,31,13,172.0,918,515,23.0,2016,0.0
Mike Tobey,945,51,749,398,203,143,2247.0,19,6,106.0,730,392,24.2,2016,1.0
Evan Nolte,451,79,382,149,85,61,1880.0,274,92,56.0,108,57,14.6,2016,0.0
Caid Kirven,11,0,13,5,0,0,77.0,3,1,6.0,10,4,14.1,2016,0.0
Dwaun Anderson,629,98,631,247,149,99,2108.0,180,36,148.0,451,211,19.8,2016,0.0
Henry Brooks,632,57,627,287,95,58,2160.0,2,0,156.0,625,287,19.9,2016,0.0
Bruce Brittingham,2,3,3,1,0,0,12.0,2,0,2.0,1,1,20.4,2016,0.0
Codi Miller-McIntyre,1329,441,1150,496,426,269,3607.0,245,68,255.0,905,428,22.4,2016,0.0
Cornelius Hudson,396,62,345,121,122,86,1165.0,227,68,80.0,118,53,20.3,2016,0.0
Gilbert McGregor,1,1,0,0,2,1,5.0,0,0,1.0,0,0,18.6,2016,0.0
Grant O'Brien,11,0,16,4,3,2,76.0,8,1,0.0,8,3,11.3,2016,0.0
Stephen Prendergast,5,0,9,2,2,1,25.0,2,0,3.0,7,2,24.1,2016,0.0
Britton Anderson,2,0,4,0,2,2,9.0,1,0,0.0,3,0,27.2,2016,0.0
Brett Boese,245,46,226,86,17,10,985.0,175,63,32.0,51,23,14.2,2016,0.0
Junior Longrus,236,80,205,100,96,36,1761.0,3,0,79.0,202,100,10.0,2016,0.0
Ny Redding,339,202,247,90,160,133,1654.0,90,26,120.0,157,64,13.7,2016,0.0
Andrew Andrews,1812,387,1340,520,709,578,3929.0,552,194,264.0,788,326,23.9,2016,0.0
Dejounte Murray,548,151,486,202,166,110,1139.0,118,34,110.0,368,168,25.8,2016,1.0
Marquese Chriss,467,26,338,179,129,88,848.0,60,21,69.0,278,158,24.1,2016,1.0
Donaven Dorsey,364,32,295,124,51,31,1150.0,221,85,38.0,74,39,15.7,2016,0.0
KJ Garrett,0,0,8,0,4,0,23.0,3,0,2.0,5,0,24.2,2016,0.0
Joe Knight,0,0,1,0,0,0,6.0,0,0,0.0,1,0,7.3,2016,0.0
Joel Bolomboy,1484,93,931,492,651,464,3743.0,97,36,260.0,834,456,21.4,2016,1.0
Juwan Williams,121,11,104,42,30,20,327.0,48,17,25.0,56,25,21.3,2016,0.0
J.C. Kennedy,8,1,4,2,2,2,11.0,4,2,0.0,0,0,23.5,2016,0.0
Kiko Stavrev,2,3,4,1,0,0,20.0,2,0,1.0,2,1,13.0,2016,0.0
Jaysean Paige,671,65,544,239,159,115,1238.0,224,78,85.0,320,161,26.4,2016,0.0
Devin Williams,1134,119,854,380,561,374,2505.0,1,0,207.0,853,380,25.1,2016,0.0
Jonathan Holton,853,117,710,326,241,161,2354.0,195,40,160.0,515,286,19.7,2016,0.0
Richard Romeo,15,3,12,5,4,4,55.0,3,1,4.0,9,4,15.7,2016,0.0
Mike Brown,1309,235,1065,446,421,304,3396.0,335,113,226.0,730,333,21.7,2016,1.0
Torrion Brummitt,977,103,760,362,389,243,2243.0,66,10,206.0,694,352,25.4,2016,0.0
Rhett Harrelson,838,160,660,248,184,150,2430.0,492,192,153.0,168,56,18.4,2016,0.0
Justin Browning,588,122,398,212,202,135,2237.0,97,29,133.0,301,183,13.8,2016,0.0
Aaron Williams,19,0,6,5,7,7,25.0,3,2,3.0,3,3,24.4,2016,1.0
J.C. Fuller,677,114,611,247,141,116,1546.0,198,67,108.0,413,180,26.7,2016,0.0
Tate Stensgaard,469,59,309,181,157,106,1564.0,4,1,103.0,305,180,16.8,2016,0.0
Jalen Chapman,326,25,276,128,121,70,924.0,0,0,74.0,276,128,23.1,2016,0.0
Jamie Batish,231,22,193,79,13,9,930.0,159,64,10.0,34,15,11.9,2016,0.0
DeVante Mayes,0,3,4,0,0,0,20.0,3,0,0.0,1,0,10.4,2016,0.0
Aaron Cosby,1274,239,1077,395,307,239,3535.0,664,245,221.0,413,150,21.1,2016,0.0
Fredrick Edmond,402,90,285,163,125,68,954.0,21,8,72.0,264,155,21.7,2016,0.0
Nigel Snipes,494,60,420,169,92,72,1546.0,224,84,103.0,196,85,18.2,2016,0.0
Aleksej Rostov,445,46,349,160,140,98,1465.0,100,27,101.0,249,133,17.8,2016,0.0
Dylan Sanford,4,0,2,2,0,0,13.0,0,0,4.0,2,2,23.0,2016,0.0
Nathan Smith,4,0,2,0,4,4,15.0,0,0,1.0,2,0,16.2,2016,0.0
Keifer Dalton,1,3,1,0,2,1,13.0,1,0,3.0,0,0,18.9,2016,0.0
A.J. Avery,384,34,300,137,161,106,1475.0,10,4,72.0,290,133,15.6,2016,0.0
Taylor Perry,296,119,270,100,101,65,1944.0,94,31,113.0,176,69,11.5,2016,0.0
Jared Klein,289,67,237,96,67,52,1201.0,124,45,76.0,113,51,14.9,2016,0.0
Ron Baker,1636,345,1205,522,437,350,3795.0,655,242,177.0,550,280,22.0,2016,1.0
Fred VanVleet,1439,637,1086,463,462,372,3775.0,365,141,207.0,721,322,21.1,2016,1.0
Anton Grady,1414,169,1124,559,458,288,3171.0,38,8,237.0,1086,551,25.4,2016,0.0
Evan Wessel,362,80,356,131,52,24,2182.0,253,76,50.0,103,55,10.4,2016,0.0
Bush Wamukota,68,4,51,23,36,22,384.0,1,0,14.0,50,23,11.3,2016,0.0
Terry Tarpey,946,270,676,335,306,228,3141.0,171,48,179.0,505,287,17.3,2016,0.0
Sean Sheldon,571,150,378,235,173,101,2039.0,0,0,96.0,378,235,14.8,2016,0.0
Jimmy Gavin,610,95,423,201,135,112,1108.0,235,96,67.0,188,105,24.4,2016,0.0
Zach Price,227,5,171,86,101,55,806.0,0,0,46.0,171,86,16.1,2016,0.0
Jarad Scott,231,21,175,84,56,34,762.0,79,29,46.0,96,55,16.6,2016,0.0
Jordan Smith,16,1,25,6,3,2,76.0,13,2,1.0,12,4,20.2,2016,0.0
Jackson Bax,0,0,0,0,0,0,2.0,0,0,0.0,0,0,0.0,2016,0.0
Will Decorah,0,0,1,0,0,0,3.0,0,0,1.0,1,0,35.5,2016,0.0
Spencer Collins,1696,194,1385,573,471,368,3882.0,512,182,203.0,873,391,25.5,2016,0.0
Justin Gordon,872,146,690,344,319,176,2421.0,25,8,195.0,665,336,23.4,2016,0.0
C.J. Neumann,521,82,375,197,186,124,2662.0,10,3,99.0,365,194,11.5,2016,0.0
Zach Korkowski,35,7,16,11,13,13,96.0,3,0,9.0,13,11,17.7,2016,0.0
Bobby Perez,27,9,18,10,5,2,96.0,6,5,11.0,12,5,17.6,2016,0.0
JT Yoho,1171,182,972,426,222,162,2848.0,412,157,190.0,560,269,24.4,2016,0.0
Michael Karena,616,27,475,253,181,110,1356.0,0,0,108.0,475,253,27.0,2016,0.0
Joe Thomasson,617,207,437,199,211,169,1916.0,150,50,127.0,287,149,19.0,2016,0.0
Biggie Minnis,504,255,441,195,187,95,2174.0,63,19,192.0,378,176,17.6,2016,0.0
Daniel Mortensen,60,5,52,21,0,0,139.0,44,18,5.0,8,3,22.1,2016,0.0
Roderick Davis,65,6,52,29,20,7,337.0,1,0,23.0,51,29,13.9,2016,0.0
Daniel Collie,26,13,33,10,3,2,221.0,17,4,11.0,16,6,11.2,2016,0.0
Brandon Neel,15,1,19,6,4,3,58.0,4,0,2.0,15,6,21.3,2016,0.0
Josh Adams,1819,398,1333,579,621,472,4299.0,572,189,325.0,761,390,27.0,2016,0.0
Trey Washington,160,51,149,52,45,27,773.0,103,29,35.0,46,23,15.7,2016,0.0
James Farr,692,40,554,278,155,101,1740.0,111,35,103.0,443,243,21.0,2016,0.0
Jalen Reynolds,811,41,581,328,234,153,1818.0,7,2,114.0,574,326,22.3,2016,0.0
Remy Abell,769,145,555,251,236,178,2567.0,222,89,110.0,333,162,15.3,2016,0.0
Larry Austin,748,278,592,285,307,172,1890.0,24,6,176.0,568,279,23.0,2016,0.0
Ashanti Burgess,1,0,1,0,2,1,7.0,0,0,1.0,1,0,19.8,2016,0.0
Kevin Coker,2,0,2,1,0,0,19.0,0,0,1.0,2,1,8.1,2016,0.0
Makai Mason,1098,259,859,360,310,244,2496.0,370,134,195.0,489,226,24.4,2016,0.0
Justin Sears,1700,198,1184,607,707,475,3507.0,37,11,281.0,1147,596,26.8,2016,0.0
Brandon Sherrod,847,93,584,294,437,259,2304.0,2,0,125.0,582,294,20.3,2016,0.0
Nick Victor,428,167,358,161,132,59,2047.0,126,47,144.0,232,114,14.1,2016,0.0
Jack Montague,571,170,463,187,80,57,1864.0,322,140,135.0,141,47,17.9,2016,0.0
Khaliq Ghani,117,19,97,38,22,17,455.0,67,24,24.0,30,14,14.8,2016,0.0
Matt Greene,7,2,6,3,6,1,29.0,0,0,3.0,6,3,20.3,2016,0.0
A.J. Edwards,17,6,18,5,6,4,81.0,16,3,4.0,2,2,15.9,2016,0.0
Eli Lininger,3,1,3,1,4,1,10.0,0,0,1.0,3,1,29.3,2016,0.0
Jordan Andrews,608,93,576,183,145,115,1772.0,406,127,104.0,170,56,20.7,2016,0.0
Sidney Umude,849,58,706,329,300,189,1970.0,18,2,138.0,688,327,25.0,2016,0.0
Bobby Hain,1187,151,925,469,324,225,2786.0,104,24,144.0,821,445,22.4,2016,0.0
Bryce Nickels,89,11,79,36,38,17,319.0,2,0,28.0,77,36,18.9,2016,0.0
Jovan Crnic,323,118,275,105,75,58,1007.0,159,55,87.0,116,50,20.5,2017,0.0
Diamante Langston,24,16,18,9,13,6,199.0,2,0,19.0,16,9,11.5,2017,0.0
Jadon Reynolds,0,0,1,0,0,0,8.0,1,0,2.0,0,0,19.9,2017,0.0
Hayden Graham,1113,181,911,432,231,153,2951.0,288,96,159.0,623,336,21.2,2017,0.0
Zach Kocur,967,212,748,328,180,124,2754.0,474,187,166.0,274,141,19.3,2017,0.0
Kyle Broekhuis,115,28,105,37,46,31,623.0,38,10,39.0,67,27,13.8,2017,0.0
Brendan Leonard,11,3,7,3,4,3,24.0,5,2,2.0,2,1,23.4,2017,0.0
Keegan Culp,0,0,1,0,0,0,7.0,1,0,0.0,0,0,7.3,2017,0.0
Danny Hummer,21,11,23,7,6,3,103.0,16,4,11.0,7,3,18.6,2017,0.0
Isaiah Johnson,1374,203,888,508,608,357,3004.0,7,1,202.0,881,507,23.4,2017,0.0
Kwan Cheatham Jr.,976,180,885,336,180,129,2825.0,498,175,175.0,387,161,20.8,2017,0.0
Noah Robotham,1116,448,906,356,264,201,3696.0,547,203,204.0,359,153,16.9,2017,0.0
Tavian Dunn-Martin,883,257,760,273,186,155,2364.0,529,182,179.0,231,91,21.9,2017,0.0
Michael Hughes,863,119,601,335,294,183,2068.0,42,10,133.0,559,325,21.2,2017,0.0
Mark Noble,7,0,9,3,1,0,35.0,3,1,3.0,6,2,18.2,2017,0.0
Carlitos Anderson,3,2,2,1,0,0,19.0,1,1,0.0,1,0,5.3,2017,0.0
Quinterian McConico,515,24,375,224,108,66,1178.0,3,1,61.0,372,223,21.7,2017,0.0
Rakiya Battle,605,473,535,172,303,217,2641.0,174,44,238.0,361,128,18.1,2017,0.0
Matthew Cotton,192,56,177,56,73,49,933.0,102,31,52.0,75,25,14.8,2017,0.0
Adrian Edwards,299,34,278,119,103,61,1175.0,7,0,64.0,271,119,17.3,2017,0.0
Eugene Jones Jr.,68,13,83,26,22,15,313.0,15,1,17.0,68,25,18.6,2017,0.0
Christopher Thomas,160,19,149,62,30,19,647.0,68,17,25.0,81,45,15.1,2017,0.0
LaQuan Wiltshire,6,3,3,1,5,3,48.0,1,1,2.0,2,0,8.1,2017,0.0
Kimium Woods,0,0,0,0,0,0,0.0,0,0,0.0,0,0,0,2017,0.0
Dirk Williams,653,97,522,229,102,86,1573.0,303,109,83.0,219,120,21.1,2017,0.0
Hakeem Baxter,1085,224,794,321,499,382,3352.0,204,61,208.0,590,260,18.9,2017,0.0
Denzell Watts,604,223,487,199,146,105,2284.0,260,101,135.0,227,98,15.2,2017,0.0
Tosin Mehinti,689,97,531,271,241,147,2417.0,0,0,189.0,531,271,17.4,2017,0.0
Javien Williams,133,36,112,42,68,46,505.0,24,3,26.0,88,39,17.4,2017,0.0
Tyler Madison,454,82,340,156,198,133,1329.0,36,9,73.0,304,147,19.4,2017,0.0
Tony Armstrong,750,54,588,285,289,180,1820.0,0,0,102.0,588,285,22.0,2017,0.0
Torloft Thomas,545,144,458,157,187,142,1924.0,265,89,137.0,193,68,17.2,2017,0.0
Amir Warnock,137,7,123,61,36,15,440.0,0,0,36.0,123,61,19.2,2017,0.0
Mikel Tyson,219,14,150,88,82,43,677.0,2,0,45.0,148,88,16.7,2017,0.0
Corvon Butler,428,37,341,178,97,71,1063.0,25,1,52.0,316,177,20.1,2017,0.0
Glenn Hollaway,80,13,66,33,20,13,510.0,7,1,17.0,59,32,8.8,2017,0.0
Artis Cleveland,10,1,6,3,7,4,40.0,0,0,5.0,6,3,17.2,2017,0.0
Davante Pope,4,2,5,2,0,0,27.0,2,0,0.0,3,2,8.9,2017,0.0
Corban Collins,887,218,751,285,225,162,2628.0,408,155,151.0,343,130,19.1,2017,0.0
Ar'Mond Davis,611,49,555,213,133,104,1377.0,256,81,60.0,299,132,25.2,2017,0.0
Bola Olaniyan,573,63,417,214,232,145,2201.0,0,0,163.0,417,214,16.4,2017,0.0
Shannon Hale,892,84,716,282,318,220,2173.0,346,108,187.0,370,174,25.9,2017,0.0
Brandon Austin,900,40,764,309,146,112,2374.0,440,170,92.0,324,139,18.9,2017,0.0
Dallas Ennema,586,69,469,195,116,80,2078.0,306,116,66.0,163,79,15.2,2017,0.0
Mike Rowley,638,114,473,235,221,163,3039.0,23,5,144.0,450,230,12.5,2017,0.0
Marqueese Grayson,129,27,124,44,27,19,455.0,57,22,34.0,67,22,19.7,2017,0.0
Jaraan Lands,27,2,21,8,21,11,85.0,0,0,9.0,21,8,24.7,2017,0.0
Terrel Martin-Garcia,20,0,13,8,4,3,40.0,2,1,5.0,11,7,26.1,2017,0.0
Jamir Andrews,76,10,69,21,25,23,188.0,45,11,14.0,24,10,25.6,2017,0.0
Marquis Vance,1302,209,1144,433,543,330,3659.0,344,106,232.0,800,327,22.6,2017,0.0
Denzel Dulin,430,56,359,145,185,117,1487.0,92,23,97.0,267,122,18.8,2017,0.0
Deandre Davis,423,31,297,167,131,79,1118.0,24,10,64.0,273,157,18.8,2017,0.0
Rahamanh Katumbusi II,106,10,104,33,32,24,409.0,50,16,30.0,54,17,18.2,2017,0.0
Mark Gasperini,936,142,817,398,202,126,2330.0,63,14,156.0,754,384,24.5,2017,0.0
Delante Jones,1228,150,1029,415,328,236,3261.0,459,162,250.0,570,253,23.8,2017,0.0
Charlie Jones,662,199,456,231,189,134,3113.0,170,66,116.0,286,165,12.7,2017,0.0
Lonnie Rivera,165,21,137,58,41,33,649.0,48,16,42.0,89,42,17.2,2017,0.0
Jalen Rhea,288,18,234,92,48,34,970.0,189,70,24.0,45,22,17.0,2017,0.0
Alex Paquin,96,15,75,36,28,15,420.0,27,9,23.0,48,27,15.2,2017,0.0
Leon Tolksdorf,118,33,133,42,20,11,605.0,94,23,21.0,39,19,15.2,2017,0.0
Andrija Matic,138,30,111,49,50,30,551.0,32,10,52.0,79,39,19.7,2017,0.0
Yilret Yiljep,168,31,108,63,72,41,602.0,1,1,55.0,107,62,17.6,2017,0.0
Emarius Logan,385,110,344,119,112,92,1316.0,166,55,113.0,178,64,18.6,2017,0.0
Patrick Good,782,160,607,242,119,96,2297.0,526,202,86.0,81,40,16.0,2017,0.0
Kelvin Robinson,381,145,336,138,128,82,1073.0,81,23,87.0,255,115,20.4,2017,0.0
Jake Babic,553,204,527,182,126,88,2116.0,330,101,136.0,197,81,17.1,2017,0.0
Matt O'Boyle,132,26,124,45,32,15,521.0,90,27,23.0,34,18,14.9,2017,0.0
Torian Graham,614,39,513,230,56,46,1147.0,279,108,44.0,234,122,25.0,2017,0.0
Obinna Oleka,719,60,591,245,240,178,1877.0,181,51,106.0,410,194,21.1,2017,0.0
Ramon Vila,753,70,511,318,181,114,1769.0,13,3,78.0,498,315,19.6,2017,0.0
Jethro Tshisumpa,68,3,74,28,27,12,413.0,0,0,23.0,74,28,12.5,2017,0.0
Andre Adams,559,56,398,240,128,77,1361.0,14,2,124.0,384,238,21.1,2017,0.0
Romaine Jackson,0,0,0,0,0,0,5.0,0,0,2.0,0,0,19.6,2017,0.0
Chris Odionu,0,0,0,0,0,0,2.0,0,0,0.0,0,0,0.0,2017,0.0
Lauri Markkanen,576,32,376,185,164,137,1140.0,163,69,40.0,213,116,22.5,2017,1.0
Kadeem Allen,617,222,451,207,211,153,1868.0,125,50,133.0,326,157,18.5,2017,1.0
Kobi Simmons,323,73,281,111,89,69,871.0,98,32,46.0,183,79,22.0,2017,1.0
Chance Comanche,275,18,189,105,90,65,810.0,0,0,46.0,189,105,17.6,2017,0.0
Kory Jones,3,0,2,1,0,0,18.0,1,1,1.0,1,0,8.4,2017,0.0
Marcus Johnson Jr.,865,145,655,277,226,182,2175.0,330,129,113.0,325,148,21.5,2017,0.0
Kemy Osse,741,92,648,247,147,109,2156.0,396,138,89.0,252,109,19.5,2017,0.0
Maurius Hill,632,109,544,238,192,129,2032.0,87,27,146.0,457,211,20.3,2017,0.0
Lis Shoshi,490,68,395,192,125,88,1460.0,60,18,69.0,335,174,19.2,2017,0.0
Stetson Billings,199,51,207,65,73,54,1095.0,47,15,51.0,160,50,13.8,2017,0.0
Evan Moorman,18,2,15,6,0,0,31.0,15,6,0.0,0,0,25.9,2017,0.0
Shandon Goldman,273,56,240,97,68,32,931.0,144,47,64.0,96,50,18.7,2017,0.0
Jaquan Lynch,361,85,319,120,74,62,1067.0,159,59,62.0,160,61,20.0,2017,0.0
Ghiavonni Robinson,1071,167,1059,363,224,150,3407.0,637,195,223.0,422,168,21.4,2017,0.0
Deshon Bayless,206,19,190,79,55,30,630.0,52,18,61.0,138,61,22.7,2017,0.0
Devin Berry,270,32,229,99,126,72,1212.0,0,0,85.0,229,99,16.2,2017,0.0
Marquis Cunningham,245,24,204,92,97,61,706.0,2,0,64.0,202,92,23.4,2017,0.0
Khalid Campbell,12,4,22,5,4,2,106.0,14,0,4.0,8,5,13.6,2017,0.0
Cedric Turner,6,2,8,2,5,2,44.0,0,0,5.0,8,2,17.7,2017,0.0
Devin Carter,1087,89,838,368,225,160,2259.0,475,191,102.0,363,177,22.8,2017,0.0
Jahmiah Simmons,302,28,226,108,134,84,1118.0,17,2,58.0,209,106,15.9,2017,0.0
Nelson Nweke,98,8,87,40,29,18,442.0,0,0,22.0,87,40,14.3,2017,0.0
Christian Davis,48,1,53,13,36,22,256.0,4,0,22.0,49,13,17.4,2017,0.0
Dusty Hannahs,1509,123,1139,487,330,293,3156.0,612,242,156.0,527,245,22.7,2017,1.0
Moses Kingsley,1200,106,835,424,508,344,2701.0,18,8,172.0,817,416,22.3,2017,0.0
Manuale Watkins,477,172,381,202,102,60,1960.0,36,13,74.0,345,189,12.4,2017,0.0
Brachen Hazen,425,63,307,147,149,105,1287.0,78,26,101.0,229,121,18.5,2017,0.0
Mac Hoffman,270,46,209,100,96,63,1199.0,27,7,65.0,182,93,13.0,2017,0.0
Kennedy Edwards,317,32,285,117,95,54,884.0,114,29,64.0,171,88,21.6,2017,0.0
Scott Mammel,164,46,140,53,23,19,629.0,99,39,32.0,41,14,14.3,2017,0.0
Adam Roe,147,13,128,48,29,18,371.0,90,33,21.0,38,15,21.0,2017,0.0
Richard Brown,13,9,21,5,4,2,155.0,12,1,11.0,9,4,10.8,2017,0.0
Gunther Klimes,5,5,11,2,0,0,56.0,5,1,4.0,6,1,13.1,2017,0.0
Ben Mammel,2,1,2,1,0,0,6.0,1,0,0.0,1,1,44.1,2017,0.0
Daniel Andrews,1,0,1,0,4,1,9.0,0,0,2.0,1,0,26.0,2017,0.0
Vincent McFadden,0,0,0,0,0,0,2.0,0,0,0.0,0,0,0.0,2017,0.0
Danjel Purifoy,692,112,553,217,159,135,1972.0,362,123,85.0,191,94,17.1,2017,0.0
T.J. Dunans,439,130,412,170,112,70,1224.0,114,29,121.0,298,141,22.4,2017,0.0
Ronnie Johnson,1238,420,1082,441,417,283,3177.0,228,73,248.0,854,368,23.8,2017,0.0
Austin Wiley,732,24,447,257,368,218,1454.0,4,0,122.0,443,257,24.4,2017,0.0
TJ Lang,609,72,471,179,169,115,2321.0,370,136,73.0,101,43,12.9,2017,0.0
LaRon Smith,314,25,242,137,107,40,1220.0,0,0,61.0,242,137,14.2,2017,0.0
Devin Waddell,29,10,38,10,11,5,452.0,19,4,14.0,19,6,6.2,2017,0.0
Mike Cohen,0,1,0,0,0,0,4.0,0,0,0.0,0,0,0.0,2017,0.0
Trey Tate,0,0,1,0,0,0,6.0,1,0,0.0,0,0,7.7,2017,0.0
John Murry,653,58,441,208,231,183,1201.0,157,54,98.0,284,154,26.9,2017,0.0
Kenny Jones,712,72,512,289,244,128,1821.0,19,6,125.0,493,283,20.5,2017,0.0
Jared Savage,1294,148,1027,417,247,204,3880.0,681,256,133.0,346,161,16.6,2017,0.0
Dre' Clayton,128,23,133,49,35,17,667.0,55,13,36.0,78,36,14.2,2017,0.0
Assane Diop,155,25,157,58,47,27,656.0,50,12,46.0,107,46,17.0,2017,0.0
Domas Budrys,23,1,36,7,7,3,112.0,25,6,5.0,11,1,19.6,2017,0.0
Jartavious Dobbs,6,1,7,3,1,0,88.0,0,0,10.0,7,3,10.0,2017,0.0
Franko House,1371,261,962,493,497,352,3368.0,121,33,245.0,841,460,22.0,2017,0.0
Ryan Weber,1095,173,829,350,224,182,3090.0,562,213,173.0,267,137,18.3,2017,0.0
DouDou Gueye,41,13,39,19,11,3,405.0,0,0,20.0,39,19,7.9,2017,0.0
Kaleb Mallory,19,18,24,7,10,4,142.0,8,1,9.0,16,6,14.1,2017,0.0
Johnathan Motley,1229,132,923,479,396,259,2477.0,50,12,205.0,873,467,27.0,2017,1.0
Ishmail Wainright,498,259,419,175,135,89,2458.0,178,59,142.0,241,116,12.8,2017,0.0
Wendell Mitchell,756,140,671,247,181,144,1938.0,376,118,150.0,295,129,23.8,2017,0.0
Evan Bradds,1921,214,1109,740,612,429,3606.0,37,12,283.0,1072,728,23.8,2017,0.0
Taylor Barnette,1085,181,897,360,162,125,3130.0,682,240,98.0,215,120,17.6,2017,0.0
Nick Smith,781,32,591,262,77,64,1546.0,485,193,51.0,106,69,22.5,2017,0.0
Josh Lester,23,3,22,7,11,7,115.0,10,2,5.0,12,5,14.3,2017,0.0
Reggie Baker,431,54,413,157,93,73,994.0,148,44,50.0,265,113,24.9,2017,0.0
Quinton Forrest,736,103,593,305,183,100,2284.0,99,26,134.0,494,279,17.7,2017,0.0
Diamante Lewis,572,186,549,214,148,96,1572.0,142,48,122.0,407,166,23.1,2017,0.0
Brandon Suggs,229,18,153,94,76,41,1093.0,0,0,31.0,153,94,10.2,2017,0.0
Josue Salaam,172,22,170,60,12,8,576.0,129,44,16.0,41,16,16.3,2017,0.0
Danny Harris,21,2,14,8,8,4,42.0,5,1,11.0,9,7,32.3,2017,0.0
Marquel Ingram,80,21,77,25,18,16,348.0,47,14,28.0,30,11,15.9,2017,0.0
Marlon Beck II,1034,276,946,331,251,164,3583.0,640,208,187.0,306,123,18.6,2017,0.0
John Rinaldi,88,55,69,33,40,22,808.0,5,0,39.0,64,33,8.3,2017,0.0
Justin McFadden,346,84,246,94,180,131,1528.0,91,27,99.0,155,67,15.2,2017,0.0
Paris Austin,1156,329,886,387,469,355,3168.0,111,27,240.0,775,360,22.1,2017,0.0
James Reid,554,93,413,170,122,98,1446.0,315,116,71.0,98,54,19.2,2017,0.0
Nick Duncan,1141,155,894,362,224,167,3587.0,683,250,147.0,211,112,16.6,2017,0.0
Cameron Oluyitan,894,139,695,305,218,171,2299.0,314,113,146.0,381,192,20.4,2017,0.0
Matt Grooms,0,0,2,0,0,0,7.0,1,0,1.0,1,0,21.4,2017,0.0
A.J. Turner,857,274,784,300,176,124,3419.0,420,133,129.0,364,167,15.2,2017,0.0
Connar Tava,1154,314,777,409,501,327,3407.0,55,9,322.0,722,400,20.5,2017,0.0
Maurice Jeffers,545,59,424,211,217,123,2101.0,0,0,152.0,424,211,16.5,2017,0.0
Garland Owens,427,94,355,168,104,63,1984.0,92,28,93.0,263,140,13.6,2017,0.0
Ty Graves,276,42,313,98,23,18,1053.0,206,62,49.0,107,36,17.8,2017,0.0
Mike Sagay,30,0,29,11,10,4,67.0,7,4,7.0,22,7,29.8,2017,0.0
Aser Ghebremichael,3,0,1,1,0,0,9.0,1,1,0.0,0,0,6.0,2017,0.0
Eric Fanning,1412,164,923,425,603,463,2641.0,272,99,262.0,651,326,28.8,2017,0.0
Justin Alston,811,67,594,333,205,145,2075.0,2,0,133.0,592,333,20.8,2017,0.0
Kyle Foreman,467,248,392,156,146,112,1631.0,143,43,157.0,249,113,19.2,2017,0.0
Dylan Haines,133,20,136,54,22,11,563.0,51,14,44.0,85,40,17.4,2017,0.0
Blaise Mbargorba,232,14,176,98,55,36,832.0,0,0,48.0,176,98,15.7,2017,0.0
Dylan Brossman,12,4,15,3,4,4,84.0,12,2,4.0,3,1,20.5,2017,0.0
Cameron Curry,22,22,24,6,6,6,188.0,19,4,9.0,5,2,10.2,2017,0.0
Zack Denny,1070,94,918,378,220,169,2699.0,399,145,124.0,519,233,21.4,2017,0.0
Wesley Alcegaire,746,67,637,269,163,109,1824.0,287,99,112.0,350,170,22.2,2017,0.0
Ismail Ali,387,247,306,121,195,132,1429.0,48,13,138.0,258,108,18.4,2017,0.0
Rasheed Worrell,379,27,312,149,133,76,1163.0,16,5,51.0,296,144,18.1,2017,0.0
Malik Hluchoweckyj,39,9,33,15,7,4,168.0,15,5,9.0,18,10,13.1,2017,0.0
Hunter Folkertsma,6,1,1,1,4,4,5.0,0,0,1.0,1,1,37.4,2017,0.0
Teo Redding,5,0,3,2,0,0,5.0,2,1,0.0,1,1,28.8,2017,0.0
Antoine Pittman,470,75,426,164,146,96,1579.0,158,46,117.0,268,118,20.4,2017,0.0
Ronnie Suggs,487,76,465,153,177,128,1960.0,209,53,97.0,256,100,17.7,2017,0.0
Lou Griffith,0,0,0,0,0,0,3.0,0,0,0.0,0,0,0.0,2017,0.0
Eric Mika,1080,88,705,372,475,336,1816.0,1,0,133.0,704,372,27.1,2017,0.0
Nick Emery,1173,214,962,401,211,172,2641.0,531,199,145.0,431,202,21.4,2017,0.0
L.J. Rose,608,415,516,192,210,155,2374.0,213,69,189.0,303,123,17.0,2017,0.0
Davin Guinn,178,26,181,66,46,28,831.0,64,18,39.0,117,48,14.5,2017,0.0
Steven Beo,80,28,77,30,24,9,399.0,39,11,18.0,38,19,12.4,2017,0.0
Jamal Aytes,543,30,382,220,150,102,1067.0,2,1,78.0,380,219,24.1,2017,0.0
Colby Leifson,89,11,82,29,5,3,211.0,78,28,13.0,4,1,21.9,2017,0.0
Corbin Kaufusi,330,13,203,119,156,92,1225.0,0,0,80.0,203,119,13.8,2017,0.0
Zach Frampton,5,2,8,1,2,2,51.0,5,1,2.0,3,0,9.9,2017,0.0
Steven Spieth,1367,337,901,406,527,447,3835.0,313,108,280.0,588,298,18.6,2017,0.0
Tavon Blackmon,1166,465,957,388,400,297,3468.0,247,93,310.0,710,295,21.0,2017,0.0
JR Hobbie,907,53,653,275,111,100,2425.0,599,257,70.0,54,18,16.0,2017,0.0
Corey Daugherty,194,75,197,66,28,21,739.0,142,41,44.0,55,25,17.0,2017,0.0
Kyle Haber,80,12,72,27,22,13,385.0,41,13,17.0,31,14,12.9,2017,0.0
Miki Ljuboja,15,1,10,5,4,4,48.0,5,1,7.0,5,4,19.7,2017,0.0
Blake Wilkinson,50,6,51,19,22,12,287.0,0,0,16.0,51,19,15.1,2017,0.0
Brandon Charnov,4,0,2,1,2,2,11.0,0,0,1.0,2,1,17.7,2017,0.0
Nisre Zouzoua,1355,156,1118,450,312,248,2928.0,567,207,140.0,551,243,24.1,2017,0.0
Marcel Pettway,673,103,494,291,173,91,1882.0,0,0,112.0,494,291,18.4,2017,0.0
Dan Garvin,895,96,749,373,245,142,2684.0,38,7,169.0,711,366,20.1,2017,0.0
Justin Brickman,40,30,39,13,15,11,221.0,10,3,24.0,29,10,16.2,2017,0.0
Terrill Toe,5,1,8,2,0,0,45.0,6,1,1.0,2,1,10.1,2017,0.0
D.J. MacLeay,388,48,291,149,126,80,1150.0,34,10,92.0,257,139,19.8,2017,0.0
John Azzinaro,459,77,439,155,68,46,1485.0,273,103,70.0,166,52,19.2,2017,0.0
Ben Oberfeld,68,2,54,26,26,16,264.0,0,0,10.0,54,26,15.2,2017,0.0
Blake Hamilton,1072,233,838,364,308,229,2048.0,314,115,226.0,524,249,28.1,2017,0.0
Willie Conner,900,86,676,282,307,221,2303.0,339,115,129.0,337,167,19.4,2017,0.0
David Kadiri,396,14,284,164,124,68,1240.0,1,0,49.0,283,164,15.2,2017,0.0
Raheem Johnson,182,3,130,76,45,30,656.0,0,0,41.0,130,76,14.1,2017,0.0
Quate McKinzie,72,10,44,28,11,7,260.0,17,9,9.0,27,19,10.5,2017,0.0
Nikola Rakicevic,95,17,82,37,28,13,348.0,28,8,18.0,54,29,15.3,2017,0.0
James Jones,28,4,26,10,5,3,83.0,15,5,3.0,11,5,17.8,2017,1.0
Christian Pino,12,6,20,3,8,6,50.0,9,0,8.0,11,3,30.2,2017,0.0
Andrew Chrabascz,1271,254,934,441,429,312,3568.0,212,77,149.0,722,364,18.8,2017,0.0
Avery Woodson,862,105,703,289,94,71,2474.0,519,213,67.0,184,76,16.5,2017,0.0
Kethan Savage,982,191,736,322,404,290,2488.0,171,48,178.0,565,274,23.1,2017,0.0
Tyler Lewis,669,402,507,207,241,192,2435.0,209,63,116.0,298,144,15.6,2017,0.0
Trey Pettus,22,12,21,8,6,3,80.0,9,3,3.0,12,5,17.4,2017,0.0
Steven Bennett,29,8,28,10,1,0,112.0,24,9,6.0,4,1,15.9,2017,0.0
Ridge Shipley,861,287,756,280,219,154,2840.0,442,147,152.0,314,133,19.1,2017,0.0
Kyle Toth,585,53,492,207,51,33,1753.0,338,138,34.0,154,69,16.3,2017,0.0
Zach Gordon,327,17,240,110,179,107,1529.0,2,0,74.0,238,110,13.9,2017,0.0
Jaylen Shead,505,326,441,177,162,109,2071.0,141,42,159.0,300,135,16.4,2017,0.0
Josh Mishler,38,9,36,12,11,7,183.0,25,7,6.0,11,5,13.5,2017,0.0
Taylor Sutlive,251,47,207,88,12,9,848.0,165,66,24.0,42,22,14.5,2017,0.0
Alec Raven,4,0,3,1,2,2,17.0,1,0,0.0,2,1,12.2,2017,0.0
Jaylin Airington,1050,192,812,338,369,289,2857.0,247,85,152.0,565,253,20.2,2017,0.0
Dedrick Basile,838,228,700,317,126,89,2008.0,306,115,132.0,394,202,21.8,2017,0.0
Matt Smith,746,36,564,290,312,166,2033.0,7,0,122.0,557,290,20.0,2017,0.0
Justin Pride,233,174,181,66,169,100,1189.0,5,1,89.0,176,65,14.5,2017,0.0
Taze Moore,884,196,716,337,212,149,2088.0,174,61,178.0,542,276,23.8,2017,0.0
Tre' Coggins,1483,194,1205,492,307,252,3101.0,682,247,232.0,523,245,26.0,2017,0.0
Lionheart Leslie,580,128,424,192,224,163,1554.0,128,33,100.0,296,159,20.0,2017,0.0
Darcy Malone,161,31,120,55,69,43,852.0,31,8,55.0,89,47,11.9,2017,0.0
Richard Peters,208,14,154,89,60,30,916.0,0,0,64.0,154,89,14.0,2017,0.0
Riley Dearring,22,2,27,7,7,4,71.0,18,4,10.0,9,3,30.3,2017,0.0
Jhan Paul Mejia,5,3,14,2,0,0,43.0,11,1,1.0,3,1,17.2,2017,0.0
Loren Brill,8,2,11,2,6,3,32.0,6,1,8.0,5,1,34.4,2017,0.0
Joshua Currenton,0,0,0,0,0,0,8.0,0,0,0.0,0,0,0.0,2017,0.0
Kendall Smith,1400,354,1177,486,443,304,3128.0,343,124,250.0,834,362,25.3,2017,0.0
Darin Johnson,712,89,531,212,294,235,1856.0,184,53,93.0,347,159,20.2,2017,0.0
Aaron Parks,1100,205,875,327,556,418,2889.0,111,28,202.0,764,299,23.2,2017,0.0
Rakim Lubin,219,11,156,83,92,53,574.0,1,0,61.0,155,83,22.0,2017,0.0
Dylan Johns,103,16,79,46,24,11,663.0,0,0,43.0,79,46,10.0,2017,0.0
Jerron Wilbut,245,25,234,86,59,40,520.0,123,33,51.0,111,53,29.3,2017,0.0
Jason Richardson,269,100,242,98,92,59,810.0,45,14,70.0,197,84,21.5,2017,1.0
Siyao Sun,2,0,4,1,0,0,9.0,1,0,0.0,3,1,21.1,2017,0.0
Mehran Nazarian,7,0,11,3,4,1,22.0,6,0,1.0,5,3,30.8,2017,0.0
Antonio Bruno,0,1,2,0,0,0,5.0,0,0,1.0,2,0,28.5,2017,0.0
Julian Richardson,24,8,23,7,8,7,98.0,14,3,5.0,9,4,16.8,2017,0.0
Brynton Lemar,1170,214,957,380,356,262,3147.0,394,148,190.0,563,232,21.8,2017,0.0
Lawrence White,427,88,356,156,147,80,1618.0,117,35,88.0,239,121,16.2,2017,0.0
Darius Graham,923,418,758,299,281,200,3834.0,339,125,315.0,419,174,16.7,2017,0.0
J.T. Adenrele,947,80,707,373,311,199,2533.0,4,2,202.0,703,371,22.2,2017,0.0
Michael Henn,497,72,412,174,117,80,1662.0,201,69,97.0,211,105,17.0,2017,0.0
Georgi Funtarov,269,26,246,103,57,28,825.0,122,35,47.0,124,68,20.5,2017,0.0
Jaron Martin,1062,226,890,370,165,132,2540.0,454,190,138.0,436,180,22.7,2017,0.0
Ioannis Dimakopoulos,766,84,642,312,150,100,1795.0,122,42,117.0,520,270,24.1,2017,0.0
Luke Nelson,1531,414,1242,514,322,245,3480.0,709,258,264.0,533,256,25.0,2017,0.0
Spencer Rivers,121,49,121,45,30,11,634.0,66,20,37.0,55,25,14.0,2017,0.0
Secean Johnson,710,105,550,213,310,234,1757.0,160,50,143.0,390,163,24.3,2017,0.0
Gentrey Thomas,418,83,389,168,62,41,1304.0,150,41,99.0,239,127,20.2,2017,0.0
Malik Thames,378,131,328,120,109,85,1437.0,151,53,69.0,177,67,15.9,2017,0.0
Eric Childress,734,407,637,253,186,133,3020.0,258,95,236.0,379,158,16.6,2017,0.0
Tide Osifeso,34,11,43,11,9,4,136.0,32,8,7.0,11,3,20.2,2017,0.0
Tyler Jackson,21,0,15,9,6,3,76.0,0,0,8.0,15,9,17.2,2017,0.0
Felix White,0,0,1,0,0,0,25.0,0,0,2.0,1,0,6.1,2017,0.0
Ivan Rabb,860,79,574,312,341,227,1987.0,22,9,119.0,552,303,21.9,2017,1.0
Charlie Moore,1243,427,1119,420,330,257,3095.0,451,146,295.0,668,274,25.1,2017,0.0
Jabari Bird,1227,132,1018,450,186,140,3013.0,504,187,137.0,514,263,21.3,2017,1.0
Grant Mullins,1316,277,938,407,334,284,3535.0,538,218,164.0,400,189,19.3,2017,0.0
Sam Singer,469,292,439,184,124,63,2451.0,138,38,147.0,301,146,13.6,2017,0.0
Kameron Rooks,354,31,243,134,152,86,1468.0,0,0,56.0,243,134,12.8,2017,0.0
Roger Moute a Bidias,161,29,147,45,79,54,914.0,60,17,41.0,87,28,12.8,2017,0.0
Stephen Domingo,153,46,202,52,54,22,935.0,134,27,21.0,68,25,13.8,2017,0.0
Koko Kurdoghlian,1,0,1,0,2,1,9.0,0,0,0.0,1,0,11.2,2017,0.0
Kyre' Hamer,937,217,649,325,291,212,2933.0,205,75,222.0,444,250,18.3,2017,0.0
Khadre Lane,127,14,101,36,60,42,357.0,46,13,15.0,55,23,21.0,2017,0.0
Austin Burnette,26,10,31,9,8,6,176.0,13,2,6.0,18,7,12.3,2017,0.0
Quinton Ray,205,199,231,74,63,41,2069.0,91,16,120.0,140,58,9.8,2017,0.0
Jacob Talbert,15,6,20,6,4,3,52.0,10,0,6.0,10,6,28.4,2017,0.0
Josh Crumpler,3,0,3,0,5,3,13.0,1,0,0.0,2,0,21.9,2017,0.0
Phil Valenti,1353,236,1047,502,334,253,3288.0,273,96,201.0,774,406,21.3,2017,0.0
Kiefer Douse,460,120,361,170,115,80,1298.0,118,40,85.0,243,130,18.8,2017,0.0
Martin Dixon-Green,52,5,49,17,18,12,172.0,18,6,14.0,31,11,20.2,2017,0.0
Chris Atkinson,165,87,184,51,40,30,734.0,125,33,38.0,59,18,16.2,2017,0.0
Ronnie Gombe,101,0,97,46,27,9,402.0,0,0,30.0,97,46,16.9,2017,0.0
Tyrell Taylor,0,0,0,0,0,0,0.0,0,0,0.0,0,0,0,2017,0.0
Derreck Brooks,766,167,668,280,142,114,1880.0,251,92,123.0,417,188,21.7,2017,0.0
Jeff Lowery,406,181,342,141,145,103,1465.0,54,21,121.0,288,120,17.3,2017,0.0
Albert Christensson,208,21,176,73,103,51,834.0,32,11,77.0,144,62,17.6,2017,0.0
Khalen Cumberlander,1138,242,1020,432,283,154,3386.0,381,120,251.0,639,312,21.2,2017,0.0
Tidell Pierre,281,26,247,100,138,78,974.0,7,3,55.0,240,97,19.3,2017,0.0
Tafari Whittingham,304,13,274,114,149,73,1022.0,11,3,88.0,263,111,21.2,2017,0.0
Kevin Seymour,293,183,323,120,44,29,1614.0,79,24,110.0,244,96,14.5,2017,0.0
Antwann Anderson,5,1,5,2,0,0,19.0,2,1,2.0,3,1,19.0,2017,0.0
Matt Williams,1105,138,950,363,136,105,3115.0,740,274,126.0,210,89,18.7,2017,0.0
Tanksley Efianayi,384,59,330,124,136,99,1223.0,130,37,74.0,200,87,19.7,2017,0.0
Nick Banyard,456,90,419,166,123,66,2100.0,151,58,141.0,268,108,15.3,2017,0.0
Anthony Catotti,2,0,1,1,0,0,6.0,0,0,0.0,1,1,8.7,2017,0.0
Tate Morse,0,1,2,0,0,0,4.0,2,0,0.0,0,0,26.0,2017,0.0
Brock Stephenson,0,0,6,0,0,0,17.0,5,0,0.0,1,0,18.3,2017,0.0
Marcus Keene,1602,293,1199,527,385,310,2655.0,625,238,242.0,574,289,29.1,2017,0.0
Braylon Rayson,1885,232,1551,625,448,364,3681.0,768,271,237.0,783,354,26.9,2017,0.0
DaRohn Scott,277,5,173,111,115,55,1106.0,0,0,57.0,173,111,12.8,2017,0.0
Blake Hibbitts,727,48,617,231,120,89,2407.0,501,176,74.0,116,55,16.1,2017,0.0
Janeau Joubert,12,2,12,3,8,6,31.0,3,0,0.0,9,3,22.9,2017,0.0
Cole Israelson,10,0,9,3,6,4,28.0,0,0,1.0,9,3,22.5,2017,0.0
Armel Potter,1388,414,1138,489,462,313,3383.0,307,97,242.0,831,392,24.3,2017,0.0
Raemond Robinson,628,153,539,205,69,49,2003.0,427,169,117.0,112,36,17.5,2017,0.0
Patrick Wallace,443,77,390,145,44,36,1277.0,330,117,60.0,60,28,18.4,2017,0.0
Antwan Maxwell,232,29,246,91,41,24,741.0,101,26,53.0,145,65,21.0,2017,0.0
Ugo Mmonu,160,5,121,52,72,51,626.0,20,5,52.0,101,47,16.6,2017,0.0
Zach Durkee,21,3,12,8,4,3,26.0,3,2,1.0,9,6,28.4,2017,0.0
TayVaughn Major,6,0,4,3,2,0,16.0,0,0,4.0,4,3,27.7,2017,0.0
Brock Johnson,4,3,5,2,0,0,8.0,2,0,0.0,3,2,31.0,2017,0.0
Braxton Ogbueze,1108,180,915,367,192,148,3064.0,550,226,110.0,365,141,17.9,2017,0.0
Anthony Vanhook,459,155,374,179,140,99,1360.0,6,2,82.0,368,177,18.7,2017,0.0
Quentin Jackson,194,43,187,73,55,36,648.0,48,12,44.0,139,61,19.5,2017,0.0
JC Washington,42,11,40,20,5,2,157.0,1,0,13.0,39,20,17.3,2017,0.0
Reid Aube,43,3,27,14,16,15,349.0,0,0,14.0,27,14,6.8,2017,0.0
Lukas Bergang,4,0,0,0,4,4,30.0,0,0,1.0,0,0,4.7,2017,0.0
Justin Tuoyo,1144,97,743,413,455,303,2837.0,55,15,151.0,688,398,19.9,2017,0.0
Tre' McLean,973,188,759,337,257,197,2761.0,299,102,158.0,460,235,19.1,2017,0.0
Greg Pryor,1203,343,879,356,446,346,3366.0,435,145,246.0,444,211,20.0,2017,0.0
Johnathan Burroughs-Cook,536,86,440,177,204,137,1436.0,158,45,88.0,282,132,22.2,2017,0.0
Casey Jones,1321,215,995,508,400,283,3187.0,78,22,278.0,917,486,22.9,2017,0.0
Peyton Woods,103,7,84,31,16,14,261.0,77,27,7.0,7,4,19.2,2017,0.0
Trayvond Massenburg,20,1,17,9,7,2,81.0,0,0,4.0,17,9,15.2,2017,0.0
Trayvon Palmer,1000,112,805,360,299,214,2792.0,207,66,216.0,598,294,20.5,2017,0.0
Clemmye Owens,985,142,888,354,147,109,2603.0,480,168,129.0,408,186,21.4,2017,0.0
Delundre Dixon,169,59,144,55,68,45,850.0,58,14,53.0,86,41,13.1,2017,0.0
Anthony Eaves,282,63,288,107,23,19,809.0,145,49,64.0,143,58,21.5,2017,0.0
Brian Greene,216,101,242,79,46,29,1122.0,88,29,71.0,154,50,15.2,2017,0.0
Joshua Batson,198,120,270,66,95,50,1407.0,86,16,92.0,184,50,14.3,2017,0.0
Gentry Hunt,25,2,23,8,6,4,85.0,17,5,6.0,6,3,18.3,2017,0.0
Troy Caupain,1317,515,1092,433,390,297,3981.0,455,154,222.0,637,279,19.8,2017,1.0
Quadri Moore,194,15,187,69,53,39,618.0,58,17,57.0,129,52,23.1,2017,0.0
Zack Tobler,29,2,27,7,23,13,69.0,9,2,5.0,18,5,32.7,2017,0.0
Warren Sledge,730,320,597,229,193,150,2812.0,341,122,153.0,256,107,13.7,2017,0.0
Ezekiel Balogun,364,25,274,140,102,56,828.0,73,28,74.0,201,112,21.4,2017,0.0
Brian White,1059,47,731,380,304,246,2467.0,154,53,127.0,577,327,19.9,2017,0.0
Tom Koopman,261,30,234,112,50,33,1071.0,17,4,57.0,217,108,14.1,2017,0.0
Tyler Burgess,125,6,128,41,5,3,223.0,125,40,9.0,3,1,27.5,2017,0.0
Aaron Washington,12,2,9,4,4,2,20.0,4,2,1.0,5,2,24.7,2017,0.0
Bobby Duncan,30,5,17,10,22,10,167.0,1,0,10.0,16,10,9.5,2017,0.0
Griffin Peevey,8,0,5,3,2,2,7.0,0,0,0.0,5,3,35.3,2017,0.0
Chris Ross,8,0,6,3,0,0,8.0,4,2,0.0,2,1,31.2,2017,0.0
Jaron Blossomgame,1733,141,1286,627,529,383,3925.0,304,96,190.0,982,531,23.4,2017,1.0
Avry Holmes,1259,251,912,377,368,288,3444.0,529,217,161.0,383,160,19.0,2017,0.0
Sidy Djitte,474,36,327,174,203,125,1854.0,2,1,105.0,325,173,15.1,2017,0.0
Ty Hudson,595,171,532,201,161,123,1876.0,235,70,143.0,297,131,19.7,2017,0.0
Riley McGillan,11,2,14,4,2,1,39.0,12,2,2.0,2,2,23.0,2017,0.0
Rob Edwards,1578,156,1317,508,422,326,3663.0,639,236,298.0,678,272,24.7,2017,0.0
Demonte Flannigan,722,48,622,304,165,101,1703.0,44,13,123.0,578,291,26.3,2017,0.0
Jibri Blount,1112,120,815,406,358,249,2599.0,166,51,237.0,649,355,23.8,2017,0.0
Daniel Levitt,113,6,103,34,22,17,329.0,84,28,6.0,19,6,18.6,2017,0.0
Nelson Maxwell,88,27,74,31,22,17,421.0,15,9,34.0,59,22,14.4,2017,0.0
Tim Hasbargen,71,11,56,23,19,14,273.0,33,11,16.0,23,12,16.3,2017,0.0
Elijah Wilson,1885,132,1681,659,385,274,4232.0,852,293,213.0,829,366,24.2,2017,0.0
Colton Ray-St Cyr,740,170,613,266,193,122,2227.0,261,86,144.0,352,180,18.7,2017,0.0
Shivaughn Wiggins,1194,335,818,357,545,391,3344.0,247,89,160.0,571,268,18.6,2017,0.0
Joseph Williams-Powell,153,11,120,56,50,33,409.0,22,8,39.0,98,48,21.5,2017,0.0
Jaylan Robertson,94,30,90,35,19,11,356.0,37,13,30.0,53,22,17.4,2017,0.0
Michel Enanga,545,111,467,192,213,119,2289.0,156,42,158.0,311,150,15.8,2017,0.0
Kevin Holmes Jr.,62,2,90,23,8,3,370.0,67,13,23.0,23,10,15.6,2017,0.0
Nathan Harries,159,38,142,61,27,18,616.0,53,19,25.0,89,42,16.0,2017,0.0
Andrew Bargmann,58,12,42,19,14,11,249.0,27,9,12.0,15,10,13.3,2017,0.0
Dave Krmpotich,140,8,124,55,57,30,413.0,3,0,35.0,121,55,24.2,2017,0.0
Jack Buckmelter,0,0,0,0,0,0,1.0,0,0,0.0,0,0,0.0,2017,0.0
Ryan Diew,0,0,1,0,0,0,6.0,1,0,1.0,0,0,17.9,2017,0.0
Chevez Goodwin,830,60,601,356,248,118,2062.0,3,0,128.0,598,356,21.5,2017,0.0
Terrance O'Donohue,182,8,151,66,70,41,872.0,23,9,49.0,128,57,14.6,2017,0.0
Erik Goldbach,0,0,2,0,0,0,5.0,2,0,1.0,0,0,32.4,2017,0.0
Gian Clavell,1062,119,835,349,308,215,2169.0,412,149,109.0,423,200,25.4,2017,1.0
Emmanuel Omogbo,849,95,639,301,307,205,1903.0,139,42,110.0,500,259,23.4,2017,0.0
Jeremiah Paige,486,137,429,154,142,110,1744.0,200,68,97.0,229,86,17.0,2017,0.0
Braden Koelliker,151,32,122,45,63,51,681.0,44,10,24.0,78,35,13.1,2017,0.0
Devocio Butler,457,87,366,157,99,76,1370.0,170,67,74.0,196,90,16.5,2017,0.0
Derrick White,615,148,404,205,182,148,1116.0,144,57,81.0,260,148,25.3,2017,1.0
Xavier Johnson,1461,91,1068,510,497,311,3387.0,340,130,215.0,728,380,22.9,2017,0.0
Wesley Gordon,870,176,638,309,357,236,3406.0,46,16,169.0,592,293,14.3,2017,0.0
Josh Fortune,1037,247,924,351,207,158,3413.0,526,177,233.0,398,174,18.3,2017,0.0
Bryce Peters,113,24,102,40,36,20,379.0,39,13,17.0,63,27,17.8,2017,0.0
Thomas Akyazili,175,92,191,60,59,37,841.0,80,18,57.0,111,42,15.9,2017,0.0
Mitch Lombard,0,3,2,0,0,0,18.0,0,0,1.0,2,0,8.2,2017,0.0
Luke Petrasek,1040,150,796,372,231,175,2580.0,333,121,162.0,463,251,21.9,2017,0.0
Jeff Coby,560,56,448,193,208,150,1617.0,81,24,98.0,367,169,21.3,2017,0.0
C.J. Davis,212,76,192,74,46,32,713.0,97,32,51.0,95,42,19.1,2017,0.0
Conor Voss,81,17,57,29,39,23,345.0,0,0,27.0,57,29,15.5,2017,0.0
Chris McComber,205,30,189,71,27,14,961.0,153,49,21.0,36,22,12.6,2017,0.0
Kendall Jackson,107,32,93,35,24,18,508.0,62,19,30.0,31,16,14.6,2017,0.0
Andrew Panayiotou,11,3,9,4,1,1,33.0,5,2,4.0,4,2,20.5,2017,0.0
John Sica,11,3,12,4,4,2,91.0,4,1,3.0,8,3,9.5,2017,0.0
Rodney Purvis,1593,243,1367,568,354,226,4097.0,636,231,227.0,731,337,22.9,2017,1.0
Kentan Facey,560,46,431,222,162,113,2173.0,6,3,99.0,425,219,15.0,2017,0.0
Vance Jackson,1089,183,868,351,309,207,2786.0,508,180,194.0,360,171,21.1,2017,0.0
Amida Brimah,895,28,545,347,312,201,2909.0,0,0,134.0,545,347,15.4,2017,0.0
Steven Enoch,756,24,572,290,208,153,1823.0,67,23,115.0,505,267,22.2,2017,0.0
Juwan Durham,726,78,513,295,196,134,1829.0,6,2,86.0,507,293,19.7,2017,0.0
Omotayo Aiyegbusi,0,1,2,0,0,0,8.0,2,0,0.0,0,0,13.3,2017,0.0
Restinel Lomotey,0,0,1,0,0,0,9.0,0,0,0.0,1,0,5.9,2017,0.0
Joshua Treadwell,600,55,513,200,158,123,1349.0,222,77,94.0,291,123,24.4,2017,0.0
Terry Harris Jr,636,57,588,207,251,189,1681.0,146,33,106.0,442,174,23.3,2017,0.0
Keith Shivers,505,112,504,196,126,71,1664.0,165,42,99.0,339,154,19.2,2017,0.0
Joseph Gripper,82,49,77,25,54,32,376.0,9,0,44.0,68,25,19.1,2017,0.0
Izais Hicks,76,8,67,28,43,20,431.0,4,0,16.0,63,28,11.6,2017,0.0
Juwan Davenport,39,5,26,11,28,17,172.0,4,0,18.0,22,11,16.3,2017,0.0
Rasool Hinson,19,4,23,7,8,4,88.0,4,1,9.0,19,6,19.9,2017,0.0
Mufaro Murinda,59,7,59,19,20,13,192.0,37,8,4.0,22,11,18.1,2017,0.0
Robert Hatter,1241,200,1068,432,327,234,2577.0,472,143,223.0,596,289,28.9,2017,0.0
Troy Whiteside,391,78,362,158,63,37,1512.0,120,38,82.0,242,120,15.8,2017,0.0
JoJo Fallas,345,86,326,115,37,28,1486.0,242,87,63.0,84,28,14.1,2017,0.0
Darryl Smith,541,90,400,209,105,74,2030.0,117,49,91.0,283,160,13.7,2017,0.0
Donovon Wright,51,4,50,16,25,11,179.0,19,8,5.0,31,8,19.0,2017,0.0
Desmond Fleming,41,21,29,18,8,5,279.0,4,0,12.0,25,18,8.1,2017,0.0
Joseph Bayless,6,2,6,2,2,2,33.0,0,0,1.0,6,2,12.2,2017,0.0
Justin Patton,453,41,296,200,87,45,885.0,15,8,60.0,281,192,22.0,2017,1.0
Cole Huff,1242,82,944,416,270,219,3132.0,487,191,120.0,457,225,19.3,2017,0.0
Maurice Watson Jr.,1537,800,1220,590,387,270,3643.0,255,87,378.0,965,503,25.2,2017,0.0
Isaiah Zierden,769,153,569,229,161,140,2545.0,441,171,68.0,128,58,14.3,2017,0.0
Zach Hanson,525,15,347,218,146,89,1190.0,2,0,80.0,345,218,21.3,2017,0.0
Kobe Paras,20,3,22,8,7,2,70.0,10,2,4.0,12,6,20.6,2017,0.0
Evan Boudreaux,1243,93,954,420,407,314,2580.0,249,89,185.0,705,331,26.2,2017,0.0
Mike Fleming,210,98,165,66,59,50,1132.0,93,28,53.0,72,38,11.2,2017,0.0
Wesley Dickinson,238,16,159,92,92,54,884.0,0,0,54.0,159,92,15.2,2017,0.0
Ike Ngwudo,77,20,71,29,21,10,405.0,24,9,25.0,47,20,13.5,2017,0.0
Ian Carter,165,28,149,63,53,32,599.0,35,7,42.0,114,56,19.3,2017,0.0
Jonas Stakeliunas,8,0,6,3,0,0,11.0,2,2,1.0,4,1,32.9,2017,0.0
Jack Gibbs,2036,466,1494,647,594,487,3618.0,690,255,284.0,804,392,28.8,2017,0.0
Nathan Ekwu,370,51,283,141,151,83,1305.0,19,5,84.0,264,136,17.1,2017,0.0
Andrew McAuliffe,318,50,262,147,72,23,1323.0,9,1,77.0,253,146,14.3,2017,0.0
Kamau Faines,13,0,8,4,8,4,23.0,2,1,1.0,6,3,28.2,2017,0.0
Manu Giamoukis,4,1,7,1,2,1,34.0,5,1,2.0,2,0,14.8,2017,0.0
Connor Perkey,15,0,5,4,6,6,46.0,1,1,1.0,4,3,10.0,2017,0.0
Charles Cooke,1570,221,1166,506,568,399,3725.0,436,159,208.0,730,347,23.1,2017,1.0
Scoochie Smith,1289,498,983,422,400,286,3851.0,432,159,247.0,551,263,19.4,2017,0.0
Kendall Pollard,1171,122,797,421,555,317,2714.0,48,12,206.0,749,409,24.8,2017,0.0
Kyle Davis,830,257,560,278,305,209,2980.0,217,65,131.0,343,213,14.8,2017,0.0
Ryan Mikesell,847,180,632,306,199,142,2665.0,296,93,120.0,336,213,16.7,2017,0.0
Sam Miller,561,63,410,197,123,93,1573.0,191,74,107.0,219,123,19.3,2017,0.0
Jeremiah Bonsu,0,0,0,0,0,0,1.0,0,0,0.0,0,0,0.0,2017,0.0
Jack Parsley,0,0,0,0,0,0,2.0,0,0,0.0,0,0,0.0,2017,0.0
Devin Morgan Jr.,1328,297,1237,447,213,172,3412.0,768,262,198.0,469,185,22.4,2017,0.0
DeAndre Haywood,1087,207,872,378,418,261,2709.0,235,70,222.0,637,308,24.5,2017,0.0
DeVaughn Mallory,361,27,310,163,54,34,1001.0,8,1,58.0,302,162,20.0,2017,0.0
Dana Raysor,376,52,304,112,102,71,1062.0,224,81,55.0,80,31,19.6,2017,0.0
Mrdjan Gasevic,259,39,224,101,101,57,988.0,1,0,69.0,223,101,17.6,2017,0.0
Mahir Johnson,54,4,47,23,6,4,126.0,8,4,10.0,39,19,24.2,2017,0.0
Jamelle Christian,11,14,14,4,7,2,95.0,7,1,9.0,7,3,14.0,2017,0.0
Quincy Tillinghast,15,6,16,5,3,2,56.0,11,3,8.0,5,2,22.6,2017,0.0
Jordan Bushrod,3,3,10,1,4,1,71.0,5,0,3.0,5,1,9.8,2017,0.0
Reginald Giles Jr.,0,0,0,0,0,0,5.0,0,0,0.0,0,0,0.0,2017,0.0
Cazmon Hayes,1019,132,919,341,301,200,3055.0,474,137,130.0,445,204,20.2,2017,0.0
Devonne Pinkard,525,77,519,174,111,74,2389.0,337,103,79.0,182,71,14.1,2017,0.0
Chivarsky Corbett,481,43,400,165,94,66,1362.0,237,85,50.0,163,80,19.1,2017,0.0
Barnett Harris,101,40,68,27,79,47,871.0,0,0,42.0,68,27,8.8,2017,0.0
Curtis McRoy,12,13,20,4,0,0,249.0,18,4,7.0,2,0,5.6,2017,0.0
C.J. Bobbitt,814,136,669,295,221,150,2416.0,248,74,157.0,421,221,20.5,2017,0.0
Bradley George,73,25,52,27,14,9,289.0,20,10,30.0,32,17,15.7,2017,0.0
Duke Douglas,187,34,158,77,47,28,783.0,25,5,36.0,133,72,16.0,2017,0.0
Josiah Dunn,4,1,2,2,1,0,11.0,0,0,1.0,2,2,17.0,2017,0.0
Jacob Lunsford,0,0,0,0,0,0,4.0,0,0,0.0,0,0,0.0,2017,0.0
Billy Garrett,1632,432,1199,463,672,565,3649.0,437,141,321.0,762,322,25.6,2017,1.0
Chris Harrison-Docks,938,188,791,294,187,152,2648.0,551,198,168.0,240,96,19.9,2017,0.0
Darrick Wood,371,88,392,146,80,47,1088.0,116,32,96.0,276,114,24.7,2017,0.0
R.J. Curington,254,26,214,89,55,43,649.0,107,33,47.0,107,56,22.5,2017,0.0
Levi Cook,130,13,94,53,44,24,541.0,0,0,45.0,94,53,14.1,2017,0.0
Al Eichelberger,744,76,585,276,317,185,1731.0,22,7,166.0,563,269,26.1,2017,0.0
Erten Gazi,304,64,252,117,44,30,1135.0,122,40,68.0,130,77,16.1,2017,0.0
David Leitao III,0,0,0,0,0,0,5.0,0,0,0.0,0,0,0.0,2017,0.0
Jarod Williams,773,215,622,264,280,195,2427.0,165,50,213.0,457,214,19.5,2017,0.0
Patrick Robinson Jr.,113,20,81,37,10,9,358.0,68,30,7.0,13,7,12.2,2017,0.0
Matthew Grant,447,122,414,136,134,108,1840.0,228,67,70.0,186,69,14.7,2017,0.0
Ed Carter III,14,14,30,4,5,4,104.0,17,2,8.0,13,2,18.3,2017,0.0
Aaron Foster-Smith,121,9,99,49,19,10,378.0,35,13,18.0,64,36,15.3,2017,0.0
Billy Wampler,1414,126,1119,462,318,251,2897.0,632,239,129.0,487,223,24.0,2017,0.0
T.J. Thomas,185,23,148,67,78,48,621.0,12,3,38.0,136,64,18.0,2017,0.0
Jacob Enevold,606,40,405,229,211,148,2148.0,0,0,162.0,405,229,17.8,2017,0.0
Johannes Dolven,12,1,14,6,2,0,27.0,0,0,3.0,14,6,33.3,2017,0.0
A.J. Rutter,11,0,10,4,0,0,18.0,8,3,2.0,2,1,33.8,2017,0.0
Rodney Williams,1158,125,860,420,479,315,3055.0,14,3,182.0,846,417,21.5,2017,0.0
Kari Jonsson,282,55,201,94,35,29,797.0,149,65,39.0,52,29,15.5,2017,0.0
Mohamed Bah,328,32,230,125,126,78,1578.0,4,0,61.0,226,125,11.8,2017,0.0
John Moran,109,32,109,32,21,13,472.0,97,32,38.0,12,0,16.2,2017,0.0
Jeremy Peck,142,23,107,57,41,26,767.0,7,2,51.0,100,55,12.1,2017,0.0
Major Canady,93,56,99,30,47,25,669.0,36,8,28.0,63,22,11.7,2017,0.0
Andrew Cartwright,8,1,8,2,2,2,22.0,7,2,1.0,1,0,23.2,2017,0.0
Elgin Ford Jr.,3,0,1,1,0,0,8.0,1,1,0.0,0,0,6.0,2017,0.0
Luke Kennard,1147,146,820,378,286,248,2275.0,373,143,87.0,447,235,22.9,2017,1.0
Jayson Tatum,488,62,365,165,139,118,966.0,117,40,76.0,248,125,26.2,2017,1.0
Frank Jackson,394,61,281,133,102,77,895.0,129,51,49.0,152,82,21.1,2017,1.0
Amile Jefferson,1079,142,687,426,395,227,3344.0,0,0,140.0,687,426,15.4,2017,1.0
Matt Jones,912,195,798,318,155,106,3411.0,459,170,113.0,339,148,14.6,2017,0.0
Harry Giles,102,9,78,45,24,12,300.0,0,0,18.0,78,45,17.9,2017,0.0
Chase Jeter,573,42,381,215,239,143,1592.0,0,0,94.0,381,215,18.6,2017,0.0
Brennan Besser,4,1,8,1,2,2,15.0,6,0,1.0,2,1,31.2,2017,0.0
Nick Pagliuca,4,3,9,1,2,1,41.0,7,1,1.0,2,0,13.7,2017,0.0
Emile Blackman,1312,133,1074,477,295,234,2990.0,355,124,205.0,719,353,23.9,2017,0.0
Isiaha Mike,1154,159,888,405,248,185,2809.0,441,159,198.0,447,246,21.8,2017,0.0
Nakye Sanders,759,110,500,266,359,219,2275.0,21,8,161.0,479,258,18.7,2017,0.0
Darius Lewis,434,49,302,167,183,100,1613.0,0,0,126.0,302,167,15.7,2017,0.0
Kale Abrahamson,714,64,623,234,184,114,2122.0,391,132,89.0,232,102,20.5,2017,0.0
Spencer Littleson,896,141,697,303,101,73,2856.0,515,217,76.0,182,86,14.4,2017,0.0
Josh Steel,83,21,60,28,10,7,278.0,40,20,17.0,20,8,14.1,2017,0.0
David Haus,4,4,5,2,0,0,53.0,1,0,2.0,4,2,6.6,2017,0.0
Caleb White,1578,216,1244,539,317,244,4083.0,676,256,188.0,568,283,20.4,2017,0.0
Jeremy Sheppard,548,172,468,194,104,73,1527.0,242,87,130.0,226,107,21.4,2017,0.0
Elijah Hughes,1269,191,999,411,338,258,2798.0,552,189,160.0,447,222,24.1,2017,0.0
Deng Riak,382,44,343,147,113,74,2123.0,57,14,131.0,286,133,12.6,2017,0.0
Michel Nzege,406,48,306,167,105,70,1505.0,8,2,83.0,298,165,15.5,2017,0.0
Clarence Williams,155,19,151,64,28,20,635.0,23,7,62.0,128,57,18.4,2017,0.0
Raquan Wilkins,49,4,55,16,16,12,211.0,24,5,14.0,31,11,18.6,2017,0.0
John Whitely,0,0,0,0,0,0,2.0,0,0,0.0,0,0,0.0,2017,0.0
T.J. Cromer,1206,221,912,406,269,218,2262.0,453,176,170.0,459,230,26.2,2017,0.0
Tevin Glass,352,35,244,127,125,92,892.0,21,6,56.0,223,121,20.0,2017,0.0
A.J. Merriweather,1084,151,778,384,344,247,2935.0,160,69,217.0,618,315,19.5,2017,0.0
Hanner Mosquera-Perea,556,39,341,197,278,162,1611.0,1,0,99.0,340,197,17.6,2017,0.0
Isaac Banks,451,57,324,190,147,70,2048.0,3,1,93.0,321,189,11.7,2017,0.0
Demetrius McReynolds,753,100,587,266,138,113,1530.0,293,108,57.0,294,158,23.1,2017,0.0
Casey Teson,425,48,351,138,49,44,1451.0,270,105,37.0,81,33,14.2,2017,0.0
Patrick Muldoon,294,44,263,124,77,46,1079.0,3,0,66.0,260,124,16.9,2017,0.0
Joe Kuligoski,174,50,159,63,47,29,933.0,75,19,35.0,84,44,11.8,2017,0.0
Marshawn Blackmon,123,11,93,55,41,12,405.0,4,1,26.0,89,54,17.4,2017,0.0
Isaac McGlone,637,238,523,209,101,75,3098.0,393,144,110.0,130,65,11.4,2017,0.0
Marlon Adams,210,27,199,88,54,18,852.0,55,16,60.0,144,72,16.9,2017,0.0
Jaylen Babb-Harrison,423,67,353,142,62,55,943.0,226,84,51.0,127,58,23.7,2017,0.0
Parker Chitty,56,35,63,17,22,14,348.0,47,8,27.0,16,9,14.6,2017,0.0
Daniel Parke,8,0,6,2,5,3,29.0,4,1,0.0,2,1,14.4,2017,0.0
Oliver Bishop,0,0,0,0,0,0,1.0,0,0,0.0,0,0,0.0,2017,0.0
Trevor Hill,0,0,1,0,0,0,7.0,1,0,1.0,0,0,14.5,2017,0.0
Willie Mangum,897,122,782,311,167,117,1603.0,427,158,119.0,355,153,29.2,2017,0.0
Ray Lee,1873,242,1426,595,591,470,3270.0,600,213,336.0,826,382,31.3,2017,0.0
Ty Toney,784,207,663,269,308,213,2171.0,135,33,148.0,528,236,21.2,2017,0.0
Baylee Steele,708,45,512,264,198,145,1987.0,107,35,95.0,405,229,17.7,2017,0.0
Quaran Jones,91,7,48,31,41,29,180.0,0,0,8.0,48,31,20.0,2017,0.0
Nick Madray,434,20,367,151,111,82,1429.0,150,50,77.0,217,101,18.1,2017,0.0
Blake Brown,24,1,16,9,13,6,174.0,0,0,5.0,16,9,7.5,2017,0.0
Jalen Brown,77,10,70,23,28,14,356.0,51,17,18.0,19,6,15.1,2017,0.0
Felix Von Hofe,1058,88,842,345,143,106,2963.0,657,262,77.0,185,83,17.0,2017,0.0
Geremy McKay,19,0,9,6,13,7,51.0,0,0,2.0,9,6,17.6,2017,0.0
Mario Soto,11,6,18,3,2,2,78.0,15,3,2.0,3,0,14.0,2017,0.0
Julian Harrell,239,48,197,88,59,32,728.0,87,31,39.0,110,57,18.2,2017,0.0
Michael Wearne,6,4,6,3,0,0,33.0,2,0,4.0,4,3,15.6,2017,0.0
Luke Eddy,782,296,594,252,266,199,2029.0,241,79,195.0,353,173,22.5,2017,0.0
Christian Hairston,586,75,422,240,176,105,1785.0,8,1,126.0,414,239,17.6,2017,0.0
Patrick Ryan,16,2,14,6,4,3,32.0,8,1,5.0,6,5,32.8,2017,0.0
Ryder Bowline,15,3,12,6,4,0,34.0,9,3,4.0,3,3,26.8,2017,0.0
Jaylon Brown,1369,339,970,464,484,376,3512.0,176,65,229.0,794,399,21.5,2017,0.0
David Howard,412,21,285,151,202,110,1206.0,2,0,56.0,283,151,19.2,2017,0.0
Christian Benzon,322,72,240,109,187,98,1403.0,16,6,71.0,224,103,15.1,2017,0.0
Willie Wiley,154,11,133,61,55,32,484.0,1,0,31.0,132,61,20.7,2017,0.0
Jaiveon Eaves,511,86,453,182,93,70,1483.0,226,77,75.0,227,105,19.4,2017,0.0
Sergej Vucetic,82,7,61,28,38,26,307.0,0,0,28.0,61,28,18.4,2017,0.0
Curtis Cobb,1286,214,1173,476,191,130,3085.0,575,204,218.0,598,272,24.0,2017,0.0
Jerry Johnson Jr.,1128,207,934,362,245,192,2840.0,599,212,164.0,335,150,21.6,2017,0.0
Amadou Sidibe,752,97,587,302,227,148,2701.0,0,0,155.0,587,302,16.6,2017,0.0
Deniz Celen,655,107,526,279,81,56,1675.0,131,41,112.0,395,238,19.9,2017,0.0
Andrew Leone,13,4,10,1,12,10,39.0,9,1,2.0,1,0,22.8,2017,0.0
Stephan Jiggetts,1263,350,1069,392,428,333,3477.0,414,146,292.0,655,246,22.8,2017,0.0
Earl Potts Jr.,922,76,727,333,186,133,2243.0,346,123,79.0,381,210,19.7,2017,0.0
Ghassan Nehme,187,33,180,63,21,17,549.0,116,44,36.0,64,19,20.1,2017,0.0
Tyrone O'Garro,324,73,270,132,135,60,1773.0,2,0,105.0,268,132,12.1,2017,0.0
DaRon Curry,39,18,38,15,14,8,196.0,7,1,14.0,31,14,14.6,2017,0.0
Ashton Malone-Dunson,2,0,2,1,0,0,13.0,0,0,0.0,2,1,7.7,2017,0.0
Derrick Dandridge,218,20,187,79,95,57,626.0,14,3,41.0,173,76,21.1,2017,0.0
Elijah Mays,171,90,173,62,43,30,652.0,63,17,34.0,110,45,16.8,2017,0.0
Trey Warren,240,6,186,91,95,57,670.0,3,1,70.0,183,90,22.1,2017,0.0
K'ja Johnson,243,89,205,85,83,45,931.0,83,28,77.0,122,57,17.0,2017,0.0
Leon Williams,53,4,48,21,19,11,160.0,1,0,9.0,47,21,19.9,2017,0.0
Andrew Smith,0,0,1,0,0,0,3.0,0,0,0.0,1,0,16.1,2017,0.0
Adonis Filer,989,219,837,315,348,264,2709.0,318,95,203.0,519,220,23.4,2017,0.0
Nick Rutherford,871,426,775,282,377,269,3258.0,147,38,285.0,628,244,19.0,2017,0.0
Jeantal Cylla,1013,51,868,346,283,219,2662.0,334,102,131.0,534,244,21.3,2017,0.0
Frank Booker,912,90,724,281,199,152,2304.0,560,198,97.0,164,83,19.5,2017,0.0
Marcus Neely,164,48,188,65,55,33,1043.0,25,1,41.0,163,64,12.1,2017,0.0
Jesse Hill,143,12,136,50,41,25,564.0,54,18,10.0,82,32,15.3,2017,0.0
Jordan Phillips,0,0,1,0,0,0,2.0,1,0,0.0,0,0,24.8,2017,0.0
Demetris Morant,646,34,419,279,163,88,1971.0,0,0,100.0,419,279,15.2,2017,0.0
Rayjon Tucker,1081,113,661,334,394,298,2368.0,278,115,151.0,383,219,20.9,2017,1.0
Marc Eddy Norelia,1084,102,804,430,343,223,2402.0,7,1,134.0,797,429,22.9,2017,0.0
Reggie Reid,222,171,217,79,58,35,1029.0,106,29,73.0,111,50,15.3,2017,0.0
Kevin Mickle,366,44,311,152,87,57,1310.0,19,5,86.0,292,147,16.6,2017,0.0
Rendijs Feikners,21,5,9,6,8,7,42.0,4,2,2.0,5,4,17.5,2017,0.0
Maxx Bleecher,16,3,11,7,0,0,37.0,4,2,4.0,7,5,20.1,2017,0.0
Donte McGill,994,69,804,371,221,191,1918.0,162,61,124.0,642,310,28.1,2017,0.0
Michael Kessens,1137,125,825,447,347,232,3178.0,52,11,251.0,773,436,20.1,2017,0.0
Eric Nottage,502,184,388,168,122,95,1609.0,192,71,141.0,196,97,19.0,2017,0.0
Elmo Stephen,466,34,374,158,84,59,1170.0,237,91,43.0,137,67,20.4,2017,0.0
Kimar Williams,447,234,416,165,202,109,2062.0,47,8,142.0,369,157,15.8,2017,0.0
Anthony Boswell,86,13,94,30,14,12,504.0,50,14,21.0,44,16,12.6,2017,0.0
Richard Bivens,35,0,25,14,3,2,142.0,8,5,8.0,17,9,12.7,2017,0.0
Dwayne Bacon,1139,111,930,418,292,214,1987.0,285,89,145.0,645,329,29.1,2017,1.0
Jonathan Isaac,383,37,256,130,118,92,839.0,89,31,48.0,167,99,20.3,2017,1.0
Xavier Rathan-Mayes,1236,451,1014,430,374,249,3047.0,432,127,256.0,582,303,23.6,2017,1.0
Michael Ojo,351,25,240,126,174,99,1282.0,0,0,96.0,240,126,16.5,2017,0.0
Jarquez Smith,612,39,468,239,172,117,1879.0,70,17,130.0,398,222,18.1,2017,0.0
Devin Robinson,935,63,742,334,234,167,2413.0,298,100,99.0,444,234,19.9,2017,1.0
Canyon Barry,1292,125,1093,423,354,286,2882.0,468,160,180.0,625,263,26.6,2017,0.0
Kasey Hill,1087,530,988,390,446,266,3600.0,172,41,304.0,816,349,21.3,2017,0.0
Justin Leon,448,28,359,164,69,46,1310.0,190,74,49.0,169,90,16.4,2017,0.0
John Egbunu,816,31,533,302,387,211,2184.0,2,1,157.0,531,301,19.8,2017,0.0
Eric Hester,43,6,23,15,4,2,111.0,19,11,3.0,4,4,12.4,2017,0.0
Schuyler Rimmer,70,5,59,25,32,19,347.0,2,1,17.0,57,24,13.0,2017,0.0
Javontae Hawkins,1169,107,893,406,351,274,2559.0,254,83,188.0,639,323,25.2,2017,0.0
Nemanja Zarkovic,212,84,218,73,33,20,1145.0,146,46,53.0,72,27,12.9,2017,0.0
Sinan Saglam,5,2,7,2,1,1,28.0,5,0,2.0,2,2,18.1,2017,0.0
Paul Watson,1361,116,1121,465,354,250,4014.0,500,181,202.0,621,284,19.4,2017,1.0
Cullen Russo,473,122,400,164,202,123,1528.0,107,22,89.0,293,142,19.0,2017,0.0
Karachi Edo,863,41,615,327,334,204,2470.0,20,5,77.0,595,322,17.8,2017,0.0
Darryl McDowell-White,3,0,2,1,1,1,15.0,1,0,0.0,1,1,8.3,2017,0.0
Ryan Beddeo,2,2,2,1,0,0,8.0,1,0,3.0,1,1,31.5,2017,0.0
Kris Acox,1051,85,731,448,297,155,3027.0,1,0,175.0,730,448,18.3,2017,0.0
Tre Clark,296,106,291,121,113,43,1467.0,64,11,99.0,227,110,15.5,2017,0.0
T.K. Hayes,14,3,17,4,8,5,61.0,10,1,6.0,7,3,23.4,2017,0.0
Laquincy Rideau,1519,574,1276,533,566,311,3604.0,433,142,394.0,843,391,26.6,2017,0.0
Tyrell Nelson,1664,139,1167,653,550,345,3412.0,39,13,253.0,1128,640,24.2,2017,0.0
Matthew Rodden,9,1,9,4,4,0,15.0,3,1,0.0,6,3,35.3,2017,0.0
Marquise Moore,1270,363,987,440,518,373,3554.0,69,17,259.0,918,423,21.1,2017,0.0
Jalen Jenkins,1106,163,786,413,424,279,3028.0,5,1,250.0,781,412,20.6,2017,0.0
Karmari Newman,446,51,382,143,97,75,1199.0,253,85,59.0,129,58,20.6,2017,0.0
Troy Temara,38,4,41,16,15,6,200.0,0,0,13.0,41,16,15.3,2017,0.0
Kameron Murrell,96,19,129,27,28,22,497.0,90,20,21.0,39,7,16.3,2017,0.0
DeAndre Abram,921,60,904,336,158,110,2546.0,452,139,116.0,452,197,21.4,2017,0.0
Daniel Relvao,22,3,20,8,9,6,187.0,0,0,12.0,20,8,9.7,2017,0.0
Danny Dixon,308,24,245,112,110,77,953.0,15,7,50.0,230,105,18.8,2017,0.0
Myles Tate,25,14,26,6,13,9,156.0,12,4,12.0,14,2,14.3,2017,0.0
Tyler Cavanaugh,1724,155,1221,545,584,479,3502.0,417,155,257.0,804,390,25.6,2017,1.0
Jaren Sina,680,247,578,197,183,147,2750.0,392,139,133.0,186,58,15.1,2017,0.0
Jordan Roland,1496,170,1118,515,263,227,3099.0,604,239,116.0,514,276,23.7,2017,0.0
Collin Smith,827,120,651,299,326,207,2111.0,75,22,186.0,576,277,24.2,2017,0.0
Matt Hart,290,43,235,99,42,37,822.0,130,55,34.0,105,44,17.9,2017,0.0
Kevin Marfo,548,89,340,159,346,229,1726.0,4,1,112.0,336,158,18.4,2017,0.0
Collin Goss,325,36,235,137,62,37,1080.0,44,14,59.0,191,123,16.0,2017,0.0
Rodney Pryor,1645,151,1270,591,314,249,3003.0,562,214,188.0,708,377,27.3,2017,0.0
L.J. Peak,1186,199,857,395,405,308,2709.0,263,88,187.0,594,307,23.3,2017,0.0
Akoy Agau,327,49,205,101,158,117,1131.0,31,8,100.0,174,93,17.3,2017,0.0
Bradley Hayes,372,56,290,155,118,62,1066.0,0,0,81.0,290,155,20.4,2017,0.0
Tre Campbell,538,193,518,175,116,85,2235.0,302,103,95.0,216,72,14.9,2017,0.0
Reggie Cameron,357,64,310,116,71,53,1225.0,221,72,56.0,89,44,16.9,2017,0.0
Trey Mourning,201,28,171,75,72,45,614.0,38,6,43.0,133,69,19.6,2017,0.0
Aubrey McRae,34,3,42,13,5,2,74.0,27,6,3.0,15,7,31.3,2017,0.0
Brandon Wimberly,9,1,7,3,3,2,21.0,3,1,0.0,4,2,19.7,2017,0.0
Dominique Bullock,6,1,5,2,0,0,12.0,5,2,2.0,0,0,29.1,2017,0.0
James Holder,9,6,11,3,2,1,18.0,7,2,1.0,4,1,35.3,2017,0.0
David Georgiev,5,2,3,2,2,0,8.0,2,1,0.0,1,1,24.6,2017,0.0
Deshaven Reynolds,1,0,2,0,4,1,5.0,1,0,0.0,1,0,38.9,2017,0.0
Jeremy Hollowell,1202,145,988,411,353,270,2825.0,349,110,213.0,639,301,24.9,2017,0.0
Willie Clayton,1049,63,715,424,462,201,3088.0,0,0,243.0,715,424,18.9,2017,0.0
Isaiah Dennis,347,136,244,141,123,61,1282.0,7,4,88.0,237,137,16.0,2017,0.0
Justin Seymour,637,124,543,217,125,89,1962.0,309,114,120.0,234,103,19.1,2017,0.0
Austin Donaldson,102,56,101,40,39,17,431.0,18,5,43.0,83,35,19.4,2017,0.0
Carter Cagle,9,2,7,3,0,0,31.0,7,3,2.0,0,0,14.9,2017,0.0
Quinton Stephens,857,157,827,303,158,113,2931.0,442,138,145.0,385,165,18.2,2017,0.0
Josh Heath,444,384,411,161,140,101,2558.0,82,21,180.0,329,140,13.1,2017,0.0
Corey Heyward,134,93,136,41,58,33,1394.0,60,19,54.0,76,22,8.0,2017,0.0
Christian Matthews,51,4,39,15,20,15,107.0,14,6,6.0,25,9,25.9,2017,0.0
Kellen McCormick,457,36,335,156,44,32,1250.0,258,113,48.0,77,43,16.7,2017,0.0
Jodan Price,276,24,321,93,39,25,1043.0,237,65,40.0,84,28,18.1,2017,0.0
Norman Harris,2,0,4,1,0,0,7.0,0,0,1.0,4,1,36.3,2017,0.0
Shaheed Medlock,4,0,4,2,0,0,13.0,0,0,1.0,4,2,19.6,2017,0.0
Rand Rowland,2,2,4,1,0,0,31.0,0,0,4.0,4,1,13.1,2017,0.0
J.J. Frazier,1628,422,1212,487,535,450,3528.0,576,204,201.0,636,283,24.1,2017,0.0
Kenny Paul Geno,191,74,172,70,42,26,1240.0,80,25,32.0,92,45,9.2,2017,0.0
Houston Kessler,113,10,130,45,30,17,925.0,38,6,36.0,92,39,9.9,2017,0.0
Brandon Young,1,1,11,0,2,1,33.0,3,0,3.0,8,0,23.2,2017,0.0
Nigel Williams-Goss,1536,496,1236,574,361,291,3415.0,293,97,258.0,943,477,24.7,2017,1.0
Przemek Karnowski,1495,165,1033,615,511,264,3212.0,3,1,245.0,1030,614,24.3,2017,0.0
Jordan Mathews,1617,170,1226,513,395,305,3799.0,699,286,145.0,527,227,21.0,2017,0.0
Zach Collins,390,16,207,135,148,110,673.0,21,10,60.0,186,125,24.8,2017,1.0
Ryan Edwards,460,25,362,176,139,97,985.0,36,11,73.0,326,165,23.4,2017,0.0
Dustin Triano,51,7,31,17,5,3,161.0,28,14,4.0,3,3,11.9,2017,0.0
Rem Bakamus,19,6,17,4,13,8,97.0,15,3,5.0,2,1,14.9,2017,0.0
Ervin Mitchell,824,62,597,274,302,208,1619.0,192,68,99.0,405,206,26.0,2017,0.0
Remond Brown,976,155,868,373,261,167,2833.0,207,63,202.0,661,310,21.3,2017,0.0
Chase Cormier,354,274,346,93,237,136,2467.0,121,32,194.0,225,61,13.5,2017,0.0
Marcel Thompson,93,10,89,33,11,6,275.0,65,21,12.0,24,12,18.9,2017,0.0
Carlton Lowe,262,17,196,83,94,63,631.0,104,33,34.0,92,50,22.4,2017,0.0
Xairius Larry,43,6,36,13,12,6,123.0,29,11,6.0,7,2,18.9,2017,0.0
Deonte Hearns,289,22,224,103,140,83,797.0,7,0,72.0,217,103,23.6,2017,0.0
Noah Cummings,24,1,18,9,9,6,162.0,0,0,17.0,18,9,11.8,2017,0.0
Dewayne Russell,1711,525,1397,565,623,459,3962.0,330,122,297.0,1067,443,25.4,2017,0.0
Darion Clark,602,53,467,229,282,144,1936.0,1,0,155.0,466,229,19.2,2017,0.0
Kenzo Nudo,35,3,50,13,8,4,117.0,27,5,10.0,23,8,26.6,2017,0.0
Adrian Carrion Armas,6,3,5,2,6,2,36.0,2,0,3.0,3,2,15.3,2017,0.0
Juwan Washington,4,0,1,1,2,2,5.0,0,0,0.0,1,1,19.0,2017,0.0
Christopher Miller,51,5,56,18,14,8,222.0,21,7,12.0,35,11,18.0,2017,0.0
Charles Cooper,913,107,669,298,447,302,1776.0,82,15,147.0,587,283,25.9,2017,0.0
Kerem Kanter,872,45,636,338,227,158,1513.0,123,38,86.0,513,300,25.6,2017,0.0
Warren Jones,532,98,399,151,217,158,1113.0,221,72,70.0,178,79,25.8,2017,0.0
Jamar Hurdle,506,34,417,205,99,70,1069.0,59,26,70.0,358,179,22.3,2017,0.0
Kenneth Lowe,720,139,563,309,229,102,2606.0,1,0,161.0,562,309,15.0,2017,0.0
Turner Botz,477,70,407,145,118,88,1808.0,277,99,56.0,130,46,13.1,2017,0.0
Trevor Anderson,356,130,266,116,88,68,1416.0,143,56,68.0,123,60,13.1,2017,0.0
Tevin Findlay,359,144,330,133,119,74,1255.0,70,19,100.0,260,114,17.8,2017,0.0
Findlay Tevin,2,2,5,1,0,0,13.0,1,0,1.0,4,1,20.7,2017,0.0
Kaharri Carter,1,0,1,0,2,1,10.0,1,0,0.0,0,0,8.8,2017,0.0
Lawrence Cooks,743,150,597,229,202,164,2282.0,338,121,131.0,259,108,17.3,2017,0.0
Branden Aughburns,108,3,91,42,40,23,332.0,2,1,22.0,89,41,19.2,2017,0.0
Devon Oakley,118,45,87,40,52,35,608.0,13,3,34.0,74,37,11.5,2017,0.0
Imani Miller,19,28,17,5,16,8,282.0,1,1,20.0,16,4,7.5,2017,0.0
Donald Ralls,7,2,12,3,0,0,28.0,8,1,8.0,4,2,34.8,2017,0.0
Jalen Ross,1112,233,921,345,380,287,2920.0,390,135,219.0,531,210,23.5,2017,0.0
TreVaughn Wilkerson,98,21,91,41,29,15,665.0,8,1,45.0,83,40,11.6,2017,0.0
Jake Fay,24,3,41,7,4,3,124.0,31,7,8.0,10,0,20.2,2017,0.0
Siyani Chambers,1287,601,1016,393,430,342,4140.0,432,159,300.0,584,234,20.0,2017,0.0
Zena Edosomwan,743,68,598,296,291,151,1684.0,0,0,128.0,598,296,27.0,2017,0.0
Corbin Miller,603,70,540,200,63,47,1961.0,418,156,66.0,122,44,17.6,2017,0.0
Tommy McCarthy,268,123,261,83,69,57,888.0,142,45,98.0,119,38,22.7,2017,0.0
Matt Fraschilla,15,5,11,5,5,2,94.0,4,3,11.0,7,2,14.0,2017,0.0
James McLean,0,0,1,0,0,0,8.0,0,0,1.0,1,0,12.9,2017,0.0
Noah Allen,555,104,441,194,165,119,1511.0,161,48,106.0,280,146,21.1,2017,0.0
Matthew Owies,70,24,72,24,16,12,312.0,38,10,21.0,34,14,16.6,2017,0.0
Larry Lewis Jr.,37,3,32,11,23,15,136.0,8,0,6.0,24,11,18.5,2017,0.0
Brian Garrett,5,0,4,1,4,2,13.0,2,1,1.0,2,0,27.3,2017,0.0
Darryl Matthews,3,0,1,0,6,3,9.0,0,0,0.0,1,0,22.0,2017,0.0
Miles Bowman,667,35,448,226,205,172,1427.0,110,43,76.0,338,183,23.0,2017,0.0
Anthony Lindauer,843,200,682,277,137,122,2427.0,398,167,169.0,284,110,19.8,2017,0.0
Tarique Thompson,640,63,498,259,150,112,1774.0,28,10,88.0,470,249,19.6,2017,0.0
Deron Powers,1497,561,1196,469,517,425,4199.0,426,134,331.0,770,335,20.6,2017,0.0
Brian Bernardi,1296,174,1042,410,231,197,3782.0,722,279,141.0,320,131,17.0,2017,0.0
Ty Greer,173,27,158,63,45,29,549.0,54,18,39.0,104,45,19.8,2017,0.0
Tommy Ros,0,0,3,0,0,0,6.0,0,0,0.0,3,0,24.9,2017,0.0
Robert Champion,1057,111,870,368,255,168,2629.0,454,153,149.0,416,215,24.6,2017,0.0
Malachi Alexander,1303,224,984,433,456,303,3743.0,336,134,230.0,648,299,21.5,2017,0.0
Matt Husek,478,70,417,184,73,47,1422.0,180,63,63.0,237,121,20.5,2017,0.0
Anthony Thompson,857,278,730,236,332,245,3561.0,451,140,137.0,279,96,16.1,2017,0.0
Thomas Kennedy,4,0,5,2,1,0,26.0,1,0,1.0,4,2,14.7,2017,0.0
Tyrone Cohen,0,0,1,0,0,0,2.0,0,0,0.0,1,0,29.8,2017,0.0
Rory Flaherty,0,0,1,0,0,0,5.0,0,0,3.0,1,0,47.7,2017,0.0
Patrick Rielly,3,0,6,1,3,1,22.0,1,0,0.0,5,1,19.0,2017,0.0
Colter Lasher,1246,214,1042,471,228,165,2796.0,390,139,193.0,652,332,23.0,2017,0.0
Reveal Chukwujekwu,911,165,705,319,337,251,2697.0,79,22,208.0,626,297,19.0,2017,0.0
Alex Fountain,535,81,423,180,167,131,1678.0,120,44,71.0,303,136,16.3,2017,0.0
Atif Russell,581,93,484,211,180,117,1804.0,140,42,110.0,344,169,19.2,2017,0.0
Asa Cantwell,349,67,290,111,31,26,1056.0,260,101,51.0,30,10,16.0,2017,0.0
Jalen Weber,78,36,69,24,29,21,348.0,29,9,30.0,40,15,15.0,2017,0.0
Cody Stetler,318,50,273,119,120,77,1029.0,13,3,67.0,260,116,18.6,2017,0.0
Colin Just,10,0,8,4,4,2,29.0,0,0,2.0,8,4,19.0,2017,0.0
Kyren Block,8,1,8,3,7,2,20.0,1,0,1.0,7,3,28.6,2017,0.0
Damyean Dotson,1732,149,1390,645,250,199,3906.0,639,243,154.0,751,402,21.5,2017,1.0
Danrad Knowles,962,72,771,353,326,204,2751.0,169,52,142.0,602,301,20.0,2017,0.0
Kyle Meyer,157,37,141,60,55,33,1024.0,29,4,47.0,112,56,10.7,2017,0.0
Morris Dunnigan,48,2,51,18,13,8,125.0,18,4,4.0,33,14,25.4,2017,0.0
Bertrand Nkali,79,5,49,25,50,29,570.0,0,0,17.0,49,25,8.1,2017,0.0
Xavier Dupree,49,16,50,18,2,1,261.0,30,12,18.0,20,6,13.5,2017,0.0
Mateen Hirbod,26,7,21,7,11,9,64.0,13,3,6.0,8,4,27.3,2017,0.0
James Miller,930,101,734,333,278,192,2082.0,234,72,189.0,500,261,25.6,2017,0.0
Solomon Mangham,675,40,687,240,147,92,2249.0,329,103,95.0,358,137,18.8,2017,0.0
Damon Collins,807,210,703,267,361,248,3497.0,109,25,313.0,594,242,16.8,2017,0.0
Marcel Boyd,657,63,487,226,365,205,2767.0,1,0,207.0,486,226,15.4,2017,0.0
Tyler Stone,556,39,434,181,270,182,2204.0,55,12,117.0,379,169,15.1,2017,0.0
Kofi Andoh,328,60,247,90,192,139,1561.0,39,9,94.0,208,81,13.5,2017,0.0
James Daniel,2128,314,1613,591,803,656,3740.0,852,290,379.0,761,301,31.7,2017,0.0
Chuck Smith,10,13,13,4,5,2,87.0,3,0,8.0,10,4,13.2,2017,0.0
Ausar Madison,57,56,54,17,37,20,485.0,15,3,49.0,39,14,12.5,2017,0.0
Prince Okoroh,936,89,853,332,378,247,2745.0,98,25,214.0,755,307,23.3,2017,0.0
Ethan Telfair,1101,301,879,325,419,346,2121.0,296,105,208.0,583,220,30.6,2017,0.0
Robert Jones III,228,35,175,82,48,32,706.0,82,32,51.0,93,50,18.2,2017,0.0
Stephen Lennox,173,19,131,52,76,54,735.0,54,15,34.0,77,37,13.9,2017,0.0
Keshawn Liggins,15,3,12,6,8,3,94.0,1,0,1.0,11,6,9.2,2017,0.0
Clark Wilkinson,15,1,9,4,9,7,65.0,0,0,1.0,9,4,11.4,2017,0.0
Patrick Ingram,240,75,193,84,102,60,912.0,33,12,77.0,160,72,17.8,2017,0.0
Ty Egbert,405,32,282,150,167,105,1423.0,0,0,72.0,282,150,15.6,2017,0.0
Tyler Brimhall,42,5,47,13,8,6,133.0,34,10,7.0,13,3,22.2,2017,0.0
Nick Blair,383,59,302,148,101,61,1407.0,86,26,75.0,216,122,15.1,2017,0.0
Myles Franklin,32,24,24,8,21,15,181.0,10,1,12.0,14,7,13.0,2017,0.0
Jake Straughan,81,8,55,25,11,7,182.0,52,24,5.0,3,1,18.2,2017,0.0
K.J. Santos,275,47,259,98,67,40,1104.0,110,39,81.0,149,59,16.1,2017,0.0
Michael Kolawole,501,130,442,179,188,123,1654.0,94,20,136.0,348,159,18.9,2017,0.0
Kyle Guice,127,32,106,41,9,6,508.0,102,39,19.0,4,2,11.9,2017,0.0
Lance Whitaker,266,140,250,86,121,67,1545.0,92,27,68.0,158,59,11.8,2017,0.0
Hassan Thomas,41,8,45,11,23,17,200.0,8,2,11.0,37,9,15.6,2017,0.0
Paris Lee,1268,495,1042,417,335,254,4000.0,497,180,275.0,545,237,19.1,2017,0.0
MiKyle McIntosh,1341,187,1078,451,478,329,3261.0,323,110,275.0,755,341,24.9,2017,0.0
DJ Clayton,348,71,335,132,102,53,1327.0,108,31,76.0,227,101,17.9,2017,0.0
Tony Wills,649,162,549,224,170,123,2897.0,253,78,111.0,296,146,13.2,2017,0.0
Andre Washington,177,16,123,69,69,39,773.0,1,0,41.0,122,69,13.1,2017,0.0
Javaka Thompson,15,1,15,6,4,2,54.0,7,1,2.0,8,5,18.2,2017,0.0
Malcolm Hill,1846,281,1347,583,655,521,3864.0,453,159,220.0,894,424,25.5,2017,0.0
Maverick Morgan,760,55,587,318,177,124,2136.0,0,0,125.0,587,318,19.4,2017,0.0
Tracy Abrams,1191,374,1041,399,369,272,3605.0,387,121,255.0,654,278,21.4,2017,0.0
Jalen Coleman-Lands,1401,140,1209,471,205,166,3733.0,792,293,177.0,417,178,20.0,2017,0.0
Mike Thorne,857,47,685,355,276,147,2199.0,2,0,133.0,683,355,21.7,2017,0.0
Jaylon Tate,293,304,248,84,161,119,1986.0,57,6,131.0,191,78,12.1,2017,0.0
D.J. Williams,544,55,519,208,151,96,1607.0,123,32,92.0,396,176,22.3,2017,0.0
Alex Austin,530,84,422,176,137,102,1684.0,234,76,69.0,188,100,18.1,2017,0.0
Clayton Jones,4,0,3,1,1,1,11.0,2,1,0.0,1,0,16.1,2017,0.0
Tyler Singleton,420,110,336,147,175,111,1348.0,41,15,95.0,295,132,18.9,2017,0.0
Jerred Kite,104,21,75,36,39,24,586.0,16,8,19.0,59,28,9.6,2017,0.0
Miles Banks,51,10,47,22,21,7,254.0,0,0,14.0,47,22,13.8,2017,0.0
Phillip Johnson,73,15,68,28,23,14,537.0,13,3,23.0,55,25,9.5,2017,0.0
Evan Beucler,0,0,0,0,0,0,3.0,0,0,0.0,0,0,0.0,2017,0.0
Marek Hulva,0,0,0,0,0,0,3.0,0,0,0.0,0,0,0.0,2017,0.0
Everett Clemons,475,229,358,172,186,125,1834.0,24,6,109.0,334,166,15.3,2017,0.0
Matt Van Scyoc,1331,101,1020,423,329,243,3450.0,661,242,195.0,359,181,20.7,2017,0.0
Laquarious Paige,285,71,262,108,44,34,1142.0,119,35,106.0,143,73,17.0,2017,0.0
T.J. Bell,278,24,211,112,80,54,878.0,0,0,66.0,211,112,18.7,2017,0.0
Niels Bunschoten,291,28,261,102,48,39,940.0,154,48,44.0,107,54,17.6,2017,0.0
Donovan Franklin,109,17,102,35,33,25,332.0,53,14,24.0,49,21,21.7,2017,0.0
James Blackmon,1235,128,938,424,221,182,2223.0,494,205,136.0,444,219,26.4,2017,0.0
Thomas Bryant,842,84,515,305,284,204,1745.0,75,28,136.0,440,277,22.1,2017,1.0
OG Anunoby,342,41,238,134,90,47,868.0,74,27,54.0,164,107,19.0,2017,1.0
Grant Gelon,22,0,9,7,8,5,39.0,5,3,1.0,4,4,17.3,2017,0.0
Jordan Washington,1070,33,747,400,416,269,1339.0,4,1,144.0,743,399,39.6,2017,0.0
Jon Severe,1305,218,1130,431,324,259,2885.0,516,184,241.0,614,247,26.0,2017,0.0
Sam Cassell Jr.,492,127,442,159,87,72,1444.0,294,102,59.0,148,57,18.9,2017,0.0
Taylor Bessick,462,32,398,193,125,76,1858.0,0,0,99.0,398,193,15.5,2017,0.0
DeAndre Turner,8,1,11,2,6,3,43.0,7,1,1.0,4,1,16.9,2017,0.0
Luka Milosavljevic,0,0,3,0,0,0,20.0,3,0,4.0,0,0,17.1,2017,0.0
Monte Morris,1708,768,1336,636,364,284,4734.0,399,152,165.0,937,484,17.7,2017,1.0
Nazareth Mitrou-Long,1250,235,954,430,173,130,3206.0,685,260,154.0,269,170,18.6,2017,0.0
Deonte Burton,1052,108,845,404,265,176,2053.0,168,68,150.0,677,336,27.7,2017,1.0
Matt Thomas,1170,181,923,394,157,128,3510.0,634,254,114.0,289,140,15.8,2017,1.0
Darrell Bowie,871,91,709,302,465,250,2532.0,62,17,248.0,647,285,24.2,2017,0.0
Merrill Holden,292,4,186,99,147,92,997.0,10,2,51.0,176,97,15.0,2017,0.0
Simeon Carter,480,26,392,218,65,40,1216.0,32,4,50.0,360,214,18.5,2017,0.0
Stuart Nezlek,8,1,7,3,2,2,18.0,0,0,3.0,7,3,30.6,2017,0.0
Wes Greder,0,0,3,0,3,0,14.0,3,0,0.0,0,0,15.9,2017,0.0
Peter Jok,1508,193,1191,491,352,310,2801.0,571,216,183.0,620,275,27.0,2017,0.0
Christian Williams,482,183,424,169,147,112,1902.0,88,32,117.0,336,137,16.6,2017,0.0
Dale Jones,391,35,314,133,57,47,876.0,208,78,55.0,106,55,22.6,2017,0.0
Mo Evans,1522,466,1141,520,263,216,3365.0,649,266,256.0,492,254,22.7,2017,0.0
Brent Calhoun,517,62,426,225,107,66,1396.0,2,1,135.0,424,224,21.4,2017,0.0
DeAngelo Stewart,457,56,378,155,65,46,1314.0,262,101,43.0,116,54,16.8,2017,0.0
Charles Ruise Jr.,166,27,166,64,35,25,481.0,57,13,24.0,109,51,20.9,2017,0.0
Racine Talla,101,17,115,33,45,27,565.0,34,8,44.0,81,25,15.5,2017,0.0
Trevor Osborn,14,5,17,3,9,7,53.0,11,1,4.0,6,2,23.7,2017,0.0
Darell Combs,1313,210,1076,436,377,284,2521.0,433,157,238.0,643,279,29.6,2017,0.0
Matt O'Leary,1018,238,809,380,219,140,2916.0,346,118,190.0,463,262,19.4,2017,0.0
Kellon Thomas,1043,277,862,321,382,298,3176.0,316,103,174.0,546,218,19.2,2017,0.0
Giovanni Fraser,18,0,14,6,14,6,82.0,0,0,6.0,14,6,15.7,2017,0.0
Grant Sinn,3,0,10,1,0,0,20.0,10,1,1.0,0,0,27.0,2017,0.0
Yettra Specks,842,234,730,263,221,179,2965.0,425,137,179.0,305,126,17.2,2017,0.0
Edric Dennis,1032,201,937,322,329,227,2489.0,503,161,225.0,434,161,26.9,2017,0.0
Janarius Middleton,803,102,717,345,144,89,2696.0,84,24,135.0,633,321,17.1,2017,0.0
Derek Roscoe,191,20,188,76,53,32,551.0,37,7,49.0,151,69,24.1,2017,0.0
Javares Brent,789,84,811,259,69,52,2590.0,664,219,103.0,147,40,18.3,2017,0.0
Dontaveon Robinson,306,65,336,127,85,52,1713.0,6,0,87.0,330,127,13.6,2017,0.0
Sherron Wilson,75,23,99,25,25,15,436.0,40,10,25.0,59,15,16.2,2017,0.0
Anfernee Felton,9,7,10,2,5,4,90.0,5,1,2.0,5,1,7.5,2017,0.0
Montreal Nabors,2,0,5,1,0,0,27.0,3,0,3.0,2,1,15.0,2017,0.0
Greg Tucker,757,146,612,207,280,225,2143.0,366,118,139.0,246,89,21.7,2017,0.0
Erik Durham,625,85,458,217,100,66,1783.0,284,125,57.0,174,92,16.6,2017,0.0
Andre Statam,232,21,209,81,33,25,724.0,129,45,32.0,80,36,18.7,2017,0.0
Derrick Green,40,14,37,10,29,15,217.0,17,5,10.0,20,5,14.9,2017,0.0
Deshawn Jones,20,8,20,7,10,6,110.0,4,0,14.0,16,7,18.7,2017,0.0
J.R. Holder,1368,161,995,464,501,344,3188.0,295,96,230.0,700,368,23.2,2017,0.0
Darien Fernandez,620,209,513,193,202,145,1716.0,249,89,127.0,264,104,21.4,2017,0.0
Darius Dawkins,458,19,333,151,39,31,971.0,273,125,27.0,60,26,19.3,2017,0.0
Marcel White,1003,75,759,320,297,204,2441.0,402,159,106.0,357,161,20.5,2017,0.0
Omar El Manasterly,248,30,186,92,103,64,1188.0,0,0,54.0,186,92,12.3,2017,0.0
Andris Misters,503,71,378,164,127,105,1275.0,180,70,78.0,198,94,21.4,2017,0.0
Demontrez Austin,135,15,101,54,35,27,824.0,0,0,28.0,101,54,8.8,2017,0.0
Jackson Kent,1228,216,990,398,317,251,3771.0,504,181,194.0,486,217,18.9,2017,0.0
Paulius Satkus,552,89,358,194,215,154,1765.0,29,10,144.0,329,184,18.2,2017,0.0
Shakir Brown,607,72,540,204,129,100,1445.0,298,99,87.0,242,105,24.9,2017,0.0
Tom Vodanovich,655,86,520,250,195,122,2674.0,138,33,181.0,382,217,15.8,2017,0.0
Ivan Lukic,271,31,216,100,90,60,1078.0,51,11,48.0,165,89,15.2,2017,0.0
Yohanny Dalembert,885,73,603,331,365,222,2152.0,1,1,202.0,602,330,24.2,2017,0.0
Dimitrije Cabarkapa,449,12,371,168,56,47,917.0,176,66,56.0,195,102,26.0,2017,0.0
V.J. Holmes,518,265,382,161,272,181,2058.0,67,15,168.0,315,146,16.0,2017,0.0
Terrence Johnson,23,6,24,6,12,7,159.0,15,4,8.0,9,2,12.7,2017,0.0
Tyriq Nady,0,2,5,0,0,0,27.0,0,0,4.0,5,0,17.8,2017,0.0
Wesley Iwundu,1249,366,917,425,506,348,3728.0,151,51,280.0,766,374,19.9,2017,0.0
D.J. Johnson,864,30,551,327,323,210,2271.0,1,0,139.0,550,327,19.0,2017,0.0
Carlbe Ervin II,196,98,162,69,59,44,1001.0,51,14,67.0,111,55,13.0,2017,0.0
Isaiah Maurice,375,23,309,151,86,55,973.0,65,18,82.0,244,133,21.2,2017,0.0
Austin Budke,97,18,75,27,54,38,539.0,24,5,23.0,51,22,11.5,2017,0.0
Zach Winter,16,3,18,6,0,0,50.0,11,4,4.0,7,2,22.4,2017,0.0
Dante Williams,9,1,6,3,3,3,29.0,0,0,1.0,6,3,15.1,2017,0.0
Frank Mason,1885,576,1340,609,633,482,4345.0,440,185,270.0,900,424,21.8,2017,1.0
Josh Jackson,572,104,429,220,173,98,1077.0,90,34,97.0,339,186,27.2,2017,1.0
Landen Lucas,632,70,392,240,239,152,2151.0,1,0,136.0,391,240,14.7,2017,0.0
Carlton Bragg Jr.,747,56,554,289,233,162,1744.0,24,7,118.0,530,282,21.6,2017,0.0
Dwight Coleby,714,34,478,270,248,174,2035.0,1,0,105.0,477,270,17.2,2017,0.0
Tyler Self,19,12,26,7,4,2,95.0,15,3,20.0,11,4,25.0,2017,0.0
Tucker Vang,0,1,1,0,0,0,17.0,0,0,1.0,1,0,5.7,2017,0.0
Kendrick Ray,1322,220,1085,493,278,206,2461.0,357,130,184.0,728,363,27.7,2017,0.0
Aubrey Williams,682,70,433,243,284,196,1777.0,2,0,89.0,431,243,18.0,2017,0.0
Johannes Nielsen,153,23,111,60,43,33,514.0,2,0,35.0,109,60,15.7,2017,0.0
Zach Cameron,112,27,93,43,47,26,845.0,1,0,30.0,92,43,8.8,2017,0.0
Josh Burnett,17,7,30,7,3,1,120.0,9,2,10.0,21,5,16.8,2017,0.0
Cameron Neysmith,3,0,5,1,2,1,14.0,1,0,1.0,4,1,24.9,2017,0.0
Jimmy Hall,1772,217,1381,708,480,345,3215.0,45,11,283.0,1336,697,29.4,2017,0.0
Deon Edwin,710,124,536,249,215,147,1830.0,185,65,130.0,351,184,20.1,2017,0.0
Alonzo Walker,558,50,451,232,135,83,1559.0,29,11,92.0,422,221,18.7,2017,0.0
Jerrelle DeBerry,205,15,151,60,73,55,418.0,74,30,31.0,77,30,25.5,2017,0.0
Leo Edwards,36,1,34,16,7,4,180.0,0,0,11.0,34,16,13.1,2017,0.0
Jon Fleming,9,4,8,2,6,4,47.0,7,1,4.0,1,1,15.7,2017,0.0
Rosel Hurley,375,61,322,149,114,68,991.0,34,9,83.0,288,140,22.8,2017,0.0
Malik Monk,754,87,558,251,180,148,1218.0,262,104,75.0,296,147,27.2,2017,1.0
De'Aaron Fox,601,165,447,214,212,156,1064.0,69,17,87.0,378,197,27.5,2017,1.0
Bam Adebayo,494,32,284,170,236,154,1145.0,0,0,64.0,284,170,18.5,2017,1.0
Isaiah Briscoe,763,258,648,295,272,151,2189.0,96,22,155.0,552,273,20.4,2017,1.0
Derek Willis,555,51,400,189,86,69,1543.0,271,108,60.0,129,81,15.6,2017,0.0
Dominique Hawkins,293,103,251,92,101,72,1426.0,130,37,35.0,121,55,11.3,2017,0.0
Mychal Mulder,163,20,149,56,15,14,428.0,108,37,13.0,41,19,18.4,2017,0.0
Isaac Humphries,148,11,129,61,40,26,525.0,0,0,26.0,129,61,15.7,2017,1.0
Jordan Price,1768,267,1449,578,467,355,3609.0,719,257,299.0,730,321,28.8,2017,0.0
Cleon Roberts,1184,140,945,368,334,253,3666.0,524,195,175.0,421,173,18.6,2017,0.0
Demetrius Henry,430,39,354,176,141,77,1573.0,4,1,105.0,350,175,17.0,2017,0.0
Yevgen Sakhniuk,134,22,95,58,43,17,340.0,6,1,37.0,89,57,23.6,2017,0.0
Hank Davis,14,3,9,4,8,6,29.0,2,0,3.0,7,4,28.3,2017,0.0
Nick Lindner,1509,520,1113,471,504,401,3878.0,454,166,272.0,659,305,22.2,2017,0.0
Hunter Janacek,355,74,337,112,58,52,1139.0,256,79,66.0,81,33,18.8,2017,0.0
Monty Boykins,568,92,522,188,170,99,1461.0,275,93,119.0,247,95,26.1,2017,0.0
Jimmy Panzini,2,0,1,1,0,0,13.0,0,0,2.0,1,1,12.0,2017,0.0
Dorian Chatman,431,51,341,161,165,106,1035.0,13,3,108.0,328,158,23.9,2017,0.0
Marcus Owens,691,76,618,230,140,100,2183.0,379,131,88.0,239,99,17.1,2017,0.0
Lincoln Davis,389,84,312,120,164,107,1187.0,126,42,76.0,186,78,18.6,2017,0.0
Christian Albright,200,40,195,81,35,22,680.0,59,16,50.0,136,65,19.6,2017,0.0
Cameron McGee,63,23,44,16,32,24,127.0,21,7,8.0,23,9,25.8,2017,0.0
Terrance Hubby,42,1,25,14,29,14,137.0,3,0,8.0,22,14,16.3,2017,0.0
Tim Kempton,2043,131,1404,744,719,526,3586.0,73,29,349.0,1331,715,30.6,2017,1.0
Austin Price,1453,214,1173,499,288,215,3745.0,612,240,187.0,561,259,20.9,2017,0.0
Matt Holba,806,111,592,272,152,106,2350.0,388,156,131.0,204,116,16.9,2017,0.0
Devon Carter,156,35,154,56,33,24,712.0,66,20,27.0,88,36,14.4,2017,0.0
John Dawson,629,189,531,217,127,96,1923.0,285,99,155.0,246,118,21.9,2017,0.0
Brock Gardner,206,26,148,76,51,33,630.0,59,21,34.0,89,55,19.0,2017,0.0
A.C. Reid,543,140,561,181,60,42,2120.0,455,139,120.0,106,42,18.5,2017,0.0
Ray Chen,61,19,35,15,26,23,248.0,21,8,15.0,14,7,14.6,2017,0.0
Josiah Talbert,38,1,39,17,9,3,125.0,13,1,10.0,26,16,24.7,2017,0.0
Ryan Hiepler,33,18,23,10,7,6,323.0,18,7,10.0,5,3,6.4,2017,0.0
Xzavier Barmore,8,11,16,4,0,0,53.0,4,0,4.0,12,4,21.9,2017,0.0
Josh Williams,1506,177,1089,513,348,268,2919.0,550,212,215.0,539,301,24.4,2017,0.0
Nathan Moran,1140,405,876,332,253,216,2777.0,699,260,230.0,177,72,21.1,2017,0.0
Cam Miller,281,100,205,103,81,54,1235.0,57,21,49.0,148,82,11.2,2017,0.0
Brett Wishon,434,109,382,142,65,51,1288.0,289,99,88.0,93,43,19.0,2017,0.0
Evan Payne,1436,129,1108,477,424,351,2595.0,371,131,210.0,737,346,29.3,2017,0.0
Justin Bibbins,1389,506,980,418,412,353,3590.0,490,200,249.0,490,218,20.0,2017,0.0
Noah Blackwell,871,301,757,308,81,63,2878.0,497,192,141.0,260,116,16.3,2017,0.0
Loren Jackson,1783,433,1370,561,505,422,3556.0,676,239,247.0,694,322,26.0,2017,0.0
Anson Moye,31,13,38,12,10,2,299.0,21,5,15.0,17,7,9.5,2017,0.0
Alex Rifkind,3,0,5,1,0,0,21.0,5,1,2.0,0,0,16.2,2017,0.0
Jerome Frink,1623,159,1296,619,455,297,3910.0,270,88,286.0,1026,531,22.5,2017,0.0
Iverson Fleming,839,148,777,287,230,165,2442.0,308,100,165.0,469,187,21.1,2017,0.0
Ganlandou Cisse,45,3,28,18,24,9,221.0,1,0,11.0,27,18,11.1,2017,0.0
Kwe Askew,13,2,12,5,5,3,84.0,0,0,2.0,12,5,9.6,2017,0.0
Glenn Feidanga,266,12,213,88,131,90,1054.0,3,0,34.0,210,88,14.4,2017,0.0
Mitchell McMullen,6,3,3,2,0,0,47.0,3,2,1.0,0,0,4.2,2017,0.0
Caylen Williams,0,1,0,0,0,0,4.0,0,0,0.0,0,0,0.0,2017,0.0
Khris Lane,1027,78,780,416,202,133,2355.0,176,62,153.0,604,354,21.9,2017,0.0
Darrion Allen,1117,146,949,377,283,232,3405.0,384,131,192.0,565,246,19.0,2017,0.0
Isaac Belton,327,46,310,105,107,80,1073.0,161,37,61.0,149,68,20.0,2017,0.0
Bryan Gee,76,91,77,20,51,32,836.0,23,4,60.0,54,16,9.7,2017,0.0
Kendrick Thompson,36,27,42,13,2,0,192.0,32,10,11.0,10,3,14.4,2017,0.0
Obi Romeo,21,2,13,7,18,7,148.0,0,0,4.0,13,7,8.9,2017,0.0
Jay Wright,1148,372,935,383,408,266,2997.0,327,116,232.0,608,267,21.2,2017,0.0
Roydell Brown,717,125,545,278,252,141,1940.0,63,20,141.0,482,258,20.6,2017,0.0
Kadavion Evans,45,27,46,15,7,6,162.0,34,9,9.0,12,6,16.7,2017,0.0
Nick Coppola,1231,555,1087,430,269,182,4768.0,523,189,253.0,564,241,16.2,2017,0.0
Marcus Washington,339,78,294,126,95,69,937.0,72,18,71.0,222,108,22.8,2017,0.0
Wade Martin,82,12,103,29,11,9,381.0,61,15,19.0,42,14,17.4,2017,0.0
Prince Cooper,136,32,111,57,40,17,471.0,12,5,42.0,99,52,19.1,2017,0.0
Ramses Sandifer,11,3,17,3,4,4,57.0,6,1,3.0,11,2,20.1,2017,0.0
Antonio Blakeney,948,85,746,331,246,181,2034.0,303,105,89.0,443,226,22.2,2017,1.0
Jalyn Patterson,912,332,830,312,162,119,3016.0,521,169,183.0,309,143,16.9,2017,0.0
Craig Victor,396,28,330,148,161,99,932.0,8,1,43.0,322,147,23.0,2017,0.0
Elbert Robinson III,182,24,136,73,86,36,717.0,0,0,77.0,136,73,17.4,2017,0.0
Kieran Hayward,84,16,100,28,6,3,382.0,81,25,17.0,19,3,15.4,2017,0.0
Brian Bridgewater,130,13,107,54,35,22,448.0,0,0,28.0,107,54,16.3,2017,0.0
Branden Jenkins,24,11,40,8,11,4,152.0,13,4,7.0,27,4,16.2,2017,0.0
Brandon Eddlestone,25,2,26,10,4,2,133.0,8,3,5.0,18,7,11.8,2017,0.0
Erik McCree,1518,107,1158,532,428,316,3082.0,404,138,228.0,754,394,25.5,2017,1.0
Omar Sherman,491,44,390,203,92,59,1273.0,97,26,64.0,293,177,20.2,2017,0.0
Luke Walker,15,1,18,6,7,3,54.0,0,0,4.0,18,6,22.9,2017,0.0
Donovan Mitchell,758,145,634,265,165,130,1689.0,298,98,86.0,336,167,23.3,2017,1.0
Jaylen Johnson,456,34,358,189,119,71,1343.0,18,7,67.0,340,182,17.8,2017,0.0
Mangok Mathiang,551,60,413,209,222,133,2054.0,0,0,99.0,413,209,14.9,2017,1.0
Tony Hicks,1146,223,990,400,305,234,2410.0,328,112,262.0,662,288,30.2,2017,0.0
David Levitch,141,47,104,41,49,31,571.0,64,28,20.0,40,13,12.8,2017,0.0
Matz Stockman,177,22,131,72,64,33,528.0,0,0,28.0,131,72,18.0,2017,0.0
Jay Henderson,18,5,23,6,4,4,58.0,12,2,2.0,11,4,22.9,2017,0.0
Tyler Sharpe,1198,156,912,377,298,230,2711.0,593,214,128.0,319,163,21.8,2017,0.0
Milton Doyle,1606,459,1229,538,543,390,3677.0,407,140,380.0,822,398,28.3,2017,1.0
Vlatko Granic,58,6,49,23,15,6,222.0,20,6,8.0,29,17,15.7,2017,0.0
Tyson Smith,549,98,443,164,156,124,1509.0,271,97,89.0,172,67,20.3,2017,0.0
Matt Chastain,179,59,138,72,30,20,1034.0,49,15,39.0,89,57,9.6,2017,0.0
Byron Burt,10,0,4,4,0,0,15.0,2,2,3.0,2,2,25.4,2017,0.0
Glorind Lisha,12,0,13,3,9,5,42.0,7,1,3.0,6,2,26.3,2017,0.0
Cameron Woodyard,5,3,6,2,2,1,15.0,1,0,0.0,5,2,25.2,2017,0.0
Igor Cvorovic,2,1,5,1,2,0,7.0,0,0,1.0,5,1,54.0,2017,0.0
Brandon Brown,808,299,727,284,220,164,1913.0,210,76,149.0,517,208,25.7,2017,0.0
Buay Tuach,427,89,330,153,102,61,1138.0,159,60,73.0,171,93,19.9,2017,0.0
Stefan Jovanovic,628,47,493,250,175,128,1763.0,9,0,111.0,484,250,19.2,2017,0.0
Shamar Johnson,365,76,309,145,125,75,1252.0,1,0,84.0,308,145,18.1,2017,0.0
Kelvin Amayo,417,156,338,159,187,86,1431.0,47,13,116.0,291,146,18.8,2017,0.0
Trevor Manuel,125,17,97,41,52,33,373.0,36,10,24.0,61,31,19.5,2017,0.0
Munis Tutu,196,139,197,63,70,51,966.0,75,19,70.0,122,44,15.6,2017,0.0
Jarred Jones,1188,140,909,433,424,311,2853.0,46,11,234.0,863,422,24.2,2017,0.0
Chancellor Barnard,671,83,464,262,248,143,2906.0,19,4,138.0,445,258,13.0,2017,0.0
Nick Gorski,158,20,159,60,45,33,784.0,23,5,48.0,136,55,15.3,2017,0.0
Austin Harriott,14,0,13,5,7,4,96.0,2,0,4.0,11,5,10.7,2017,0.0
Wesley Myers,1233,184,1006,417,393,281,3198.0,319,118,210.0,687,299,21.7,2017,0.0
Austin Howard,243,28,236,90,37,25,683.0,101,38,35.0,135,52,21.3,2017,0.0
Vincent Eze,662,68,540,248,288,165,2089.0,4,1,156.0,536,247,21.2,2017,0.0
Marko Pirovic,350,56,294,117,133,83,1189.0,133,33,68.0,161,84,17.8,2017,0.0
Jaquan McKennon,98,58,97,38,32,19,309.0,21,3,36.0,76,35,24.2,2017,0.0
C.J. Ward,10,6,11,3,2,2,35.0,8,2,0.0,3,1,16.8,2017,0.0
Na'Quan Council,159,18,158,46,54,42,417.0,100,25,27.0,58,21,24.5,2017,0.0
Ahmed Ismail,372,34,243,137,141,93,1088.0,10,5,102.0,233,132,18.2,2017,0.0
Samson Usilo,161,20,162,63,82,32,737.0,19,3,59.0,143,60,18.0,2017,0.0
Zavier Peart,212,18,197,91,56,28,790.0,8,2,44.0,189,89,16.7,2017,0.0
Tyler Wilson,369,364,275,99,273,164,2666.0,24,7,238.0,251,92,12.2,2017,0.0
Ak Ojo,30,2,20,11,18,8,281.0,0,0,24.0,20,11,9.3,2017,0.0
Oliver Ehrnvall,3,1,5,1,0,0,42.0,5,1,2.0,0,0,8.1,2017,0.0
Sky Williams,1,0,0,0,2,1,1.0,0,0,0.0,0,0,46.0,2017,0.0
Khallid Hart,1879,240,1321,584,607,496,3851.0,589,215,225.0,732,369,24.8,2017,0.0
Kentrall Brooks,307,69,244,112,114,83,1327.0,8,0,118.0,236,112,16.3,2017,0.0
Richie Mitchell,94,26,96,30,26,25,336.0,33,9,24.0,63,21,20.6,2017,0.0
Obi Momah,93,8,76,31,43,28,271.0,9,3,23.0,67,28,23.1,2017,0.0
JaJuan Johnson,1013,222,834,379,221,173,2519.0,253,82,179.0,581,297,22.6,2017,1.0
Luke Fischer,1051,96,693,429,307,193,2533.0,1,0,145.0,692,429,19.7,2017,0.0
Katin Reinhardt,1444,249,1272,503,230,195,3571.0,656,243,213.0,616,260,22.0,2017,0.0
Duane Wilson,1105,290,917,374,313,220,2858.0,410,137,203.0,507,237,22.5,2017,0.0
Traci Carter,1009,530,961,345,232,179,3532.0,410,140,293.0,551,205,19.8,2017,0.0
Deon Franklin,0,0,2,0,0,0,16.0,1,0,1.0,1,0,9.4,2017,0.0
Stevie Browning,968,230,810,369,145,114,2160.0,313,116,139.0,497,253,21.6,2017,0.0
Austin Loop,1096,105,793,337,149,129,3155.0,714,293,65.0,79,44,13.8,2017,0.0
Terrence Thompson,425,32,319,145,201,118,1379.0,47,17,67.0,272,128,16.4,2017,0.0
Aleksa Nikolic,228,141,292,93,37,25,1202.0,78,17,117.0,214,76,17.1,2017,0.0
Ky're Allison,57,17,56,21,7,5,194.0,31,10,21.0,25,11,19.2,2017,0.0
Jacob Kilgore,24,1,22,8,2,1,91.0,20,7,0.0,2,1,11.5,2017,0.0
Will Darley,1095,155,798,378,217,181,2746.0,384,158,172.0,414,220,19.9,2017,0.0
Rodney Elliott,1034,251,726,316,385,284,2303.0,341,118,217.0,385,198,24.6,2017,0.0
Malcolm Brent,284,43,282,92,52,39,1130.0,187,61,66.0,95,31,17.9,2017,0.0
Ben Grace,152,31,116,45,26,22,647.0,101,40,27.0,15,5,12.8,2017,0.0
Joel Wincowski,35,9,45,13,2,2,300.0,28,7,6.0,17,6,8.8,2017,0.0
Daquon Ervin,35,23,45,9,28,16,252.0,14,1,14.0,31,8,14.5,2017,0.0
Bakari Copeland,980,106,689,313,381,290,1948.0,181,64,148.0,508,249,26.4,2017,0.0
Ryan Andino,1195,105,1079,384,120,98,3342.0,915,329,104.0,164,55,19.3,2017,0.0
Dontae Caldwell,511,68,460,184,115,78,1584.0,210,65,103.0,250,119,19.9,2017,0.0
Derrico Peck,382,68,266,168,109,45,1686.0,7,1,91.0,259,167,12.4,2017,0.0
Isaac Taylor,378,39,301,147,122,84,1122.0,2,0,90.0,299,147,20.7,2017,0.0
Thomas Rivera,283,190,282,95,82,56,1216.0,129,37,121.0,153,58,18.4,2017,0.0
Michael Chambers,62,14,56,21,21,14,245.0,31,6,18.0,25,15,17.2,2017,0.0
Marc Seylan,48,24,70,19,21,10,455.0,15,0,22.0,55,19,11.3,2017,0.0
Deven Dorsett,23,4,42,10,9,2,142.0,11,1,9.0,31,9,19.5,2017,0.0
Randell Pickett,21,0,23,7,5,3,62.0,16,4,0.0,7,3,20.5,2017,0.0
Melo Trimble,1658,402,1139,489,597,503,3415.0,515,177,282.0,624,312,26.2,2017,0.0
Jaylen Brantley,238,50,201,82,48,30,814.0,111,44,30.0,90,38,16.0,2017,0.0
Damonte Dodd,422,46,273,160,185,102,1797.0,0,0,112.0,273,160,13.8,2017,0.0
L.G. Gill,778,79,666,279,156,106,2413.0,339,114,90.0,327,165,17.1,2017,0.0
Tyler Livingston,934,107,815,350,73,55,2635.0,491,179,111.0,324,171,18.7,2017,0.0
Logan Primerano,388,89,292,132,121,96,1142.0,79,28,88.0,213,104,18.6,2017,0.0
Cameron Wolter,143,9,114,57,38,27,332.0,10,2,20.0,104,55,22.4,2017,0.0
Isaac White,428,91,293,129,100,82,1187.0,215,88,82.0,78,41,17.2,2017,0.0
Jordan Shea,56,20,51,21,11,8,292.0,21,6,16.0,30,15,12.1,2017,0.0
Donte Clark,1902,325,1445,582,740,565,3935.0,553,173,298.0,892,409,25.9,2017,0.0
Dejon Jarreau,1162,483,926,397,415,296,2866.0,253,72,323.0,673,325,24.8,2017,0.0
Tyrn Flowers,1362,221,1155,508,217,150,3196.0,593,196,165.0,562,312,21.3,2017,0.0
Brison Gresham,403,41,274,174,119,55,1842.0,0,0,87.0,274,174,11.2,2017,0.0
Seth Berger,361,62,293,142,90,54,1488.0,87,23,68.0,206,119,13.4,2017,0.0
Zach Turcotte,4,2,6,2,0,0,18.0,3,0,2.0,3,2,21.8,2017,0.0
Jamaya Burr,1148,361,857,341,540,386,3149.0,234,80,266.0,623,261,21.6,2017,0.0
Lance Potier,367,64,360,145,62,35,1545.0,146,42,77.0,214,103,14.8,2017,0.0
Howard Thomas,60,3,51,24,28,12,188.0,0,0,12.0,51,24,19.8,2017,0.0
Dedric Lawson,1835,250,1422,647,592,448,3341.0,280,93,263.0,1142,554,28.5,2017,0.0
K.J. Lawson,971,180,854,345,281,196,2673.0,252,85,158.0,602,260,21.4,2017,0.0
Craig Randall,531,96,516,193,78,50,1412.0,321,95,91.0,195,98,22.1,2017,0.0
Keon Clergeot,870,167,629,247,357,280,2392.0,291,96,180.0,338,151,20.2,2017,0.0
Chad Rykhoek,74,11,57,31,34,12,212.0,2,0,16.0,55,31,20.6,2017,0.0
Christian Kessee,837,138,717,274,173,138,2081.0,408,151,142.0,309,123,21.6,2017,0.0
Jake McDowell,33,7,36,14,10,4,271.0,4,1,8.0,32,13,8.7,2017,0.0
Jonathan Bins,8,5,8,3,0,0,19.0,3,2,1.0,5,1,23.2,2017,0.0
Kaleb Castro,6,0,4,2,0,0,14.0,3,2,1.0,1,0,17.5,2017,0.0
Rashad Lewis,91,70,103,29,21,15,400.0,69,18,23.0,34,11,18.2,2017,0.0
Andrew Fishler,174,7,134,69,65,36,505.0,0,0,25.0,134,69,19.7,2017,0.0
J.J. N'Ganga,135,10,102,55,46,25,590.0,0,0,48.0,102,55,15.9,2017,0.0
Darius Roy,954,216,798,329,229,187,2145.0,296,109,170.0,502,220,25.1,2017,0.0
Stephen Gavin,0,0,1,0,0,0,3.0,0,0,0.0,1,0,17.9,2017,0.0
Davon Reed,1343,216,1018,438,340,265,3679.0,512,202,187.0,506,236,20.2,2017,1.0
Kamari Murphy,740,79,610,309,210,120,3219.0,12,2,149.0,598,307,13.9,2017,0.0
Michael Weathers,1076,272,820,368,392,298,1982.0,166,42,273.0,654,326,31.6,2017,0.0
Marcus Weathers,1324,126,911,468,519,343,3039.0,166,45,203.0,745,423,22.4,2017,0.0
Abdoulaye Harouna,541,72,465,170,157,116,1858.0,257,85,130.0,208,85,18.3,2017,0.0
Milos Jovic,343,87,314,128,77,35,1522.0,139,52,107.0,175,76,15.1,2017,0.0
Dion Wade,307,54,299,98,68,46,1338.0,221,65,44.0,78,33,14.4,2017,0.0
Bruno Solomun,33,2,35,13,8,4,129.0,18,3,4.0,17,10,16.4,2017,0.0
Jake Bischoff,26,16,29,7,13,9,179.0,20,3,8.0,9,4,12.0,2017,0.0
Zach McCormick,205,45,227,81,33,18,918.0,99,25,30.0,128,56,15.9,2017,0.0
Ben Eke Kazee,9,1,5,1,12,7,48.0,0,0,3.0,5,1,14.1,2017,0.0
Eron Harris,1489,200,1128,487,366,296,3068.0,545,219,214.0,583,268,25.0,2017,0.0
Alvin Ellis III,434,110,349,141,136,85,1486.0,186,67,103.0,163,74,18.1,2017,0.0
Kyle Ahrens,355,60,292,124,59,46,1282.0,182,61,59.0,110,63,15.0,2017,0.0
Matt Van Dyk,62,16,40,21,36,20,280.0,0,0,15.0,40,21,13.2,2017,0.0
Greg Roy,3,0,4,1,2,1,11.0,2,0,1.0,2,1,27.7,2017,0.0
Derrick Walton Jr.,1471,499,1068,432,447,374,4053.0,581,233,224.0,487,199,20.8,2017,1.0
Zak Irvin,1610,282,1417,600,249,169,4220.0,681,241,199.0,736,359,23.1,2017,0.0
D.J. Wilson,491,58,366,192,71,58,1337.0,135,49,52.0,231,143,19.0,2017,1.0
Sean Lonergan,21,4,16,8,8,5,116.0,3,0,6.0,13,8,12.6,2017,0.0
Fred Wright-Jones,5,0,4,1,2,2,19.0,2,1,1.0,2,0,17.7,2017,0.0
Jacorey Williams,989,127,856,412,248,158,2208.0,37,7,139.0,819,405,25.5,2017,0.0
Reggie Upshaw Jr.,1571,257,1230,598,482,288,3967.0,269,87,213.0,961,511,22.1,2017,0.0
Xavier Habersham,289,70,234,102,38,24,1082.0,150,61,45.0,84,41,14.2,2017,0.0
Aldonis Foote,154,32,139,62,45,25,508.0,16,5,30.0,123,57,19.3,2017,0.0
Quavius Copeland,490,136,449,190,74,54,1455.0,189,56,104.0,260,134,20.8,2017,0.0
Stephen Strachan,2,0,0,0,2,2,9.0,0,0,0.0,0,0,5.5,2017,0.0
Cody Wichmann,856,121,680,288,107,82,2516.0,506,198,68.0,174,90,17.1,2017,0.0
Cameron Harvey,564,62,568,198,76,54,2150.0,331,114,80.0,237,84,16.5,2017,0.0
Dan Studer,40,15,51,16,17,8,214.0,8,0,14.0,43,16,18.3,2017,0.0
Derek Rongstad,23,4,17,8,4,3,85.0,9,4,4.0,8,4,13.9,2017,0.0
Baylor Peterson,3,0,8,1,2,1,27.0,6,0,2.0,2,1,21.3,2017,0.0
Akeem Springs,1151,159,981,406,266,190,3014.0,449,149,155.0,532,257,21.7,2017,0.0
Eric Curry,355,92,312,134,116,77,1419.0,60,10,77.0,252,124,15.4,2017,0.0
Ahmad Gilbert,182,36,207,66,28,15,591.0,121,35,39.0,86,31,21.5,2017,0.0
Stephon Sharp,60,11,50,19,22,17,202.0,17,5,17.0,33,14,19.6,2017,0.0
Darin Haugh,2,2,5,1,0,0,27.0,3,0,4.0,2,1,16.9,2017,0.0
Mario Kegler,603,73,496,211,174,114,1692.0,205,67,105.0,291,144,20.2,2017,0.0
I.J. Ready,888,401,812,328,177,150,3057.0,278,82,184.0,534,246,18.0,2017,0.0
L.J. Singleton,5,2,7,2,0,0,27.0,4,1,1.0,3,1,14.8,2017,0.0
Joe Strugg,3,0,4,1,0,0,15.0,3,1,4.0,1,0,26.6,2017,0.0
Miles Washington,2,0,3,1,0,0,13.0,1,0,0.0,2,1,11.5,2017,0.0
Isaac Williams,1156,88,1082,409,197,163,2529.0,525,175,101.0,557,234,24.4,2017,0.0
Marcus Romain,970,125,711,320,376,271,1539.0,158,59,208.0,553,261,34.5,2017,0.0
Rashaan Surles,465,157,451,173,118,83,1591.0,129,36,124.0,322,137,19.2,2017,0.0
Darrell Riley,244,82,226,79,75,55,719.0,75,31,78.0,151,48,22.7,2017,0.0
Ta'Jay Henry,391,38,296,153,143,85,1300.0,2,0,75.0,294,153,16.3,2017,0.0
Amos Given,131,9,131,60,25,11,383.0,0,0,34.0,131,60,22.1,2017,0.0
Vacha Vaughn,403,99,351,154,136,87,1899.0,30,8,102.0,321,146,13.1,2017,0.0
Jabari Alex,241,23,183,114,22,12,1039.0,6,1,48.0,177,113,11.2,2017,0.0
Michael Matlock,94,20,90,34,60,26,589.0,0,0,24.0,90,34,11.7,2017,0.0
Jevon Smith,121,22,105,43,37,26,315.0,29,9,30.0,76,34,23.0,2017,0.0
Ronald Strother Jr.,72,5,88,28,17,10,339.0,34,6,17.0,54,22,16.1,2017,0.0
T.J. Traylor,33,6,37,13,13,5,209.0,8,2,6.0,29,11,11.8,2017,0.0
Hasaan Buggs,8,2,11,3,4,2,55.0,1,0,5.0,10,3,15.5,2017,0.0
Sebastian Saiz,1273,77,936,464,464,322,3389.0,83,23,175.0,853,441,18.8,2017,0.0
Cullen Neal,1198,302,958,359,366,288,3032.0,521,192,256.0,437,167,23.0,2017,0.0
Rasheed Brooks,478,105,483,175,61,42,1617.0,271,86,74.0,212,89,17.2,2017,0.0
Donte Fitzpatrick-Dorsey,479,69,357,159,159,119,1135.0,116,42,107.0,241,117,22.7,2017,0.0
Karlis Silins,698,45,471,252,228,158,1734.0,99,36,123.0,372,216,19.9,2017,0.0
Nate Morris,0,0,5,0,0,0,36.0,0,0,3.0,5,0,10.3,2017,0.0
LaVell Boyd,1061,206,806,338,263,217,2100.0,409,168,134.0,397,170,24.7,2017,0.0
Kyle Steward,655,56,517,227,172,120,1678.0,206,81,96.0,311,146,20.1,2017,0.0
Broderick Newbill,532,38,406,199,165,108,1396.0,83,26,92.0,323,173,20.4,2017,0.0
Dashawn King,493,96,396,173,172,116,1177.0,102,31,107.0,294,142,24.4,2017,0.0
Darnell Tillman,229,16,154,94,78,41,1011.0,0,0,44.0,154,94,11.3,2017,0.0
Duane Clark,111,14,102,50,31,11,349.0,0,0,37.0,102,50,20.9,2017,0.0
Martez Harrison,1652,393,1222,504,722,518,3212.0,402,126,307.0,820,378,29.5,2017,0.0
Grant Leach,72,14,62,23,12,8,368.0,52,18,10.0,10,5,10.5,2017,0.0
Broderick Ross,5,0,10,1,2,2,29.0,8,1,1.0,2,0,19.6,2017,0.0
Dequon Miller,825,220,720,270,242,173,2284.0,335,112,155.0,385,158,22.1,2017,0.0
Chris Kendrix,716,66,503,200,284,226,1956.0,267,90,129.0,236,110,20.5,2017,0.0
Austin Ruder,946,140,860,309,112,92,3114.0,649,236,82.0,211,73,17.0,2017,0.0
Jordan Martin,126,8,102,46,76,34,507.0,0,0,47.0,102,46,18.6,2017,0.0
Tyler McCullough,263,24,226,105,82,53,1178.0,0,0,59.0,226,105,14.9,2017,0.0
Robin Thompson,51,8,42,19,24,13,231.0,0,0,10.0,42,19,14.3,2017,0.0
Tyrie Hill-Thomas,4,0,2,2,0,0,10.0,0,0,0.0,2,2,10.3,2017,0.0
Frankie Hughes,585,101,636,194,116,67,1665.0,451,130,94.0,185,64,23.1,2017,0.0
K.J. Walton,1198,117,885,432,462,317,2678.0,71,17,180.0,814,415,23.8,2017,0.0
Russell Woods,293,21,214,106,150,81,1098.0,0,0,47.0,214,106,15.0,2017,0.0
Willie Jackson,885,148,680,347,283,188,2483.0,11,3,185.0,669,344,20.2,2017,0.0
Mitchell Smith,374,56,308,124,110,85,1638.0,136,41,64.0,172,83,13.2,2017,0.0
Trevor Glassman,7,1,20,2,2,1,42.0,18,2,4.0,2,0,29.8,2017,0.0
Jakoby Kemp,36,3,28,13,14,9,105.0,5,1,13.0,23,12,21.8,2017,0.0
Je'lon Hornbeak,1035,249,786,317,305,233,2859.0,437,168,194.0,349,149,18.9,2017,0.0
Chris Brady,778,37,616,328,174,116,2307.0,26,6,136.0,590,322,17.6,2017,0.0
Collin Stewart,735,70,639,236,197,149,1776.0,364,114,123.0,275,122,23.7,2017,0.0
Josh James,584,212,550,215,215,124,2691.0,115,30,150.0,435,185,14.5,2017,0.0
Quinton Everett,508,75,455,178,165,96,1365.0,164,56,72.0,291,122,21.6,2017,0.0
Sarp Gobeloglu,307,22,249,107,33,27,792.0,176,66,49.0,73,41,19.2,2017,0.0
Devin Kirby,430,65,308,162,181,106,1871.0,0,0,98.0,308,162,13.3,2017,0.0
Mandrell Worthy,21,9,27,7,11,6,150.0,9,1,10.0,18,6,13.7,2017,0.0
Cooper Olson,6,0,3,2,0,0,14.0,3,2,1.0,0,0,13.9,2017,0.0
Dallas Lussier,0,0,1,0,0,0,7.0,1,0,0.0,0,0,7.0,2017,0.0
Walter Wright,763,242,647,258,212,175,1758.0,224,72,153.0,423,186,26.6,2017,0.0
Jack Lopez,485,76,365,165,71,48,1974.0,249,107,76.0,116,58,12.7,2017,0.0
Brandon Gfeller,756,90,599,238,105,77,2318.0,521,203,76.0,78,35,16.9,2017,0.0
Mario Dunn,634,225,462,222,198,128,2471.0,165,62,161.0,297,160,16.1,2017,0.0
Gavin DeJong,30,3,29,12,11,6,127.0,0,0,9.0,29,12,17.8,2017,0.0
Aaron Misipeka-Ward,2,1,4,0,4,2,23.0,0,0,1.0,4,0,15.4,2017,0.0
Xavier Moon,857,207,662,299,170,141,1948.0,287,118,95.0,375,181,20.6,2017,0.0
DeJuan Marrero,687,94,630,277,229,133,1882.0,0,0,158.0,630,277,22.9,2017,0.0
Miguel Dicent,664,197,578,231,125,94,2022.0,307,108,126.0,271,123,18.3,2017,0.0
Treshaad Williams,344,25,190,133,113,78,980.0,0,0,38.0,190,133,13.7,2017,0.0
Ronnye Beamon,272,44,203,93,116,67,1171.0,48,19,61.0,155,74,13.1,2017,0.0
Ty'Quan Bitting,233,14,148,98,78,37,583.0,0,0,39.0,148,98,18.6,2017,0.0
Wes Noble,27,5,22,7,13,10,55.0,9,3,6.0,13,4,29.9,2017,0.0
Keion Alexander,46,4,35,18,22,10,230.0,0,0,15.0,35,18,12.5,2017,0.0
Kyle Thomas,676,53,705,245,151,99,1847.0,303,87,107.0,402,158,23.3,2017,0.0
Isiah Graves,96,33,87,29,44,31,305.0,30,7,29.0,57,22,21.4,2017,0.0
Clive Vaughan Jr.,157,8,173,58,23,11,457.0,112,30,24.0,61,28,22.5,2017,0.0
Elijah Mitrou-Long,1151,344,1023,402,319,225,3169.0,349,122,238.0,674,280,23.1,2017,0.0
Miles Wilson,412,25,317,144,115,86,1009.0,105,38,71.0,212,106,23.0,2017,0.0
Khalid Nwandu,327,157,258,114,175,96,1705.0,12,3,151.0,246,111,15.1,2017,0.0
Randy Miller Jr.,743,91,573,225,231,187,1783.0,296,106,130.0,277,119,23.2,2017,0.0
Bryce Thurston,5,2,5,2,0,0,17.0,4,1,0.0,1,1,15.4,2017,0.0
Sean Gurdon,0,1,1,0,0,0,9.0,0,0,1.0,1,0,11.7,2017,0.0
Bryce Jones,792,245,603,228,278,245,2027.0,270,91,140.0,333,137,21.9,2017,0.0
Damarcus Croaker,688,100,615,269,135,85,2022.0,219,65,128.0,396,204,20.0,2017,0.0
Gee McGhee,1189,277,879,354,575,378,3527.0,337,103,187.0,542,251,18.7,2017,0.0
Gilbert Thomas Jr.,67,5,46,30,18,7,246.0,2,0,8.0,44,30,12.3,2017,0.0
Jerami Grace,57,9,66,18,13,9,219.0,47,12,11.0,19,6,18.3,2017,0.0
Dondre Griffin,272,81,240,92,47,37,1047.0,151,51,55.0,89,41,14.7,2017,0.0
Edward Alade,444,63,341,199,99,46,1678.0,1,0,97.0,340,199,15.5,2017,0.0
Tim Abruzzo,365,52,364,124,66,46,1103.0,249,71,45.0,115,53,20.9,2017,0.0
Zach Fong,490,62,445,159,63,48,1345.0,356,124,61.0,89,35,21.6,2017,0.0
James Hemphill,144,18,109,60,58,24,621.0,1,0,29.0,108,60,14.3,2017,0.0
Grant Vermeer,95,29,88,38,8,5,374.0,49,14,26.0,39,24,17.2,2017,0.0
James Butler,1025,123,731,409,287,198,2533.0,20,9,114.0,711,400,19.9,2017,0.0
Kyran McClure,4,4,6,1,3,1,20.0,5,1,1.0,1,0,21.6,2017,0.0
Aaron Briggs,0,0,0,0,0,0,2.0,0,0,0.0,0,0,0.0,2017,0.0
Marcus Tyus,1334,168,967,451,357,268,2648.0,398,164,203.0,569,287,24.0,2017,0.0
Tre'Shawn Thurman,1444,170,1073,539,459,310,3476.0,207,56,189.0,866,483,20.0,2017,0.0
Tra-Deon Hollins,829,405,636,282,264,202,2089.0,210,63,214.0,426,219,21.5,2017,0.0
Zach Pirog,417,25,272,161,140,95,1361.0,5,0,65.0,267,161,14.4,2017,0.0
Kyler Erickson,200,43,146,53,91,67,1017.0,82,27,23.0,64,26,9.7,2017,0.0
Tai Webster,1116,288,922,382,382,273,3295.0,283,79,269.0,639,303,21.2,2017,0.0
Ed Morrow,588,28,443,246,157,96,1658.0,0,0,137.0,443,246,19.5,2017,0.0
Michael Jacobson,983,108,799,377,275,191,3036.0,136,38,120.0,663,339,17.4,2017,0.0
Jeriah Horne,1139,114,936,404,180,152,2731.0,493,179,141.0,443,225,22.1,2017,0.0
Nick Fuller,404,29,263,145,135,100,978.0,50,14,47.0,213,131,19.0,2017,0.0
Mohammad Elradi,2,1,1,1,0,0,3.0,0,0,0.0,1,1,16.2,2017,0.0
Jason Shultis,0,0,0,0,0,0,3.0,0,0,0.0,0,0,0.0,2017,0.0
Tyrell Green,377,36,320,126,95,76,834.0,146,49,40.0,174,77,23.8,2017,0.0
Jalen Poyser,786,153,680,256,229,177,2123.0,310,97,139.0,370,159,21.8,2017,0.0
Christian Jones,609,77,532,252,178,104,1893.0,4,1,118.0,528,251,18.9,2017,0.0
Uche Ofoegbu,539,84,431,189,154,103,1872.0,157,58,106.0,274,131,15.9,2017,0.0
Troy Baxter,970,92,834,342,244,171,2289.0,378,115,170.0,456,227,23.2,2017,0.0
Dwayne Morgan,964,69,854,361,289,196,2466.0,158,46,208.0,696,315,24.3,2017,0.0
Zion Morgan,204,85,202,80,69,37,828.0,31,7,52.0,171,73,17.7,2017,0.0
Ben Coupet,651,106,503,222,169,126,1932.0,234,81,112.0,269,141,18.2,2017,0.0
Djordjije Sljivancanin,15,1,11,6,0,0,47.0,4,3,1.0,7,3,12.5,2017,0.0
Larry Bush,8,1,10,2,4,2,38.0,6,2,1.0,4,0,16.6,2017,0.0
Jaylan Ballou,2,2,2,1,1,0,5.0,0,0,0.0,2,1,24.3,2017,0.0
Marcus Marshall,1502,242,1046,445,474,391,3029.0,586,221,141.0,460,224,24.6,2017,0.0
Cameron Oliver,1071,94,830,403,264,179,2233.0,233,86,162.0,597,317,24.1,2017,0.0
D.J. Fenner,1345,183,1177,453,381,309,3544.0,394,130,200.0,783,323,21.6,2017,0.0
Devearl Ramsey,808,299,661,259,225,189,3019.0,286,101,157.0,375,158,16.0,2017,0.0
John Carlson,1,0,1,0,5,1,31.0,0,0,1.0,1,0,6.9,2017,0.0
David Kyle,0,0,0,0,0,0,6.0,0,0,0.0,0,0,0.0,2017,0.0
Collin Weaver,29,3,32,10,2,2,94.0,27,7,3.0,5,3,19.8,2017,0.0
Jaleen Smith,1397,364,1089,457,415,342,3785.0,411,141,266.0,678,316,21.5,2017,0.0
Daniel Dion,1200,235,997,383,240,190,3310.0,649,244,186.0,348,139,20.7,2017,0.0
Kijana Love,99,11,100,36,20,12,327.0,45,15,24.0,55,21,21.4,2017,0.0
Ken Uhlar,4,2,7,2,1,0,31.0,0,0,1.0,7,2,14.3,2017,0.0
Ian Baker,1411,375,1059,443,407,325,3454.0,542,200,238.0,517,243,21.7,2017,0.0
Braxton Huggins,1303,143,997,414,297,241,2536.0,613,234,170.0,384,180,25.8,2017,0.0
Matt Taylor,446,155,387,164,138,84,1841.0,123,34,135.0,264,130,16.0,2017,0.0
Jermaine Haley,645,191,474,238,226,140,2289.0,115,29,166.0,359,209,15.4,2017,0.0
Chancellor Ellis,480,53,440,158,39,32,1198.0,364,132,42.0,76,26,20.2,2017,0.0
Jalyn Pennie,328,50,302,130,65,29,1385.0,125,39,78.0,177,91,15.1,2017,0.0
Marlon Jones,17,1,14,7,6,3,57.0,1,0,4.0,13,7,17.7,2017,0.0
Elijah Brown,1969,322,1469,585,609,520,3685.0,793,279,308.0,676,306,28.1,2017,0.0
Tim Williams,1939,115,1309,759,599,419,3990.0,8,2,194.0,1301,757,23.4,2017,0.0
Obij Aget,643,34,438,262,178,119,2268.0,0,0,113.0,438,262,14.5,2017,0.0
Damien Jefferson,967,168,757,385,223,132,2673.0,214,65,153.0,543,320,19.4,2017,0.0
Connor MacDougall,297,21,173,105,116,87,610.0,0,0,43.0,173,105,22.4,2017,0.0
Xavier Adams,303,53,214,100,137,90,989.0,60,13,69.0,154,87,18.0,2017,0.0
Aher Uguak,626,140,414,223,239,161,2522.0,80,19,154.0,334,204,15.2,2017,0.0
Adam Cumber,0,0,1,0,0,0,4.0,1,0,0.0,0,0,12.2,2017,0.0
Erik Thomas,957,117,602,347,345,259,1705.0,19,4,134.0,583,343,25.2,2017,0.0
Christavious Gill,1356,252,1129,434,376,290,3317.0,602,198,180.0,527,236,21.3,2017,0.0
Nate Frye,943,273,686,283,390,303,2492.0,192,74,213.0,494,209,20.6,2017,0.0
Tevin Broyles,807,182,632,271,348,230,2446.0,126,35,237.0,506,236,20.2,2017,0.0
A.J. Cheeseman,486,33,416,177,195,127,1189.0,32,5,94.0,384,172,26.2,2017,0.0
Coleman Edwards,81,29,90,27,16,10,420.0,56,17,23.0,34,10,13.1,2017,0.0
Cameron Reed,182,29,177,57,28,22,640.0,139,46,33.0,38,11,16.0,2017,0.0
Venjie Wallis,664,110,517,220,275,187,1724.0,131,37,124.0,386,183,22.7,2017,0.0
Danny Cohen,57,6,54,18,11,10,233.0,31,11,16.0,23,7,14.9,2017,0.0
Shane Gatling,712,117,622,225,167,136,2000.0,387,126,102.0,235,99,20.1,2017,0.0
Maurice Taylor,189,24,147,67,109,52,1023.0,13,3,90.0,134,64,13.9,2017,1.0
Ali Tew,73,3,73,27,44,19,366.0,0,0,35.0,73,27,17.3,2017,0.0
Dwayne Pow,33,15,29,11,14,10,145.0,6,1,18.0,23,10,17.7,2017,0.0
Ja'Dante' Frye,1279,125,952,453,402,305,3148.0,200,68,197.0,752,385,21.2,2017,0.0
Johnathan Bell,697,92,609,238,222,164,1832.0,189,57,102.0,420,181,21.9,2017,0.0
DeAndre Harris,491,64,381,155,197,136,896.0,150,45,105.0,231,110,32.3,2017,0.0
Liam Thomas,808,188,549,311,274,165,2690.0,80,21,196.0,469,290,16.2,2017,0.0
Tre O'Neal,146,66,133,44,71,44,796.0,53,14,67.0,80,30,14.4,2017,0.0
Adam Ward,227,24,168,91,105,45,877.0,1,0,48.0,167,91,14.9,2017,0.0
Brett Weaver,5,0,11,2,1,0,20.0,8,1,3.0,3,1,35.3,2017,0.0
Luka Kamber,316,50,313,106,39,27,1245.0,247,77,69.0,66,29,16.1,2017,0.0
Damon Lynn,2153,369,1769,657,498,405,4225.0,1225,434,266.0,544,223,27.1,2017,0.0
Tim Coleman,1439,244,1066,487,482,347,3191.0,319,118,254.0,747,369,24.4,2017,0.0
Rob Ukawuba,720,144,532,251,249,163,2085.0,162,55,116.0,370,196,18.4,2017,0.0
Osa Izevbuwa,324,46,316,118,52,34,1153.0,165,54,60.0,151,64,17.5,2017,0.0
Ron Alston,26,7,31,11,0,0,111.0,16,4,9.0,15,7,17.5,2017,0.0
James McMillon,2,1,3,1,0,0,7.0,0,0,1.0,3,1,28.4,2017,0.0
Jonathan Wade,852,82,606,280,276,212,1719.0,215,80,139.0,391,200,25.3,2017,0.0
Zaynah Robinson,986,369,876,341,215,164,3312.0,403,140,143.0,473,201,16.9,2017,0.0
Jordan Butler,812,99,584,288,349,236,3027.0,0,0,175.0,584,288,15.2,2017,0.0
Kerwin Okoro,247,36,239,88,46,32,678.0,119,39,62.0,120,49,23.7,2017,0.0
Micah Goss,78,9,91,28,14,9,375.0,51,13,13.0,40,15,14.6,2017,0.0
Alex Brown,61,10,70,24,6,3,248.0,35,10,21.0,35,14,18.7,2017,0.0
Carrington Ward,184,40,157,59,64,48,682.0,69,18,51.0,88,41,17.0,2017,0.0
David Robertson,913,219,756,296,210,150,2871.0,472,171,142.0,284,125,17.3,2017,0.0
Will Weeks,805,211,566,309,346,187,2883.0,0,0,174.0,566,309,15.6,2017,0.0
Giacomo Zilli,301,39,210,111,114,79,801.0,0,0,65.0,210,111,20.5,2017,0.0
Malik Smith,26,7,27,8,11,9,130.0,6,1,8.0,21,7,15.9,2017,0.0
Eliel Gonzalez,296,82,234,101,96,66,789.0,75,28,84.0,159,73,24.2,2017,0.0
Aaron Scales,291,18,213,111,128,69,1199.0,0,0,83.0,213,111,15.6,2017,0.0
James Whitaker,467,29,414,151,155,122,1290.0,168,43,91.0,246,108,23.6,2017,0.0
Nick Reese,122,26,126,50,31,16,609.0,30,6,38.0,96,44,15.2,2017,0.0
Martin Jones,34,5,50,12,7,4,153.0,38,6,3.0,12,6,19.1,2017,0.0
Mike Owona,63,7,58,28,18,7,514.0,0,0,29.0,58,28,9.6,2017,0.0
Joshua Mullins,5,3,6,1,2,2,44.0,3,1,1.0,3,0,9.5,2017,0.0
Charles Carrington,2,0,6,0,2,2,29.0,0,0,3.0,6,0,18.1,2017,0.0
Patrick Cole,1360,343,1143,423,525,386,2710.0,401,128,299.0,742,295,31.0,2017,0.0
Dajuan Graf,971,417,751,347,301,224,3338.0,162,53,230.0,589,294,16.8,2017,0.0
Rashaun Madison,558,67,511,191,47,27,1781.0,427,149,55.0,84,42,16.5,2017,0.0
Del'Vin Dickerson,449,27,367,170,125,74,1156.0,123,35,54.0,244,135,21.4,2017,0.0
Kyle Benton,466,22,302,180,189,106,1474.0,2,0,55.0,300,180,15.1,2017,0.0
Ron Trapps,394,51,372,136,59,43,1028.0,250,79,58.0,122,57,22.2,2017,0.0
Will Ransom,126,7,96,56,29,14,774.0,1,0,41.0,95,56,9.8,2017,0.0
Michael Wolfe,85,8,60,27,37,28,241.0,16,3,8.0,44,24,17.6,2017,0.0
Diante Baldwin,1226,437,1050,446,388,249,3491.0,246,85,257.0,804,361,21.6,2017,0.0
RJ White,1460,130,1053,591,383,235,3122.0,127,43,222.0,926,548,23.5,2017,0.0
Jelani Mofford,12,2,9,5,0,0,25.0,4,2,1.0,5,3,20.1,2017,0.0
Taqqi Muhammad,7,2,5,2,4,3,26.0,2,0,3.0,3,2,19.1,2017,0.0
Jack Konstanzer,0,0,0,0,0,0,3.0,0,0,0.0,0,0,0.0,2017,0.0
Dennis Smith Jr.,580,197,420,191,200,143,1114.0,153,55,108.0,267,136,27.2,2017,1.0
Terry Henderson,1006,107,755,328,231,183,2355.0,434,167,109.0,321,161,20.5,2017,0.0
Maverick Rowan,725,45,636,246,125,99,1850.0,388,134,79.0,248,112,20.4,2017,0.0
Ted Kapita,113,9,74,45,28,23,328.0,0,0,25.0,74,45,16.7,2017,0.0
BeeJay Anya,462,39,309,180,214,102,2200.0,0,0,112.0,309,180,12.0,2017,0.0
Chris Corchiani Jr.,10,3,11,4,2,2,19.0,2,0,3.0,9,4,39.2,2017,0.0
Tucker Thompson,103,17,82,39,38,25,478.0,1,0,20.0,81,39,12.7,2017,0.0
Chris Brickhouse,4,1,5,2,0,0,24.0,0,0,3.0,5,2,17.0,2017,0.0
C.J. Bryce,1730,251,1359,651,434,304,3884.0,360,124,238.0,999,527,22.3,2017,0.0
Chris Flemmings,1087,128,762,373,270,214,2268.0,356,127,120.0,406,246,21.4,2017,0.0
Denzel Ingram,1332,399,1170,453,238,177,3784.0,677,249,198.0,493,204,18.9,2017,0.0
Ambrose Mosley,815,108,713,272,100,72,2456.0,551,199,79.0,162,73,17.7,2017,0.0
JaQuel Richmond,250,99,254,91,57,42,928.0,77,26,74.0,177,65,19.5,2017,0.0
Chuck Ogbodo,203,8,144,84,62,35,980.0,0,0,62.0,144,84,11.9,2017,0.0
Matt Elmore,22,0,20,8,6,5,92.0,7,1,3.0,13,7,13.6,2017,0.0
Nick Powell,38,5,52,14,6,3,199.0,30,7,9.0,22,7,15.1,2017,0.0
Joel Berry II,1811,451,1447,606,400,333,3973.0,726,266,222.0,721,340,21.8,2017,0.0
Kennedy Meeks,1482,141,1097,608,422,266,3068.0,1,0,187.0,1096,608,22.7,2017,0.0
Isaiah Hicks,1112,100,735,420,374,271,2442.0,6,1,159.0,729,419,20.5,2017,1.0
Tony Bradley,269,23,178,102,105,65,553.0,0,0,25.0,178,102,20.7,2017,1.0
Luke Maye,1394,220,1180,543,302,204,2977.0,288,104,180.0,892,439,23.1,2017,0.0
Nate Britt,774,299,688,256,223,181,2650.0,242,81,167.0,446,175,17.1,2017,0.0
Kenny Williams,915,276,750,329,154,114,2967.0,418,143,130.0,332,186,14.7,2017,1.0
Theo Pinson,757,416,602,257,264,197,2647.0,179,46,186.0,423,211,16.1,2017,1.0
Brandon Robinson,533,156,430,178,108,79,1722.0,263,98,86.0,167,80,15.3,2017,0.0
Seventh Woods,264,175,278,99,86,55,1157.0,52,11,140.0,226,88,17.9,2017,0.0
Stilman White,70,42,59,17,44,31,347.0,26,5,10.0,33,12,11.8,2017,0.0
Shea Rush,31,3,42,9,18,9,114.0,16,4,16.0,26,5,26.9,2017,0.0
Kanler Coker,11,2,8,3,5,5,45.0,2,0,3.0,6,3,13.7,2017,0.0
Aaron Rohlman,6,3,4,3,1,0,64.0,0,0,3.0,4,3,5.3,2017,0.0
Paul Miller,1719,237,1320,569,427,336,3838.0,652,245,237.0,668,324,24.4,2017,0.0
Dexter Werner,943,91,648,351,364,241,2168.0,2,0,104.0,646,351,23.1,2017,0.0
Khy Kabellis,879,273,784,298,240,161,3073.0,372,122,197.0,412,176,18.9,2017,0.0
A.J. Jacobson,1355,214,976,429,354,286,3802.0,524,211,150.0,452,218,18.3,2017,0.0
Carlin Dupree,797,214,714,301,263,162,2903.0,133,33,187.0,581,268,19.2,2017,0.0
Tyson Ward,1530,283,1131,554,399,302,3427.0,339,120,253.0,792,434,24.4,2017,0.0
Dylan Miller,248,25,205,109,38,26,818.0,16,4,32.0,189,105,16.4,2017,0.0
Deng Geu,879,56,633,345,253,164,2047.0,104,25,155.0,529,320,23.8,2017,0.0
Jared Samuelson,642,94,469,199,77,67,2396.0,413,177,42.0,56,22,12.2,2017,0.0
Spencer Eliason,171,25,136,73,54,25,740.0,0,0,38.0,136,73,14.2,2017,0.0
Evan Wessenberg,24,4,22,12,2,0,112.0,1,0,7.0,21,12,14.9,2017,0.0
Zach Rammelt,6,2,5,2,0,0,25.0,4,2,0.0,1,0,10.3,2017,0.0
Quinton Hooker,1787,417,1278,592,523,433,3917.0,436,170,216.0,842,422,22.2,2017,0.0
Geno Crandall,1485,441,1059,503,480,351,3526.0,357,128,340.0,702,375,22.8,2017,0.0
Corey Baldwin,590,78,469,198,111,68,1619.0,317,126,78.0,152,72,18.1,2017,0.0
Conner Avants,1163,94,838,467,326,220,2818.0,27,9,178.0,811,458,20.6,2017,0.0
Drick Bernstine,803,241,693,345,215,111,2859.0,17,2,223.0,676,343,17.9,2017,0.0
Cortez Seales,1231,247,1064,497,322,205,3362.0,120,32,151.0,944,465,20.2,2017,0.0
Josh Collins,97,14,88,35,34,20,465.0,26,7,24.0,62,28,13.5,2017,0.0
Billy Brown,527,141,429,180,82,66,2683.0,278,101,106.0,151,79,10.7,2017,0.0
Kienan Walter,817,109,596,271,219,162,2180.0,307,113,146.0,289,158,19.5,2017,0.0
Thomas Blake,20,8,27,7,8,4,90.0,15,2,8.0,12,5,21.4,2017,0.0
Devon Pekas,11,3,7,3,4,2,39.0,7,3,2.0,0,0,13.6,2017,0.0
Dallas Moore,2437,551,1870,904,463,354,4463.0,705,275,302.0,1165,629,26.3,2017,0.0
Garrett Sams,1541,226,1148,471,445,357,3446.0,625,242,310.0,523,229,23.2,2017,0.0
Wajid Aminu,1337,155,985,517,448,272,3239.0,102,31,231.0,883,486,21.1,2017,0.0
Chris Davenport,1353,335,917,482,410,298,3311.0,260,91,371.0,657,391,22.1,2017,0.0
Romelo Banks,554,17,414,215,249,124,1702.0,0,0,101.0,414,215,18.2,2017,0.0
Aaron Bodager,549,100,443,182,47,37,1979.0,385,148,96.0,58,34,13.7,2017,0.0
Aaron Horne,107,26,92,40,15,11,413.0,54,16,31.0,38,24,14.7,2017,0.0
Karlos Odum,113,15,65,29,81,55,405.0,1,0,21.0,64,29,14.5,2017,0.0
Osborn Blount,354,64,334,115,84,65,1069.0,179,59,76.0,155,56,19.9,2017,0.0
Nick Malonga,199,39,196,70,59,35,855.0,99,24,52.0,97,46,15.7,2017,0.0
CJ Fisher,24,11,16,7,23,10,100.0,0,0,9.0,16,7,16.7,2017,0.0
Benedikt Haid,37,3,31,12,6,5,127.0,27,8,6.0,4,4,14.7,2017,0.0
Chase Driscoll,1,0,11,0,4,1,52.0,7,0,2.0,4,0,13.8,2017,0.0
A.J. Lawson,1425,370,1209,541,447,266,3251.0,257,77,327.0,952,464,26.3,2017,0.0
J-Mychal Reese,1034,279,879,363,291,217,2849.0,252,91,250.0,627,272,22.3,2017,0.0
Derail Green,603,94,496,208,126,103,1677.0,222,84,100.0,274,124,19.5,2017,0.0
Shane Temara,436,21,380,170,77,42,1193.0,172,54,46.0,208,116,19.1,2017,0.0
Ryan Woolridge,1368,573,1064,529,416,231,4050.0,216,79,350.0,848,450,19.7,2017,0.0
Ja'Michael Brown,436,124,418,157,77,41,1604.0,243,81,100.0,175,76,16.7,2017,0.0
Rickey Brice Jr.,285,4,240,106,123,73,738.0,1,0,58.0,239,106,23.4,2017,0.0
Deckie Johnson,589,95,484,180,173,140,1365.0,286,89,80.0,198,91,22.8,2017,0.0
Allante Holston,459,120,378,165,173,118,2454.0,36,11,127.0,342,154,11.9,2017,0.0
Keith Frazier,734,95,615,258,120,92,1839.0,351,126,107.0,264,132,22.1,2017,0.0
Bryce Jackson,42,5,38,15,14,10,266.0,13,2,19.0,25,13,11.6,2017,0.0
DJ Draper,459,73,330,144,61,43,1837.0,289,128,49.0,41,16,11.4,2017,0.0
Jacob Gross,10,1,13,3,7,3,61.0,6,1,3.0,7,2,15.5,2017,0.0
Greg White-Pittman,72,11,59,19,68,34,305.0,11,0,23.0,48,19,18.7,2017,0.0
T.J. Williams,1377,403,991,445,585,406,3671.0,257,81,260.0,734,364,22.3,2017,0.0
Alex Murphy,602,61,470,226,166,89,1520.0,192,61,98.0,278,165,22.5,2017,0.0
Devon Begley,649,200,570,213,167,121,2392.0,297,102,167.0,273,111,18.2,2017,0.0
Bolden Brace,1178,286,876,383,225,182,3712.0,609,230,144.0,267,153,16.4,2017,0.0
Shawn Occeus,670,115,525,225,165,113,2004.0,308,107,112.0,217,118,19.1,2017,0.0
Maxime Boursiquot,650,102,506,269,116,79,2039.0,86,33,157.0,420,236,18.9,2017,0.0
Anthony Green,701,46,441,290,238,121,2012.0,0,0,126.0,441,290,18.2,2017,0.0
Jeremy Miller,532,39,376,190,130,96,1490.0,163,56,62.0,213,134,17.9,2017,0.0
Jimmy Marshall,161,27,155,54,28,19,687.0,113,34,29.0,42,20,15.3,2017,0.0
Donnell Gresham Jr.,894,242,647,266,255,203,3117.0,402,159,113.0,245,107,14.9,2017,0.0
Sajon Ford,17,2,19,8,7,1,107.0,0,0,9.0,19,8,15.6,2017,0.0
Jordyn Martin,881,117,681,366,217,140,3143.0,21,9,156.0,660,357,15.0,2017,0.0
Ako Kaluna,1173,113,977,437,300,205,2814.0,276,94,167.0,701,343,23.0,2017,0.0
Marcus DeBerry,991,213,995,348,125,96,3376.0,628,199,123.0,367,149,17.2,2017,0.0
Mike Green,532,126,505,187,88,62,1420.0,268,96,139.0,237,91,23.8,2017,1.0
JoJo Anderson,591,156,403,145,307,232,1633.0,211,69,133.0,192,76,20.6,2017,0.0
Jaleni Neely,294,96,259,80,103,84,950.0,152,50,69.0,107,30,19.8,2017,0.0
Kye de Laveaga,149,33,145,45,21,16,633.0,131,43,27.0,14,2,14.1,2017,0.0
Brooks DeBisschop,806,174,628,322,262,140,2859.0,83,22,156.0,545,300,16.0,2017,0.0
Chris Bowling,455,70,496,157,83,61,1768.0,284,80,103.0,212,77,18.0,2017,0.0
Isaiah Thomas,364,13,279,152,104,60,1295.0,0,0,66.0,279,152,15.1,2017,1.0
Felix Rivera-Vega,176,13,143,65,52,24,526.0,61,22,30.0,82,43,18.7,2017,0.0
Corey Brown,489,40,362,201,157,87,1525.0,8,0,98.0,354,201,17.4,2017,0.0
Aziz Seck,61,8,56,25,34,11,288.0,1,0,21.0,55,25,15.9,2017,0.0
Steven Stanley,26,4,14,9,9,8,89.0,0,0,9.0,14,9,14.9,2017,0.0
Omar Ndiaye,6,0,5,2,1,1,7.0,4,1,0.0,1,1,38.5,2017,0.0
Torry Johnson,937,164,711,286,398,297,2935.0,210,68,215.0,501,218,18.9,2017,0.0
Travis Rice,6,0,9,2,0,0,18.0,9,2,0.0,0,0,22.5,2017,0.0
Raynard Robinson,0,0,0,0,0,0,4.0,0,0,0.0,0,0,0.0,2017,0.0
DJ Miles,386,35,300,120,90,70,792.0,191,76,53.0,109,44,24.8,2017,0.0
Chaz Glotta,510,70,453,172,66,43,1345.0,355,123,62.0,98,49,20.3,2017,0.0
Jonah Radebaugh,1336,384,1013,464,281,202,4684.0,521,206,183.0,492,258,14.6,2017,0.0
Kai Edwards,656,62,396,273,219,110,2005.0,1,0,76.0,395,273,14.8,2017,0.0
Jon'te Dotson,203,40,183,64,77,48,1101.0,97,27,59.0,86,37,12.7,2017,0.0
Ibrahim Sylla,513,22,367,206,205,101,1414.0,0,0,104.0,367,206,20.4,2017,0.0
Roberto Vercellino,124,20,89,44,44,30,564.0,28,6,38.0,61,38,12.9,2017,0.0
Gerad Davis,63,8,43,21,28,20,123.0,4,1,11.0,39,20,27.2,2017,0.0
Kyle Carey,49,5,54,16,21,13,181.0,21,4,12.0,33,12,20.9,2017,0.0
Mike Ranson,24,7,25,7,5,4,117.0,20,6,8.0,5,1,15.0,2017,0.0
Tyler Loose,36,56,38,10,34,15,585.0,5,1,28.0,33,9,7.0,2017,0.0
Tanner Morgan,382,46,342,149,121,78,1513.0,25,6,82.0,317,143,15.5,2017,0.0
Levi Bradley,1464,107,1179,536,371,300,3205.0,287,92,147.0,892,444,23.7,2017,0.0
Eugene German,2203,252,1754,805,499,354,3548.0,672,239,257.0,1082,566,32.3,2017,0.0
Aaric Armstead,1191,121,1055,395,435,295,3530.0,348,106,213.0,707,289,21.1,2017,0.0
Jaylen Key,770,74,664,313,197,130,2288.0,41,14,157.0,623,299,19.8,2017,0.0
Laytwan Porter,342,138,286,110,104,76,1106.0,132,46,109.0,154,64,19.8,2017,0.0
Justin Thomas,610,254,544,234,202,118,2573.0,96,24,145.0,448,210,15.2,2017,0.0
Austin Pauga,150,20,126,52,6,4,578.0,109,42,12.0,17,10,12.0,2017,0.0
Marshawn Wilson,430,53,328,137,123,89,847.0,172,67,48.0,156,70,25.3,2017,0.0
Noah McCarty,483,96,442,187,136,78,1990.0,110,31,123.0,332,156,16.2,2017,0.0
Sean Damaska,10,1,6,4,3,2,18.0,0,0,1.0,6,4,23.0,2017,0.0
Jon Siu,9,1,6,3,0,0,17.0,5,3,1.0,1,0,20.7,2017,0.0
Jeremy Morgan,1218,235,908,393,331,259,3669.0,475,173,165.0,433,220,19.2,2017,0.0
Bennett Koch,1028,45,661,358,424,312,2127.0,1,0,189.0,660,358,28.0,2017,0.0
Jordan Ashton,277,41,227,91,53,41,1181.0,132,54,38.0,95,37,13.7,2017,0.0
Klint Carlson,819,138,729,311,165,120,2799.0,257,77,132.0,472,234,18.9,2017,0.0
Spencer Haldeman,932,140,733,280,210,173,2850.0,545,199,128.0,188,81,18.4,2017,0.0
Juwan McCloud,281,107,324,106,80,42,1281.0,119,27,79.0,205,79,19.2,2017,0.0
Luke McDonnell,354,71,257,128,118,74,1100.0,70,24,73.0,187,104,19.3,2017,0.0
Hunter Rhodes,169,48,135,50,42,38,667.0,84,31,12.0,51,19,13.9,2017,0.0
Isaiah Brown,780,182,722,280,149,112,3067.0,334,108,163.0,388,172,16.9,2017,0.0
Wyatt Lohaus,877,144,763,310,166,130,2843.0,332,127,120.0,431,183,19.1,2017,0.0
Justin Dahl,170,26,140,74,42,22,573.0,0,0,49.0,140,74,19.7,2017,0.0
Ted Friedman,86,22,69,34,48,16,774.0,4,2,29.0,65,32,8.8,2017,0.0
Lincoln Conrey,23,3,21,9,5,3,66.0,9,2,6.0,12,7,24.2,2017,0.0
Rafael de Souza,2,2,3,1,0,0,13.0,0,0,2.0,3,1,21.8,2017,0.0
Drew McDonald,2066,262,1520,717,586,450,3652.0,496,182,267.0,1024,535,28.1,2017,0.0
LaVone Holland,1250,396,1022,428,357,249,2860.0,403,145,273.0,619,283,25.5,2017,0.0
Carson Williams,1388,158,907,515,456,313,3476.0,118,45,173.0,789,470,18.7,2017,0.0
Cole Murray,930,88,720,316,52,39,2615.0,630,259,71.0,90,57,15.9,2017,0.0
Mason Faulkner,1343,431,1006,420,451,352,2946.0,478,151,267.0,528,269,24.9,2017,0.0
Jordan Garnett,518,148,393,179,138,96,2401.0,165,64,100.0,228,115,11.6,2017,0.0
Jeff Garrett,230,21,193,96,68,34,725.0,27,4,47.0,166,92,18.5,2017,0.0
Dantez Walton,1008,181,854,375,173,113,2432.0,465,145,135.0,389,230,21.9,2017,0.0
Brennan Gillis,166,28,133,60,52,33,571.0,33,13,55.0,100,47,18.5,2017,0.0
Jalen Tate,1302,408,983,488,410,261,3327.0,217,65,267.0,766,423,21.2,2017,0.0
Brandon Maxwell,34,10,41,12,8,3,201.0,28,7,26.0,13,5,17.3,2017,0.0
Blake Spellman,25,8,23,8,2,2,141.0,21,7,7.0,2,1,10.8,2017,0.0
Tre Cobbs,79,22,42,23,43,29,198.0,9,4,21.0,33,19,21.0,2017,0.0
Matt Rosenwinkel,48,7,46,15,11,8,382.0,38,10,7.0,8,5,7.9,2017,0.0
Nick Ayers,0,2,2,0,0,0,20.0,0,0,0.0,2,0,5.0,2017,0.0
Sabri Thompson,1086,179,883,362,225,169,2649.0,484,193,168.0,399,169,20.3,2017,0.0
Ishmael Lane,1467,108,1048,553,520,325,3062.0,114,36,242.0,934,517,23.9,2017,0.0
Devonte Hall,782,379,676,261,297,217,2386.0,169,43,201.0,507,218,20.0,2017,0.0
Zeek Woodley,2033,109,1336,743,492,414,3092.0,324,133,145.0,1012,610,25.6,2017,0.0
Iziahiah Sweeney,613,87,590,232,158,107,1734.0,159,42,112.0,431,190,21.4,2017,0.0
Tra'von Joseph,591,115,446,219,180,126,2124.0,89,27,127.0,357,192,14.4,2017,0.0
Josh Boyd,196,57,150,58,88,55,448.0,74,25,65.0,76,33,27.0,2017,0.0
Reggie Kissoonlal,164,14,151,50,42,31,423.0,108,33,36.0,43,17,22.9,2017,0.0
Malik Metoyer,381,81,296,130,135,97,1463.0,98,24,114.0,198,106,15.5,2017,0.0
Tanner Hamilton,33,11,29,13,7,2,174.0,12,5,13.0,17,8,12.3,2017,0.0
Bailey Walker,99,54,92,32,24,16,624.0,45,19,67.0,47,13,12.8,2017,0.0
Jacob Guest,147,13,181,50,18,13,488.0,139,34,30.0,42,16,21.5,2017,0.0
Cody Cambre,5,1,5,1,6,3,43.0,3,0,0.0,2,1,8.6,2017,0.0
Bryant McIntosh,1683,700,1519,621,319,271,4348.0,498,170,327.0,1021,451,24.7,2017,0.0
Scottie Lindsey,1270,187,1097,454,203,164,3053.0,556,198,142.0,541,256,23.3,2017,0.0
Vic Law,1442,254,1198,481,371,287,3790.0,524,193,215.0,674,288,22.4,2017,1.0
Dererk Pardon,1182,134,783,471,380,234,3234.0,29,6,134.0,754,465,17.9,2017,0.0
Isiah Brown,1005,191,807,342,274,223,2387.0,304,98,144.0,503,244,23.5,2017,0.0
Sanjay Lumpkin,607,158,441,213,190,127,3475.0,171,54,143.0,270,159,10.7,2017,0.0
Gavin Skelly,550,108,392,187,187,130,1926.0,127,46,126.0,265,141,16.7,2017,0.0
Nathan Taphorn,436,60,334,149,55,37,1241.0,244,101,66.0,90,48,18.8,2017,0.0
Barret Benson,532,67,395,200,181,112,1727.0,58,20,111.0,337,180,18.8,2017,0.0
Jordan Ash,238,111,214,88,69,39,1191.0,87,23,58.0,127,65,12.7,2017,0.0
Aaron Falzon,724,78,629,233,106,84,2237.0,498,174,70.0,131,59,17.6,2017,0.0
Charlie Hall,1,0,4,0,3,1,36.0,4,0,0.0,0,0,7.9,2017,0.0
Bonzie Colson,1632,122,1154,609,474,366,3132.0,137,48,126.0,1017,561,25.3,2017,1.0
V.J. Beachem,1215,81,994,435,159,117,3067.0,582,228,96.0,412,207,20.2,2017,0.0
Matt Farrell,1097,417,870,366,214,174,2785.0,493,191,185.0,377,175,21.7,2017,0.0
Steve Vasturia,1400,331,1102,483,286,244,4402.0,521,190,190.0,581,293,17.3,2017,0.0
T.J. Gibbs,1576,382,1287,502,403,331,4161.0,646,241,158.0,641,261,20.3,2017,0.0
Rex Pflueger,756,344,660,247,182,141,3452.0,351,121,151.0,309,126,13.4,2017,0.0
Matt Ryan,1058,121,854,345,165,139,2539.0,631,229,110.0,223,116,21.2,2017,0.0
Martinas Geben,565,76,355,216,160,132,1554.0,3,1,99.0,352,215,17.8,2017,0.0
Austin Torres,200,26,145,88,58,24,903.0,0,0,38.0,145,88,12.3,2017,0.0
John Mooney,1181,117,965,446,283,191,2590.0,274,98,98.0,691,348,23.7,2017,0.0
Elijah Burns,515,35,293,168,191,162,1146.0,34,17,73.0,259,151,20.6,2017,0.0
Patrick Mazza,2,0,2,1,0,0,4.0,0,0,1.0,2,1,39.1,2017,0.0
Matt Gregory,10,0,22,3,4,2,65.0,14,2,1.0,8,1,20.3,2017,0.0
Martez Walker,1489,129,1033,458,484,391,3132.0,535,182,156.0,498,276,21.6,2017,0.0
Jalen Hayes,1814,175,1322,697,541,403,3901.0,57,17,217.0,1265,680,22.2,2017,0.0
Sherron Dorsey-Walker,716,188,572,215,245,179,2119.0,299,107,135.0,273,108,18.3,2017,0.0
Nick Daniels,895,282,726,280,205,150,2617.0,473,185,186.0,253,95,18.7,2017,0.0
Isaiah Brock,362,37,232,161,62,40,1552.0,0,0,58.0,232,161,9.9,2017,0.0
Stevie Clark,264,151,204,76,93,73,751.0,120,39,81.0,84,37,21.2,2017,0.0
Xavier Hill-Mais,1430,171,1058,556,386,267,2843.0,167,51,243.0,891,505,26.3,2017,0.0
Brailen Neely,219,253,175,65,87,68,1142.0,74,21,91.0,101,44,13.0,2017,0.0
Brad Brechting,770,79,518,279,279,200,2011.0,42,12,135.0,476,267,19.6,2017,0.0
Jaevin Cumberland,946,176,724,287,225,179,2289.0,509,193,111.0,215,94,20.7,2017,0.0
Chris Palombizio,156,18,155,49,56,35,627.0,86,23,15.0,69,26,15.1,2017,0.0
Jae'Sean Tate,1512,216,1113,614,447,248,3611.0,130,36,234.0,983,578,22.1,2017,0.0
Marc Loving,1338,141,988,414,442,334,3414.0,477,176,228.0,511,238,21.4,2017,0.0
JaQuan Lyle,1176,423,927,395,365,265,2955.0,364,121,299.0,563,274,23.7,2017,0.0
Trevor Thompson,717,26,502,259,280,199,1851.0,0,0,131.0,502,259,21.4,2017,0.0
Kam Williams,1057,102,890,392,115,101,2980.0,427,172,76.0,463,220,17.5,2017,0.0
C.J. Jackson,1016,342,825,337,251,190,2693.0,418,152,191.0,407,185,21.8,2017,0.0
Micah Potter,843,68,613,304,189,150,1769.0,223,85,107.0,390,219,24.5,2017,0.0
Keita Bates-Diop,1272,121,993,469,272,211,2702.0,349,123,134.0,644,346,23.8,2017,1.0
Andre Wesson,730,164,571,244,182,133,2900.0,305,109,160.0,266,135,14.7,2017,0.0
David Bell,653,44,441,251,229,151,1568.0,1,0,123.0,440,251,21.4,2017,0.0
Joey Lane,33,8,31,10,8,5,89.0,24,8,7.0,7,2,23.9,2017,0.0
Jimmy Jent,3,0,10,1,0,0,22.0,6,1,1.0,4,0,26.3,2017,0.0
Jordan Dartis,1461,194,1054,457,270,233,3892.0,737,314,129.0,317,143,16.9,2017,0.0
Kenny Kaminski,922,79,745,304,138,112,2232.0,496,202,75.0,249,102,20.0,2017,0.0
Jason Carter,1173,161,934,424,382,265,3144.0,221,60,165.0,713,364,20.1,2017,0.0
Gavin Block,866,290,711,276,251,169,3148.0,423,145,168.0,288,131,15.7,2017,0.0
Antonio Campbell,1257,64,929,498,251,166,2396.0,272,95,129.0,657,403,25.2,2017,0.0
Mike Laster,770,84,615,293,157,110,2319.0,191,74,110.0,424,219,17.3,2017,0.0
Doug Taylor,642,46,449,257,221,125,2089.0,10,3,117.0,439,254,15.8,2017,0.0
Rodney Culver,82,17,67,30,31,17,316.0,14,5,35.0,53,25,18.2,2017,0.0
Ellis Dozier,13,0,21,6,5,1,68.0,4,0,5.0,17,6,20.6,2017,0.0
Antonio Bisutti,5,2,7,2,0,0,31.0,3,1,2.0,4,1,14.3,2017,0.0
Jaylin McDonald,7,1,8,2,4,3,41.0,4,0,0.0,4,2,12.0,2017,0.0
Drew Crabtree,16,3,16,5,2,2,58.0,13,4,4.0,3,1,18.5,2017,0.0
Sam Frayer,12,1,20,5,4,1,52.0,9,1,4.0,11,4,25.0,2017,0.0
Jawun Evans,896,312,688,308,275,225,1571.0,135,55,146.0,553,253,29.8,2017,1.0
Jeffrey Carroll,1416,125,1074,484,341,265,2960.0,512,183,157.0,562,301,23.0,2017,0.0
Phil Forte,1746,178,1237,512,445,393,3994.0,832,329,132.0,405,183,20.1,2017,0.0
Leyton Hammonds,676,60,594,244,120,88,2043.0,305,100,96.0,289,144,18.5,2017,0.0
Mitchell Solomon,638,104,451,231,213,165,2437.0,56,11,153.0,395,220,14.2,2017,0.0
Brandon Averette,1099,352,933,411,228,178,2910.0,292,99,229.0,641,312,21.4,2017,0.0
Davon Dillard,163,14,113,60,42,29,381.0,31,14,32.0,82,46,20.2,2017,0.0
Lindy Waters,1152,254,907,387,246,201,3377.0,454,177,165.0,453,210,17.7,2017,0.0
Cameron McGriff,1211,149,904,386,430,345,3414.0,300,94,202.0,604,292,19.3,2017,0.0
Thomas Dziagwa,918,105,757,301,75,65,2310.0,610,251,107.0,147,50,19.7,2017,0.0
Lucas N'Guessan,550,42,311,203,211,140,1552.0,14,4,121.0,297,199,16.9,2017,0.0
Tavarius Shine,587,82,489,191,154,112,1888.0,295,93,87.0,194,98,17.4,2017,0.0
Tyler Underwood,24,11,24,7,7,4,163.0,17,6,9.0,7,1,10.9,2017,0.0
Will Lienhard,2,1,2,1,2,0,34.0,0,0,1.0,2,1,5.4,2017,0.0
Trey Reeves,2,1,11,1,0,0,46.0,6,0,4.0,5,1,15.8,2017,0.0
Kameron McGusty,1208,138,1023,443,243,188,2853.0,401,134,187.0,622,309,23.0,2017,0.0
Rashard Odomes,794,132,602,303,296,173,2159.0,44,15,117.0,558,288,19.3,2017,0.0
Jordan Woodard,1440,471,1091,419,542,440,3733.0,421,162,261.0,670,257,21.1,2017,0.0
Kristian Doolittle,1188,162,955,424,373,291,3081.0,131,49,177.0,824,375,21.3,2017,0.0
Khadeem Lattin,745,61,545,293,237,159,2598.0,3,0,110.0,542,293,14.2,2017,0.0
Christian James,1209,162,997,414,273,205,3075.0,485,176,196.0,512,238,21.0,2017,0.0
Jamuni McNeace,528,28,385,223,165,82,1721.0,1,0,106.0,384,223,16.0,2017,0.0
Jordan Shepherd,866,264,678,294,299,219,2593.0,192,59,209.0,486,235,21.2,2017,0.0
Darrion Strong-Moore,111,41,109,42,13,7,437.0,65,20,32.0,44,22,16.3,2017,0.0
Dante Buford,224,25,195,71,75,53,726.0,84,29,41.0,111,42,18.2,2017,0.0
Matt Freeman,531,87,462,183,74,63,1620.0,284,102,88.0,178,81,18.5,2017,0.0
C.J. Cole,24,2,23,10,14,4,133.0,3,0,7.0,20,10,13.5,2017,0.0
Richard Anderson,57,13,58,20,9,7,215.0,35,10,10.0,23,10,17.6,2017,1.0
Daniel Harper,3,4,6,1,0,0,36.0,3,1,2.0,3,0,10.9,2017,0.0
Marshall Thorpe,0,0,2,0,0,0,13.0,0,0,1.0,2,0,11.2,2017,0.0
Ahmad Caver,1538,607,1368,516,446,291,4183.0,647,215,239.0,721,301,22.5,2017,0.0
B.J. Stith,1389,126,1183,485,324,268,2996.0,420,151,154.0,763,334,25.7,2017,0.0
Brandan Stith,1027,105,765,402,397,223,3097.0,2,0,149.0,763,402,18.5,2017,0.0
Trey Porter,976,49,621,345,440,284,2224.0,10,2,124.0,611,343,21.9,2017,0.0
Jordan Baker,632,242,590,205,110,70,3293.0,459,152,149.0,131,53,12.7,2017,0.0
Denzell Taylor,540,153,407,228,202,84,3724.0,2,0,185.0,405,228,9.8,2017,0.0
Randy Haynes,477,94,486,178,67,45,1266.0,244,76,64.0,242,102,23.7,2017,0.0
Travis Fields,1001,291,866,355,191,135,2820.0,404,156,163.0,462,199,21.0,2017,0.0
Aaron Carver,322,66,289,127,136,67,2427.0,15,1,82.0,274,126,9.2,2017,0.0
Alassane Kah,20,1,14,9,4,1,42.0,3,1,1.0,11,8,21.0,2017,0.0
Stephen Vassor,73,12,50,31,14,11,385.0,0,0,21.0,50,31,10.5,2017,0.0
Khary Mauras,5,0,0,0,6,5,3.0,0,0,0.0,0,0,49.5,2017,0.0
Keith Pinckney,96,29,105,40,28,13,429.0,19,3,37.0,86,37,19.1,2017,0.0
Albert Owens,1318,76,1127,529,377,254,2840.0,26,6,155.0,1101,523,25.6,2017,0.0
Jalen Bradley,747,188,626,270,140,115,1950.0,243,92,90.0,383,178,19.8,2017,0.0
Kris Martin,1092,214,927,367,246,169,3017.0,532,189,194.0,395,178,20.7,2017,0.0
Emmanuel Nzekwesi,1492,142,1210,601,348,240,3148.0,182,50,207.0,1028,551,24.8,2017,0.0
Aaron Anderson,390,198,274,124,145,109,1847.0,90,33,136.0,184,91,13.1,2017,0.0
Chris Miller,338,16,267,148,67,42,810.0,0,0,83.0,267,148,23.3,2017,0.0
Darian Harris,194,81,169,62,37,23,1070.0,135,47,43.0,34,15,10.9,2017,0.0
Jontray Harris,346,82,288,116,87,63,1235.0,152,51,55.0,136,65,15.5,2017,0.0
Dezmond McDaniel,19,10,23,7,2,1,109.0,8,4,3.0,15,3,12.3,2017,0.0
Isaac Gilliam,9,0,13,3,4,2,20.0,8,1,4.0,5,2,46.9,2017,0.0
Kellen Manek,29,3,19,6,18,13,60.0,10,4,5.0,9,2,26.7,2017,0.0
Javan White,762,99,633,308,227,131,2076.0,46,15,136.0,587,293,21.5,2017,0.0
Drew Eubanks,1127,87,747,447,336,233,2715.0,0,0,194.0,747,447,21.0,2017,1.0
Stephen Thompson Jr.,1767,309,1498,636,389,265,3941.0,677,230,229.0,821,406,25.1,2017,0.0
Jaquori McLaughlin,1498,489,1162,482,431,342,4136.0,519,192,252.0,643,290,20.5,2017,0.0
Kendal Manuel,1093,163,892,370,206,171,3026.0,471,182,167.0,421,188,20.1,2017,0.0
Gligorije Rakocevic,394,19,299,152,135,81,1470.0,25,9,84.0,274,143,15.8,2017,0.0
Tres Tinkle,2233,374,1605,739,723,570,4285.0,561,185,309.0,1044,554,27.3,2017,0.0
Ronnie Stacy,103,39,106,39,45,21,575.0,16,4,56.0,90,35,16.6,2017,0.0
Ben Kone,171,13,153,58,69,47,701.0,27,8,45.0,126,50,16.8,2017,0.0
Matt Dahlen,53,21,40,20,30,13,381.0,1,0,23.0,39,20,10.7,2017,0.0
Daine Muller,42,18,28,13,4,3,207.0,28,13,9.0,0,0,9.9,2017,0.0
Cheikh N'diaye,116,6,74,48,38,20,521.0,0,0,37.0,74,48,13.2,2017,0.0
Tanner Sanders,37,19,56,15,2,0,387.0,39,7,19.0,17,8,10.6,2017,0.0
Keondre Dew,22,7,43,10,7,2,185.0,2,0,22.0,41,10,19.6,2017,0.0
Tyler Dorsey,1055,138,752,342,295,216,2252.0,373,155,128.0,379,187,22.6,2017,1.0
Dillon Brooks,1612,279,1243,587,384,305,3153.0,367,133,234.0,876,454,26.4,2017,1.0
Jordan Bell,814,155,566,345,192,121,2591.0,16,3,162.0,550,342,15.9,2017,1.0
Dylan Ennis,1233,440,991,412,353,244,3681.0,475,165,247.0,516,247,19.6,2017,0.0
Chris Boucher,825,28,564,300,234,150,1712.0,218,75,75.0,346,225,21.9,2017,1.0
Payton Pritchard,1938,659,1504,657,420,336,4854.0,759,288,292.0,745,369,21.2,2017,0.0
Kavell Bigby-Williams,386,23,257,146,158,94,1104.0,0,0,51.0,257,146,16.9,2017,0.0
Roman Sorkin,187,23,141,66,36,30,484.0,69,25,21.0,72,41,18.6,2017,0.0
Evan Gross,5,3,2,2,0,0,12.0,1,1,4.0,1,1,25.1,2017,0.0
Charlie Noebel,6,0,10,2,0,0,53.0,9,2,5.0,1,0,14.2,2017,0.0
T.J. Wallace,1278,265,1089,425,409,297,3255.0,387,131,244.0,702,294,24.2,2017,0.0
Anthony Townes,853,34,672,352,222,149,2332.0,0,0,129.0,672,352,20.0,2017,0.0
Jack Williams,644,66,602,225,135,91,2177.0,283,103,81.0,319,122,17.6,2017,0.0
D.J. Ursery,343,86,308,122,134,88,998.0,51,11,86.0,257,111,23.3,2017,0.0
Jacob Lampkin,467,74,378,195,138,77,1590.0,3,0,99.0,375,195,17.6,2017,0.0
David Taylor,545,110,516,186,96,71,1886.0,317,102,112.0,199,84,18.6,2017,0.0
Tonko Vuko,263,36,194,95,82,60,1047.0,49,13,41.0,145,82,13.3,2017,0.0
K.J. Smith,118,42,118,41,39,24,496.0,55,12,24.0,63,29,15.8,2017,0.0
Keshon Montague,80,36,75,27,11,8,488.0,51,18,22.0,24,9,10.6,2017,0.0
Sami Eleraky,159,16,127,58,102,43,756.0,0,0,51.0,127,58,15.7,2017,0.0
Max Tinsley,61,16,50,25,7,4,296.0,18,7,9.0,32,18,10.7,2017,0.0
Maleke Haynes,132,98,145,41,58,37,785.0,62,13,71.0,83,28,15.8,2017,0.0
Ilias Theodorou,173,16,143,62,26,15,483.0,86,34,34.0,57,28,20.2,2017,0.0
Dominic Rector,0,0,1,0,0,0,2.0,1,0,0.0,0,0,25.1,2017,0.0
Tony Carr,1161,325,974,386,341,268,2392.0,306,121,171.0,668,265,27.4,2017,0.0
Lamar Stevens,2207,262,1841,801,703,519,4351.0,312,86,324.0,1529,715,28.5,2017,0.0
Shep Garner,1629,317,1356,532,291,229,4443.0,887,336,221.0,469,196,19.8,2017,0.0
Payton Banks,1015,104,919,337,209,156,2850.0,546,185,140.0,373,152,21.1,2017,0.0
Mike Watkins,1169,68,809,483,354,203,2741.0,4,0,158.0,805,483,20.5,2017,0.0
Josh Reaves,1079,310,926,406,225,158,3482.0,336,109,217.0,590,297,18.1,2017,1.0
Terrence Samuel,516,221,393,162,226,173,2362.0,68,19,157.0,325,143,14.8,2017,0.0
Julian Moore,351,32,273,131,137,88,1728.0,3,1,78.0,270,130,12.3,2017,0.0
Nazeer Bostick,239,38,219,84,86,62,895.0,47,9,64.0,172,75,18.1,2017,0.0
Deividas Zemgulis,107,13,108,37,23,16,563.0,69,17,23.0,39,20,13.0,2017,0.0
Grant Hazle,2,0,2,1,0,0,7.0,0,0,0.0,2,1,14.1,2017,0.0
Alex Zhao,0,0,2,0,0,0,5.0,1,0,0.0,1,0,19.7,2017,0.0
AJ Brodeur,1832,390,1436,752,427,267,3830.0,198,61,307.0,1238,691,26.1,2017,0.0
Matt Howard,965,107,740,352,263,169,2548.0,281,92,128.0,459,260,20.4,2017,0.0
Darnell Foreman,831,312,706,278,287,207,2906.0,245,68,175.0,461,210,18.2,2017,0.0
Ryan Betley,1190,121,957,398,217,173,3080.0,600,221,140.0,357,177,20.2,2017,0.0
Jackson Donahue,590,100,535,195,84,50,1657.0,437,150,65.0,98,45,19.9,2017,0.0
Caleb Wood,454,49,342,153,71,57,975.0,241,91,59.0,101,62,22.9,2017,0.0
Devon Goodman,998,235,845,376,212,130,2800.0,372,116,180.0,473,260,20.6,2017,0.0
Max Rothschild,586,168,445,230,203,125,1948.0,8,1,194.0,437,229,19.4,2017,0.0
Sam Jones,556,45,461,175,68,56,1504.0,400,150,45.0,61,25,18.8,2017,1.0
Matt MacDonald,627,95,505,198,165,124,2353.0,320,107,85.0,185,91,14.6,2017,0.0
Tyler Hamilton,187,57,173,61,77,56,1064.0,39,9,60.0,134,52,13.2,2017,0.0
Jake Silpe,398,163,324,133,121,77,1673.0,166,55,100.0,158,78,14.8,2017,0.0
Collin McManus,21,2,16,9,4,3,76.0,0,0,3.0,16,9,14.1,2017,0.0
Dan Dwyer,117,33,82,47,34,23,827.0,3,0,33.0,79,47,8.2,2017,0.0
Ray Jerome,77,22,78,25,15,11,390.0,52,16,20.0,26,9,13.7,2017,0.0
Zack Kaminsky,1,0,5,0,4,1,28.0,4,0,1.0,1,0,14.5,2017,0.0
Kuba Mijakowski,48,6,48,16,2,2,141.0,42,14,7.0,6,2,20.5,2017,0.0
Shawn Simmons,1,1,2,0,6,1,19.0,1,0,2.0,1,0,19.5,2017,0.0
Lamond Murray Jr.,1492,107,1217,575,337,255,2876.0,233,87,175.0,984,488,27.6,2017,0.0
Jeremy Major,1236,494,1074,429,373,219,3809.0,431,159,248.0,643,270,20.4,2017,0.0
Chris Reyes,601,88,452,233,220,130,1734.0,15,5,86.0,437,228,19.3,2017,0.0
Nolan Taylor,547,52,437,211,186,121,1313.0,25,4,56.0,412,207,22.7,2017,0.0
Elijah Lee,148,90,125,45,58,40,736.0,44,18,71.0,81,27,15.4,2017,0.0
Knox Hellums,390,50,328,129,66,48,1380.0,215,84,54.0,113,45,14.8,2017,0.0
Craig LeCesne,337,96,332,127,82,68,1105.0,72,15,101.0,260,112,21.0,2017,0.0
Nate Gehring,84,11,62,36,26,12,397.0,0,0,24.0,62,36,12.6,2017,0.0
Jonathan Allen,68,20,59,24,17,8,528.0,32,12,24.0,27,12,8.7,2017,0.0
Amadi Udenyi,544,426,541,175,190,118,2563.0,262,76,188.0,279,99,16.6,2017,0.0
Ryan Keenan,34,3,25,15,12,4,226.0,0,0,12.0,25,15,9.5,2017,0.0
Kevin Hempy,18,9,17,7,11,4,226.0,6,0,3.0,11,7,5.7,2017,0.0
Kaijae Yee-Stephens,29,6,33,12,3,1,125.0,16,4,1.0,17,8,14.5,2017,0.0
Michael Young,1835,243,1313,642,644,490,3924.0,180,61,221.0,1133,581,24.7,2017,1.0
Jamel Artis,1696,304,1231,579,485,368,3726.0,450,170,252.0,781,409,24.2,2017,1.0
Sheldon Jeter,856,105,674,320,207,148,2586.0,190,68,119.0,484,252,18.3,2017,0.0
Chris Jones,792,193,635,280,231,154,2809.0,245,78,123.0,390,202,16.3,2017,0.0
Ryan Luther,720,103,551,270,145,101,2133.0,202,79,123.0,349,191,18.1,2017,0.0
Jonathan Milligan,233,65,195,74,73,56,828.0,103,29,55.0,92,45,18.5,2017,0.0
Justice Kithcart,197,68,179,68,48,22,818.0,110,39,35.0,69,29,15.0,2017,0.0
Rozelle Nix,57,5,55,24,15,9,246.0,0,0,25.0,55,24,18.0,2017,0.0
Damon Wilson,662,173,532,221,209,143,2069.0,214,77,147.0,318,144,18.3,2017,0.0
Corey Manigault,705,47,491,251,270,194,1403.0,35,9,112.0,456,242,24.9,2017,0.0
Ryan Seelye,6,0,6,3,0,0,16.0,1,0,0.0,5,3,19.1,2017,0.0
De'Sean Parsons,648,119,496,243,255,142,1419.0,77,20,117.0,419,223,24.4,2017,0.0
Deontae North,911,115,697,304,288,205,1706.0,299,98,121.0,398,206,26.1,2017,0.0
Calaen Robinson,740,248,616,248,142,113,2088.0,383,131,147.0,233,117,18.9,2017,0.0
Traylin Farris,753,48,534,303,252,145,1702.0,9,2,69.0,525,301,20.4,2017,0.0
Bryce Canda,776,148,668,281,115,82,2068.0,379,132,92.0,289,149,17.8,2017,0.0
Zach Gengler,710,203,559,261,124,103,2235.0,235,85,96.0,324,176,15.6,2017,0.0
Brandon Hollins,475,33,337,193,150,84,1187.0,34,5,61.0,303,188,17.9,2017,0.0
Khari Holloway,179,44,138,54,55,48,577.0,65,23,31.0,73,31,16.0,2017,0.0
Braxton Tucker,434,28,358,177,104,76,974.0,18,4,46.0,340,173,23.0,2017,0.0
Montie Leunen,50,17,40,14,24,19,279.0,19,3,8.0,21,11,10.1,2017,0.0
Brendan Rumel,183,5,127,72,50,39,444.0,1,0,30.0,126,72,18.6,2017,0.0
Michael Mayhew,442,72,379,142,68,53,1126.0,290,105,67.0,89,37,19.0,2017,0.0
Tyrell Henderson,7,3,13,3,0,0,36.0,3,1,2.0,10,2,19.6,2017,0.0
Daniel Davydov,6,0,3,2,2,2,9.0,0,0,0.0,3,2,20.9,2017,0.0
Jazz Johnson,1563,221,1185,518,333,271,3608.0,609,256,203.0,576,262,21.6,2017,0.0
Gabe Taylor,713,47,588,271,187,137,2090.0,114,34,87.0,474,237,18.7,2017,0.0
Alec Wintering,1548,568,1104,471,631,499,3492.0,267,107,324.0,837,364,25.1,2017,0.0
D'Marques Tyson,1016,71,794,337,106,87,2327.0,605,255,96.0,189,82,20.7,2017,0.0
Rashad Jackson,268,33,254,82,106,78,898.0,92,26,50.0,162,56,20.5,2017,0.0
Jarrel Marshall,359,46,336,129,96,75,939.0,91,26,49.0,245,103,22.5,2017,0.0
Ray Barreno,195,18,150,76,64,43,839.0,0,0,76.0,150,76,15.2,2017,0.0
Xavier Hallinan,98,23,84,34,26,18,305.0,28,12,30.0,56,22,21.7,2017,0.0
Chier Maker,621,61,551,225,105,74,2041.0,294,97,92.0,257,128,17.6,2017,0.0
Philipp Hartwich,291,57,197,117,160,57,1808.0,0,0,113.0,197,117,11.2,2017,0.0
Joseph Smoyer,157,27,112,56,73,44,678.0,5,1,35.0,107,55,14.0,2017,0.0
Andre Ferguson,47,23,46,13,25,15,262.0,17,6,23.0,29,7,16.3,2017,0.0
Alec Monson,8,2,9,3,0,0,24.0,5,2,0.0,4,1,19.8,2017,0.0
Zachary Hamilton,1396,114,1195,474,324,257,3149.0,522,191,159.0,673,283,23.7,2017,0.0
Tevin Bellinger,720,131,668,254,176,141,1729.0,262,71,151.0,406,183,26.4,2017,0.0
Troy Thompson,508,43,400,164,103,75,1167.0,275,105,71.0,125,59,22.1,2017,0.0
Ja'Donta Blakley,290,168,262,113,100,57,1335.0,23,7,105.0,239,106,15.8,2017,0.0
Daquan Cook,237,54,246,80,59,42,785.0,116,35,49.0,130,45,21.0,2017,0.0
Shay'rone Jett,204,16,154,78,57,37,675.0,42,11,21.0,112,67,15.0,2017,0.0
James Westbrook,118,22,92,37,47,34,388.0,33,10,39.0,59,27,20.3,2017,0.0
Jordan Giddings,210,27,178,68,87,64,678.0,38,10,38.0,140,58,19.1,2017,0.0
Shaq Preston,255,42,230,95,88,53,884.0,47,12,62.0,183,83,18.6,2017,0.0
Avery Lomax,183,109,188,54,101,72,1163.0,40,3,82.0,148,51,13.7,2017,0.0
JD Wallace,327,15,197,131,116,65,1438.0,3,0,42.0,194,131,9.9,2017,0.0
Admassu Williams,363,21,268,134,150,95,905.0,0,0,96.0,268,134,24.0,2017,0.0
Yusef Yakubu,20,2,14,9,7,2,189.0,1,0,11.0,13,9,7.7,2017,0.0
Nolan Wilson,37,11,32,12,31,13,528.0,0,0,18.0,32,12,6.1,2017,0.0
Lavonne Davis,24,1,16,8,13,8,157.0,0,0,10.0,16,8,10.4,2017,0.0
Jordan Lumpkins,10,0,13,5,1,0,113.0,0,0,8.0,13,5,8.9,2017,0.0
Evans Ganapamo,117,9,126,40,28,15,336.0,74,22,29.0,52,18,23.9,2017,0.0
Jacoby Green,124,33,120,42,24,15,509.0,74,25,35.0,46,17,16.1,2017,0.0
Malik Amos,35,1,44,11,5,4,86.0,34,9,4.0,10,2,29.2,2017,0.0
Reggie Dillard,1419,344,1211,500,341,231,3969.0,536,188,324.0,675,312,22.7,2017,0.0
Ed Drew,721,49,622,272,241,174,2490.0,26,3,131.0,596,269,18.4,2017,0.0
Jo'Vontae Millner-Criss,547,50,470,209,111,73,1524.0,181,56,120.0,289,153,21.5,2017,0.0
Darius Moore,305,132,303,106,47,29,1167.0,164,64,106.0,139,42,19.1,2017,0.0
Will Adams,341,58,337,118,38,30,1344.0,222,75,45.0,115,43,15.5,2017,0.0
JC Younger,1042,95,874,347,143,112,3029.0,600,236,136.0,274,111,18.8,2017,0.0
Ruben Arroyo-Felix,478,40,450,195,93,50,1617.0,138,38,86.0,312,157,19.0,2017,0.0
Austin Venable,197,9,169,87,37,23,691.0,0,0,51.0,169,87,17.6,2017,0.0
Jaron Withers,278,113,286,95,126,71,1872.0,80,17,116.0,206,78,13.0,2017,0.0
Armel TeTe,240,15,199,92,112,56,1220.0,1,0,77.0,198,92,14.3,2017,0.0
Davon Bell,965,538,761,315,372,283,3370.0,188,52,230.0,573,263,18.3,2017,0.0
Brent Carraway,5,0,8,2,1,0,17.0,3,1,1.0,5,1,29.6,2017,0.0
Stephen Osu,21,2,21,8,14,5,82.0,0,0,6.0,21,8,21.6,2017,0.0
Myles McGregor,1,0,1,0,2,1,2.0,0,0,0.0,1,0,51.3,2017,0.0
Charlie Inclan,5,2,12,2,2,1,15.0,3,0,2.0,9,2,52.6,2017,0.0
Steven Cook,1148,159,858,400,271,192,2913.0,394,156,149.0,464,244,21.0,2017,0.0
Devin Cannady,1515,169,1091,481,318,285,3235.0,665,268,140.0,426,213,22.5,2017,0.0
Myles Stephens,1345,116,1051,509,322,222,3152.0,302,105,190.0,749,404,23.3,2017,0.0
Spencer Weisz,1241,383,979,422,255,188,3723.0,555,209,194.0,424,213,18.8,2017,0.0
Amir Bell,1043,313,800,366,323,212,3367.0,281,99,172.0,519,267,18.0,2017,0.0
Pete Miller,526,136,428,224,166,77,1911.0,1,1,126.0,427,223,17.8,2017,0.0
Henry Caruso,1069,128,705,355,350,276,2535.0,209,83,143.0,496,272,21.3,2017,0.0
Will Gladson,144,30,137,55,25,16,511.0,58,18,25.0,79,37,18.4,2017,0.0
Alec Brennan,228,39,173,86,51,28,832.0,65,28,43.0,108,58,15.4,2017,0.0
Aaron Young,224,44,169,69,32,28,763.0,145,58,22.0,24,11,14.6,2017,0.0
Richmond Aririguzoh,755,117,451,287,269,181,1815.0,2,0,168.0,449,287,21.5,2017,0.0
Jose Morales,261,103,224,88,73,58,1022.0,77,27,74.0,147,61,16.9,2017,0.0
Mike LeBlanc,83,22,90,27,13,10,414.0,69,19,16.0,21,8,14.5,2017,0.0
Vittorio Reynoso-Avila,37,8,26,14,12,7,133.0,3,2,7.0,23,12,15.4,2017,0.0
Noah Bramlage,66,25,65,22,27,15,246.0,23,7,20.0,42,15,20.5,2017,0.0
Jackson Forbes,46,12,46,16,5,4,148.0,38,10,9.0,8,6,19.9,2017,0.0
Alexander Lee,6,0,7,3,0,0,15.0,0,0,0.0,7,3,25.4,2017,0.0
Khyan Rayner,58,10,51,16,28,16,236.0,31,10,11.0,20,6,16.8,2017,0.0
Elias Berbari,3,1,11,1,2,0,43.0,10,1,0.0,1,0,14.6,2017,0.0
Rodney Bullock,1404,120,1110,486,414,305,3351.0,387,127,210.0,723,359,23.0,2017,0.0
Emmitt Holt,641,54,450,235,211,138,1659.0,95,33,73.0,355,202,19.2,2017,0.0
Kyron Cartwright,1100,646,959,389,315,229,3638.0,269,93,278.0,690,296,19.4,2017,0.0
Jalen Lindsey,993,80,785,321,185,134,3559.0,585,217,76.0,200,104,13.6,2017,0.0
Alpha Diallo,1591,295,1281,550,580,397,3906.0,323,94,284.0,958,456,23.4,2017,0.0
Isaiah Jackson,1041,199,827,321,363,279,2966.0,341,120,176.0,486,201,20.1,2017,0.0
Kalif Young,536,84,428,220,193,93,2154.0,9,3,95.0,419,217,14.3,2017,0.0
Ryan Fazekas,657,48,520,222,85,62,1944.0,364,151,41.0,156,71,15.9,2017,0.0
Maliek White,657,214,609,230,154,105,2222.0,295,92,153.0,314,138,18.6,2017,0.0
Drew Edwards,551,103,464,169,184,141,2018.0,224,72,95.0,240,97,16.8,2017,0.0
Ricky Council II,303,29,283,94,56,45,932.0,223,70,35.0,60,24,19.6,2017,0.0
Casey Woodring,11,0,21,4,0,0,40.0,16,3,0.0,5,1,27.0,2017,0.0
Tom Planek,17,1,15,6,13,5,78.0,0,0,8.0,15,6,19.4,2017,0.0
Caleb Swanigan,994,168,703,352,304,231,2014.0,157,59,208.0,546,293,26.3,2017,1.0
Isaac Haas,1555,71,953,561,628,433,2496.0,0,0,229.0,953,561,30.3,2017,0.0
Vince Edwards,1638,403,1244,589,350,287,3957.0,441,173,237.0,803,416,21.3,2017,0.0
Carsen Edwards,1920,270,1538,634,454,371,3180.0,763,281,241.0,775,353,32.2,2017,1.0
Dakota Mathias,1140,408,887,385,149,120,3604.0,597,250,153.0,290,135,15.8,2017,0.0
P.J. Thompson,805,294,567,248,185,148,3229.0,399,161,100.0,168,87,11.9,2017,0.0
Ryan Cline,882,279,736,300,63,44,2997.0,585,238,94.0,151,62,14.7,2017,0.0
Basil Smotherman,321,67,249,134,77,44,1259.0,46,9,46.0,203,125,13.2,2017,0.0
Spike Albrecht,499,271,398,159,111,96,2277.0,224,85,82.0,174,74,13.1,2017,0.0
Grady Eifert,276,78,172,95,77,49,1293.0,86,37,29.0,86,58,9.5,2017,0.0
Jon McKeeman,10,0,11,4,2,0,50.0,4,2,3.0,7,2,15.0,2017,0.0
Tommy Luce,26,19,32,8,15,7,108.0,9,3,16.0,23,5,26.3,2017,0.0
Mikey Dixon,997,146,785,337,253,201,2237.0,334,122,117.0,451,215,22.1,2017,0.0
Peter Kiss,958,185,807,348,212,161,2207.0,314,101,178.0,493,247,22.7,2017,0.0
Chaise Daniels,1048,84,867,417,344,214,2537.0,3,0,214.0,864,417,23.4,2017,0.0
Reggie Oliver,221,65,220,72,52,37,630.0,124,40,62.0,96,32,22.0,2017,0.0
Daniel Harris,504,106,453,175,60,43,1518.0,299,111,72.0,154,64,16.8,2017,0.0
Abdulai Bundu,720,45,511,268,305,184,2570.0,2,0,141.0,509,268,15.0,2017,0.0
Donovan Smith,363,33,342,143,91,66,946.0,27,11,67.0,315,132,22.0,2017,0.0
Phil Winston,134,96,99,39,75,49,488.0,26,7,47.0,73,32,16.8,2017,0.0
Andrew Robinson,629,35,597,208,72,54,1841.0,487,159,61.0,110,49,18.1,2017,0.0
Alain Chigha,150,21,141,55,53,26,914.0,53,14,38.0,88,41,10.8,2017,0.0
Aaron Robinson,380,66,406,135,31,8,1846.0,340,102,57.0,66,33,12.8,2017,0.0
Ja'Kwan Jones,17,1,17,5,14,7,104.0,1,0,5.0,16,5,12.4,2017,0.0
Greg Tarca,10,0,14,5,4,0,22.0,3,0,3.0,11,5,41.7,2017,0.0
Cameron Young,1350,149,908,409,479,364,2245.0,452,168,182.0,456,241,30.3,2017,0.0
Ed Polite Jr.,1558,189,1119,563,562,379,4031.0,184,53,241.0,935,510,21.0,2017,0.0
Justin Cousin,624,111,589,211,91,62,1950.0,408,140,108.0,181,71,19.5,2017,0.0
Caleb Tanner,841,78,662,269,98,83,1961.0,532,220,69.0,130,49,20.7,2017,0.0
Donald Hicks,1033,163,962,351,143,106,3578.0,594,225,162.0,368,126,17.5,2017,0.0
Christian Bradford,398,180,398,142,79,60,1738.0,182,54,100.0,216,88,16.1,2017,0.0
Darius Bolstad,269,25,181,115,61,39,763.0,0,0,49.0,181,115,17.3,2017,0.0
Randy Phillips,393,37,300,154,159,85,1403.0,0,0,127.0,300,154,18.9,2017,0.0
Christian Lutete,1431,124,1028,507,349,243,2841.0,478,174,183.0,550,333,24.2,2017,0.0
Devonnte Holland,652,53,499,271,180,110,2052.0,3,0,147.0,496,271,18.8,2017,0.0
Sterling Christy,73,31,84,27,27,15,460.0,22,4,35.0,62,23,14.6,2017,0.0
Devin Cooper,47,10,44,15,14,12,149.0,17,5,15.0,27,10,22.6,2017,0.0
Brian Rodriguez,3,1,5,1,0,0,12.0,3,1,0.0,2,0,21.5,2017,0.0
E.C. Matthews,1899,213,1503,632,564,413,3931.0,668,222,303.0,835,410,26.8,2017,0.0
Jared Terrell,1754,281,1442,586,511,390,4232.0,526,192,233.0,916,394,23.2,2017,1.0
Hassan Martin,1300,71,894,518,427,261,3284.0,24,3,164.0,870,515,19.8,2017,0.0
Kuran Iverson,693,126,565,267,212,116,1935.0,136,43,154.0,429,224,21.7,2017,0.0
Stanford Robinson,817,189,692,299,286,172,2457.0,157,47,161.0,535,252,20.1,2017,0.0
Jeff Dowtin,1410,473,1160,519,344,246,4067.0,349,126,160.0,811,393,18.0,2017,0.0
Jarvis Garrett,941,398,801,314,285,198,3210.0,326,115,192.0,475,199,18.1,2017,0.0
Cyril Langevine,1082,101,753,404,507,273,2998.0,4,1,222.0,749,403,20.1,2017,0.0
Nicola Akele,250,47,208,98,47,27,1125.0,69,27,29.0,139,71,11.8,2017,0.0
Christion Thompson,790,172,628,246,318,216,2665.0,297,82,113.0,331,164,17.2,2017,0.0
Andre Berry,375,14,259,158,84,59,773.0,0,0,56.0,259,158,23.0,2017,0.0
Eric Dadika,13,1,13,5,1,0,52.0,8,3,6.0,5,2,18.6,2017,0.0
Mike Layssard,21,2,22,10,2,1,60.0,1,0,4.0,21,10,22.5,2017,0.0
Will Leviton,7,2,11,3,0,0,39.0,2,1,2.0,9,2,16.8,2017,0.0
Marcus Evans,2045,397,1442,625,747,583,3658.0,636,212,384.0,806,413,29.4,2017,0.0
Connor Cashaw,1085,224,907,384,267,178,3253.0,387,139,172.0,520,245,18.2,2017,0.0
Marquez Letcher-Ellis,597,39,397,196,273,178,1357.0,96,27,135.0,301,169,23.7,2017,0.0
Chad Lott,1032,159,805,419,276,176,2550.0,43,18,185.0,762,401,21.5,2017,0.0
Ako Adams,1129,299,908,338,261,225,3082.0,624,228,237.0,284,110,20.3,2017,0.0
Austin Meyer,183,9,113,76,54,31,614.0,0,0,42.0,113,76,14.3,2017,0.0
Andrew Drone,636,37,425,255,205,126,1891.0,0,0,120.0,425,255,17.9,2017,0.0
Corey Douglas,361,39,281,151,92,55,1422.0,14,4,63.0,267,147,13.8,2017,0.0
Tim Harrison,162,15,150,63,34,22,588.0,65,14,45.0,85,49,17.8,2017,0.0
Bishop Mency,626,92,590,207,124,72,2733.0,452,140,115.0,138,67,14.6,2017,0.0
Robert Martin,904,137,654,290,323,222,2241.0,280,102,154.0,374,188,21.2,2017,0.0
Addison Owen,9,2,8,3,2,1,32.0,6,2,3.0,2,1,18.3,2017,0.0
Harrison Brown,4,0,4,2,0,0,6.0,0,0,0.0,4,2,32.8,2017,0.0
Grant Youngkin,0,0,12,0,0,0,18.0,2,0,0.0,10,0,33.2,2017,0.0
T.J. Cline,1909,398,1397,730,408,267,3575.0,519,182,250.0,878,548,27.4,2017,0.0
ShawnDre' Jones,1608,364,1236,539,374,303,3750.0,588,227,187.0,648,312,23.0,2017,0.0
Khwan Fore,1030,252,822,393,314,195,3434.0,154,49,165.0,668,344,17.3,2017,0.0
De'Monte Buckingham,1194,271,963,406,321,249,3314.0,415,133,223.0,548,273,20.9,2017,0.0
Nick Sherod,1192,143,939,438,162,129,2870.0,475,187,93.0,464,251,20.3,2017,0.0
Julius Johnson,428,94,381,146,67,54,2017.0,259,82,60.0,122,64,12.4,2017,0.0
Marshall Wood,565,42,489,188,124,77,1937.0,321,112,95.0,168,76,17.3,2017,0.0
Joe Kirby,56,16,66,23,1,0,306.0,42,10,12.0,24,13,13.5,2017,0.0
Grant Golden,1739,367,1385,710,406,266,3411.0,176,53,274.0,1209,657,28.9,2017,0.0
Kwesi Abakah,100,28,83,35,70,30,824.0,0,0,33.0,83,35,9.7,2017,0.0
Paul Friendshuh,25,4,18,9,12,6,130.0,2,1,15.0,16,8,15.6,2017,0.0
Chase Fletcher,0,0,0,0,0,0,3.0,0,0,0.0,0,0,0.0,2017,0.0
Keith Oddo,15,2,7,4,7,5,53.0,3,2,1.0,4,2,11.3,2017,0.0
Jesse Pistokache,29,6,29,11,6,1,109.0,19,6,6.0,10,5,18.1,2017,0.0
Jimmie Taylor,1539,201,1223,517,412,290,4076.0,548,215,198.0,675,302,20.0,2017,0.0
Kahlil Thomas,1141,107,851,448,377,233,2889.0,39,12,194.0,812,436,21.2,2017,0.0
Norville Carey,869,51,668,340,288,183,2076.0,23,6,161.0,645,334,23.4,2017,0.0
Xavier Lundy,883,90,737,334,169,123,2356.0,282,92,141.0,455,242,20.4,2017,0.0
Stevie Jordan,1444,597,1165,502,479,322,3868.0,371,118,387.0,794,384,21.5,2017,0.0
Kealen Washington-Ives,246,149,221,79,74,52,1099.0,116,36,81.0,105,43,14.1,2017,0.0
Anthony Durham,675,187,534,235,180,138,2314.0,193,67,104.0,341,168,14.6,2017,0.0
Tyere Marshall,1152,109,892,468,383,216,2545.0,2,0,152.0,890,468,22.5,2017,0.0
Dimencio Vaughn,1266,132,938,441,413,289,2679.0,276,95,215.0,662,346,23.6,2017,0.0
Xzavier Malone,671,111,540,245,158,103,1770.0,225,78,110.0,315,167,20.9,2017,0.0
Isaiah Still,872,120,714,266,373,240,2210.0,327,100,145.0,387,166,23.5,2017,0.0
Kavon Stewart,995,503,815,291,584,376,3458.0,143,37,364.0,672,254,21.4,2017,0.0
Dachon Burke,1168,141,1026,442,303,192,2612.0,286,92,187.0,740,350,25.4,2017,0.0
Matty McConnell,1156,304,1064,375,278,204,3790.0,655,202,170.0,409,173,17.9,2017,0.0
Aaron Tate,457,50,371,190,138,77,2403.0,0,0,100.0,371,190,11.4,2017,0.0
Clive Allen,187,58,173,64,56,40,578.0,63,19,63.0,110,45,22.5,2017,0.0
Braden Burke,150,6,156,66,46,18,541.0,0,0,33.0,156,66,19.3,2017,0.0
Billy Giles,396,17,286,171,110,54,1173.0,4,0,52.0,282,171,16.8,2017,0.0
Lorenzen Wright Jr.,131,8,124,42,16,10,443.0,106,37,23.0,18,5,17.4,2017,0.0
Roberto Mantovani,38,9,35,13,22,12,286.0,0,0,17.0,35,13,10.8,2017,0.0
Jordan Lester,31,19,39,13,4,3,266.0,14,2,18.0,25,11,11.2,2017,0.0
Conrad Stephens,38,5,32,16,9,6,221.0,1,0,14.0,31,16,11.5,2017,0.0
Seth Rouse,12,0,9,4,2,2,37.0,2,2,0.0,7,2,13.1,2017,0.0
Corey Sanders,1370,328,1307,524,352,238,3035.0,307,84,249.0,1000,440,28.1,2017,0.0
DeShawn Freeman,832,67,689,310,301,201,1945.0,50,11,141.0,639,299,24.8,2017,0.0
Nigel Johnson,802,217,715,273,237,160,2336.0,292,96,127.0,423,177,21.3,2017,0.0
Mike Williams,1093,130,1008,376,269,208,2958.0,467,133,132.0,541,243,21.4,2017,1.0
C.J. Gettys,551,64,432,222,165,107,1648.0,0,0,90.0,432,222,18.0,2017,0.0
Issa Thiam,452,46,433,162,50,33,1980.0,283,95,69.0,150,67,13.2,2017,0.0
Candido Sa,165,12,156,64,69,31,825.0,24,6,48.0,132,58,14.2,2017,0.0
Jonathan Laurent,749,93,545,261,219,169,2254.0,164,58,162.0,381,203,18.0,2017,0.0
Eugene Omoruyi,1197,196,973,441,386,260,2762.0,170,55,213.0,803,386,25.3,2017,0.0
Shaquille Doorson,254,30,188,109,103,36,1482.0,0,0,58.0,188,109,10.0,2017,0.0
Khalil Batie,27,9,35,10,3,0,127.0,19,7,4.0,16,3,16.2,2017,0.0
Jake Dadika,27,17,34,9,14,6,277.0,17,3,14.0,17,6,9.9,2017,0.0
Matt Bullock,22,2,24,9,10,4,76.0,7,0,5.0,17,9,22.3,2017,0.0
Joey Downes,11,1,8,3,2,2,35.0,6,3,1.0,2,0,14.3,2017,0.0
Aaren Smith,0,1,1,0,2,0,15.0,0,0,2.0,1,0,13.1,2017,0.0
Justin Strings,1570,144,1313,584,399,257,3260.0,415,145,152.0,898,439,26.4,2017,0.0
Marcus Graves,1354,472,1130,478,417,307,3301.0,307,91,247.0,823,387,24.4,2017,0.0
Eric Stuteville,1013,34,717,403,368,206,2595.0,4,1,150.0,713,402,21.3,2017,0.0
Nick Hornsby,914,180,743,340,299,204,2997.0,93,30,195.0,650,310,19.1,2017,0.0
Izayah Mauriohooho-Le'afa,941,302,893,329,128,96,3511.0,534,187,186.0,359,142,16.9,2017,0.0
Joshua Patton,1226,66,763,449,492,328,2823.0,2,0,177.0,761,449,21.6,2017,0.0
Trevis Jackson,113,76,81,33,44,32,792.0,52,15,37.0,29,18,9.1,2017,0.0
Grant Dressler,100,21,98,32,25,20,301.0,53,16,18.0,45,16,21.9,2017,0.0
Jiday Ugbaja,161,47,137,56,52,37,516.0,39,12,38.0,98,44,19.9,2017,0.0
Chibueze Jacobs,357,49,289,125,101,76,1382.0,80,31,68.0,209,94,15.2,2017,0.0
Jeff Wu,367,82,349,139,55,31,1282.0,184,58,69.0,165,81,17.9,2017,0.0
Matt Battaglia,29,5,33,9,3,2,96.0,28,9,0.0,5,0,18.6,2017,0.0
James Herrick,54,2,42,19,29,16,197.0,0,0,14.0,42,19,18.5,2017,0.0
Quincy McKnight,1588,458,1270,548,553,401,3797.0,295,91,377.0,975,457,24.4,2017,0.0
Joseph Lopez,857,58,686,362,246,131,1960.0,28,2,139.0,658,360,23.5,2017,0.0
Sean Hoehn,1366,364,1064,449,347,283,3603.0,518,185,296.0,546,264,20.3,2017,0.0
Matej Buovac,486,40,417,148,102,80,1508.0,325,110,51.0,92,38,16.5,2017,0.0
DeVon Barnett,1008,86,804,433,247,142,2546.0,6,0,160.0,798,433,20.8,2017,0.0
Charles Tucker Jr.,294,225,241,94,131,87,1521.0,75,19,150.0,166,75,14.4,2017,0.0
Chris Robinson,415,71,418,149,86,53,1630.0,216,64,71.0,202,85,15.7,2017,1.0
Mario Matasovic,554,59,414,212,133,97,1600.0,104,33,120.0,310,179,18.5,2017,0.0
Shawn Montague,42,4,31,16,21,8,161.0,4,2,11.0,27,14,15.5,2017,0.0
Cole Walton,98,22,93,38,43,22,677.0,1,0,32.0,92,38,10.5,2017,0.0
Zach Radz,324,52,305,114,78,57,1143.0,131,39,68.0,174,75,17.4,2017,0.0
Travis Berry,0,3,3,0,0,0,43.0,1,0,2.0,2,0,5.9,2017,0.0
Cavan LaRose,1,0,0,0,2,1,14.0,0,0,0.0,0,0,3.3,2017,0.0
Keith Braxton,2067,454,1507,722,606,480,4511.0,404,143,335.0,1103,579,23.2,2017,0.0
Isaiah Blackmon,1606,146,1217,553,370,282,3308.0,519,218,175.0,698,335,23.2,2017,0.0
Josh Nebo,1162,69,742,448,435,265,3120.0,3,1,191.0,739,447,18.4,2017,0.0
Jamaal King,1517,386,1211,526,389,301,3152.0,491,164,296.0,720,362,26.4,2017,0.0
Georgios Angelou,397,91,302,124,55,48,1271.0,251,101,79.0,51,23,16.0,2017,0.0
Randall Gaskins Jr.,722,176,580,278,173,115,3059.0,136,51,123.0,444,227,12.6,2017,0.0
Andre Wolford,866,46,623,279,145,120,1989.0,441,188,66.0,182,91,18.7,2017,0.0
Scott Meredith,323,44,287,106,41,36,1020.0,222,75,37.0,65,31,16.8,2017,0.0
Patrick Wrencher,122,12,96,51,30,20,513.0,0,0,33.0,96,51,14.4,2017,0.0
Deivydas Kuzavas,379,36,277,161,109,57,1437.0,2,0,53.0,275,161,13.1,2017,0.0
Ifeanyi Umezurike,136,6,121,53,57,30,619.0,0,0,56.0,121,53,16.9,2017,0.0
Deon Baker,31,3,28,14,3,3,70.0,0,0,6.0,28,14,25.3,2017,0.0
Michael Klebon,18,1,18,5,4,4,76.0,14,4,4.0,4,1,15.7,2017,0.0
Daniel Wallace,46,14,44,20,15,6,253.0,1,0,21.0,43,20,14.4,2017,0.0
Tre McKeithen,5,2,10,1,2,2,35.0,10,1,2.0,0,0,18.4,2017,0.0
Jordan Forehand,21,4,15,7,10,5,48.0,5,2,3.0,10,5,23.4,2017,0.0
Charlie Brown,1006,81,821,334,244,204,2199.0,362,134,95.0,459,200,24.0,2017,0.0
Lamarr Kimble,1114,349,985,374,328,239,3070.0,402,127,220.0,583,247,22.5,2017,0.0
James Demery,1295,115,1077,483,459,283,3191.0,189,46,176.0,888,437,23.2,2017,0.0
Shavar Newkirk,1193,333,964,372,466,349,2966.0,315,100,180.0,649,272,23.1,2017,0.0
Chris Clover,785,94,734,282,209,142,2422.0,266,79,96.0,468,203,19.4,2017,0.0
Nick Robinson,626,208,509,209,229,159,2302.0,168,49,148.0,341,160,16.7,2017,0.0
Brendan Casper,200,49,185,78,62,38,709.0,38,6,42.0,147,72,18.2,2017,0.0
Markell Lodge,213,7,129,93,62,27,953.0,0,0,19.0,129,93,9.3,2017,0.0
Javon Baumann,232,24,155,97,105,38,1191.0,0,0,55.0,155,97,11.3,2017,0.0
Jai Williams,112,2,68,42,45,28,446.0,0,0,25.0,68,42,12.9,2017,0.0
Gerald Blount,7,0,4,2,4,3,22.0,0,0,3.0,4,2,20.1,2017,0.0
Mike Booth,8,2,10,2,4,2,36.0,6,2,2.0,4,0,19.4,2017,0.0
Kyle Thompson,7,3,6,1,10,5,41.0,1,0,4.0,5,1,18.1,2017,0.0
Lorenzo Edwards,484,64,473,169,91,59,1775.0,306,87,61.0,167,82,16.5,2017,0.0
Toliver Freeman,181,18,135,67,39,26,519.0,60,21,31.0,75,46,17.5,2017,0.0
Christian Vega,0,1,5,0,0,0,11.0,1,0,2.0,4,0,31.7,2017,0.0
Davell Roby,1160,281,893,345,430,304,3536.0,455,166,224.0,438,179,19.9,2017,0.0
Mike Crawford,950,144,790,327,252,188,2680.0,334,108,136.0,456,219,20.9,2017,0.0
Reggie Agbeko,633,39,449,249,234,134,2150.0,1,1,164.0,448,248,18.1,2017,0.0
Elliott Welmer,262,25,203,90,78,49,813.0,89,33,39.0,114,57,18.6,2017,0.0
Jalen Johnson,1186,81,933,387,323,254,3200.0,454,158,162.0,479,229,19.8,2017,0.0
Aaron Hines,505,184,555,173,135,90,2082.0,243,69,123.0,312,104,18.9,2017,0.0
Zeke Moore,580,80,468,203,129,101,1627.0,195,73,89.0,273,130,19.5,2017,0.0
Jermaine Bishop,827,173,697,278,151,129,1887.0,378,142,137.0,319,136,24.3,2017,0.0
Matt Neufeld,518,21,383,205,168,108,1420.0,5,0,126.0,378,205,22.1,2017,0.0
Austin Gillmann,178,54,160,68,35,19,910.0,75,23,54.0,85,45,13.7,2017,0.0
Markos Psimitis,8,1,7,2,6,2,31.0,6,2,1.0,1,0,18.5,2017,0.0
Jock Landale,1658,153,1044,652,469,346,2776.0,29,8,204.0,1015,644,29.8,2017,0.0
Calvin Hermanson,1300,99,943,451,187,144,3329.0,598,254,98.0,345,197,19.1,2017,0.0
Emmett Naar,1343,815,998,460,320,271,4533.0,360,152,326.0,638,308,18.3,2017,0.0
Joe Rahon,1277,607,1086,454,285,194,4773.0,491,175,248.0,595,279,17.3,2017,0.0
Dane Pineau,782,111,544,335,165,92,2388.0,73,20,106.0,471,315,17.1,2017,0.0
Evan Fitzner,780,64,621,285,88,67,2256.0,359,143,76.0,262,142,18.2,2017,0.0
Tanner Krebs,1018,97,824,346,150,128,3427.0,508,198,102.0,316,148,16.1,2017,0.0
Kyle Clark,263,26,185,83,70,52,1019.0,126,45,43.0,59,38,14.5,2017,0.0
Stefan Gonzalez,729,81,528,244,78,58,1833.0,411,183,69.0,117,61,18.8,2017,0.0
Jordan Ford,1929,241,1419,696,397,320,3702.0,522,217,154.0,897,479,26.1,2017,0.0
Jordan Hunter,432,50,304,176,138,79,1221.0,1,1,69.0,303,175,19.7,2017,0.0
Dan Sheets,6,1,6,3,0,0,40.0,0,0,0.0,6,3,8.3,2017,0.0
Quadir Welton,1191,165,924,435,575,321,3482.0,0,0,246.0,924,435,22.6,2017,0.0
Trevis Wyche,1228,501,919,394,483,351,3871.0,252,89,237.0,667,305,19.5,2017,0.0
Nick Griffin,868,69,754,303,97,76,2302.0,476,186,87.0,278,117,21.0,2017,0.0
Antwon Portley,1304,275,1155,426,302,228,3681.0,663,224,225.0,492,202,22.2,2017,0.0
Cavon Baker,459,69,385,160,121,87,1147.0,150,52,95.0,235,108,25.3,2017,0.0
Samuel Idowu,956,49,740,372,186,135,2119.0,229,77,131.0,511,295,24.7,2017,0.0
Chazz Patterson,579,152,514,177,166,123,2898.0,323,102,151.0,191,75,13.9,2017,0.0
Nnamdi Enechionyia,508,84,461,168,98,70,2178.0,291,102,88.0,170,66,14.8,2017,0.0
Mamadou Ndiaye,210,14,171,77,84,48,636.0,22,8,40.0,149,69,21.5,2017,0.0
J.R. William,3,0,4,1,0,0,16.0,1,1,0.0,3,0,14.0,2017,0.0
Sean Barksdale,0,0,2,0,0,0,6.0,2,0,0.0,0,0,18.7,2017,0.0
Dakarai Henderson,1325,126,1206,449,281,189,2978.0,703,238,147.0,503,211,24.5,2017,0.0
Christopher Galbreath Jr.,875,62,751,358,207,140,1651.0,63,19,136.0,688,339,29.0,2017,0.0
John Dewey III,703,326,564,218,241,191,2035.0,214,76,217.0,350,142,21.3,2017,0.0
Aurimas Majauskas,1170,118,705,398,437,334,2122.0,110,40,150.0,595,358,24.6,2017,0.0
Paul Baxter,1103,362,905,377,339,228,3501.0,347,121,216.0,558,256,18.2,2017,0.0
Torry Butler,448,79,369,180,122,72,1345.0,66,16,66.0,303,164,17.7,2017,0.0
Jovante' Spivey,436,136,328,113,232,171,1331.0,139,39,81.0,189,74,19.0,2017,0.0
Albert Almanza,679,91,583,228,93,73,2280.0,402,150,64.0,181,78,14.9,2017,0.0
Jamal Williams,918,283,704,342,296,202,2893.0,90,32,204.0,614,310,17.8,2017,0.0
Josh Delaney,901,327,752,284,179,139,2607.0,525,194,149.0,227,90,18.7,2017,0.0
Cameron Delaney,749,127,587,243,168,133,2072.0,348,130,99.0,239,113,18.7,2017,0.0
Jesse Lopez,72,9,57,27,21,15,236.0,9,3,9.0,48,24,15.8,2017,0.0
Demetrius Dyson,1183,91,870,393,294,212,2487.0,450,185,161.0,420,208,23.6,2017,0.0
Wyatt Walker,969,107,629,365,323,235,2375.0,15,4,160.0,614,361,19.7,2017,0.0
Alex Thompson,852,59,709,300,173,128,2090.0,357,124,87.0,352,176,21.2,2017,0.0
Christen Cunningham,1617,674,1236,546,545,440,4621.0,279,85,326.0,957,461,20.0,2017,0.0
Josh Sharkey,1592,756,1119,490,701,526,3732.0,286,86,535.0,833,404,26.1,2017,0.0
Triston Chambers,640,76,502,212,71,53,1833.0,390,163,85.0,112,49,16.8,2017,0.0
Justin Hopkins,938,105,637,298,397,296,2818.0,146,46,176.0,491,252,16.6,2017,0.0
Alex Peters,238,17,167,96,80,46,1132.0,0,0,62.0,167,96,11.9,2017,0.0
Terry Brutus,116,16,97,44,46,28,606.0,5,0,35.0,92,44,12.6,2017,0.0
Eric Adams,443,33,267,167,157,109,1211.0,1,0,79.0,266,167,17.4,2017,0.0
Gerald Smith,25,10,34,9,7,4,239.0,14,3,6.0,20,6,9.2,2017,0.0
James Boone,7,5,8,2,4,2,43.0,5,1,3.0,3,1,15.2,2017,0.0
Tanner Tapp,9,4,20,4,4,0,54.0,11,1,6.0,9,3,25.9,2017,0.0
Trey Kell,1403,320,1212,461,468,331,3640.0,485,150,206.0,727,311,23.1,2017,0.0
Jeremy Hemsley,1392,286,1135,483,406,273,3632.0,443,153,260.0,692,330,22.2,2017,0.0
Zylan Cheatham,994,187,627,331,460,316,2618.0,54,16,235.0,573,315,20.5,2017,1.0
Dakarai Allen,676,116,529,235,256,165,2476.0,155,41,128.0,374,194,16.3,2017,0.0
Malik Pope,1111,122,910,421,260,177,2732.0,241,92,159.0,669,329,22.2,2017,0.0
Max Hoetzel,474,42,395,151,91,69,1222.0,292,103,57.0,103,48,20.4,2017,0.0
Matt Shrigley,536,79,527,179,59,40,2003.0,420,138,65.0,107,41,16.3,2017,0.0
Montaque Gill-Caesar,362,24,357,122,108,80,1045.0,143,38,84.0,214,84,25.0,2017,0.0
Valentine Izundu,202,13,130,84,84,34,1034.0,0,0,39.0,130,84,10.3,2017,0.0
D'Erryl Williams,101,52,91,38,36,19,717.0,16,6,39.0,75,32,10.7,2017,0.0
Nolan Narain,237,28,176,99,55,29,789.0,32,10,55.0,144,89,16.4,2017,0.0
Emmanuel Wilson,1,0,4,0,2,1,18.0,3,0,4.0,1,0,25.5,2017,0.0
Brett Bailey,876,114,751,306,307,204,2593.0,210,60,145.0,541,246,21.8,2017,0.0
Olin Carter III,1558,212,1338,537,234,180,4061.0,843,304,168.0,495,233,21.3,2017,0.0
Cameron Neubauer,710,145,546,225,198,139,2380.0,348,121,137.0,198,104,17.7,2017,0.0
Juwan Gray,629,71,495,219,181,127,2196.0,190,64,89.0,305,155,16.3,2017,0.0
Tyler Williams,839,283,695,268,201,156,3792.0,395,147,184.0,300,121,13.8,2017,0.0
Frank Ryder,191,21,137,74,62,43,559.0,0,0,29.0,137,74,18.6,2017,0.0
Nassir Barrino,94,37,99,38,42,18,536.0,6,0,33.0,93,38,15.6,2017,0.0
Mark Carbone,529,129,423,160,98,88,1805.0,316,121,106.0,107,39,16.4,2017,0.0
Mitch Schafer,3,2,3,1,2,1,23.0,2,0,0.0,1,1,9.3,2017,0.0
Nick Busch,0,0,0,0,0,0,2.0,0,0,0.0,0,0,0.0,2017,0.0
Andy Nelson,0,1,0,0,1,0,8.0,0,0,0.0,0,0,3.2,2017,0.0
Ronnie Boyce III,758,89,658,281,162,118,1206.0,257,78,102.0,401,203,34.4,2017,0.0
Chase Foster,850,125,692,289,181,136,2243.0,368,136,117.0,324,153,20.3,2017,0.0
Charles Minlend,1277,151,1090,452,355,230,2674.0,449,143,150.0,641,309,26.7,2017,0.0
Jordan Ratinho,1271,153,1067,447,199,126,3852.0,669,251,119.0,398,196,16.9,2017,0.0
Matthew McCarthy,866,110,695,365,214,121,2537.0,77,15,176.0,618,350,19.5,2017,0.0
Nate Renfro,744,188,609,292,266,114,2877.0,181,46,180.0,428,246,16.2,2017,0.0
Remu Raitanen,536,87,434,172,124,92,1947.0,299,100,57.0,135,72,14.4,2017,0.0
Frankie Ferrari,1053,410,877,358,202,165,2723.0,447,172,166.0,430,186,21.5,2017,0.0
Mladen Djordjevic,171,95,160,63,43,18,941.0,81,27,62.0,79,36,13.0,2017,0.0
Jimbo Lull,916,82,639,370,222,162,2292.0,57,14,148.0,582,356,19.8,2017,0.0
Marquill Smith,84,8,67,25,22,17,174.0,49,17,10.0,18,8,25.0,2017,0.0
Chance Anderson,74,9,58,32,20,10,315.0,5,0,21.0,53,32,14.2,2017,0.0
Nick Loew,16,3,14,6,7,4,88.0,0,0,3.0,14,6,12.0,2017,0.0
Garrett Turner,0,0,0,0,0,0,4.0,0,0,0.0,0,0,0.0,2017,0.0
Brandon Clarke,1419,185,916,585,393,243,2725.0,24,6,144.0,892,579,22.5,2017,1.0
Ryan Welage,1494,137,1232,539,249,195,3334.0,560,221,152.0,672,318,22.6,2017,0.0
Jalen James,675,274,639,226,188,143,2560.0,267,80,232.0,372,146,19.2,2017,0.0
Terrell Brown,764,121,581,221,255,194,2066.0,344,128,115.0,237,93,19.9,2017,0.0
Jaycee Hillsman,863,182,635,261,313,252,2650.0,284,89,223.0,351,172,19.2,2017,0.0
Gary Williams Jr.,355,60,310,114,129,107,740.0,90,20,68.0,220,94,29.2,2017,0.0
Isaac Thornton,589,250,520,185,239,166,2629.0,184,53,210.0,336,132,16.6,2017,0.0
Isaiah Nichols,292,120,283,98,113,62,1248.0,116,34,115.0,167,64,18.1,2017,0.0
Cody Schwartz,833,120,701,278,130,102,2488.0,485,175,101.0,216,103,16.6,2017,0.0
Brandon Mitchell,334,29,298,117,134,83,1452.0,65,17,84.0,233,100,16.1,2017,0.0
E.J. Boyce,82,13,66,26,8,7,272.0,59,23,10.0,7,3,14.5,2017,0.0
Ashtin Chastain,217,33,181,81,113,51,1036.0,19,4,70.0,162,77,14.8,2017,0.0
Ryan Singer,49,11,58,14,30,17,512.0,24,4,23.0,34,10,9.9,2017,0.0
Jared Brownridge,2313,322,1723,729,560,470,4519.0,956,385,208.0,767,344,26.7,2017,0.0
Nate Kratch,914,84,725,364,204,116,3111.0,183,70,119.0,542,294,16.8,2017,0.0
Matt Hauser,1054,340,958,377,172,123,3258.0,496,177,137.0,462,200,19.0,2017,0.0
KJ Feagin,1472,423,1236,532,236,198,3728.0,533,210,245.0,703,322,23.3,2017,0.0
Jarvis Pugh,392,88,332,151,104,58,1715.0,99,32,75.0,233,119,14.9,2017,0.0
Henrik Jadersten,426,36,383,159,50,38,1417.0,209,70,63.0,174,89,18.2,2017,0.0
Kai Healy,485,94,387,161,123,95,1951.0,182,68,90.0,205,93,15.1,2017,0.0
Emmanuel Ndumanya,393,35,283,143,198,106,2028.0,1,1,128.0,282,142,13.8,2017,0.0
Evan Wardlow,85,45,80,31,24,17,612.0,18,6,29.0,62,25,11.0,2017,0.0
Tony Lewis,386,35,328,154,107,72,1061.0,30,6,106.0,298,148,23.7,2017,0.0
Akil Douglas,26,0,22,10,10,6,42.0,7,0,4.0,15,10,41.9,2017,0.0
Matt Hubbard,395,44,379,145,71,54,1368.0,183,51,79.0,196,94,19.9,2017,0.0
Will Burkett,4,0,5,0,5,4,14.0,4,0,1.0,1,0,34.3,2017,0.0
Johnny Sawyer,3,3,5,1,2,0,23.0,1,1,0.0,4,0,14.6,2017,0.0
Evan Crawford,2,1,2,0,2,2,12.0,0,0,2.0,2,0,23.6,2017,0.0
Troyce Manassa,886,160,673,289,292,222,1746.0,251,86,137.0,422,203,25.4,2017,0.0
Dexter McClanahan,1526,220,1230,513,389,274,3164.0,682,226,206.0,548,287,22.7,2017,0.0
Austin Dassent,556,128,458,181,153,95,1280.0,296,99,103.0,162,82,20.6,2017,0.0
R.J. Kelly,397,64,273,140,140,89,1494.0,90,28,78.0,183,112,13.0,2017,0.0
Casey Wells,299,25,278,91,44,33,718.0,254,84,31.0,24,7,20.6,2017,0.0
Joshua Floyd,217,75,190,73,62,38,614.0,101,33,50.0,89,40,18.4,2017,0.0
Zach Sellers,1077,409,893,373,238,180,3124.0,459,151,240.0,434,222,17.6,2017,0.0
Jahir Cabeza,344,67,312,122,76,45,1048.0,194,55,52.0,118,67,15.9,2017,0.0
Jordan Gaines,66,1,67,26,20,9,232.0,19,5,20.0,48,21,17.5,2017,0.0
Isaiah Felder,250,61,286,82,29,21,907.0,231,65,76.0,55,17,19.0,2017,0.0
Kamil Williams,185,18,179,55,50,33,436.0,147,42,26.0,32,13,25.7,2017,0.0
Maricus Glenn,93,16,72,37,39,19,568.0,4,0,36.0,68,37,9.3,2017,0.0
William Nash,4,0,2,2,2,0,8.0,0,0,0.0,2,2,15.5,2017,0.0
Marlon Daniel,1,1,6,0,3,1,30.0,5,0,4.0,1,0,16.0,2017,0.0
Brandon Jordan,20,2,13,7,11,6,144.0,0,0,7.0,13,7,9.1,2017,0.0
Brendan Westendorf,839,247,720,290,182,144,2005.0,317,115,190.0,403,175,25.6,2017,0.0
William Powell,952,257,654,327,471,298,3178.0,7,0,286.0,647,327,19.2,2017,0.0
Zack Moore,374,45,287,122,47,42,1002.0,227,88,41.0,60,34,18.1,2017,0.0
Matej Kavas,1096,84,824,372,201,152,2457.0,464,200,118.0,360,172,21.1,2017,0.0
Morgan Means,1289,335,1077,420,366,299,3737.0,469,150,263.0,608,270,20.2,2017,0.0
Emmanuel Chibuogwu,459,127,396,162,142,85,2125.0,164,50,112.0,232,112,14.0,2017,0.0
Aaron Menzies,752,45,537,305,241,142,1856.0,0,0,112.0,537,305,20.9,2017,0.0
Scott Ulaneo,211,47,160,71,110,58,810.0,44,11,58.0,116,60,17.0,2017,0.0
Jack Shaughnessy,120,41,100,33,64,45,609.0,48,9,39.0,52,24,14.3,2017,0.0
Malik Montoya,96,39,84,36,18,13,404.0,34,11,23.0,50,25,14.7,2017,0.0
Mattia Da Campo,360,82,240,116,132,92,1616.0,95,36,82.0,145,80,11.8,2017,0.0
Manroop Clair,378,55,340,118,61,46,1118.0,281,96,68.0,59,22,20.0,2017,0.0
Latio Cosmos,0,2,1,0,0,0,12.0,1,0,2.0,0,0,13.0,2017,0.0
Khadeen Carrington,1846,388,1478,612,564,433,4044.0,536,189,272.0,942,423,24.3,2017,0.0
Desi Rodriguez,1657,182,1286,609,448,300,3390.0,386,139,214.0,900,470,24.5,2017,0.0
Angel Delgado,1593,227,1196,644,566,305,4039.0,5,0,286.0,1191,644,21.1,2017,1.0
Myles Powell,2252,303,1750,736,531,432,3971.0,1006,348,279.0,744,388,28.1,2017,0.0
Madison Jones,564,359,456,199,264,150,2918.0,60,16,255.0,396,183,14.4,2017,0.0
Michael Nzei,700,63,454,278,236,144,2597.0,0,0,110.0,454,278,12.7,2017,0.0
Ismael Sanogo,432,96,332,163,173,94,2381.0,30,12,104.0,302,151,10.5,2017,0.0
Eron Gordon,442,93,351,146,128,85,1758.0,184,65,91.0,167,81,14.7,2017,0.0
Veer Singh,77,5,85,24,15,10,351.0,67,19,17.0,18,5,14.9,2017,0.0
Rashed Anthony,71,13,50,27,25,17,779.0,0,0,40.0,50,27,6.6,2017,0.0
Jevon Thomas,200,165,199,64,138,61,1233.0,43,11,107.0,156,53,16.0,2017,0.0
Dalton Soffer,18,1,21,6,0,0,55.0,21,6,1.0,0,0,19.3,2017,0.0
Manny Anderson,0,0,0,0,0,0,5.0,0,0,0.0,0,0,0.0,2017,0.0
Michael Dowdy,3,0,5,1,1,0,23.0,1,1,0.0,4,0,11.4,2017,0.0
Marquis Wright,1546,614,1295,544,496,359,4251.0,293,99,354.0,1002,445,21.6,2017,0.0
Javion Ogunyemi,1327,107,951,499,508,317,3313.0,43,12,185.0,908,487,20.1,2017,0.0
Brett Bisping,1528,151,1116,532,477,368,3750.0,274,96,235.0,842,436,20.4,2017,0.0
Lavon Long,1379,281,1016,479,533,394,3729.0,81,27,313.0,935,452,20.7,2017,0.0
Nico Clareth,976,132,852,352,184,131,1856.0,427,141,171.0,425,211,29.0,2017,0.0
Ahsante Shivers,780,139,640,250,280,202,2449.0,238,78,166.0,402,172,19.1,2017,0.0
Khailil Richard,378,64,314,141,65,53,1061.0,99,43,75.0,215,98,19.9,2017,0.0
Kadeem Smithen,390,109,274,114,154,123,1740.0,110,39,72.0,164,75,12.8,2017,0.0
Evan Fisher,840,80,719,329,179,127,2460.0,180,55,121.0,539,274,20.6,2017,0.0
Sammy Friday IV,455,16,321,174,182,107,1090.0,0,0,70.0,321,174,22.5,2017,0.0
Willem Brandwijk,84,12,68,29,31,17,446.0,21,9,24.0,47,20,12.0,2017,0.0
Thomas Huerter Jr.,95,39,82,35,23,14,679.0,37,11,37.0,45,24,10.0,2017,0.0
Jimmy Merrill,7,1,10,3,0,0,48.0,8,1,0.0,2,2,10.1,2017,0.0
Ken Williams,1725,343,1508,553,464,366,3847.0,778,253,269.0,730,300,25.9,2017,0.0
Josh Ajayi,1691,145,1147,603,586,426,3629.0,170,59,270.0,977,544,23.9,2017,0.0
Nick Stover,892,140,741,310,256,181,2568.0,286,91,163.0,455,219,19.7,2017,0.0
Don MuepoKelly,469,57,392,183,174,102,1376.0,7,1,83.0,385,182,20.0,2017,0.0
Shaq Calhoun,908,88,786,303,201,154,2153.0,445,148,132.0,341,155,23.0,2017,0.0
Georgi Boyanov,858,60,585,300,323,208,2226.0,143,50,130.0,442,250,19.3,2017,0.0
Herb McGee,895,294,699,272,286,199,3285.0,447,152,245.0,252,120,16.8,2017,0.0
Trhae Mitchell,1127,310,861,414,329,220,3515.0,197,79,212.0,664,335,18.0,2017,0.0
Dederick Lee,235,165,219,71,57,33,1265.0,180,60,94.0,39,11,13.4,2017,0.0
Nick Davis,291,42,246,110,76,41,1312.0,108,30,73.0,138,80,13.4,2017,0.0
Kevin Morris,203,17,171,86,77,31,774.0,0,0,50.0,171,86,16.8,2017,0.0
Ethan Haslam,7,0,9,2,2,1,33.0,8,2,2.0,1,0,18.0,2017,0.0
Nikola Marijan,79,8,71,31,36,17,414.0,0,0,39.0,71,31,15.0,2017,0.0
Eric Eaves,1107,144,753,371,416,304,1882.0,181,61,139.0,572,310,29.1,2017,0.0
Tashombe Riley,1064,78,979,461,174,123,2670.0,88,19,115.0,891,442,22.3,2017,0.0
Greg Mortimer,922,210,779,315,305,222,2582.0,224,70,192.0,555,245,21.9,2017,0.0
James Richardson,540,68,532,206,93,60,1242.0,211,68,90.0,321,138,26.1,2017,0.0
Ian Kinard,790,70,574,232,355,261,2732.0,195,65,173.0,379,167,16.6,2017,0.0
Janai Raynor Powell,700,288,565,230,227,179,2451.0,166,61,211.0,399,169,17.7,2017,0.0
Damani Applewhite,1444,94,986,510,590,418,3404.0,23,6,144.0,963,504,20.5,2017,0.0
Ozante Fields,556,44,401,219,175,118,1625.0,2,0,105.0,399,219,18.0,2017,0.0
Ty Solomon,208,258,202,61,79,56,1686.0,110,30,129.0,92,31,11.1,2017,0.0
David Bottenberg,203,28,190,67,85,65,953.0,27,4,37.0,163,63,13.8,2017,0.0
Earnest Jones,8,1,4,2,4,4,27.0,1,0,1.0,3,2,12.8,2017,0.0
Bobby Williams,8,4,12,3,4,2,49.0,4,0,0.0,8,3,13.3,2017,0.0
Tarik Clement,16,3,15,5,8,6,59.0,2,0,3.0,13,5,17.7,2017,0.0
Jaylen Reid,4,2,7,2,0,0,50.0,1,0,2.0,6,2,9.0,2017,0.0
Michael Buchanan,1286,109,909,527,423,231,2381.0,1,1,199.0,908,526,27.1,2017,0.0
Mike Cunningham,1237,289,1065,415,231,180,3134.0,603,227,158.0,462,188,20.8,2017,0.0
Malik Moore,1407,228,1069,488,434,290,3110.0,451,141,209.0,618,347,23.5,2017,0.0
Philip Whittington,1113,73,889,471,271,170,2528.0,12,1,180.0,877,470,23.2,2017,0.0
Ramel Thompkins,680,100,558,231,107,77,2155.0,392,141,77.0,166,90,15.5,2017,0.0
Josh Cuthbertson,845,258,717,310,153,105,2612.0,371,120,151.0,346,190,17.8,2017,0.0
Deion Holmes,1584,156,1354,564,322,259,3127.0,588,197,268.0,766,367,28.0,2017,0.0
Jure Span,635,418,627,225,105,63,3054.0,378,122,212.0,249,103,14.3,2017,0.0
Carson Smith,147,43,127,61,19,14,609.0,41,11,29.0,86,50,13.2,2017,0.0
Blake Edwards,13,1,8,4,2,1,19.0,8,4,2.0,0,0,28.0,2017,0.0
Tim Hart,8,4,12,2,2,2,60.0,8,2,4.0,4,0,13.6,2017,0.0
Thomas Booker,265,22,241,98,67,53,739.0,58,16,29.0,183,82,20.3,2017,0.0
Sindarius Thornwell,1941,390,1521,596,739,570,4194.0,528,179,331.0,993,417,25.8,2017,1.0
PJ Dozier,730,171,708,282,197,114,1680.0,188,52,168.0,520,230,27.7,2017,1.0
Chris Silva,1509,89,910,452,791,577,2904.0,59,28,263.0,851,424,25.7,2017,1.0
Duane Notice,1409,353,1181,454,393,282,3989.0,599,219,236.0,582,235,19.8,2017,0.0
Maik Kotsar,1028,172,933,433,283,153,3406.0,34,9,185.0,899,424,17.7,2017,0.0
Rakym Felder,202,47,152,62,67,44,538.0,81,34,49.0,71,28,21.1,2017,0.0
Justin McKie,286,81,280,101,65,44,1193.0,135,40,45.0,145,61,14.7,2017,0.0
Hassani Gravett,700,234,613,236,168,120,2318.0,319,108,159.0,294,128,17.8,2017,0.0
Sedee Keita,79,13,89,30,38,19,584.0,2,0,26.0,87,30,11.2,2017,0.0
TeMarcus Blanton,40,4,34,13,12,8,155.0,16,6,7.0,18,7,14.5,2017,0.0
Ran Tut,12,2,15,6,0,0,73.0,1,0,1.0,14,6,10.7,2017,0.0
Khadim Gueye,11,2,14,3,10,5,296.0,0,0,15.0,14,3,5.5,2017,0.0
Evan Hinson,271,31,256,91,80,59,941.0,125,30,59.0,131,61,18.3,2017,0.0
Jarrell Holliman,8,2,8,3,2,2,98.0,0,0,3.0,8,3,5.9,2017,0.0
Tommy Corchiani,0,0,0,0,0,0,14.0,0,0,1.0,0,0,3.5,2017,0.0
Christian Schmitt,0,0,3,0,0,0,13.0,3,0,2.0,0,0,18.7,2017,0.0
Mike Daum,3067,179,1994,1005,927,786,4038.0,661,271,299.0,1333,734,33.9,2017,0.0
Reed Tellinghuisen,1436,189,1131,484,297,212,4070.0,684,256,181.0,447,228,18.1,2017,0.0
A.J. Hess,1115,115,870,353,225,192,3041.0,575,217,130.0,295,136,19.0,2017,0.0
Chris Howell,735,141,623,282,250,166,1778.0,20,5,197.0,603,277,27.0,2017,0.0
Michael Orris,397,262,394,146,132,84,2275.0,104,21,162.0,290,125,13.9,2017,0.0
Ian Theisen,579,61,374,197,180,134,1842.0,126,51,87.0,248,146,15.0,2017,0.0
Skyler Flatten,986,148,726,349,146,105,2905.0,428,183,87.0,298,166,15.3,2017,0.0
Tevin King,883,328,640,315,308,206,3186.0,150,47,207.0,490,268,15.6,2017,0.0
Andre Wallace,122,29,109,40,49,24,388.0,61,18,24.0,48,22,20.6,2017,0.0
Lane Severyn,265,64,218,89,54,32,1373.0,161,55,51.0,57,34,10.9,2017,0.0
Cole Gentry,1018,282,798,347,197,169,3096.0,421,155,122.0,377,192,16.2,2017,0.0
Sergio El Darwich,726,226,599,269,154,121,1941.0,220,67,187.0,379,202,23.6,2017,0.0
Adam Dykman,7,1,2,2,4,3,23.0,0,0,1.0,2,2,10.9,2017,0.0
Beau Brown,16,2,22,5,5,3,57.0,14,3,1.0,8,2,22.2,2017,0.0
Matt Mooney,1899,354,1524,679,403,311,3834.0,625,230,294.0,899,449,26.4,2017,1.0
Tyler Flack,952,65,711,370,238,178,2173.0,108,34,128.0,603,336,22.1,2017,0.0
Trey Burch-Manning,906,130,724,336,306,185,2604.0,119,49,161.0,605,287,19.7,2017,0.0
Carlton Hurst,583,83,385,194,241,169,2240.0,67,26,84.0,318,168,12.8,2017,0.0
Tyler Peterson,1172,245,891,432,319,245,3426.0,244,63,181.0,647,369,18.1,2017,0.0
Triston Simpson,1193,392,895,389,395,295,3776.0,350,120,215.0,545,269,17.5,2017,0.0
Tyler Hagedorn,1225,128,878,410,316,255,2426.0,352,150,132.0,526,260,23.9,2017,0.0
Brandon Armstrong,597,67,516,203,124,90,1948.0,289,101,47.0,227,102,16.2,2017,1.0
Dan Jech,371,17,277,143,110,71,875.0,55,14,59.0,222,129,22.0,2017,0.0
Austin Sparks,171,19,108,67,54,37,795.0,0,0,49.0,108,67,11.4,2017,0.0
Logan Power,181,27,123,61,38,28,441.0,74,31,17.0,49,30,18.1,2017,0.0
Joshua Doss,49,7,26,16,19,15,192.0,6,2,9.0,20,14,11.1,2017,0.0
Geno Thorpe,858,195,678,276,295,240,2216.0,193,66,164.0,485,210,22.7,2017,0.0
Tulio Da Silva,1139,90,902,450,343,215,2980.0,85,24,243.0,817,426,22.6,2017,0.0
Troy Holston Jr.,564,56,575,194,101,63,1696.0,363,113,89.0,212,81,21.6,2017,0.0
Malik Fitts,1280,105,975,447,318,237,2867.0,380,149,155.0,595,298,24.0,2017,0.0
Michael Bibby,309,104,246,98,59,50,1282.0,173,63,92.0,73,35,14.2,2017,0.0
Luis Santos,204,6,148,76,72,52,617.0,2,0,45.0,146,76,18.4,2017,0.0
Ruben Guerrero,920,60,684,385,246,150,3114.0,0,0,176.0,684,385,15.8,2017,0.0
Jahmal McMurray,1465,205,1252,528,201,163,3003.0,639,246,188.0,613,282,26.2,2017,0.0
Jake Bodway,68,29,89,24,21,15,516.0,26,5,29.0,63,19,12.5,2017,0.0
Isaiah Manderson,362,26,303,151,105,60,1053.0,6,0,74.0,297,151,21.6,2017,0.0
Yito Alvarado,3,1,5,1,0,0,15.0,3,1,1.0,2,0,20.7,2017,0.0
Henry Beard,1,3,4,0,2,1,45.0,0,0,2.0,4,0,8.2,2017,0.0
Antonius Cleveland,1556,242,1184,585,529,324,3488.0,215,62,225.0,969,523,23.6,2017,1.0
Denzel Mahoney,1717,144,1257,534,535,435,3341.0,584,214,165.0,673,320,25.7,2017,0.0
Trey Kellum,1050,70,803,400,385,250,2698.0,2,0,207.0,801,400,21.4,2017,0.0
Tahj Eaddy,1439,327,1199,493,275,225,3660.0,603,228,200.0,596,265,21.4,2017,0.0
Jamaal Calvin,596,180,519,185,114,94,2232.0,371,132,104.0,148,53,15.0,2017,0.0
Milos Vranes,356,35,271,127,69,41,1135.0,161,61,64.0,110,66,16.6,2017,0.0
Jaylen Benton,388,141,348,140,70,50,1082.0,171,58,85.0,177,82,20.7,2017,0.0
Daniel Simmons,552,107,461,191,142,95,1290.0,190,75,100.0,271,116,25.0,2017,0.0
Jonathan Dalton,420,315,312,132,154,110,2250.0,122,46,156.0,190,86,12.3,2017,0.0
Dondre Duffus,314,88,225,100,150,96,1011.0,53,18,95.0,172,82,18.2,2017,0.0
William Tchiengang,31,0,16,12,12,7,212.0,0,0,15.0,16,12,8.8,2017,0.0
Eli Sample,8,3,8,3,0,0,42.0,4,2,4.0,4,1,14.5,2017,0.0
Ray Kowalski,155,18,130,53,17,14,526.0,86,35,25.0,44,18,15.9,2017,0.0
Marlain Veal,1666,596,1206,522,586,451,3831.0,467,171,464.0,739,351,25.5,2017,0.0
Davon Hayes,481,71,411,160,126,92,1130.0,191,69,102.0,220,91,25.7,2017,0.0
Moses Greenwood,1515,65,1067,608,415,279,3143.0,54,20,230.0,1013,588,23.9,2017,0.0
Eddy Polanco,567,101,426,163,206,161,1253.0,230,80,98.0,196,83,24.7,2017,0.0
James Currington,800,47,609,330,242,140,2236.0,7,0,143.0,602,330,18.9,2017,0.0
Dimi Cook,353,83,236,101,162,125,1109.0,71,26,76.0,165,75,17.3,2017,0.0
Jabbar Singleton,510,255,449,157,155,97,2688.0,277,99,158.0,172,58,12.8,2017,0.0
Dominic Nelson,198,12,156,73,120,52,1179.0,0,0,77.0,156,73,12.1,2017,0.0
Jordan Capps,978,57,720,388,349,175,1926.0,77,27,149.0,643,361,27.1,2017,0.0
Michael Corchiani,44,25,33,12,17,10,267.0,25,10,21.0,8,2,11.4,2017,0.0
Chris Mejia,43,4,38,15,0,0,136.0,34,13,2.0,4,2,14.5,2017,0.0
George Brock,31,11,46,11,7,3,103.0,24,6,6.0,22,5,26.4,2017,0.0
Joshua Filmore,1035,278,915,360,171,98,3435.0,609,217,140.0,306,143,16.9,2017,0.0
Chimezie Metu,1284,121,928,495,406,281,2809.0,43,13,180.0,885,482,23.0,2017,1.0
Jordan McLaughlin,1648,739,1304,572,432,319,4294.0,488,185,303.0,816,387,20.9,2017,1.0
Elijah Stewart,1402,148,1131,485,249,187,3741.0,628,245,132.0,503,240,18.3,2017,0.0
De'Anthony Melton,300,125,231,101,109,77,972.0,74,21,64.0,157,80,17.7,2017,1.0
Bennie Boatwright,1542,190,1182,511,365,277,3005.0,639,243,153.0,543,268,24.8,2017,0.0
Shaqquan Aaron,725,149,633,264,165,103,2384.0,281,94,121.0,352,170,17.5,2017,0.0
Jonah Mathews,1390,204,1174,486,245,171,3727.0,644,247,144.0,530,239,19.2,2017,0.0
Nick Rakocevic,1292,124,944,510,409,263,3135.0,25,9,176.0,919,501,20.9,2017,0.0
Charles Buggs,368,43,287,138,63,41,1432.0,143,51,49.0,144,87,13.0,2017,0.0
Harrison Henderson,273,12,219,94,120,77,667.0,44,8,54.0,175,86,24.2,2017,0.0
Kurt Karis,79,53,85,28,39,23,595.0,13,0,45.0,72,28,12.8,2017,0.0
Samer Dhillon,7,0,8,3,0,0,27.0,2,1,1.0,6,2,16.4,2017,0.0
Devin Fleming,9,1,6,3,7,3,28.0,1,0,2.0,5,3,20.2,2017,0.0
Burak Eslik,793,89,578,215,332,277,1890.0,271,86,103.0,307,129,21.9,2017,0.0
Jalen Henry,1059,61,829,356,419,293,2206.0,162,54,190.0,667,302,27.2,2017,0.0
Carlos Anderson,521,108,480,184,162,114,1635.0,148,39,113.0,332,145,20.3,2017,0.0
Tre Harris,308,23,264,101,57,40,624.0,167,66,42.0,97,35,26.5,2017,0.0
Christian Ellis,600,257,487,220,293,149,2149.0,53,11,211.0,434,209,19.0,2017,0.0
Keenan Simmons,604,26,456,250,156,94,2288.0,26,10,72.0,430,240,13.0,2017,0.0
Joshua White,240,44,227,90,36,23,757.0,122,37,32.0,105,53,18.3,2017,0.0
Devin Thornton,153,25,127,50,51,34,513.0,49,19,29.0,78,31,17.2,2017,0.0
Brandon Jackson,901,39,756,371,228,144,2328.0,64,15,170.0,692,356,21.7,2017,0.0
Justin Benton,223,126,213,80,47,32,1258.0,89,31,76.0,124,49,12.1,2017,0.0
Glen Pierre Jr.,49,3,45,15,25,19,360.0,0,0,19.0,45,15,11.5,2017,0.0
D'Quan Applewhite,8,0,9,2,7,3,16.0,6,1,0.0,3,1,37.3,2017,0.0
Luka Radovic,0,0,0,0,0,0,1.0,0,0,0.0,0,0,0.0,2017,0.0
Mike Rodriguez,690,226,516,209,322,226,1993.0,150,46,120.0,366,163,20.2,2017,0.0
Armon Fletcher,1328,134,989,464,350,254,3139.0,414,146,146.0,575,318,21.6,2017,0.0
Thik Bol,402,15,349,174,92,53,1339.0,1,1,60.0,348,173,17.6,2017,0.0
Leo Vincent,562,69,479,188,117,95,1526.0,278,91,99.0,201,97,21.0,2017,0.0
Sean Lloyd,1001,145,768,342,321,228,3044.0,238,89,174.0,530,253,18.9,2017,0.0
Aaron Cook,974,309,769,330,314,214,2965.0,292,100,229.0,477,230,20.3,2017,0.0
Jonathan Wiley,230,31,186,87,81,56,781.0,5,0,49.0,181,87,18.5,2017,0.0
Rudy Stradnieks,247,24,210,99,55,34,824.0,56,15,54.0,154,84,18.4,2017,0.0
Austin Weiher,159,13,132,61,37,23,556.0,41,14,30.0,91,47,16.4,2017,0.0
Bernard Cherestal,0,0,0,0,0,0,1.0,0,0,0.0,0,0,0.0,2017,0.0
Crishawn Cook,0,0,0,0,0,0,3.0,0,0,1.0,0,0,17.3,2017,0.0
Tyler Smithpeters,750,185,563,217,236,169,2779.0,385,147,169.0,178,70,16.0,2017,0.0
Semi Ojeleye,711,56,463,222,237,186,1338.0,195,81,55.0,268,141,24.9,2017,1.0
Sterling Brown,1110,294,782,394,252,194,3492.0,284,128,210.0,498,266,16.7,2017,1.0
Shake Milton,1166,337,859,388,253,200,3019.0,445,190,159.0,414,198,19.7,2017,1.0
Ben Moore,1214,242,852,459,445,295,3303.0,5,1,195.0,847,458,19.9,2017,1.0
Jarrey Foster,845,188,684,318,214,133,2514.0,215,76,122.0,469,242,18.9,2017,0.0
Ben Emelogu,828,195,745,289,155,105,2891.0,391,145,152.0,354,144,18.0,2017,0.0
Dashawn McDowell,50,16,42,18,31,12,265.0,4,2,18.0,38,16,14.8,2017,0.0
Tom Wilson,16,5,15,5,4,1,61.0,14,5,6.0,1,0,19.9,2017,0.0
Leo Kontopoulos,8,1,10,3,4,2,34.0,1,0,3.0,9,3,23.2,2017,0.0
Jonathan Wilfong,29,6,34,13,3,1,165.0,13,2,12.0,21,11,15.0,2017,0.0
James Pyle,9,2,14,4,2,0,63.0,8,1,4.0,6,3,15.9,2017,0.0
Quinton Campbell,630,67,535,209,150,113,1694.0,308,99,77.0,227,110,21.6,2017,0.0
Cortez Edwards,1401,368,1195,551,305,224,3765.0,255,75,204.0,940,476,21.8,2017,0.0
Raheem Watts,422,31,334,148,133,99,1291.0,96,27,105.0,238,121,21.0,2017,0.0
Eddie Davis,667,66,550,241,165,124,1838.0,195,61,142.0,355,180,21.7,2017,0.0
Michael Ramey,385,33,367,137,40,26,1279.0,239,85,39.0,128,52,17.8,2017,0.0
Kevin Holland,576,196,531,200,55,39,3326.0,358,137,106.0,173,63,10.7,2017,0.0
Bilal Abdur-Rahim,119,23,86,46,43,24,312.0,9,3,21.0,77,43,21.6,2017,0.0
D'Angelo Richardson,237,103,230,76,72,56,1075.0,108,29,76.0,122,47,16.8,2017,0.0
Tim Rowe,491,40,384,189,160,97,1651.0,54,16,112.0,330,173,18.6,2017,0.0
Robert Thomas,144,46,106,40,48,37,602.0,73,27,42.0,33,13,15.4,2017,0.0
Khari Price,619,251,478,185,167,142,2288.0,294,107,134.0,184,78,16.2,2017,0.0
Josh Conley,28,3,31,10,15,8,123.0,3,0,7.0,28,10,19.4,2017,0.0
Christian Clark,5,2,5,2,1,0,39.0,2,1,2.0,3,1,10.1,2017,0.0
Clay Weatherspoon,16,2,28,5,8,5,190.0,10,1,9.0,18,4,11.3,2017,0.0
James McGee,1300,240,930,390,302,231,3280.0,675,289,146.0,255,101,18.5,2017,0.0
John Marshall,664,282,471,190,337,250,2605.0,100,34,161.0,371,156,15.5,2017,0.0
Jacob Calloway,702,86,559,234,164,122,1861.0,308,112,94.0,251,122,18.9,2017,0.0
Ivan Madunic,421,57,387,142,101,71,1868.0,220,66,80.0,167,76,13.2,2017,0.0
Christian Musoko,322,19,244,122,132,78,921.0,1,0,71.0,243,122,19.6,2017,0.0
Race Parsons,596,91,506,190,129,98,1857.0,344,118,83.0,162,72,18.2,2017,0.0
Brayden Holker,132,4,88,49,54,34,486.0,0,0,24.0,88,49,13.2,2017,0.0
Will Joyce,163,9,125,67,56,29,549.0,2,0,26.0,123,67,15.8,2017,0.0
Decardo Day,289,114,271,91,133,83,1106.0,93,24,144.0,178,67,21.2,2017,0.0
Matthew Johnson,89,9,78,28,20,13,316.0,54,20,10.0,24,8,14.8,2017,0.0
Adonis Saltes,9,1,3,0,10,9,13.0,0,0,4.0,3,0,43.6,2017,0.0
Neema Namdar,5,0,4,1,4,2,12.0,4,1,0.0,0,0,22.9,2017,0.0
Joel Swallow,6,0,6,2,6,2,30.0,0,0,1.0,6,2,16.0,2017,0.0
Shawn Prudhomme,917,62,750,339,153,117,1790.0,329,122,97.0,421,217,25.3,2017,0.0
Jared Sam,1489,120,973,502,668,484,3802.0,4,1,208.0,969,501,19.4,2017,0.0
Trelun Banks,1407,423,1325,466,484,320,4173.0,485,155,347.0,840,311,22.8,2017,0.0
Chris Thomas,659,64,606,236,271,156,2190.0,138,31,115.0,468,205,19.1,2017,0.0
Emanual Shepherd,380,57,303,158,118,62,1330.0,4,2,68.0,299,156,15.6,2017,0.0
JaMarcus Weatherspoon,339,38,276,118,152,101,1093.0,15,2,69.0,261,116,19.8,2017,0.0
LaQuentin Collins,250,50,238,84,74,49,941.0,97,33,60.0,141,51,17.3,2017,0.0
Patrick Smith,91,9,78,36,29,16,363.0,9,3,32.0,69,33,16.6,2017,0.0
Brendon Ganaway,78,42,53,21,37,29,360.0,17,7,29.0,36,14,13.5,2017,0.0
Rashad Andrews,163,21,142,57,49,29,651.0,61,20,35.0,81,37,15.3,2017,0.0
Brandon Bolden,38,3,25,15,17,8,138.0,0,0,14.0,25,15,17.6,2017,0.0
Josh Robinson,23,5,30,8,0,0,79.0,27,7,5.0,3,1,21.6,2017,0.0
Isaiah Fontaine,106,4,93,43,50,20,504.0,1,0,18.0,92,43,13.1,2017,0.0
DeRias Johnson,89,35,119,31,26,11,389.0,71,16,30.0,48,15,20.7,2017,0.0
Jaylen Adams,1912,590,1246,532,690,578,3998.0,685,270,314.0,561,262,23.6,2017,1.0
Matt Mobley,1946,272,1478,602,537,447,4382.0,819,295,285.0,659,307,23.4,2017,0.0
Denzel Gregg,816,90,658,312,282,176,2390.0,65,16,149.0,593,296,19.5,2017,0.0
David Andoh,613,34,561,238,177,124,1677.0,52,13,134.0,509,225,23.4,2017,0.0
Idris Taqqee,592,158,534,227,166,103,3073.0,127,35,94.0,407,192,11.5,2017,0.0
Josh Ayeni,487,19,376,179,166,125,1292.0,15,4,75.0,361,175,20.6,2017,0.0
LaDarien Griffin,629,87,484,238,217,149,2165.0,21,4,104.0,463,234,16.4,2017,0.0
Amadi Ikpeze,400,17,345,160,120,80,1455.0,0,0,69.0,345,160,16.6,2017,0.0
Nelson Kaputo,459,150,407,153,63,53,1646.0,279,100,93.0,128,53,16.5,2017,0.0
Chinonso Obokoh,32,4,24,14,12,4,211.0,0,0,9.0,24,14,9.3,2017,0.0
Tareq Coburn,975,75,690,295,266,214,2619.0,426,171,102.0,264,124,17.9,2017,0.0
Caleb McGuire,0,0,0,0,0,0,3.0,0,0,1.0,0,0,16.3,2017,0.0
Rasheem Dunn,1407,306,1223,476,500,367,3296.0,367,88,223.0,856,388,24.6,2017,0.0
Glenn Sanabria,1347,326,1188,453,312,203,3666.0,645,238,172.0,543,215,20.3,2017,0.0
Yunus Hopkinson,856,196,852,264,222,174,2290.0,512,154,178.0,340,110,24.8,2017,0.0
Robert Montgomery,155,14,138,59,60,35,559.0,6,2,53.0,132,57,19.3,2017,0.0
Gianni Ford,124,11,126,41,29,21,375.0,69,21,17.0,57,20,20.6,2017,0.0
Jahmel Bodrick,121,7,129,49,38,22,454.0,9,1,37.0,120,48,19.9,2017,0.0
Gunnar Olafsson,324,44,309,126,50,25,1684.0,170,47,73.0,139,79,12.0,2017,0.0
Keon Williams,351,55,345,122,95,56,1943.0,189,51,62.0,156,71,11.6,2017,0.0
Darelle Porter,74,8,85,27,19,12,267.0,33,8,15.0,52,19,20.1,2017,0.0
Joshua Nurse,119,31,100,42,81,35,704.0,0,0,66.0,100,42,14.3,2017,0.0
Jagos Lasic,200,34,163,70,43,35,815.0,67,25,48.0,96,45,14.0,2017,0.0
Sam Harris,1,0,3,0,2,1,24.0,2,0,1.0,1,0,10.1,2017,0.0
Shamorie Ponds,1870,413,1448,632,499,419,3378.0,570,187,209.0,878,445,27.7,2017,1.0
Marcus LoVett,580,125,451,205,132,105,1177.0,170,65,92.0,281,140,24.7,2017,0.0
Bashir Ahmed,814,71,679,272,267,174,1877.0,275,96,124.0,404,176,24.2,2017,0.0
Federico Mussini,588,96,492,180,135,116,1514.0,315,112,102.0,177,68,20.7,2017,0.0
Tariq Owens,808,63,598,319,207,150,2780.0,71,20,120.0,527,299,14.9,2017,1.0
Kassoum Yakwe,398,42,322,144,197,110,1710.0,0,0,102.0,322,144,14.5,2017,0.0
Yankuba Sima,341,45,287,139,135,62,1158.0,3,1,71.0,284,138,17.4,2017,0.0
Amar Alibegovic,298,45,290,106,70,39,1291.0,176,47,85.0,114,59,15.3,2017,0.0
Richard Freudenberg,34,12,48,12,4,3,242.0,35,7,17.0,13,5,13.1,2017,0.0
Elijah Holifield,18,5,23,7,4,1,68.0,15,3,3.0,8,4,19.5,2017,0.0
Brandon Lawrence,2,0,1,1,2,0,4.0,0,0,0.0,1,1,23.8,2017,0.0
Justin Cole,7,1,11,3,4,1,54.0,0,0,2.0,11,3,13.4,2017,0.0
Reid Travis,1786,107,1216,656,701,449,3825.0,88,25,223.0,1128,631,23.1,2017,0.0
Dorian Pickens,1186,162,887,371,335,248,2916.0,507,196,135.0,380,175,20.3,2017,0.0
Michael Humphrey,1037,89,870,415,248,167,2685.0,121,40,163.0,749,375,21.4,2017,0.0
Marcus Allen,847,171,709,309,289,184,2716.0,187,45,143.0,522,264,18.7,2017,0.0
Robert Cartwright,666,283,611,224,171,132,2463.0,276,86,146.0,335,138,17.2,2017,0.0
Marcus Sheffield,1154,188,964,386,301,240,2599.0,378,142,157.0,586,244,25.2,2017,0.0
Grant Verhoeven,250,27,192,90,92,60,1156.0,22,10,39.0,170,80,12.1,2017,0.0
Josh Sharma,585,20,432,243,147,88,1630.0,44,11,88.0,388,232,17.8,2017,0.0
Christian Sanders,290,218,256,86,126,93,1643.0,87,25,125.0,169,61,13.6,2017,0.0
Cameron Walker,53,26,35,11,55,30,374.0,7,1,26.0,28,10,11.9,2017,0.0
Trevor Stanback,37,9,33,13,30,11,229.0,0,0,16.0,33,13,13.6,2017,0.0
Malcolm Allen,99,40,85,42,19,9,503.0,20,6,37.0,65,36,13.6,2017,0.0
Rodney Herenton,14,3,13,5,8,4,51.0,2,0,5.0,11,5,21.5,2017,0.0
Blake Pagon,2,6,5,0,3,2,95.0,4,0,6.0,1,0,6.4,2017,0.0
Josh Hanson,0,0,4,0,0,0,12.0,4,0,0.0,0,0,17.0,2017,0.0
T.J. Holyfield,1357,138,949,507,360,264,3268.0,213,79,286.0,736,428,21.1,2017,0.0
Ivan Canete,666,156,488,219,168,132,1559.0,239,96,138.0,249,123,21.9,2017,0.0
Leon Gilmore III,667,97,499,246,245,161,1653.0,70,14,130.0,429,232,21.8,2017,0.0
Kevon Harris,1833,203,1215,587,648,471,3551.0,474,188,312.0,741,399,24.7,2017,0.0
Dallas Cameron,627,243,503,192,221,162,2672.0,257,81,138.0,246,111,13.9,2017,0.0
Ty Charles,1044,233,847,375,283,207,2925.0,272,87,195.0,575,288,19.7,2017,0.0
Isaiah Traylor,195,18,154,60,52,40,511.0,105,35,43.0,49,25,21.5,2017,0.0
Josh Huntley,82,3,69,34,21,14,271.0,0,0,38.0,69,34,21.4,2017,0.0
Samuli Nieminen,193,23,145,66,56,42,998.0,53,19,71.0,92,47,11.8,2017,0.0
Aaron Augustin,202,188,178,65,81,48,1371.0,77,24,106.0,101,41,11.3,2017,0.0
Jovan Grujic,140,15,142,57,38,25,716.0,11,1,66.0,131,56,15.4,2017,0.0
Chase Winchester,31,4,19,7,17,14,71.0,10,3,3.0,9,4,21.0,2017,0.0
Nathan Bain,453,111,340,166,141,94,1724.0,79,27,98.0,261,139,14.1,2017,0.0
Khiorie Stewart,2,0,2,1,0,0,15.0,1,0,0.0,1,1,6.6,2017,0.0
Derick Newton,1121,87,783,355,357,293,2073.0,287,118,138.0,496,237,25.3,2017,0.0
Divine Myles,1845,501,1413,681,533,372,4163.0,321,111,223.0,1092,570,22.3,2017,0.0
Luke Doyle,1101,177,962,390,118,88,3111.0,651,233,113.0,311,157,17.7,2017,0.0
Angel Rivera,942,582,670,287,366,264,3420.0,300,104,199.0,370,183,15.0,2017,0.0
Leo Goodman,794,62,731,283,116,86,2105.0,418,142,85.0,313,141,19.9,2017,0.0
B.J. Glasford,752,142,750,285,133,86,2338.0,319,96,132.0,431,189,20.2,2017,0.0
Brian Pegg,1088,116,855,446,361,190,2936.0,25,6,209.0,830,440,21.3,2017,0.0
Larry Dennis,246,13,253,105,101,36,964.0,4,0,71.0,249,105,18.7,2017,0.0
Clay Verk,145,17,153,54,60,28,543.0,28,9,38.0,125,45,19.4,2017,0.0
Kevin Ndahiro,42,0,34,14,24,14,201.0,0,0,18.0,34,14,15.1,2017,0.0
Matthew Cioce,12,1,9,4,5,2,21.0,7,2,3.0,2,2,33.0,2017,0.0
Brady Moses,15,0,8,5,2,2,23.0,6,3,1.0,2,2,21.0,2017,0.0
Will Hollmann,2,0,4,0,2,2,26.0,1,0,3.0,3,0,14.7,2017,0.0
Lucas Woodhouse,1215,662,924,400,278,235,3731.0,444,180,285.0,480,220,18.1,2017,0.0
Tyrell Sturdivant,763,105,659,277,300,179,2246.0,104,30,150.0,555,247,21.4,2017,0.0
Roland Nyama,680,112,564,232,186,130,2047.0,253,86,113.0,311,146,19.1,2017,0.0
Akwasi Yeboah,1620,137,1288,540,419,332,3327.0,615,208,227.0,673,332,25.6,2017,0.0
Bryan Sekunda,619,130,595,208,49,39,2162.0,454,164,69.0,141,44,16.1,2017,0.0
UC Iroegbu,424,76,387,136,88,64,1370.0,262,88,51.0,125,48,17.6,2017,0.0
Junior Saintel,375,29,332,148,103,70,1211.0,47,9,70.0,285,139,18.7,2017,0.0
Jakub Petras,317,40,256,129,104,58,1192.0,1,1,51.0,255,128,15.1,2017,0.0
Kameron Mitchell,285,84,256,94,69,44,1666.0,150,53,72.0,106,41,11.1,2017,0.0
Michael Almonacy,486,140,421,160,101,79,1389.0,263,87,73.0,158,73,20.0,2017,0.0
Alonzo Campbell,183,8,144,74,57,35,679.0,4,0,47.0,140,74,15.8,2017,0.0
Tim Donohoe,5,0,7,2,0,0,26.0,4,1,1.0,3,1,15.4,2017,0.0
Blair Mendy,0,0,0,0,0,0,4.0,0,0,0.0,0,0,0.0,2017,0.0
Andrew White III,1291,63,944,427,280,220,2514.0,550,217,127.0,394,210,24.4,2017,1.0
Tyler Lydon,823,111,584,278,209,169,2349.0,245,98,106.0,339,180,17.3,2017,1.0
Tyus Battle,1647,214,1315,549,461,370,3649.0,534,179,183.0,781,370,24.4,2017,0.0
John Gillon,1361,489,925,365,531,446,3411.0,489,185,252.0,436,180,21.0,2017,0.0
Taurean Thompson,440,24,363,181,102,68,891.0,45,10,66.0,318,171,27.0,2017,0.0
Tyler Roberson,779,130,647,317,252,145,2797.0,10,0,134.0,637,317,16.6,2017,0.0
Frank Howard,992,435,941,342,249,170,3069.0,432,138,270.0,509,204,22.5,2017,0.0
DaJuan Coleman,448,25,327,169,198,110,1388.0,1,0,98.0,326,169,19.3,2017,0.0
Paschal Chukwu,445,30,237,160,208,125,2114.0,0,0,100.0,237,160,10.7,2017,0.0
Doyin Akintobi-Adeyeye,10,0,13,5,5,0,31.0,0,0,5.0,13,5,33.5,2017,0.0
Adrian Autry,10,1,20,3,4,2,36.0,15,2,4.0,5,1,37.0,2017,0.0
Ky Feldman,10,2,9,4,0,0,26.0,7,2,0.0,2,2,17.7,2017,0.0
Ray Featherston,3,2,2,1,0,0,10.0,2,1,0.0,0,0,10.2,2017,0.0
Shaun Belbey,4,3,9,2,0,0,36.0,2,0,4.0,7,2,18.5,2017,0.0
Evan Dourdas,0,0,0,0,0,0,6.0,0,0,1.0,0,0,8.5,2017,0.0
Jonathan Radner,0,2,3,0,0,0,7.0,2,0,1.0,1,0,29.1,2017,0.0
Mike Sutton,0,2,4,0,1,0,21.0,4,0,1.0,0,0,13.3,2017,0.0
Shizz Alston Jr.,1597,417,1360,543,295,261,3799.0,704,250,195.0,656,293,22.7,2017,0.0
Obi Enechionyia,1296,100,1114,457,245,182,3449.0,546,200,130.0,568,257,20.4,2017,0.0
Daniel Dingle,757,220,659,246,269,168,2657.0,311,97,151.0,348,149,18.2,2017,0.0
Quinton Rose,1860,325,1654,675,509,365,4036.0,488,145,297.0,1166,530,27.4,2017,0.0
Alani Moore,682,202,581,216,125,98,2652.0,409,152,113.0,172,64,14.3,2017,0.0
Mark Williams,540,109,536,197,145,98,1774.0,186,48,110.0,350,149,20.6,2017,0.0
Ernest Aflakpui,497,47,345,204,157,89,1950.0,0,0,109.0,345,204,13.8,2017,0.0
Damion Moore,286,17,230,121,74,44,915.0,0,0,40.0,230,121,16.9,2017,0.0
Josh Brown,927,390,818,329,246,186,3858.0,227,83,172.0,591,246,14.8,2017,0.0
Mike Robbins,35,11,21,11,14,8,136.0,12,5,5.0,9,6,12.4,2017,0.0
Steve Leonard,9,0,6,2,4,3,18.0,5,2,2.0,1,0,28.3,2017,0.0
Isaiah Lewis,2,0,4,1,0,0,7.0,1,0,1.0,3,1,36.7,2017,0.0
Ayan Nunez de Carvalho,0,1,6,0,0,0,18.0,6,0,2.0,0,0,22.8,2017,0.0
Jacolby Mobley,932,114,729,304,206,164,1880.0,448,160,109.0,281,144,24.7,2017,0.0
Matthew Butler,1037,233,929,374,134,103,2703.0,516,186,228.0,413,188,22.5,2017,0.0
Javier Martinez,752,65,475,319,153,114,1924.0,0,0,95.0,475,319,16.8,2017,0.0
Kedar Edwards,643,187,563,242,167,105,1741.0,196,54,166.0,367,188,23.0,2017,0.0
Fatodd Lewis,824,90,695,310,237,144,2137.0,206,60,139.0,489,250,22.1,2017,0.0
Chandler Rowe,301,87,203,101,147,87,1767.0,27,12,85.0,176,89,10.2,2017,0.0
Malik London,133,9,85,57,38,19,383.0,0,0,24.0,85,57,16.3,2017,0.0
Kahari Beaufort,152,20,136,54,36,25,487.0,62,19,35.0,74,35,19.0,2017,0.0
Jalen Jackson,81,34,59,21,34,25,256.0,32,14,25.0,27,7,18.9,2017,0.0
Malik Pugh,151,58,127,55,58,30,461.0,42,11,54.0,85,44,22.5,2017,0.0
Dante Bailey,73,8,68,24,14,10,223.0,51,15,10.0,17,9,18.4,2017,0.0
Mike Fofana,117,38,112,46,36,24,596.0,12,1,40.0,100,45,14.3,2017,0.0
Nick Detlev,14,0,9,6,4,2,30.0,0,0,3.0,9,6,22.9,2017,0.0
Wayne Martin,983,44,744,389,313,195,2246.0,45,10,201.0,699,379,24.3,2017,0.0
Tahjere McCall,1170,363,908,388,536,363,3047.0,135,31,322.0,773,357,23.9,2017,1.0
Darreon Reddick,895,169,805,287,274,202,3259.0,361,119,192.0,444,168,17.9,2017,0.0
Delano Spencer,707,59,542,231,121,102,1625.0,348,143,84.0,194,88,21.8,2017,0.0
Ken'Darrius Hamilton,439,35,366,165,72,57,1201.0,163,52,104.0,203,113,21.6,2017,0.0
Christian Mekowulu,993,62,681,323,503,342,2744.0,17,5,202.0,664,318,21.2,2017,0.0
Armani Chaney,675,265,599,229,167,131,2341.0,257,86,209.0,342,143,19.1,2017,0.0
A'Torey Everett,58,17,44,17,25,20,233.0,7,4,19.0,37,13,15.9,2017,0.0
Samson Oyediran,53,5,44,20,19,8,364.0,19,5,20.0,25,15,10.1,2017,0.0
Xavier Williams,23,3,23,9,9,5,113.0,3,0,8.0,20,9,16.0,2017,0.0
Jalen Duke,70,4,52,28,10,6,223.0,22,8,8.0,30,20,14.6,2017,0.0
Thomas Davis,4,2,3,2,0,0,14.0,0,0,1.0,3,2,14.2,2017,0.0
Khalill Spencer,122,13,98,56,25,10,482.0,1,0,26.0,97,56,14.3,2017,0.0
Aleksa Jugovic,1319,288,978,417,292,255,3328.0,598,230,190.0,380,187,19.4,2017,0.0
Kajon Mack,971,261,778,330,293,220,2848.0,287,91,168.0,491,239,18.9,2017,0.0
Hakeem Rogers,674,53,544,213,157,123,1274.0,349,125,78.0,195,88,27.2,2017,0.0
Mason Ramsey,910,107,704,350,259,181,2497.0,117,29,132.0,587,321,18.9,2017,0.0
Curtis Phillips,1007,144,831,324,320,228,2473.0,386,131,191.0,445,193,24.0,2017,0.0
Stephaun Adams,128,76,120,37,56,40,596.0,48,14,50.0,72,23,16.2,2017,0.0
Micaiah Henry,543,39,382,220,228,103,1697.0,1,0,146.0,381,220,18.1,2017,0.0
Markell Henderson,136,10,122,51,21,14,350.0,67,20,12.0,55,31,20.4,2017,0.0
Savonte Frazier,122,81,92,35,66,44,571.0,27,8,50.0,65,27,15.1,2017,0.0
Ja'Cardo Hawkins,70,18,71,30,19,7,293.0,17,3,17.0,54,27,16.3,2017,0.0
Courtney Alexander II,570,163,455,204,329,162,2433.0,2,0,229.0,453,204,16.8,2017,0.0
Colton Blevins,46,3,31,15,22,16,88.0,4,0,5.0,27,15,26.1,2017,0.0
Robert Hubbs,1047,127,937,409,222,174,2826.0,197,55,102.0,740,354,20.1,2017,0.0
Grant Williams,1629,219,1064,549,661,501,3003.0,103,30,219.0,961,519,26.5,2017,1.0
Lamonte Turner,1084,347,896,342,286,229,2785.0,502,171,182.0,394,171,21.9,2017,0.0
Jordan Bowden,1365,261,1093,440,373,299,3730.0,546,186,147.0,547,254,19.2,2017,0.0
Admiral Schofield,1570,177,1277,585,283,216,3288.0,476,184,188.0,801,401,24.2,2017,1.0
Shembari Phillips,432,110,369,140,137,104,1474.0,144,48,106.0,225,92,17.8,2017,0.0
Jordan Bone,921,405,799,339,186,152,2479.0,258,91,150.0,541,248,20.9,2017,1.0
Detrick Mostella,790,118,730,260,175,133,1934.0,441,137,134.0,289,123,24.0,2017,0.0
Lew Evans,542,78,457,170,198,134,1816.0,229,68,117.0,228,102,18.4,2017,0.0
Kyle Alexander,623,37,414,243,207,132,2408.0,14,5,98.0,400,238,12.6,2017,1.0
John Fulkerson,875,131,568,322,317,230,2465.0,5,1,141.0,563,321,17.8,2017,0.0
Kwe Parker,287,57,237,103,69,40,923.0,115,41,80.0,122,62,17.8,2017,0.0
Brad Woodson,22,6,27,6,6,6,95.0,18,4,2.0,9,2,16.2,2017,0.0
Lucas Campbell,15,3,13,4,6,4,32.0,7,3,2.0,6,1,27.5,2017,0.0
Rashawn Thomas,2034,173,1348,737,802,539,3475.0,70,21,381.0,1278,716,31.0,2017,0.0
Ehab Amin,1281,225,1034,458,362,254,2967.0,373,111,229.0,661,347,24.6,2017,0.0
Joe Kilgore,1212,235,1012,430,352,274,3022.0,249,78,217.0,763,352,23.1,2017,0.0
Kareem South,1390,199,1203,482,309,256,3979.0,489,170,184.0,714,312,19.8,2017,0.0
Jake Kocher,563,101,460,214,119,80,1977.0,187,55,86.0,273,159,15.6,2017,0.0
Cole Martinez,414,55,304,126,83,75,1225.0,233,87,36.0,71,39,16.1,2017,0.0
Elijah Schmidt,571,81,424,230,196,108,2323.0,20,3,130.0,404,227,14.2,2017,0.0
Perry Francois,400,52,323,175,104,50,1354.0,0,0,112.0,323,175,18.0,2017,0.0
Colin Hale,104,38,107,41,18,10,620.0,46,12,45.0,61,29,12.9,2017,0.0
Alex Holcombe,55,4,46,24,17,7,242.0,0,0,10.0,46,24,12.9,2017,0.0
David Bloom,28,15,32,4,27,19,296.0,15,1,13.0,17,3,9.8,2017,0.0
Jamell Bradley,11,2,11,3,5,4,55.0,4,1,2.0,7,2,14.0,2017,0.0
Marcus Lightfoot,0,0,1,0,0,0,2.0,1,0,0.0,0,0,24.8,2017,0.0
Tyler Davis,1363,114,850,522,483,312,2650.0,26,7,211.0,824,515,23.9,2017,1.0
Admon Gilder,1407,312,1092,477,348,268,3631.0,498,185,193.0,594,292,19.5,2017,0.0
Robert Williams,680,87,496,293,170,92,1570.0,30,2,106.0,466,291,21.4,2017,0.0
DJ Hogg,847,194,746,297,149,98,2314.0,431,155,135.0,315,142,20.2,2017,0.0
Tonny Trocha-Morelos,791,148,732,302,189,108,2549.0,255,79,120.0,477,223,18.3,2017,0.0
J.C. Hampton,1409,331,1170,455,343,270,3652.0,643,229,229.0,527,226,21.0,2017,0.0
Tavario Miller,292,29,226,110,148,72,1298.0,2,0,81.0,224,110,14.9,2017,0.0
Eric Vila,124,66,140,40,43,26,768.0,78,18,46.0,62,22,13.7,2017,0.0
Chris Collins,83,69,109,26,21,15,861.0,84,16,36.0,25,10,8.9,2017,0.0
Caleb Smith,23,7,22,9,6,3,101.0,8,2,3.0,14,7,13.8,2017,0.0
Kobie Eubanks,28,5,41,11,5,0,153.0,32,6,9.0,9,5,17.1,2017,0.0
Mark French,52,29,61,17,12,8,340.0,37,10,18.0,24,7,12.8,2017,0.0
Chase Carlton,2,11,5,1,3,0,94.0,3,0,3.0,2,1,5.0,2017,0.0
Frank Byers,4,1,5,2,1,0,18.0,2,0,2.0,3,2,20.5,2017,0.0
Kyle Nugent,0,0,0,0,0,0,2.0,0,0,0.0,0,0,0.0,2017,0.0
Kevin Hervey,1783,216,1435,631,413,317,3186.0,630,204,236.0,805,427,27.8,2017,1.0
Erick Neal,1557,756,1281,521,350,253,3880.0,740,262,396.0,541,259,22.4,2017,0.0
Jorge Bilbao,727,122,541,275,281,175,2554.0,26,2,158.0,515,273,15.4,2017,0.0
Kaelon Wilson,1191,156,913,412,418,274,3021.0,290,93,174.0,623,319,20.1,2017,0.0
Drew Charles,928,173,765,299,204,154,2664.0,465,176,142.0,300,123,18.0,2017,0.0
Faith Pope,333,39,257,127,92,58,817.0,75,21,42.0,182,106,19.7,2017,0.0
Nathan Hawkins,489,155,508,181,99,53,2092.0,271,74,137.0,237,107,15.6,2017,0.0
Julian Harris,216,22,177,77,85,54,884.0,24,8,54.0,153,69,14.6,2017,0.0
Link Kabadyundi,131,6,77,50,75,31,495.0,0,0,35.0,77,50,14.4,2017,0.0
Scott Muirhead,44,3,51,15,0,0,87.0,47,14,5.0,4,1,30.7,2017,0.0
DJ Bryant,147,130,120,43,55,44,1136.0,71,17,76.0,49,26,9.5,2017,0.0
Erkam Kiris,12,2,7,6,2,0,49.0,0,0,1.0,7,6,8.8,2017,0.0
Patrick Binzer,4,0,6,2,0,0,14.0,3,0,1.0,3,2,24.3,2017,0.0
Mairega Clarke,110,19,84,36,38,26,462.0,30,12,36.0,54,24,13.9,2017,0.0
Vladimir Brodziansky,1364,80,900,502,408,314,2551.0,135,46,124.0,765,456,23.7,2017,0.0
Alex Robinson,1367,756,1194,510,376,234,4165.0,345,113,390.0,849,397,21.3,2017,0.0
Kenrich Williams,1125,271,860,416,307,192,3281.0,269,101,145.0,591,315,17.6,2017,1.0
Jaylen Fisher,664,255,532,226,125,99,1714.0,276,113,134.0,256,113,21.1,2017,0.0
Desmond Bane,1784,333,1331,659,270,217,4279.0,575,249,220.0,756,410,19.9,2017,0.0
JD Miller,1153,153,932,409,378,253,3128.0,276,82,175.0,656,327,20.5,2017,0.0
Brandon Parrish,948,109,831,335,212,128,3284.0,409,150,138.0,422,185,16.6,2017,0.0
Karviar Shepherd,855,96,718,313,326,222,2743.0,22,7,166.0,696,306,19.4,2017,0.0
Chris Washburn,602,117,474,212,330,173,2050.0,16,5,155.0,458,207,19.9,2017,1.0
Michael Williams,314,123,293,103,96,66,1515.0,134,42,73.0,159,61,13.9,2017,0.0
Josh Parrish,572,103,395,224,188,114,1617.0,45,10,98.0,350,214,17.9,2017,0.0
Dalton Dry,31,5,28,8,22,10,155.0,12,5,10.0,16,3,15.6,2017,0.0
Austin Sottile,6,2,5,3,0,0,21.0,0,0,0.0,5,3,11.9,2017,0.0
Omega Harris,1407,246,1098,486,340,261,3768.0,448,174,243.0,650,312,20.8,2017,0.0
Dominic Artis,1215,502,1065,430,359,235,3321.0,376,120,269.0,689,310,22.9,2017,0.0
Matt Willms,886,107,606,348,310,190,2475.0,3,0,188.0,603,348,20.1,2017,0.0
Paul Thomas,798,144,680,322,204,111,2598.0,135,43,178.0,545,279,19.0,2017,0.0
Jake Flaggert,326,87,260,95,69,51,2066.0,232,85,50.0,28,10,8.6,2017,0.0
Trey Touchet,411,167,365,139,90,73,1946.0,203,60,90.0,162,79,13.2,2017,0.0
Kelvin Jones,478,44,373,203,128,72,1299.0,0,0,107.0,373,203,21.5,2017,0.0
Deon Barrett,105,29,93,34,14,12,420.0,63,25,17.0,30,9,14.7,2017,0.0
Terry Winn,998,98,793,366,403,263,2280.0,20,3,162.0,773,363,24.4,2017,0.0
Tim Cameron,90,26,67,27,46,32,236.0,22,4,20.0,45,23,24.1,2017,0.0
Ivan Venegas,15,1,14,5,13,5,74.0,0,0,4.0,14,5,16.8,2017,0.0
Chris Barnes,191,41,176,72,60,44,704.0,21,3,65.0,155,69,19.7,2017,0.0
Jose Martinez,0,0,1,0,2,0,8.0,0,0,0.0,1,0,12.9,2017,0.0
Adrian Moore,0,0,0,0,0,0,1.0,0,0,0.0,0,0,0.0,2017,0.0
Hudson Urbanus,0,3,6,0,0,0,22.0,5,0,3.0,1,0,21.7,2017,0.0
Nick Dixon,1282,188,840,400,514,400,1899.0,242,82,178.0,598,318,30.3,2017,0.0
Antonio Green,1788,264,1578,603,287,231,3936.0,987,351,300.0,591,252,24.7,2017,0.0
Lew Stallworth,1053,397,799,376,300,219,2484.0,245,82,226.0,554,294,21.6,2017,0.0
Michael Hoffman,567,59,469,213,87,66,1743.0,194,75,64.0,275,138,15.8,2017,0.0
Xavier McDaniel Jr.,518,57,477,185,130,94,1234.0,165,54,89.0,312,131,23.2,2017,0.0
Moe McDonald,372,131,319,110,153,109,1515.0,173,43,110.0,146,67,15.5,2017,0.0
Lesley Varner II,1180,141,939,400,383,282,2835.0,304,98,134.0,635,302,21.3,2017,0.0
Gage Loy,100,26,104,35,32,21,414.0,32,9,27.0,72,26,16.0,2017,0.0
Dan Kimasa,762,73,674,298,255,163,2474.0,24,3,127.0,650,295,18.7,2017,0.0
Mike Nwabuzor,58,19,62,18,24,17,271.0,20,5,22.0,42,13,15.9,2017,0.0
Walter Jones,80,31,91,31,25,12,562.0,27,6,40.0,64,25,12.1,2017,0.0
Adonis Rwabigwi,276,20,202,98,138,80,1306.0,1,0,88.0,201,98,13.7,2017,0.0
Onuralp Demirer,6,0,3,2,2,2,9.0,0,0,2.0,3,2,29.9,2017,0.0
Solomon Yon,2,1,1,0,2,2,6.0,0,0,1.0,1,0,22.3,2017,0.0
Nick Mora,5,6,4,0,12,5,44.0,2,0,7.0,2,0,17.3,2017,0.0
Clarke Cooper,0,0,1,0,0,0,7.0,0,0,2.0,1,0,19.4,2017,0.0
Byron Frohnen,863,246,719,357,255,145,3725.0,38,4,164.0,681,353,12.9,2017,0.0
Giovanni De Nicolao,823,348,823,301,208,139,2887.0,273,82,217.0,550,219,18.9,2017,0.0
Lucas O'Brien,509,37,423,187,114,83,1513.0,164,52,57.0,259,135,17.1,2017,0.0
Gino Littles,624,258,558,212,202,126,2992.0,223,74,161.0,335,138,13.4,2017,0.0
Nick Allen,899,124,737,350,174,115,2846.0,246,84,206.0,491,266,17.2,2017,0.0
George Willborn III,706,85,580,252,294,151,1900.0,142,51,142.0,438,201,22.9,2017,0.0
Nick Billingsley,241,9,202,81,62,48,425.0,91,31,42.0,111,50,31.1,2017,0.0
Austin Karrer,242,92,212,78,88,53,1960.0,122,33,60.0,90,45,7.7,2017,0.0
Mitar Stanojevic,76,10,60,30,26,15,266.0,16,1,18.0,44,29,16.3,2017,0.0
Bola Alade,26,4,38,10,9,4,108.0,14,2,8.0,24,8,22.7,2017,0.0
J.R. Harris,392,51,368,126,87,71,930.0,215,69,63.0,153,57,24.4,2017,0.0
James Ringholt,106,20,97,32,30,19,650.0,81,23,22.0,16,9,10.0,2017,0.0
Kyle Massie,16,6,19,5,7,4,61.0,13,2,1.0,6,3,18.4,2017,0.0
Terrell Scruggs,12,3,14,4,10,4,82.0,4,0,11.0,10,4,17.4,2017,0.0
Demontrae Jefferson,1029,211,833,335,304,235,1914.0,345,124,171.0,488,211,29.3,2017,0.0
Kevin Scott,437,81,378,161,101,72,1205.0,127,43,79.0,251,118,20.7,2017,0.0
Marvin Jones,342,22,220,118,127,99,1087.0,37,7,39.0,183,111,14.6,2017,0.0
Dulani Robinson,498,163,460,154,122,100,1578.0,266,90,97.0,194,64,20.4,2017,0.0
Derrick Griffin,506,21,298,201,196,103,1361.0,6,1,41.0,292,200,15.8,2017,0.0
Stephan Bennett,239,24,201,91,96,53,964.0,11,4,40.0,190,87,15.2,2017,0.0
Lamont Walker,243,23,180,83,95,63,906.0,45,14,31.0,135,69,13.8,2017,0.0
Tyree Bynum,181,26,181,64,25,16,858.0,115,37,29.0,66,27,13.0,2017,0.0
Jamie Rutherford,26,2,42,8,6,2,131.0,38,8,1.0,4,0,17.3,2017,0.0
Eric Washington Jr.,4,0,3,1,4,2,13.0,1,0,0.0,2,1,18.7,2017,0.0
Kavin Gilder-Tilbury,1385,182,1057,477,381,262,3345.0,451,169,232.0,606,308,23.6,2017,0.0
Nijal Pearson,2122,292,1752,733,563,409,4438.0,694,247,292.0,1058,486,27.1,2017,0.0
Bobby Conley,394,109,348,135,109,68,1519.0,171,56,55.0,177,79,16.1,2017,0.0
Ojai Black,553,287,444,182,224,166,2344.0,93,23,130.0,351,159,15.5,2017,0.0
Immanuel King,494,54,356,204,169,86,1533.0,0,0,84.0,356,204,18.1,2017,0.0
Nedeljko Prijovic,606,110,533,228,111,76,2069.0,253,74,106.0,280,154,17.7,2017,0.0
Marlin Davis,440,298,410,159,129,83,2082.0,139,39,133.0,271,120,15.4,2017,0.0
Tyler Blount,328,50,291,119,27,17,1091.0,188,73,32.0,103,46,16.3,2017,0.0
Maljhum McCrea,147,13,145,65,43,17,473.0,4,0,36.0,141,65,22.7,2017,0.0
Maxwell Starwood,256,24,251,114,32,20,783.0,21,8,62.0,230,106,20.9,2017,0.0
Nathan Josephs,36,9,28,10,10,8,79.0,18,8,5.0,10,2,25.5,2017,0.0
Deris Duncan,77,12,71,25,23,18,313.0,32,9,15.0,39,16,16.4,2017,0.0
Courtney Julien,35,7,37,10,12,9,131.0,20,6,5.0,17,4,19.4,2017,0.0
Keenan Evans,1571,346,1103,490,575,458,3390.0,369,133,223.0,734,357,24.6,2017,0.0
Zach Smith,1033,168,768,393,354,220,3353.0,90,27,180.0,678,366,17.5,2017,0.0
Anthony Livingston,1257,74,1007,445,343,263,2755.0,306,104,163.0,701,341,24.5,2017,0.0
Justin Gray,844,126,603,305,263,200,2728.0,110,34,121.0,493,271,16.3,2017,0.0
Niem Stevenson,535,114,439,183,168,109,1410.0,155,60,67.0,284,123,21.6,2017,0.0
Aaron Ross,739,79,518,225,252,216,1806.0,208,73,93.0,310,152,21.4,2017,0.0
Devon Thomas,318,176,266,122,104,62,1547.0,55,12,92.0,211,110,14.0,2017,0.0
Shadell Millinghaus,255,42,184,84,101,65,703.0,67,22,46.0,117,62,21.6,2017,0.0
Matthew Temple,161,30,126,62,42,26,571.0,25,11,40.0,101,51,17.1,2017,0.0
Thomas Brandsma,25,1,16,8,9,7,131.0,5,2,6.0,11,6,10.7,2017,0.0
Gio McLean,398,101,365,129,103,81,1001.0,181,59,89.0,184,70,23.6,2017,0.0
Norense Odiase,691,82,503,265,282,160,2265.0,2,1,159.0,501,264,18.4,2017,0.0
Jarrett Allen,442,27,316,179,149,84,1061.0,7,0,84.0,309,179,22.6,2017,1.0
Andrew Jones,1249,257,1013,426,282,219,2796.0,498,178,219.0,515,248,25.1,2017,0.0
Kerwin Roach Jr.,1411,372,1111,479,485,315,3529.0,405,138,283.0,706,341,23.8,2017,0.0
Shaquille Cleare,618,32,458,257,161,104,1997.0,1,0,105.0,457,257,16.3,2017,0.0
Eric Davis Jr.,707,71,655,237,153,113,2233.0,372,120,89.0,283,117,18.8,2017,0.0
Tevin Mack,1073,80,949,391,213,128,2487.0,511,163,123.0,438,228,24.3,2017,0.0
Kendal Yancy,576,118,484,204,174,109,1996.0,174,59,86.0,310,145,16.7,2017,0.0
Jacob Young,960,200,886,365,186,126,2526.0,352,104,196.0,534,261,23.7,2017,0.0
James Banks III,695,83,495,264,264,167,2341.0,1,0,163.0,494,264,17.1,2017,0.0
Mareik Isom,576,33,456,187,137,101,1619.0,268,101,53.0,188,86,18.6,2017,0.0
Ryan McClurg,13,1,7,4,9,5,38.0,0,0,4.0,7,4,21.0,2017,0.0
Isaiah Hobbs,97,13,72,30,60,37,404.0,15,0,34.0,57,30,17.7,2017,0.0
Joe Schwartz,4,1,6,1,4,1,11.0,5,1,0.0,1,0,37.2,2017,0.0
Steve Taylor Jr.,854,154,715,355,236,121,2303.0,106,23,175.0,609,332,22.6,2017,0.0
Jaelan Sanford,1789,373,1404,618,391,315,4377.0,646,238,219.0,758,380,20.8,2017,0.0
Nate Navigato,1427,235,1053,461,241,196,3884.0,733,309,114.0,320,152,16.6,2017,0.0
Jordan Lauf,702,159,430,231,275,188,3045.0,149,52,83.0,281,179,10.7,2017,0.0
Luke Knapke,1451,214,1004,534,349,262,3406.0,301,121,226.0,703,413,20.7,2017,0.0
Taylor Adway,262,21,191,98,115,66,839.0,1,0,63.0,190,98,18.6,2017,0.0
Zach Garber,377,41,219,107,231,162,1590.0,7,1,71.0,212,106,12.6,2017,0.0
Daniel Dzierzawski,50,11,42,18,15,13,109.0,6,1,17.0,36,17,30.9,2017,0.0
Lucas Antunez,14,10,12,2,10,9,89.0,6,1,8.0,6,1,14.1,2017,0.0
Matt Schaffer,11,2,12,3,4,3,36.0,9,2,2.0,3,1,22.3,2017,0.0
Fred John Jr.,6,0,3,2,3,2,21.0,0,0,1.0,3,2,12.9,2017,0.0
Mike Morsell,1523,180,1218,519,457,335,3407.0,459,150,235.0,759,369,24.4,2017,0.0
Arnaud William Adala Moto,1284,129,964,413,609,424,2957.0,137,34,246.0,827,379,25.3,2017,0.0
Deshaun Morman,594,117,453,195,233,174,1574.0,95,30,117.0,358,165,21.7,2017,0.0
John Davis,1114,55,881,431,336,221,2483.0,91,31,138.0,790,400,24.0,2017,0.0
Brian Starr,444,138,363,149,125,94,1725.0,156,52,100.0,207,97,14.9,2017,0.0
Zane Martin,1396,273,1183,502,376,266,2716.0,401,126,222.0,782,376,28.7,2017,0.0
Eddie Keith,750,201,604,266,291,163,2796.0,168,55,162.0,436,211,16.2,2017,0.0
Jordan McNeil,558,94,496,202,120,75,1893.0,240,79,106.0,256,123,17.5,2017,0.0
Alex Thomas,343,37,289,135,116,71,1700.0,7,2,84.0,282,133,12.6,2017,0.0
Justin Gorham,750,88,560,276,249,168,2314.0,95,30,103.0,465,246,16.7,2017,0.0
Dennis Tunstall,462,50,330,198,100,57,2283.0,32,9,63.0,298,189,9.9,2017,0.0
Van Rolle,36,12,46,11,18,8,139.0,21,6,14.0,25,5,23.9,2017,0.0
Jordon Varnado,1917,172,1421,717,508,364,3434.0,346,119,215.0,1075,598,27.2,2017,0.0
Wesley Person,2063,192,1522,642,521,418,4382.0,947,361,197.0,575,281,22.4,2017,1.0
Jeremy Hollimon,761,109,609,247,251,184,1643.0,241,83,120.0,368,164,25.4,2017,0.0
Kevin Baker,524,216,494,151,149,105,1712.0,384,117,125.0,110,34,20.0,2017,0.0
DeVon Walker,434,89,374,144,179,118,1797.0,110,28,83.0,264,116,15.2,2017,0.0
Juan Davis Jr.,442,15,332,153,79,60,1399.0,197,76,53.0,135,77,15.0,2017,0.0
Alex Hicks,947,72,698,365,261,177,2313.0,128,40,162.0,570,325,21.3,2017,0.0
Daniel Peace,229,178,191,74,156,80,1304.0,11,1,125.0,180,73,14.8,2017,0.0
Shawn Hopkins,237,33,215,80,55,34,793.0,141,43,41.0,74,37,17.6,2017,0.0
B.J. Miller,684,264,525,251,182,138,2662.0,156,44,170.0,369,207,14.7,2017,0.0
Jaro Moravek,110,16,113,39,21,13,488.0,78,19,18.0,35,20,14.3,2017,0.0
Aaron Ariri,102,5,91,39,54,24,553.0,2,0,28.0,89,39,13.2,2017,0.0
Whit Moreman,12,1,12,5,5,2,28.0,0,0,2.0,12,5,28.9,2017,0.0
Cameron Reynolds,1370,157,1262,489,278,199,3546.0,577,193,163.0,685,296,22.1,2017,1.0
Melvin Frazier,997,156,746,359,303,198,2601.0,260,81,187.0,486,278,20.6,2017,0.0
Malik Morgan,983,278,853,345,248,164,2964.0,394,129,215.0,459,216,19.7,2017,0.0
Kain Harris,463,28,435,152,111,89,1149.0,226,70,65.0,209,82,23.7,2017,0.0
Ryan Smith,415,32,343,169,132,77,1617.0,1,0,93.0,342,169,15.5,2017,0.0
Ray Ona Embo,526,172,442,178,146,107,1870.0,190,63,100.0,252,115,16.3,2017,0.0
Colin Slater,595,120,548,201,140,116,1794.0,245,77,110.0,303,124,20.0,2017,0.0
Blake Paul,400,65,317,160,125,80,1653.0,1,0,109.0,316,160,14.6,2017,0.0
Von Julien,601,372,533,199,187,133,2962.0,211,70,227.0,322,129,14.1,2017,0.0
Sammis Reyes,24,8,34,9,23,6,254.0,0,0,17.0,34,9,11.9,2017,0.0
D.J. Jones,554,76,575,246,108,62,1976.0,16,0,120.0,559,246,18.9,2017,0.0
Riley Conroy,0,1,9,0,0,0,33.0,8,0,1.0,1,0,15.1,2017,0.0
Jackson Johnson,1,0,1,0,3,1,8.0,0,0,0.0,1,0,15.0,2017,0.0
Bernard Woodside,0,0,0,0,0,0,2.0,0,0,0.0,0,0,0.0,2017,0.0
Junior Etou,1239,125,898,403,436,313,3418.0,340,120,221.0,558,283,19.9,2017,0.0
Sterling Taplin,1030,406,818,339,327,241,2918.0,315,111,248.0,503,228,21.5,2017,0.0
Pat Birt,848,98,758,271,199,152,2371.0,442,154,98.0,316,117,20.6,2017,0.0
Jaleel Wheeler,417,83,320,140,170,117,1444.0,76,20,103.0,244,120,17.9,2017,0.0
Corey Henderson,655,82,573,206,136,107,1783.0,385,136,69.0,188,70,20.4,2017,0.0
Martins Igbanu,1310,70,790,450,597,400,2881.0,30,10,224.0,760,440,23.4,2017,0.0
Will Magnay,124,8,83,48,49,28,449.0,1,0,33.0,82,48,16.0,2017,0.0
Lawson Korita,546,113,486,179,122,88,2239.0,310,100,81.0,176,79,14.5,2017,0.0
Travis Atson,480,70,406,176,88,66,1276.0,183,62,89.0,223,114,20.8,2017,0.0
Geno Artison,95,16,107,33,17,11,443.0,67,18,13.0,40,15,14.8,2017,0.0
Corey Haith,17,5,15,5,4,2,65.0,15,5,6.0,0,0,17.9,2017,0.0
Joseph Battle,82,10,46,25,42,32,262.0,0,0,19.0,46,25,15.5,2017,0.0
Alex Foree,2,1,3,1,0,0,7.0,2,0,0.0,1,1,21.9,2017,0.0
TJ Leaf,569,85,381,235,106,72,1048.0,58,27,52.0,323,208,22.0,2017,1.0
Bryce Alford,1922,537,1443,584,515,425,4509.0,829,329,235.0,614,255,20.8,2017,0.0
Lonzo Ball,524,274,343,189,98,66,1263.0,194,80,89.0,149,109,18.1,2017,1.0
Isaac Hamilton,1426,321,1202,538,203,157,3431.0,513,193,230.0,689,345,21.6,2017,0.0
Aaron Holiday,1443,477,1058,476,391,311,3209.0,427,180,304.0,631,296,23.3,2017,1.0
Thomas Welsh,1248,103,990,532,173,138,3295.0,113,46,90.0,877,486,17.1,2017,1.0
Ike Anigbogu,137,6,101,57,43,23,377.0,0,0,24.0,101,57,18.4,2017,1.0
Gyorgy Goloman,441,86,323,169,133,76,1764.0,73,27,85.0,250,142,13.0,2017,0.0
Jerrold Smith,7,2,13,3,2,1,35.0,3,0,3.0,10,3,23.1,2017,0.0
Alec Wulff,23,5,15,7,2,2,58.0,14,7,1.0,1,0,14.2,2017,0.0
Isaac Wulff,7,0,6,2,4,3,15.0,2,0,0.0,4,2,25.7,2017,0.0
Armani Dodson,4,0,2,2,0,0,20.0,0,0,0.0,2,2,4.9,2017,0.0
Ikenna Okwarabizie,8,0,9,3,6,2,73.0,1,0,6.0,8,3,11.8,2017,0.0
Jalen Moore,1645,241,1210,574,435,325,3833.0,449,172,166.0,761,402,22.1,2017,0.0
Koby McEwen,1481,367,1118,449,510,387,3597.0,568,196,317.0,550,253,23.8,2017,0.0
Sam Merrill,2197,477,1521,715,503,448,4371.0,759,319,208.0,762,396,22.8,2017,0.0
Shane Rector,523,170,415,175,184,132,1488.0,126,41,134.0,289,134,22.0,2017,0.0
Norbert Janicek,207,17,157,91,49,24,659.0,3,1,52.0,154,90,18.7,2017,0.0
Quinn Taylor,791,175,572,319,176,108,2676.0,124,45,112.0,448,274,14.6,2017,0.0
Alexis Dargenton,332,56,242,113,149,98,1137.0,32,8,77.0,210,105,17.8,2017,0.0
Julion Pearre,646,140,566,226,119,84,2221.0,319,110,115.0,247,116,17.8,2017,0.0
Ngor Barnaba,73,14,83,27,17,12,275.0,37,7,16.0,46,20,0,2017,0.0
Diogo Brito,794,246,655,274,201,142,2723.0,325,104,169.0,330,170,17.2,2017,0.0
Connor Garner,14,2,9,5,0,0,32.0,8,4,3.0,1,1,0,2017,0.0
Abel Porter,406,221,307,121,154,110,1802.0,160,54,113.0,147,67,13.7,2017,0.0
Conner Toolson,1224,138,990,430,217,168,2972.0,553,196,140.0,437,234,20.5,2017,0.0
Jordan Poydras,364,73,310,115,93,71,832.0,196,63,45.0,114,52,22.8,2017,0.0
Kenneth Ogbe,1014,111,696,317,312,219,2412.0,384,161,144.0,312,156,20.5,2017,0.0
Isaac Neilson,601,55,410,235,157,110,1544.0,57,21,99.0,353,214,18.2,2017,0.0
Zach Nelson,1001,246,775,386,229,153,2859.0,262,76,217.0,513,310,20.3,2017,0.0
Ivory Young,432,111,391,141,87,66,1247.0,232,84,94.0,159,57,20.1,2017,0.0
Hayden Schenck,332,117,206,92,168,122,1306.0,83,26,94.0,123,66,13.9,2017,0.0
Andrew Bastien,144,12,107,56,56,32,594.0,0,0,29.0,107,56,13.1,2017,0.0
Joonas Tahvanainen,68,9,57,26,18,12,268.0,19,4,19.0,38,22,15.0,2017,0.0
Telly Davenport,60,28,49,23,24,12,203.0,15,2,29.0,34,21,21.0,2017,0.0
Jeffrey Yan,2,0,0,0,4,2,5.0,0,0,1.0,0,0,27.6,2017,0.0
Kyle Kuzma,966,141,735,372,270,171,2013.0,169,51,151.0,566,321,25.9,2017,1.0
Lorenzo Bonam,767,205,522,283,186,149,1913.0,142,52,130.0,380,231,19.7,2017,0.0
David Collette,1114,103,752,456,303,196,2088.0,15,6,117.0,737,450,26.2,2017,0.0
Devon Daniels,1224,242,1003,474,258,178,3018.0,296,98,220.0,707,376,21.9,2017,0.0
JoJo Zamora,483,68,397,172,78,60,1182.0,214,79,68.0,183,93,21.1,2017,0.0
Sedrick Barefield,1121,247,885,359,270,219,2491.0,490,184,182.0,395,175,24.8,2017,0.0
Tyler Rawson,787,211,589,269,218,156,2215.0,267,93,148.0,322,176,19.9,2017,0.0
Parker Van Dyke,606,166,521,212,58,40,2166.0,390,142,72.0,131,70,14.8,2017,0.0
Jayce Johnson,600,36,411,236,261,128,1928.0,0,0,115.0,411,236,17.2,2017,0.0
Gabe Bealer,360,28,280,126,43,30,1072.0,197,78,37.0,83,48,16.4,2017,0.0
Jake Connor,59,13,51,21,6,2,186.0,43,15,5.0,8,6,16.4,2017,0.0
Jakub Jokl,21,3,12,7,10,7,86.0,0,0,6.0,12,7,13.6,2017,0.0
Marc Reininger,11,0,9,3,8,4,76.0,1,1,6.0,8,2,12.6,2017,0.0
Beau Rydalch,17,3,19,5,8,5,81.0,12,2,6.0,7,3,18.0,2017,0.0
Alec Peters,2348,204,1623,790,566,479,4250.0,694,289,248.0,929,501,25.6,2017,1.0
Shane Hammink,883,166,633,309,256,197,2215.0,221,68,184.0,412,241,21.0,2017,0.0
Tevonn Walker,1405,195,1141,470,458,342,3374.0,408,123,182.0,733,347,23.1,2017,0.0
Max Joseph,501,172,389,169,188,119,2031.0,136,44,116.0,253,125,14.8,2017,0.0
Jaume Sorolla,474,51,364,188,137,96,1735.0,3,2,86.0,361,186,15.1,2017,0.0
Micah Bradford,573,203,553,189,163,104,1782.0,299,91,138.0,254,98,21.5,2017,0.0
Derrik Smits,793,81,548,310,284,173,1853.0,4,0,178.0,544,310,24.1,2017,0.0
Jubril Adekoya,648,105,468,234,226,149,2227.0,77,31,144.0,391,203,16.5,2017,0.0
John Kiser,399,121,308,144,88,69,1999.0,129,42,68.0,179,102,10.7,2017,0.0
Nick Davidson,118,41,93,34,38,34,441.0,46,16,17.0,47,18,14.8,2017,0.0
Jason Karys,9,1,9,2,4,3,17.0,8,2,3.0,1,0,40.7,2017,0.0
Chandler Levingston Simon,12,3,14,6,0,0,75.0,0,0,1.0,14,6,9.9,2017,0.0
Matthew Fisher-Davis,1219,138,985,388,217,174,3044.0,685,269,129.0,300,119,21.1,2017,0.0
Luke Kornet,1135,143,918,383,281,219,3085.0,469,150,138.0,449,233,20.5,2017,1.0
Jeff Roberson,1373,185,925,427,465,373,3705.0,370,146,195.0,555,281,19.1,2017,0.0
Riley LaChance,1476,423,1151,498,264,220,4091.0,630,260,198.0,521,238,19.1,2017,0.0
Nolan Cressler,1172,153,976,432,184,134,2827.0,464,174,156.0,512,258,22.6,2017,0.0
Joe Toye,737,96,623,249,218,144,2368.0,299,95,138.0,324,154,18.9,2017,0.0
Payton Willis,834,219,703,287,145,100,2660.0,449,160,131.0,254,127,18.0,2017,0.0
Djery Baptiste,268,14,210,104,101,60,1359.0,0,0,80.0,210,104,12.9,2017,0.0
Clevon Brown,424,33,357,172,109,51,1907.0,116,29,92.0,241,143,13.5,2017,0.0
Camron Justice,987,148,783,317,234,193,2147.0,464,160,155.0,319,157,24.0,2017,0.0
Phillip McGloin,11,1,10,3,4,3,23.0,7,2,3.0,3,1,33.6,2017,0.0
Anthony Lamb,1933,195,1440,685,535,419,3243.0,428,144,248.0,1012,541,31.9,2017,0.0
Trae Bell-Haynes,1629,518,1066,524,657,501,3944.0,208,80,373.0,858,444,23.8,2017,0.0
Payton Henson,1072,124,842,374,314,241,2975.0,266,83,151.0,576,291,20.8,2017,0.0
Ernie Duncan,1489,308,1085,479,268,223,3840.0,735,308,183.0,350,171,19.3,2017,0.0
Kurt Steidl,1146,135,851,362,244,198,3461.0,567,224,129.0,284,138,16.8,2017,0.0
Darren Payen,607,23,430,248,165,107,1591.0,24,4,102.0,406,244,19.9,2017,0.0
Dre Wills,772,188,523,304,290,159,2290.0,25,5,161.0,498,299,19.2,2017,0.0
Drew Urquhart,823,108,587,313,257,182,2084.0,38,15,138.0,549,298,21.8,2017,0.0
Cam Ward,851,266,659,276,247,161,2621.0,376,138,130.0,283,138,18.4,2017,0.0
Josh Hearlihy,454,123,346,141,162,122,1453.0,133,50,122.0,213,91,18.9,2017,0.0
Nate Rohrer,164,39,114,63,49,32,835.0,24,6,17.0,90,57,9.7,2017,0.0
David Urso,8,8,23,3,2,0,108.0,15,2,7.0,8,1,15.3,2017,0.0
Josh Hart,1921,266,1326,677,500,360,4093.0,532,207,194.0,794,470,22.7,2017,1.0
Jalen Brunson,1667,432,1135,579,405,332,3349.0,450,177,217.0,685,402,24.0,2017,1.0
Kris Jenkins,1383,215,1039,432,305,255,3319.0,708,264,137.0,331,168,21.1,2017,0.0
Mikal Bridges,1311,183,873,458,265,224,3171.0,428,171,124.0,445,287,18.3,2017,1.0
Donte DiVincenzo,870,204,646,303,190,134,2163.0,344,130,137.0,302,173,20.9,2017,1.0
Eric Paschall,1687,209,1259,589,443,339,4057.0,513,170,265.0,746,419,22.3,2017,1.0
Darryl Reynolds,327,38,179,120,138,87,1634.0,0,0,79.0,179,120,10.5,2017,0.0
Dylan Painter,431,52,268,149,185,131,1033.0,8,2,84.0,260,147,22.3,2017,0.0
Phil Booth,1507,374,1136,492,381,299,3636.0,603,224,219.0,533,268,22.2,2017,0.0
Tim Delaney,7,3,8,2,2,1,83.0,7,2,4.0,1,0,8.1,2017,0.0
Denny Grace,3,0,3,1,0,0,29.0,3,1,3.0,0,0,10.5,2017,0.0
Matt Kennedy,2,0,1,1,0,0,30.0,0,0,0.0,1,1,1.7,2017,0.0
Tom Leibig,2,0,5,1,1,0,33.0,4,0,1.0,1,1,9.9,2017,0.0
JeQuan Lewis,1444,505,1074,457,416,341,3447.0,505,189,320.0,569,268,22.8,2017,0.0
Justin Tillman,1415,37,1022,586,354,216,2876.0,85,27,127.0,937,559,22.6,2017,0.0
Mo Alie-Cox,1092,112,705,405,409,281,3322.0,1,1,162.0,704,404,15.8,2017,0.0
Samir Doughty,1123,227,840,355,369,284,2812.0,369,129,194.0,471,226,21.0,2017,0.0
Jonathan Williams,783,388,656,276,300,210,2573.0,87,21,176.0,569,255,18.8,2017,0.0
Ahmed Hamdy Mohamed,581,21,443,218,239,145,1292.0,1,0,99.0,442,218,25.1,2017,0.0
Doug Brooks,563,139,529,179,142,97,1889.0,343,108,93.0,186,71,18.1,2017,0.0
Jordan Burgess,636,131,625,225,175,95,2812.0,314,91,118.0,311,134,14.5,2017,0.0
De'Riante Jenkins,1179,215,986,413,200,157,2879.0,524,196,186.0,462,217,21.9,2017,0.0
Malik Crowfield,436,106,392,145,40,28,1885.0,324,118,58.0,68,27,12.4,2017,0.0
Marquell Fraser,427,145,335,153,169,117,1373.0,33,4,97.0,302,149,19.4,2017,0.0
Torey Burston,18,16,30,4,17,9,173.0,7,1,6.0,23,3,12.6,2017,0.0
QJ Peterson,2200,300,1794,715,614,487,3681.0,845,283,300.0,949,432,30.5,2017,0.0
Julian Eleby,1178,234,931,364,348,274,2865.0,517,176,223.0,414,188,22.0,2017,0.0
Trey Chapman,841,115,723,301,282,183,2679.0,210,56,179.0,513,245,18.3,2017,0.0
Armani Branch,427,44,397,166,83,53,1150.0,152,42,77.0,245,124,21.8,2017,0.0
Adrian Rich,294,104,283,113,49,36,1386.0,112,32,96.0,171,81,14.5,2017,0.0
Keith Smith,602,314,549,217,140,93,2638.0,213,75,201.0,336,142,15.8,2017,1.0
Will Miller,223,53,191,95,37,18,1066.0,58,15,54.0,133,80,12.3,2017,0.0
Garrett Gilkeson,905,263,798,299,235,184,3180.0,382,123,159.0,416,176,16.8,2017,0.0
Fred Iruafemi,270,64,218,110,78,50,1497.0,1,0,69.0,217,110,10.4,2017,0.0
Austin Vereen,570,70,509,177,146,113,2072.0,312,103,87.0,197,74,16.2,2017,0.0
Tyler Creammer,520,77,437,197,177,118,1760.0,36,8,122.0,401,189,18.2,2017,0.0
Chuchu Enechionyia,3,1,6,1,4,1,26.0,4,0,2.0,2,1,19.0,2017,0.0
Kuony Deng,0,0,0,0,0,0,1.0,0,0,0.0,0,0,0.0,2017,0.0
Marcus Larsson,0,0,1,0,0,0,3.0,0,0,0.0,1,0,16.6,2017,0.0
D'Andre Mahaffey,2,1,5,0,4,2,47.0,4,0,4.0,1,0,11.6,2017,0.0
Will Weethee,2,0,2,0,2,2,16.0,2,0,2.0,0,0,15.5,2017,0.0
Zach LeDay,1346,109,916,442,552,420,3029.0,134,42,152.0,782,400,22.7,2017,0.0
Seth Allen,1487,338,1125,484,443,335,3297.0,529,184,292.0,596,300,24.9,2017,0.0
Ahmed Hill,1473,167,1155,514,290,215,4024.0,589,230,162.0,566,284,19.4,2017,0.0
Justin Bibbs,1457,189,1160,523,221,157,4049.0,599,254,168.0,561,269,18.5,2017,0.0
Chris Clarke,896,347,615,324,338,228,2713.0,66,20,224.0,549,304,18.9,2017,0.0
Ty Outlaw,670,58,502,226,85,65,2056.0,343,153,57.0,159,73,15.2,2017,0.0
Khadim Sy,450,33,343,179,113,79,1248.0,44,13,84.0,299,166,19.8,2017,0.0
Seth LeDay,385,53,279,147,137,90,847.0,4,1,77.0,275,146,24.9,2017,0.0
Johnny Hamilton,421,23,261,163,150,95,939.0,1,0,70.0,260,163,20.3,2017,0.0
Matt Galloway,8,2,19,3,0,0,74.0,17,2,2.0,2,1,14.4,2017,0.0
Greg Donlon,14,0,10,5,6,4,37.0,0,0,1.0,10,5,19.1,2017,0.0
London Perrantes,1225,569,981,397,271,220,4425.0,516,211,211.0,465,186,17.2,2017,1.0
Marial Shayok,1221,174,968,455,235,185,2842.0,331,126,176.0,637,329,24.2,2017,1.0
Devon Hall,884,264,728,305,197,159,3075.0,296,115,115.0,432,190,17.6,2017,1.0
Kyle Guy,1323,173,1075,466,170,137,3081.0,597,254,116.0,478,212,23.8,2017,1.0
Isaiah Wilkins,645,156,520,264,161,108,2866.0,30,9,105.0,490,255,14.1,2017,0.0
Darius Thompson,975,394,746,344,257,183,3309.0,308,104,165.0,438,240,16.6,2017,0.0
Ty Jerome,1011,384,835,363,151,119,2775.0,424,166,145.0,411,197,21.9,2017,1.0
Jack Salt,415,38,300,177,132,61,2053.0,0,0,76.0,300,177,12.3,2017,0.0
Mamadi Diakite,997,41,756,396,246,177,2795.0,83,28,137.0,673,368,21.0,2017,0.0
Jarred Reuter,403,76,318,158,125,87,1074.0,1,0,79.0,317,158,22.9,2017,0.0
Austin Nichols,684,43,547,294,161,94,1586.0,11,2,72.0,536,292,21.9,2017,0.0
Justice Bartley,15,2,16,6,4,1,61.0,7,2,11.0,9,4,27.4,2017,0.0
Trevon Gross Jr.,15,7,28,6,5,0,124.0,16,3,8.0,12,3,17.0,2017,0.0
Jeff Jones,10,1,14,4,3,1,70.0,7,1,5.0,7,3,16.7,2017,0.0
Corey Henson,1233,246,1030,426,227,185,3210.0,545,196,195.0,485,230,20.5,2017,0.0
Michael Carey,843,103,653,318,221,176,2015.0,103,31,123.0,550,287,21.8,2017,0.0
Mike Aaman,847,44,695,329,295,189,2037.0,1,0,130.0,694,329,23.7,2017,0.0
JoJo Cooper,1018,517,870,320,428,295,3624.0,288,83,319.0,582,237,18.8,2017,0.0
Blake Francis,1518,178,1217,516,287,226,3107.0,674,260,152.0,543,256,24.5,2017,0.0
Connor Ferrell,153,23,139,49,50,35,575.0,77,20,23.0,62,29,16.3,2017,0.0
AJ Sumbry,613,34,484,224,289,165,2015.0,3,0,142.0,481,224,18.7,2017,0.0
Devin Liggeons,505,66,418,163,176,128,1863.0,186,51,123.0,232,112,16.6,2017,0.0
Elijah Davis,649,71,544,223,179,141,1742.0,209,62,126.0,335,161,21.5,2017,0.0
Greg Senat,238,13,193,92,110,54,1094.0,0,0,57.0,193,92,13.5,2017,0.0
Shack Scott,111,5,93,47,30,16,464.0,2,1,14.0,91,46,12.8,2017,0.0
Romone Saunders,1335,257,1099,434,354,278,3109.0,546,189,210.0,553,245,23.4,2017,0.0
Marquis Salmon,190,11,129,75,66,38,771.0,5,2,34.0,124,73,12.2,2017,0.0
Jamar Brown,138,11,106,53,65,32,352.0,1,0,53.0,105,53,25.6,2017,0.0
John Collins,859,24,524,315,314,229,1324.0,1,0,91.0,523,315,27.8,2017,1.0
Bryant Crawford,1470,467,1133,471,450,361,2988.0,476,167,283.0,657,304,26.5,2017,0.0
Keyshawn Woods,1299,294,1042,480,236,185,3500.0,389,154,188.0,653,326,19.2,2017,0.0
Konstantinos Mitoglou,890,64,674,290,245,187,2262.0,354,123,128.0,320,167,19.8,2017,0.0
Austin Arians,1236,153,984,422,179,145,3529.0,671,247,109.0,313,175,17.0,2017,0.0
Mitchell Wilbekin,889,177,747,272,179,148,3196.0,510,197,84.0,237,75,14.0,2017,0.0
Brandon Childress,1415,443,1105,425,467,375,3687.0,535,190,280.0,570,235,21.4,2017,0.0
Doral Moore,538,11,357,233,144,72,1262.0,0,0,90.0,357,233,20.0,2017,0.0
Greg McClinton,229,34,188,92,77,44,949.0,6,1,58.0,182,91,14.6,2017,0.0
Sam Japhet-Mathias,78,6,89,32,19,13,325.0,15,1,35.0,74,31,19.7,2017,0.0
Trent VanHorn,46,13,40,13,25,19,319.0,13,1,15.0,27,12,10.1,2017,0.0
DJ Mitchell,560,82,407,197,150,108,1459.0,156,58,95.0,251,139,19.6,2017,0.0
Troy Rike,12,2,11,5,3,1,31.0,3,1,2.0,8,4,22.8,2017,0.0
Rich Washington,2,3,6,1,0,0,17.0,4,0,1.0,2,1,20.0,2017,0.0
Aaron Spivey,13,3,11,4,7,4,36.0,6,1,1.0,5,3,20.9,2017,0.0
Anthony Bilas,5,2,8,2,2,0,27.0,2,1,3.0,6,1,21.7,2017,0.0
Josh Hawkinson,1414,158,995,520,399,324,3259.0,143,50,150.0,852,470,21.4,2017,0.0
Ike Iroegbu,1232,375,965,418,387,280,3409.0,329,116,252.0,636,302,21.6,2017,0.0
Charles Callison,514,148,455,194,80,60,1514.0,174,66,96.0,281,128,20.2,2017,0.0
Malachi Flynn,1355,385,1072,450,293,244,3132.0,582,211,188.0,490,239,23.4,2017,0.0
Conor Clifford,583,41,420,248,106,87,1297.0,2,0,116.0,418,248,23.5,2017,0.0
Robert Franks,1349,161,992,463,310,257,2619.0,439,166,211.0,553,297,26.3,2017,0.0
Viont'e Daniels,556,175,433,186,62,47,2280.0,326,137,76.0,107,49,12.1,2017,0.0
Derrien King,412,58,402,133,100,80,1444.0,199,66,86.0,203,67,18.7,2017,0.0
Jeff Pollard,540,54,396,213,134,97,1829.0,68,17,65.0,328,196,14.4,2017,0.0
KJ Langston,36,6,54,15,2,0,185.0,31,6,7.0,23,9,17.9,2017,0.0
Steven Shpreyregin,38,2,43,13,3,2,143.0,37,10,2.0,6,3,16.8,2017,0.0
Markelle Fultz,579,148,439,209,168,109,892.0,126,52,80.0,313,157,31.4,2017,1.0
David Crisp,1507,356,1341,518,325,215,4116.0,766,256,271.0,575,262,20.9,2017,0.0
Noah Dickerson,1609,96,1040,562,682,482,3425.0,16,3,259.0,1024,559,23.1,2017,0.0
Matisse Thybulle,1242,276,1027,441,216,169,3963.0,534,191,252.0,493,250,17.0,2017,1.0
Carlos Johnson,1196,123,909,421,367,268,2519.0,264,86,215.0,645,335,26.1,2017,0.0
Dominic Green,640,72,615,212,103,70,2458.0,428,146,78.0,187,66,14.7,2017,0.0
Malik Dime,344,19,230,133,112,78,1149.0,0,0,50.0,230,133,13.0,2017,0.0
Sam Timmins,376,31,279,157,114,57,1681.0,15,5,118.0,264,152,13.3,2017,0.0
Matthew Atewe,268,18,204,105,113,58,1072.0,0,0,69.0,204,105,15.4,2017,0.0
Dan Kingma,59,18,49,18,19,10,252.0,34,13,15.0,15,5,14.0,2017,0.0
Greg Bowman,32,2,23,15,7,2,64.0,2,0,1.0,21,15,20.0,2017,0.0
Bitumba Baruti,261,39,280,100,50,33,1166.0,119,28,58.0,161,72,15.6,2017,0.0
Devenir Duruisseau,39,2,34,14,22,11,205.0,4,0,14.0,30,14,12.7,2017,0.0
Quin Barnard,8,4,5,2,2,2,27.0,5,2,1.0,0,0,12.2,2017,0.0
Jeremy Senglin,2078,345,1444,668,545,397,4183.0,823,345,269.0,621,323,25.0,2017,0.0
Kyndahl Hill,1005,110,663,343,388,294,3224.0,83,25,169.0,580,318,16.7,2017,0.0
Zach Braxton,1242,113,774,456,542,330,3065.0,1,0,190.0,773,456,20.7,2017,0.0
Jerrick Harding,2266,183,1591,790,544,473,3582.0,572,213,245.0,1019,577,30.5,2017,0.0
Dusty Baker,676,230,427,195,203,171,2052.0,244,115,123.0,183,80,16.5,2017,0.0
Ryan Richardson,1024,183,819,343,133,103,2870.0,596,235,157.0,223,108,19.1,2017,0.0
Cody John,1354,241,1122,499,317,243,3580.0,371,113,197.0,751,386,21.3,2017,0.0
Jordan Dallas,211,9,154,76,53,39,804.0,53,20,35.0,101,56,13.6,2017,0.0
Richaud Gittens,1063,262,858,356,301,214,3482.0,367,137,212.0,491,219,18.2,2017,0.0
Brenden Morris,54,3,39,21,8,6,93.0,16,6,3.0,23,15,25.8,2017,0.0
Jevon Carter,1758,559,1441,587,430,343,4299.0,678,241,264.0,763,346,21.0,2017,1.0
Esa Ahmad,1039,192,767,356,429,285,2644.0,142,42,220.0,625,314,21.0,2017,0.0
Nathan Adrian,792,198,686,284,178,120,2920.0,334,104,127.0,352,180,14.5,2017,0.0
Tarik Phillip,814,238,589,248,336,240,2118.0,211,78,161.0,378,170,20.0,2017,1.0
Daxter Miles Jr.,1311,241,1070,464,317,202,3256.0,540,181,146.0,530,283,19.7,2017,0.0
Elijah Macon,518,65,393,203,210,112,1456.0,0,0,103.0,393,203,19.1,2017,0.0
Teyvon Myers,282,68,239,100,85,61,729.0,59,21,55.0,180,79,21.4,2017,0.0
Lamont West,1257,86,1009,408,302,241,2833.0,598,200,148.0,411,208,21.7,2017,0.0
Brandon Watkins,296,26,254,127,91,42,1069.0,0,0,58.0,254,127,15.8,2017,0.0
Sagaba Konate,650,45,499,254,176,133,1511.0,23,9,95.0,476,245,21.0,2017,0.0
James Bolden,864,124,695,278,179,145,1768.0,425,163,126.0,270,115,23.9,2017,0.0
Maciej Bender,496,60,417,209,158,77,1427.0,9,1,92.0,408,208,20.3,2017,0.0
James Long,33,3,30,11,5,3,113.0,23,8,3.0,7,3,15.1,2017,0.0
Chase Harler,406,101,399,147,59,37,1733.0,245,75,57.0,154,72,13.0,2017,0.0
Logan Routt,159,21,117,63,68,33,709.0,0,0,39.0,117,63,12.3,2017,0.0
Haboubacar Mutombo,568,101,533,238,117,56,1924.0,121,36,85.0,412,202,17.1,2017,0.0
Devin Peterson,802,283,798,293,234,164,2749.0,205,52,204.0,593,241,19.8,2017,0.0
Marc Gosselin,841,146,675,308,191,143,2993.0,230,82,212.0,445,226,16.0,2017,0.0
Adam Sledd,341,20,297,145,85,50,1149.0,2,1,62.0,295,144,17.0,2017,0.0
Onno Steger,1002,140,806,324,217,160,2886.0,496,194,196.0,310,130,18.8,2017,0.0
Elijah Pughsley,422,83,421,126,113,79,1085.0,288,91,119.0,133,35,26.8,2017,0.0
Ashley Williams,255,28,215,77,95,70,712.0,99,31,38.0,116,46,20.4,2017,0.0
Deriece Parks,443,111,425,154,62,49,1297.0,281,86,91.0,144,68,20.4,2017,0.0
Yalim Olcay,92,7,76,35,43,22,412.0,1,0,29.0,75,35,14.9,2017,0.0
Kyle Rhoades,64,11,46,22,23,16,212.0,8,4,22.0,38,18,18.3,2017,0.0
Charlendez Brooks,75,32,79,30,23,15,621.0,0,0,41.0,79,30,10.4,2017,0.0
Devonte Fuller,66,6,42,19,28,23,99.0,13,5,8.0,29,14,31.1,2017,0.0
Maurice Smith,91,31,110,35,38,16,518.0,16,5,50.0,94,30,16.7,2017,0.0
Jason McMillan,44,8,57,15,3,0,222.0,52,14,11.0,5,1,15.3,2017,0.0
Jesse Deloach,33,6,38,12,29,9,283.0,1,0,15.0,37,12,11.5,2017,0.0
Garret Covington,1896,261,1460,602,479,396,3764.0,768,296,270.0,692,306,27.7,2017,0.0
Mike Miklusak,727,121,622,249,130,92,2118.0,362,137,108.0,260,112,19.8,2017,0.0
Dalan Ancrum,742,98,606,257,162,134,1905.0,233,94,130.0,373,163,22.3,2017,0.0
C.J. Duff,1023,189,959,369,144,109,3618.0,456,176,130.0,503,193,16.4,2017,0.0
Brandon Gilbeck,872,80,629,366,267,140,2596.0,1,0,209.0,628,366,19.2,2017,0.0
De'Angelo Bruster,281,128,246,101,63,48,1166.0,89,31,88.0,157,70,16.2,2017,0.0
Jeremiah Usiosefe,259,52,214,84,68,53,1188.0,123,38,44.0,91,46,12.6,2017,0.0
Jalen Morgan,227,23,169,91,68,45,773.0,3,0,49.0,166,91,16.7,2017,0.0
Jabari Sandifer,765,369,666,248,294,201,2820.0,218,68,231.0,448,180,19.8,2017,0.0
Chris Snyder,41,5,29,18,10,5,177.0,2,0,9.0,27,18,12.5,2017,0.0
Jordan Hughes,106,0,72,44,26,18,397.0,0,0,16.0,72,44,13.1,2017,0.0
Lynrick Moxey,78,14,46,31,25,14,201.0,2,2,12.0,44,29,18.1,2017,0.0
James Claar,271,14,192,114,65,43,974.0,0,0,41.0,192,114,13.6,2017,0.0
Ryan Maas,23,2,28,9,3,2,95.0,11,3,6.0,17,6,19.3,2017,0.0
Noah Wells,5,2,5,2,0,0,18.0,3,1,0.0,2,1,14.3,2017,0.0
Justin Johnson,1715,184,1241,669,522,303,3785.0,192,74,175.0,1049,595,22.2,2017,0.0
Pancake Thomas,1179,208,911,378,301,245,2883.0,443,178,124.0,468,200,21.3,2017,0.0
Que Johnson,1257,142,1065,423,297,225,3122.0,514,186,163.0,551,237,23.0,2017,0.0
Anton Waters,358,17,277,145,102,65,1053.0,14,3,62.0,263,142,18.8,2017,0.0
Junior Lomomba,578,221,504,179,256,174,2582.0,144,46,188.0,360,133,16.2,2017,0.0
Ben Lawson,487,43,306,176,206,134,1747.0,5,1,101.0,301,175,14.7,2017,0.0
Jabari McGhee,430,32,317,162,173,106,1067.0,0,0,57.0,317,162,21.1,2017,0.0
Tobias Howard,501,144,491,176,86,64,1667.0,270,85,125.0,221,91,20.7,2017,0.0
Damari Parris,183,60,210,69,30,25,676.0,81,20,41.0,129,49,19.9,2017,0.0
Marty Leahy,32,5,22,8,11,10,168.0,12,6,6.0,10,2,10.3,2017,0.0
Willie Carmichael,102,11,84,42,26,17,498.0,5,1,32.0,79,41,14.0,2017,0.0
Tyler Miller,6,5,7,3,5,0,122.0,3,0,3.0,4,3,5.1,2017,0.0
Marko Stajkovski,0,0,0,0,0,0,3.0,0,0,0.0,0,0,0.0,2017,0.0
Thomas Wilder,2040,413,1458,641,729,590,3775.0,446,168,266.0,1012,473,27.5,2017,0.0
Tucker Haymond,1545,233,1150,518,528,382,3557.0,388,127,252.0,762,391,23.6,2017,0.0
Reggie Jones,723,161,647,257,151,115,1833.0,279,94,140.0,368,163,23.3,2017,0.0
Brandon Johnson,1264,94,978,466,412,284,3241.0,162,48,146.0,816,418,20.4,2017,0.0
Drake LaMont,882,96,713,365,232,150,2877.0,6,2,95.0,707,363,16.1,2017,0.0
Seth Dugan,1000,112,755,403,324,192,2574.0,17,2,178.0,738,401,20.9,2017,0.0
Bryce Moore,719,143,619,228,177,123,2852.0,394,140,113.0,225,88,14.2,2017,0.0
Jarrin Randall,105,33,127,37,24,15,437.0,74,16,32.0,53,21,19.1,2017,0.0
Josh Davis,809,113,690,290,219,139,2294.0,303,90,176.0,387,200,20.9,2017,1.0
Jared Printy,364,52,315,118,55,43,1524.0,247,85,44.0,68,33,12.6,2017,0.0
Joeviair Kennedy,27,2,24,12,1,1,59.0,6,2,2.0,18,10,21.8,2017,0.0
Adida Ikongshul,63,17,64,22,30,16,466.0,8,3,31.0,56,19,11.6,2017,0.0
Maxwell Omili,2,0,4,1,0,0,17.0,0,0,1.0,4,1,14.3,2017,0.0
Markis McDuffie,1525,148,1161,497,469,371,3199.0,471,160,174.0,690,337,24.1,2017,0.0
Landry Shamet,914,288,617,296,201,163,2029.0,364,159,108.0,253,137,19.8,2017,1.0
Darral Willis Jr.,698,56,477,250,256,180,1190.0,48,18,106.0,429,232,29.0,2017,0.0
Shaquille Morris,1172,104,835,456,332,238,2337.0,61,22,143.0,774,434,24.4,2017,0.0
Conner Frankamp,889,209,738,309,105,92,2307.0,468,179,44.0,270,130,17.9,2017,0.0
Zach Brown,739,152,528,229,252,181,2357.0,299,100,124.0,229,129,16.5,2017,0.0
Rashard Kelly,630,167,494,232,248,144,2448.0,69,22,143.0,425,210,15.6,2017,0.0
Rauno Nurger,425,44,309,155,126,88,1377.0,85,27,60.0,224,128,15.6,2017,0.0
Daishon Smith,844,194,562,245,259,216,1644.0,348,138,109.0,214,107,24.5,2017,0.0
Austin Reaves,1314,313,950,400,424,358,2990.0,449,156,208.0,501,244,22.9,2017,0.0
C.J. Keyser,577,73,447,212,145,105,1273.0,137,48,99.0,310,164,24.3,2017,0.0
Eric Hamilton,494,13,344,175,206,138,1360.0,26,6,63.0,318,169,18.7,2017,0.0
John Robert Simon,83,36,56,22,39,26,323.0,35,13,23.0,21,9,15.6,2017,0.0
Brett Barney,115,11,105,48,15,5,388.0,41,14,11.0,64,34,16.1,2017,0.0
Zach Bush,16,13,26,5,11,4,155.0,13,2,8.0,13,3,13.0,2017,0.0
Kaelen Malone,231,134,256,91,36,27,798.0,81,22,62.0,175,69,21.1,2017,0.0
Daniel Dixon,1355,179,1029,452,257,210,2918.0,618,241,153.0,411,211,23.3,2017,0.0
Omar Prewitt,1831,320,1340,626,555,390,3822.0,537,189,239.0,803,437,25.5,2017,0.0
Jack Whitman,443,60,259,160,216,123,1283.0,0,0,84.0,259,160,17.8,2017,0.0
Nathan Knight,2141,268,1365,765,760,559,3321.0,184,52,281.0,1181,713,31.2,2017,0.0
Greg Malinowski,805,155,643,276,136,101,2320.0,390,152,137.0,253,124,18.6,2017,0.0
David Cohn,1049,519,723,332,321,269,3402.0,298,116,198.0,425,216,16.2,2017,0.0
Paul Rowley,475,94,372,165,53,39,1491.0,252,106,71.0,120,59,16.0,2017,0.0
Connor Burchfield,759,97,497,259,74,62,1918.0,353,179,82.0,144,80,16.5,2017,0.0
Justin Pierce,1139,234,917,422,272,181,2839.0,355,114,166.0,562,308,21.7,2017,0.0
Oliver Tot,139,129,94,44,60,40,1052.0,33,11,72.0,61,33,9.6,2017,0.0
Jamison Glover,44,3,25,14,21,14,66.0,5,2,4.0,20,12,31.1,2017,0.0
Michael Schlotman,59,45,42,15,43,26,434.0,7,3,25.0,35,12,10.8,2017,0.0
Omar Mostafa,15,3,10,5,4,2,27.0,6,3,2.0,4,2,25.9,2017,0.0
Keon Johnson,2076,270,1474,632,610,517,3940.0,740,295,219.0,734,337,25.2,2017,0.0
Xavier Cooks,1778,306,1300,659,520,359,3558.0,290,101,333.0,1010,558,26.1,2017,0.0
Anders Broman,795,134,593,246,185,149,2190.0,399,154,78.0,194,92,17.3,2017,0.0
Roderick Perkins,343,48,299,119,61,39,915.0,186,66,45.0,113,53,20.0,2017,0.0
Josh Davenport,592,165,455,208,237,161,2106.0,55,15,144.0,400,193,17.0,2017,0.0
Bjorn Broman,1000,297,761,288,248,200,3637.0,618,224,127.0,143,64,13.4,2017,0.0
Tevin Prescott,528,22,365,214,176,100,1807.0,1,0,66.0,364,214,14.5,2017,0.0
Adam Pickett,838,163,559,305,219,159,1878.0,176,69,207.0,383,236,22.2,2017,0.0
Josh Ferguson,1114,108,830,404,254,187,2801.0,341,119,160.0,489,285,18.8,2017,0.0
Kellen Blake,54,5,40,21,10,5,91.0,18,7,4.0,22,14,26.5,2017,0.0
Freddy Poole,25,1,22,9,9,4,99.0,10,3,9.0,12,6,17.6,2017,0.0
Mitch Hill,38,9,39,13,6,3,137.0,33,9,7.0,6,4,17.8,2017,0.0
Patrick Fisher,4,0,2,2,0,0,9.0,0,0,1.0,2,2,16.5,2017,0.0
Hunter Sadlon,6,7,10,1,8,4,97.0,4,0,3.0,6,1,8.7,2017,0.0
Bronson Koenig,1459,296,1210,498,237,193,4075.0,695,270,154.0,515,228,19.6,2017,0.0
Ethan Happ,2130,423,1618,880,682,369,4120.0,16,1,353.0,1602,879,30.1,2017,0.0
Nigel Hayes,1857,319,1358,605,820,546,4439.0,304,101,238.0,1054,504,24.3,2017,1.0
Zak Showalter,678,169,494,231,155,126,2599.0,254,90,102.0,240,141,13.8,2017,0.0
Vitto Brown,661,76,593,251,108,77,1918.0,233,82,110.0,360,169,21.0,2017,0.0
D'Mitrik Trice,1430,430,1247,486,279,214,4125.0,641,244,204.0,606,242,20.9,2017,0.0
Khalil Iverson,733,131,524,279,271,168,2787.0,55,7,167.0,469,272,16.0,2017,0.0
Charles Thomas IV,206,18,196,78,66,41,736.0,37,9,36.0,159,69,19.1,2017,0.0
Jordan Hill,599,155,526,203,123,92,1960.0,294,101,129.0,232,102,18.3,2017,1.0
Brevin Pritzl,741,74,591,238,150,125,2658.0,383,140,55.0,208,98,14.8,2017,0.0
Alex Illikainen,125,32,118,45,30,16,718.0,56,19,20.0,62,26,11.3,2017,0.0
Andy Van Vliet,498,54,418,191,70,48,1166.0,179,68,79.0,239,123,24.0,2017,0.0
Aaron Moesch,41,13,22,11,21,17,273.0,3,2,9.0,19,9,8.3,2017,0.0
T.J. Schlundt,25,7,42,9,1,1,217.0,31,6,4.0,11,3,11.7,2017,0.0
Matt Ferris,4,2,9,2,0,0,36.0,3,0,3.0,6,2,18.3,2017,0.0
Fletcher Magee,2516,221,1766,807,433,393,4261.0,1169,509,208.0,597,298,26.6,2017,0.0
Eric Garcia,1260,537,829,360,409,332,3777.0,486,208,177.0,343,152,17.0,2017,0.0
Cameron Jackson,1399,203,976,569,399,252,2587.0,27,9,207.0,949,560,27.5,2017,0.0
Ryan Sawvell,812,103,593,329,178,123,2581.0,80,31,100.0,513,298,15.8,2017,0.0
Nathan Hoover,1619,165,1313,533,287,255,3910.0,798,298,141.0,515,235,21.3,2017,0.0
Matthew Pegram,553,72,470,231,97,77,1716.0,46,14,95.0,424,217,18.5,2017,0.0
Jaylen Allen,655,94,582,231,121,76,1954.0,313,117,120.0,269,114,21.0,2017,0.0
Derrick Brooks,268,117,216,86,114,76,1448.0,57,20,115.0,159,66,14.2,2017,0.0
Donovan Theme-Love,247,173,211,82,52,33,1326.0,141,50,92.0,70,32,12.9,2017,0.0
Justin Tucker,57,6,49,20,28,17,249.0,1,0,10.0,48,20,14.9,2017,0.0
Dishon Lowery,60,10,40,21,26,18,268.0,0,0,21.0,40,21,14.2,2017,0.0
Kevon Tucker,125,23,129,43,17,13,409.0,91,26,22.0,38,17,19.0,2017,0.0
Trevor Stumpe,630,135,490,219,96,82,1865.0,281,110,77.0,209,109,17.4,2017,0.0
Eric Wagenlander,9,6,19,3,0,0,68.0,17,3,6.0,2,0,19.6,2017,0.0
Steven Davis,637,54,472,222,176,131,1390.0,186,62,106.0,286,160,24.2,2017,0.0
Grant Benzinger,1451,132,1147,477,246,206,3884.0,731,291,125.0,416,186,18.4,2017,0.0
Justin Mitchell,745,236,586,285,253,167,2224.0,37,8,198.0,549,277,20.7,2017,0.0
Mike La Tulip,279,50,200,78,75,64,963.0,155,59,28.0,45,19,13.6,2017,0.0
Parker Ernsthausen,577,165,412,193,223,156,2523.0,123,35,135.0,289,158,13.1,2017,0.0
Mark Hughes,863,285,688,280,203,153,3279.0,448,150,163.0,240,130,14.6,2017,0.0
Ryan Custer,70,13,67,22,26,16,315.0,36,10,12.0,31,12,14.2,2017,0.0
Tye Wilburn,64,30,51,21,26,19,320.0,13,3,24.0,38,18,13.5,2017,0.0
Trey Stacey,38,3,26,13,2,2,89.0,20,10,6.0,6,3,19.1,2017,0.0
Alan Vest,232,53,190,84,40,28,1231.0,90,36,45.0,100,48,10.6,2017,0.0
Adam Giles,14,3,14,5,8,3,67.0,2,1,3.0,12,4,15.5,2017,0.0
Justin James,2061,343,1565,692,710,519,3684.0,469,158,328.0,1096,534,30.9,2017,1.0
Hayden Dalton,1156,214,815,363,341,283,2528.0,394,147,206.0,421,216,23.3,2017,0.0
Jason McManamen,1034,178,799,322,250,180,3015.0,564,210,103.0,235,112,18.3,2017,0.0
Alan Herndon,1149,168,859,423,293,179,3594.0,366,124,146.0,493,299,16.5,2017,0.0
Louis Adams,559,79,363,166,262,191,1099.0,101,36,103.0,262,130,26.5,2017,0.0
Alexander Aka Gorski,682,116,578,214,156,111,2158.0,441,143,97.0,137,71,18.0,2017,0.0
Jeremy Lieberman,336,148,323,120,49,37,1707.0,196,59,91.0,127,61,13.7,2017,0.0
Jordan Naughton,347,18,214,127,155,93,1119.0,1,0,56.0,213,127,15.7,2017,0.0
Cody Kelley,878,290,679,287,181,135,3050.0,425,169,162.0,254,118,15.5,2017,0.0
Andrew Moemeka,96,11,67,40,25,16,512.0,0,0,35.0,67,40,10.9,2017,0.0
Morris Marshall,29,4,29,9,10,8,111.0,11,3,5.0,18,6,17.8,2017,0.0
Jonathan Barnes,93,7,64,31,59,31,434.0,0,0,20.0,64,31,14.7,2017,0.0
Sam Averbuck,4,6,8,1,2,2,63.0,2,0,3.0,6,1,9.3,2017,0.0
Trevon Bluiett,2261,307,1662,717,648,508,4553.0,831,319,255.0,831,398,24.3,2017,1.0
J.P. Macura,1491,300,1105,495,400,319,3518.0,517,182,213.0,588,313,21.2,2017,1.0
Edmond Sumner,663,223,478,205,296,216,1541.0,130,37,128.0,348,168,23.5,2017,1.0
Rashid Gaston,1191,86,835,485,414,221,2798.0,0,0,189.0,835,485,22.3,2017,0.0
Malcolm Bernard,814,232,624,254,368,235,2687.0,213,71,196.0,411,183,18.4,2017,0.0
Sean O'Mara,604,70,391,234,199,136,1366.0,0,0,83.0,391,234,20.5,2017,0.0
Quentin Goodin,1018,544,925,351,320,215,3813.0,350,101,299.0,575,250,18.1,2017,0.0
Kaiser Gates,533,58,409,166,132,94,1813.0,300,107,57.0,109,59,14.3,2017,0.0
Tyrique Jones,1211,101,798,475,438,261,2631.0,0,0,159.0,798,475,22.2,2017,0.0
Leighton Schrand,9,2,8,1,10,6,67.0,5,1,10.0,3,0,16.9,2017,0.0
Tim Stainbrook,3,3,6,1,2,0,70.0,5,1,1.0,1,0,5.7,2017,0.0
Myles Davis,930,245,722,273,262,216,2601.0,462,168,135.0,260,105,19.1,2017,0.0
Cullen Barr,0,0,2,0,0,0,8.0,1,0,0.0,1,0,12.5,2017,0.0
Alex Bergen,0,0,0,0,0,0,11.0,0,0,0.0,0,0,0.0,2017,0.0
Conor Peterson,0,0,0,0,0,0,7.0,0,0,0.0,0,0,0.0,2017,0.0
Miye Oni,1308,287,1052,450,301,234,2756.0,489,174,222.0,563,276,25.8,2017,1.0
Alex Copeland,1153,244,897,434,255,210,2419.0,217,75,163.0,680,359,24.5,2017,0.0
Sam Downey,609,45,443,250,148,104,1567.0,18,5,59.0,425,245,18.7,2017,0.0
Blake Reynolds,970,209,781,378,142,102,2546.0,324,112,153.0,457,266,19.8,2017,0.0
Anthony Dallier,527,198,437,169,174,119,2097.0,208,70,121.0,229,99,15.6,2017,0.0
Jordan Bruner,962,254,748,357,225,161,2740.0,282,87,187.0,466,270,19.1,2017,0.0
Trey Phills,723,156,523,244,255,186,2370.0,163,49,142.0,360,195,16.7,2017,0.0
Eric Monroe,427,229,321,139,68,61,1838.0,216,88,132.0,105,51,13.5,2017,0.0
Noah Yates,313,60,257,106,43,32,1125.0,197,69,50.0,60,37,15.3,2017,0.0
Thomas Ryan,39,4,40,11,17,12,150.0,27,5,10.0,13,6,19.4,2017,0.0
Eric Anderson,82,12,75,30,33,17,359.0,18,5,16.0,57,25,15.1,2017,1.0
Landon Russell,18,5,19,7,2,2,54.0,12,2,2.0,7,5,21.7,2017,0.0
Cameron Morse,1913,334,1593,666,450,349,3418.0,668,232,194.0,925,434,27.7,2017,0.0
Francisco Santiago,704,306,631,268,141,106,2237.0,195,62,153.0,436,206,18.2,2017,0.0
Matt Donlan,738,97,598,251,102,87,2016.0,354,149,86.0,244,102,17.4,2017,0.0
Braun Hartfield,1169,187,962,417,339,220,2885.0,345,115,207.0,617,302,22.0,2017,0.0
Jorden Kaufman,639,67,516,280,144,79,1612.0,0,0,87.0,516,280,20.4,2017,0.0
Devin Haygood,686,63,567,287,226,104,2020.0,23,8,156.0,544,279,19.1,2017,0.0
Brett Frantz,294,80,293,97,50,41,1323.0,204,59,54.0,89,38,13.4,2017,0.0
Latin Davis,192,72,180,68,54,38,795.0,54,18,49.0,126,50,15.4,2017,0.0
Rahim Williams,74,15,73,26,24,16,352.0,26,6,25.0,47,20,14.8,2017,0.0
Jeremiah Ferguson,151,51,152,53,48,29,522.0,48,16,43.0,104,37,19.1,2017,0.0
Stefan Rosic,27,3,29,10,6,4,90.0,15,3,5.0,14,7,19.5,2017,0.0
Tyler Warford,7,3,9,3,2,0,29.0,5,1,1.0,4,2,18.6,2017,0.0
Ryan Strollo,23,5,24,8,1,0,123.0,21,7,5.0,3,1,11.0,2017,0.0
Jalone Friday,1085,47,827,397,234,180,1779.0,291,111,140.0,536,286,31.1,2018,0.0
Jaren Lewis,1580,253,1180,595,448,333,3666.0,158,57,244.0,1022,538,23.0,2018,0.0
Tevin Foster,395,112,291,122,131,105,1037.0,145,46,84.0,146,76,20.8,2018,0.0
Payten Ricks,1106,203,836,334,295,238,3028.0,541,200,174.0,295,134,19.2,2018,0.0
Drake Green,400,80,399,142,42,31,1708.0,247,85,75.0,152,57,15.0,2018,0.0
Hayden Howell,490,48,412,191,165,101,1418.0,28,7,132.0,384,184,22.4,2018,0.0
Hayden Farquhar,601,68,492,227,91,53,1444.0,263,94,84.0,229,133,22.2,2018,0.0
B.J. Maxwell,387,71,310,146,51,39,1157.0,144,56,49.0,166,90,17.0,2018,0.0
Isaiah Tripp,402,97,307,131,115,85,1507.0,149,55,70.0,158,76,14.9,2018,0.0
Kolton Kohl,742,73,536,281,254,176,1343.0,19,4,95.0,517,277,27.3,2018,0.0
Trey Lenox,175,80,176,62,36,22,1353.0,97,29,65.0,79,33,9.7,2018,0.0
Paul Hiepler,53,6,46,15,14,11,151.0,37,12,6.0,9,3,19.0,2018,0.0
Chase Cobb,17,4,17,6,4,2,66.0,13,3,7.0,4,3,19.9,2018,0.0
Lavelle Scottie,1546,180,1291,600,352,234,3290.0,328,112,271.0,963,488,27.5,2018,0.0
Trevor Lyons,1060,309,843,341,409,280,3432.0,266,98,176.0,577,243,18.7,2018,0.0
Ryan Swan-Ford,1094,157,769,393,308,219,2408.0,233,89,155.0,536,304,23.3,2018,0.0
Ryan Manning,440,48,385,152,87,64,1203.0,230,72,53.0,155,80,20.8,2018,0.0
Jacob Van,686,157,499,214,215,179,1840.0,203,79,118.0,296,135,20.1,2018,0.0
Frank Toohey,651,93,416,205,257,198,1629.0,108,43,112.0,308,162,20.6,2018,0.0
Sid Tomes,537,200,495,174,120,92,2244.0,337,97,90.0,158,77,15.0,2018,0.0
Caleb Morris,620,117,461,198,135,104,1856.0,307,120,89.0,154,78,17.3,2018,0.0
Pervis Louder,355,81,296,122,134,83,1130.0,103,28,92.0,193,94,20.8,2018,0.0
Keaton Van Soelen,484,128,379,168,162,112,2336.0,136,36,105.0,243,132,13.1,2018,0.0
C.J. Siples,423,165,345,148,146,85,1696.0,132,42,104.0,213,106,15.9,2018,0.0
Jonathan DeWane,73,7,50,26,20,14,134.0,13,7,4.0,37,19,24.5,2018,0.0
Dane Norman,131,15,101,45,36,25,401.0,41,16,29.0,60,29,18.9,2018,0.0
LeSean Brown,85,33,68,24,48,31,417.0,23,6,18.0,45,18,13.7,2018,0.0
Christopher Joyce,700,138,590,242,158,114,2153.0,302,102,126.0,288,140,20.2,2018,0.0
Ameka Akaya,349,59,269,135,65,50,1009.0,80,29,82.0,189,106,21.1,2018,0.0
Charles O'Briant,10,0,6,4,3,1,16.0,1,1,3.0,5,3,34.6,2018,0.0
James Edwards,4,3,4,1,2,2,15.0,3,0,0.0,1,1,17.4,2018,1.0
Bryce Hughes,8,3,3,2,9,4,23.0,0,0,0.0,3,2,16.8,2018,0.0
Kobi Betts,0,0,0,0,0,0,3.0,0,0,0.0,0,0,0.0,2018,0.0
Daniel Utomi,1400,136,1094,464,304,222,3268.0,658,250,186.0,436,214,22.1,2018,0.0
Malcolm Duvivier,1079,289,953,371,263,176,3296.0,444,161,255.0,509,210,21.3,2018,0.0
Jimond Ivey,1259,315,977,438,325,244,3461.0,457,139,207.0,520,299,19.7,2018,0.0
Eric Parrish,443,96,339,173,102,67,1409.0,102,30,88.0,237,143,16.7,2018,0.0
Virshon Cotton,646,158,556,209,151,119,1929.0,324,109,177.0,232,100,20.3,2018,0.0
Torrey Patton,806,132,651,302,233,144,2106.0,179,58,149.0,472,244,22.0,2018,0.0
Emmanuel Olojakpoke,391,25,249,163,124,65,1421.0,1,0,64.0,248,163,13.3,2018,0.0
Jaden Sayles,387,35,277,144,151,97,1140.0,10,2,63.0,267,142,18.3,2018,0.0
Mark Kostelac,79,10,69,35,16,9,409.0,0,0,33.0,69,35,13.7,2018,0.0
Lucas Smith,34,8,40,10,15,10,284.0,23,4,10.0,17,6,10.3,2018,0.0
Sina Gbadebo,7,6,8,3,1,0,76.0,5,1,5.0,3,2,9.0,2018,0.0
Craig Eubanks,11,2,10,4,0,0,59.0,8,3,5.0,2,1,13.0,2018,0.0
Marquelle McIntyre,6,3,6,2,4,2,33.0,0,0,4.0,6,2,18.4,2018,0.0
Arthur Johnson,497,64,442,176,121,80,1229.0,198,65,117.0,244,111,25.5,2018,0.0
Andre Kennedy,650,49,554,272,167,105,1663.0,16,1,128.0,538,271,23.4,2018,0.0
De'Edrick Petty,636,86,526,179,277,210,1558.0,268,68,132.0,258,111,26.3,2018,0.0
Evan Wiley,590,77,533,219,98,63,2191.0,240,89,102.0,293,130,15.9,2018,0.0
Marcus Merriweather,411,67,384,130,113,91,1193.0,193,60,89.0,191,70,22.8,2018,0.0
Julian Walters,302,175,254,101,72,56,1186.0,136,44,79.0,118,57,15.5,2018,0.0
Mohamed Sherif,257,22,217,99,155,59,938.0,1,0,78.0,216,99,20.2,2018,0.0
Jalen Reeder,403,53,386,150,83,52,1174.0,176,51,88.0,210,99,22.4,2018,0.0
Tracy Burnett,154,11,150,66,39,22,538.0,1,0,37.0,149,66,19.6,2018,0.0
Ariston Johnson,117,52,146,40,35,25,771.0,39,12,51.0,107,28,14.4,2018,0.0
Amari Goulbourne,77,42,75,26,23,12,379.0,35,13,30.0,40,13,15.6,2018,0.0
Brandon Houston,206,23,174,83,42,31,607.0,32,9,39.0,142,74,19.5,2018,0.0
Terry Ellis,0,0,0,0,0,0,10.0,0,0,0.0,0,0,0.0,2018,0.0
Ryan McLaurin,0,0,3,0,0,0,12.0,1,0,3.0,2,0,25.3,2018,0.0
Chris Cokley,1660,162,1185,678,401,304,2934.0,3,0,178.0,1182,678,26.9,2018,0.0
Zack Bryant,1272,297,1029,456,343,252,2935.0,329,108,212.0,700,348,24.4,2018,0.0
William Lee,1394,173,1051,520,301,220,3383.0,367,134,210.0,684,386,21.1,2018,0.0
Nate Darling,1081,196,785,360,208,175,2429.0,456,186,170.0,329,174,22.4,2018,0.0
Jalen Perry,635,112,527,215,166,109,1801.0,270,96,90.0,257,119,19.9,2018,0.0
Nick Norton,975,536,743,303,196,168,3223.0,543,201,193.0,200,102,16.2,2018,0.0
Lewis Sullivan,876,102,623,337,242,167,2195.0,104,35,123.0,519,302,20.1,2018,0.0
Makhtar Gueye,578,59,500,219,135,100,2030.0,152,40,125.0,348,179,17.6,2018,0.0
Deion Lavender,726,289,593,269,199,148,2667.0,153,40,181.0,440,229,17.3,2018,0.0
Thomas Smallwood,264,36,211,96,45,34,697.0,88,38,40.0,123,58,20.0,2018,0.0
Hunter Reynolds,7,2,3,3,0,0,19.0,1,1,1.0,2,2,10.6,2018,0.0
Anderson McCoy,15,5,11,4,4,4,135.0,9,3,7.0,2,1,7.7,2018,0.0
Reginald Gee,1395,99,1098,444,432,321,3150.0,483,186,197.0,615,258,23.1,2018,0.0
Jacoby Ross,941,170,882,313,197,164,2350.0,479,151,160.0,403,162,23.7,2018,0.0
Branden Johnson,375,11,249,154,179,67,1332.0,2,0,58.0,247,154,14.3,2018,0.0
Tobi Ewuosho,811,107,631,279,317,211,2279.0,121,42,199.0,510,237,21.2,2018,0.0
Ed Jones,301,11,311,122,54,39,987.0,77,18,45.0,234,104,19.0,2018,0.0
Rodney Simeon,579,38,562,187,108,80,1443.0,397,125,106.0,165,62,24.3,2018,0.0
Terrance LeFlore,716,233,754,256,203,124,2441.0,296,80,206.0,458,176,21.0,2018,0.0
Gene Davis,174,99,158,56,48,41,831.0,72,21,95.0,86,35,16.1,2018,0.0
Fausto Pichardo,293,28,205,112,117,67,978.0,7,2,84.0,198,110,17.2,2018,0.0
Steve Rogers Jr.,514,98,508,163,136,95,1974.0,299,93,98.0,209,70,16.4,2018,0.0
Austin Rogers,180,49,197,71,40,16,932.0,83,22,43.0,114,49,13.6,2018,0.0
Marice Wright,27,2,30,12,9,2,129.0,7,1,7.0,23,11,15.4,2018,0.0
Fredens Deneus,22,3,21,8,13,6,78.0,0,0,5.0,21,8,19.9,2018,0.0
Micah Johnson,6,3,10,3,0,0,30.0,2,0,8.0,8,3,28.9,2018,0.0
Demetrius Houston,149,20,159,55,66,36,578.0,17,3,61.0,142,52,22.4,2018,0.0
Collin Sexton,632,119,438,196,252,196,987.0,131,44,92.0,307,152,32.9,2018,1.0
John Petty,1539,263,1231,519,270,190,3968.0,814,311,279.0,417,208,19.7,2018,0.0
Donta Hall,1014,63,605,400,351,213,2809.0,1,1,127.0,604,399,16.1,2018,0.0
Dazon Ingram,1221,419,810,373,591,409,3645.0,197,66,313.0,613,307,19.4,2018,0.0
Braxton Key,1070,221,883,379,363,234,3325.0,285,78,228.0,598,301,20.7,2018,0.0
Avery Johnson,462,98,493,164,97,76,1531.0,206,58,66.0,287,106,19.9,2018,1.0
Herb Jones,947,285,771,340,386,233,3076.0,118,34,266.0,653,306,18.9,2018,0.0
Daniel Giddens,400,37,313,163,150,74,1599.0,2,0,108.0,311,163,15.7,2018,0.0
Alex Reese,755,75,679,263,128,92,1949.0,441,137,112.0,238,126,20.7,2018,0.0
Galin Smith,418,24,312,174,157,70,1628.0,2,0,113.0,310,174,15.4,2018,0.0
Riley Norris,919,94,779,305,229,157,3255.0,439,152,127.0,340,153,16.1,2018,0.0
Lawson Schaffer,32,20,37,9,8,6,131.0,31,8,11.0,6,1,20.0,2018,0.0
Landon Fuller,3,0,1,1,0,0,9.0,1,1,0.0,0,0,5.6,2018,0.0
Tyler Barnes,4,1,5,1,6,2,41.0,2,0,0.0,3,1,9.1,2018,0.0
Joe Cremo,1614,344,1150,524,460,387,3649.0,447,179,232.0,703,345,22.6,2018,0.0
David Nichols,1355,288,1203,504,261,202,2951.0,416,145,230.0,787,359,27.0,2018,0.0
Travis Charles,757,39,523,301,208,155,1582.0,0,0,89.0,523,301,23.0,2018,0.0
Greig Stire,822,107,568,306,326,210,2876.0,1,0,125.0,567,306,15.2,2018,0.0
Devonte Campbell,638,112,480,199,255,193,2500.0,161,47,105.0,319,152,14.7,2018,0.0
Alex Foster,256,13,194,104,99,48,906.0,1,0,66.0,193,104,17.5,2018,0.0
Ahmad Clark,1143,297,953,360,375,298,2322.0,388,125,264.0,565,235,31.2,2018,0.0
Costa Anderson,158,39,140,53,19,17,535.0,101,35,15.0,39,18,15.7,2018,0.0
Matt Conway,54,6,49,22,13,7,200.0,14,3,8.0,35,19,16.0,2018,0.0
Xavier Cochran,8,1,9,3,4,2,51.0,2,0,4.0,7,3,14.8,2018,0.0
Nick Fruscio,17,4,18,7,4,2,44.0,7,1,3.0,11,6,26.9,2018,0.0
A.J. Mosby,818,211,634,290,145,121,2025.0,297,117,113.0,337,173,20.0,2018,0.0
Dante Sterling,377,48,299,116,107,87,867.0,161,58,67.0,138,58,24.1,2018,0.0
Maurice Howard,1363,339,1152,455,213,177,3628.0,724,276,296.0,428,179,21.1,2018,0.0
Troymain Crosby,1222,165,971,418,435,350,2615.0,156,36,284.0,815,382,27.5,2018,0.0
Devon Brewer,384,61,312,154,150,76,1612.0,2,0,100.0,310,154,15.0,2018,0.0
Yalen Reed,241,33,180,94,84,44,858.0,33,9,42.0,147,85,15.2,2018,0.0
Avery Patterson,317,110,274,104,89,65,1129.0,146,44,109.0,128,60,18.7,2018,0.0
Tyler Carter,155,30,135,48,70,51,660.0,37,8,46.0,98,40,16.2,2018,0.0
Reginald Johnson,1361,85,1163,539,272,183,2636.0,315,100,125.0,848,439,26.8,2018,0.0
Kobe Wilson,195,58,200,79,58,31,1429.0,32,6,53.0,168,73,9.6,2018,0.0
Khari Jabriel Allen,188,34,196,57,49,40,722.0,127,34,63.0,69,23,20.2,2018,0.0
TyQuayion Smith,51,5,50,17,26,14,312.0,11,3,17.0,39,14,12.7,2018,0.0
Juwan Henderson,77,89,109,26,31,19,603.0,44,6,69.0,65,20,15.9,2018,0.0
James Stokes,11,2,13,5,5,1,53.0,0,0,1.0,13,5,15.5,2018,0.0
Sa'eed Nelson,2116,521,1627,765,758,499,4355.0,334,87,405.0,1293,678,29.2,2018,0.0
Laurynas Motuzis,642,77,531,229,148,95,1896.0,271,89,88.0,260,140,19.3,2018,0.0
Sam Iorio,967,115,769,339,173,139,2525.0,399,150,108.0,370,189,20.0,2018,0.0
Cheikh Diallo,181,32,165,68,18,12,845.0,112,33,57.0,53,35,14.5,2018,0.0
Marvin Bragg,251,60,199,87,62,41,1216.0,114,36,42.0,85,51,11.7,2018,0.0
Stacy Beckton,780,96,629,272,196,149,2365.0,268,87,146.0,361,185,19.2,2018,0.0
Jesse Little,85,21,60,34,30,16,472.0,6,1,25.0,54,33,11.2,2018,0.0
Drew LaMont,66,17,55,21,10,6,297.0,46,18,10.0,9,3,12.4,2018,0.0
James Washington,332,58,341,122,64,43,1408.0,167,45,79.0,174,77,18.3,2018,0.0
Matt Cimino,115,31,105,46,19,9,590.0,45,14,52.0,60,32,15.4,2018,0.0
Nick Macarchuk,18,13,12,8,4,1,212.0,1,1,10.0,11,7,6.0,2018,0.0
Tyler McFarland,3,0,1,1,0,0,2.0,1,1,0.0,0,0,26.6,2018,0.0
Kevin Brown,0,0,4,0,0,0,11.0,2,0,2.0,2,0,29.1,2018,0.0
Ronshad Shabazz,2067,273,1737,712,517,374,3824.0,764,269,268.0,973,443,28.2,2018,0.0
Justin Forrest,1828,299,1519,581,580,422,3553.0,758,244,358.0,761,337,30.0,2018,0.0
Griffin Kinney,934,123,668,342,366,245,2460.0,18,5,241.0,650,337,21.3,2018,0.0
O'Showen Williams,777,203,629,253,210,142,2574.0,376,129,133.0,253,124,16.6,2018,0.0
Tyrell Johnson,868,59,730,321,257,167,2465.0,202,59,143.0,528,262,19.3,2018,0.0
Isaac Johnson,1090,213,780,377,464,293,3377.0,178,43,206.0,602,334,17.5,2018,0.0
Craig Hinton,478,58,383,166,79,52,1593.0,256,94,81.0,127,72,14.5,2018,0.0
Hunter Seacat,498,90,352,204,147,90,1871.0,1,0,99.0,351,204,13.8,2018,0.0
Bennett Holley,324,28,237,101,52,43,940.0,198,79,24.0,39,22,14.6,2018,0.0
Jake Wilson,67,8,55,24,52,19,355.0,0,0,30.0,55,24,14.8,2018,0.0
Zach Cottrell,43,13,46,15,10,5,245.0,34,8,8.0,12,7,11.5,2018,0.0
Trey Ford,29,10,14,9,5,4,59.0,12,7,3.0,2,2,15.7,2018,0.0
Nick Hough,33,4,21,10,10,7,60.0,16,6,5.0,5,4,24.6,2018,0.0
Kevin Kerley,35,12,17,10,12,7,68.0,13,8,5.0,4,2,19.5,2018,0.0
Tra Holder,1797,448,1370,544,696,533,4181.0,496,176,308.0,874,368,23.7,2018,0.0
Shannon Evans,1777,504,1408,553,494,406,4201.0,738,265,259.0,670,288,22.3,2018,0.0
Kodi Justice,1043,249,826,354,165,118,3076.0,540,217,172.0,286,137,17.2,2018,0.0
Romello White,1247,83,758,467,502,313,3236.0,4,0,212.0,754,467,18.1,2018,0.0
Remy Martin,1754,466,1380,591,520,396,3623.0,524,176,262.0,856,415,25.4,2018,0.0
De'Quon Lake,377,7,205,150,118,77,977.0,0,0,38.0,205,150,14.8,2018,0.0
Mickey Mitchell,241,78,196,88,97,55,1247.0,32,10,81.0,164,78,12.7,2018,0.0
Vitaliy Shibel,137,24,123,46,32,24,721.0,78,21,30.0,45,25,11.6,2018,0.0
Kimani Lawrence,683,80,559,250,193,130,2103.0,185,53,104.0,374,197,17.3,2018,0.0
Austin Witherill,20,1,19,5,6,5,88.0,17,5,1.0,2,0,12.8,2018,0.0
Grant Fogerty,3,2,3,1,2,1,27.0,1,0,0.0,2,1,7.1,2018,0.0
Jordan Salzman,2,0,5,0,4,2,14.0,0,0,0.0,5,0,23.7,2018,0.0
Deandre Ayton,704,57,451,276,191,140,1172.0,35,12,69.0,416,264,26.6,2018,1.0
Allonzo Trier,1307,185,828,397,446,369,2456.0,381,144,153.0,447,253,24.6,2018,1.0
Dusan Ristic,1181,77,857,484,285,199,2640.0,30,14,137.0,827,470,21.8,2018,0.0
Rawle Alkins,706,134,538,242,199,145,1760.0,211,77,126.0,327,165,22.2,2018,1.0
Parker Jackson-Cartwright,733,459,556,238,204,141,2943.0,286,116,177.0,270,122,14.3,2018,0.0
Dylan Smith,1113,181,960,346,261,205,3060.0,616,216,221.0,344,130,21.2,2018,0.0
Brandon Randolph,514,58,477,183,122,94,1284.0,178,54,63.0,299,129,23.8,2018,0.0
Keanu Pinder,151,14,92,55,67,40,755.0,4,1,42.0,88,54,11.3,2018,0.0
Ira Lee,444,50,319,178,140,87,1484.0,4,1,96.0,315,177,16.4,2018,0.0
Emmanuel Akot,330,107,313,122,75,42,1235.0,132,44,77.0,181,78,17.5,2018,0.0
Alex Barcello,881,207,634,308,159,137,2317.0,294,128,104.0,340,180,18.0,2018,0.0
Tyler Trillo,3,4,4,1,0,0,37.0,4,1,2.0,0,0,8.4,2018,0.0
Jake Desjardins,11,2,10,2,14,7,42.0,0,0,3.0,10,2,24.0,2018,0.0
Talbott Denny,391,66,287,119,243,137,1736.0,46,16,91.0,241,103,14.0,2018,0.0
Matt Weyand,8,1,6,3,0,0,23.0,5,2,2.0,1,1,17.3,2018,0.0
Andre Jones,995,223,888,402,205,140,2298.0,219,51,203.0,669,351,25.6,2018,0.0
Jaizec Lottie,576,272,502,217,198,105,2221.0,144,37,185.0,358,180,17.9,2018,0.0
Oliver Black,400,68,307,158,159,84,1963.0,1,0,116.0,306,158,13.4,2018,0.0
Cameron Corcoran,479,119,428,159,72,57,1430.0,285,104,74.0,143,55,18.6,2018,0.0
Anthony Black,182,42,169,71,11,7,543.0,94,33,21.0,75,38,18.9,2018,0.0
Ben Marcus,248,18,167,108,77,32,702.0,0,0,46.0,167,108,18.7,2018,0.0
Camron Reedus,159,13,118,49,35,29,410.0,83,32,31.0,35,17,21.2,2018,0.0
Ryan Pippins,269,47,237,93,58,35,953.0,122,48,54.0,115,45,17.2,2018,0.0
Kris Bankston,457,62,269,195,136,67,1357.0,2,0,91.0,267,195,15.9,2018,0.0
Damir Hadzic,124,24,111,43,30,21,411.0,62,17,34.0,49,26,20.1,2018,0.0
Wadly Mompremier,217,13,160,77,100,51,816.0,39,12,66.0,121,65,17.4,2018,0.0
K.J. Gilmore,74,26,99,31,10,9,334.0,17,3,24.0,82,28,20.1,2018,0.0
Brandon Brady,30,7,30,11,5,3,138.0,21,5,5.0,9,6,14.2,2018,0.0
Cezanne Carson,8,2,16,4,0,0,76.0,7,0,2.0,9,4,12.4,2018,0.0
Khari Harley,138,30,120,40,56,43,740.0,52,15,38.0,68,25,12.9,2018,0.0
Deondre Burns,979,197,789,351,246,197,2331.0,246,80,158.0,543,271,22.7,2018,0.0
Martaveous McKnight,1317,218,991,443,409,293,2311.0,373,138,179.0,618,305,30.1,2018,0.0
Travon Harper,555,40,418,207,196,127,1367.0,53,14,110.0,365,193,23.5,2018,0.0
Charles Jackson,943,205,797,302,206,146,2953.0,550,193,231.0,247,109,19.9,2018,0.0
Trent Steen,549,37,457,222,167,103,1386.0,11,2,126.0,446,220,24.6,2018,0.0
Joe'Randle Toliver,421,119,379,139,35,24,1520.0,335,119,90.0,44,20,16.4,2018,0.0
Terrance Banyard,712,68,511,240,333,218,2188.0,56,14,184.0,455,226,20.3,2018,0.0
Quamauri Hardy,142,85,146,56,41,23,934.0,30,7,57.0,116,49,12.5,2018,0.0
Cameron Posey,181,67,175,62,46,34,1163.0,76,23,94.0,99,39,13.1,2018,0.0
Christian Robertson,119,20,114,48,40,23,594.0,8,0,31.0,106,48,14.5,2018,0.0
Artavious McDyess,186,25,136,75,89,36,990.0,0,0,76.0,136,75,13.4,2018,0.0
Kennedy McKinney,159,45,157,63,43,30,666.0,25,3,74.0,132,60,19.2,2018,0.0
David Tillman,51,10,43,22,25,7,499.0,0,0,36.0,43,22,9.6,2018,0.0
J'Breun Sprinkle,28,17,24,12,7,2,291.0,5,2,20.0,19,10,8.6,2018,0.0
Dwain Whitfield,60,19,75,25,17,9,605.0,4,1,23.0,71,24,8.6,2018,0.0
Jordan McNair,80,45,97,29,28,15,542.0,42,7,61.0,55,22,16.7,2018,0.0
William Ridgell,3,2,4,1,3,1,88.0,1,0,5.0,3,1,6.2,2018,0.0
Marcus Wallace,393,78,373,132,94,66,1697.0,202,63,128.0,171,69,16.9,2018,0.0
Ty Cockfield,1257,176,987,431,329,266,2226.0,365,129,176.0,622,302,28.9,2018,0.0
Deven Simms,813,99,624,293,256,185,1535.0,120,42,132.0,504,251,28.4,2018,0.0
Rashad Lindsey,614,159,504,215,149,114,2033.0,192,70,107.0,312,145,16.7,2018,0.0
Tamas Bruce,511,20,372,210,175,91,1170.0,1,0,81.0,371,210,22.7,2018,0.0
Grantham Gillard,585,54,471,189,131,90,1597.0,333,117,66.0,138,72,18.3,2018,0.0
Tristin Walley,445,59,366,140,163,115,1450.0,156,50,76.0,210,90,17.5,2018,0.0
Marquis Eaton,1321,374,1091,432,405,329,3456.0,379,128,249.0,712,304,22.1,2018,0.0
Connor Kern,507,59,402,164,75,59,1863.0,308,120,62.0,94,44,12.8,2018,0.0
Salif Boudie,416,26,249,159,151,97,1369.0,2,1,96.0,247,158,15.2,2018,0.0
Jake Scoggins,37,7,38,17,13,3,238.0,0,0,12.0,38,17,11.6,2018,0.0
C.J. Foster,218,47,178,72,93,55,1041.0,71,19,63.0,107,53,13.8,2018,0.0
Andrew Riley,26,3,18,10,2,2,41.0,9,4,0.0,9,6,22.9,2018,0.0
Shaquillo Fritz,131,13,89,51,50,29,651.0,0,0,38.0,89,51,11.8,2018,0.0
Christian Willis,427,85,350,149,104,67,1474.0,153,62,79.0,197,87,16.3,2018,0.0
Jaylen Barford,1087,161,874,398,238,175,2007.0,310,116,137.0,564,282,27.3,2018,0.0
Daryl Macon,1070,218,700,315,333,290,1990.0,370,150,128.0,330,165,24.2,2018,1.0
Daniel Gafford,955,47,595,378,354,199,1709.0,0,0,113.0,595,378,25.0,2018,1.0
Anton Beard,949,268,835,319,271,191,2950.0,360,120,132.0,475,199,18.0,2018,0.0
C.J. Jones,758,52,621,267,108,91,1674.0,335,133,68.0,286,134,21.6,2018,0.0
Darious Hall,409,56,349,147,172,97,1464.0,62,18,104.0,287,129,17.8,2018,0.0
Dustin Thomas,589,112,463,215,227,145,2210.0,59,14,148.0,404,201,16.3,2018,0.0
Adrio Bailey,568,68,465,227,176,97,1999.0,51,17,93.0,414,210,15.9,2018,0.0
Trey Thompson,299,146,219,122,91,55,1669.0,1,0,92.0,218,122,10.3,2018,0.0
Arlando Cook,152,23,138,61,53,30,697.0,0,0,33.0,138,61,13.7,2018,0.0
Gabe Osabuohien,262,168,265,92,158,71,1672.0,41,7,125.0,224,85,13.4,2018,0.0
Jonathan Holmes,23,1,27,9,2,1,36.0,15,4,3.0,12,5,42.0,2018,0.0
Jt Plummer,0,0,0,0,0,0,6.0,0,0,0.0,0,0,0.0,2018,0.0
Jordan Fox,1186,436,1019,409,200,156,3188.0,584,212,225.0,435,197,20.6,2018,0.0
Matthew Wilson,1587,65,1125,685,388,217,3044.0,0,0,204.0,1125,685,25.0,2018,0.0
Tommy Funk,1544,728,1317,551,396,275,4032.0,485,167,330.0,832,384,22.9,2018,0.0
Alex King,1015,139,835,381,196,123,2760.0,369,130,191.0,466,251,20.5,2018,0.0
Luke Morrison,713,64,634,256,43,29,1591.0,453,172,90.0,181,84,22.9,2018,0.0
Tucker Blackwell,565,101,468,188,100,73,1637.0,308,116,69.0,160,72,18.1,2018,0.0
Jacob Kessler,468,142,398,180,73,47,1964.0,196,61,98.0,202,119,13.3,2018,0.0
John Emezie,675,121,545,225,207,139,2050.0,249,86,144.0,296,139,18.8,2018,0.0
Lonnie Grayson,855,137,781,289,145,108,2291.0,507,169,126.0,274,120,21.8,2018,0.0
Babacar Thiombane,203,56,158,74,93,49,1147.0,21,6,67.0,137,68,12.2,2018,0.0
John Miller,44,5,35,19,19,6,231.0,0,0,12.0,35,19,11.9,2018,0.0
Cayne Edwards,133,8,94,49,50,34,376.0,5,1,21.0,89,48,18.3,2018,0.0
Parker Fennema,6,1,6,2,2,1,21.0,4,1,1.0,2,1,18.5,2018,0.0
Mark Pollack,16,1,26,6,0,0,57.0,19,4,5.0,7,2,27.0,2018,0.0
Mark Madden,35,11,29,13,9,7,217.0,14,2,8.0,15,11,9.8,2018,0.0
Will Culliton,2,0,3,1,0,0,9.0,2,0,1.0,1,1,22.2,2018,0.0
Nick Finke,141,56,102,60,52,20,638.0,2,1,36.0,100,59,13.1,2018,0.0
Jason Houle,15,1,22,5,0,0,55.0,19,5,3.0,3,0,22.3,2018,0.0
Lance Lawson,0,3,0,0,0,0,6.0,0,0,0.0,0,0,0.0,2018,0.0
Keeston Smith,0,0,1,0,2,0,9.0,1,0,1.0,0,0,17.2,2018,0.0
Mustapha Heron,1752,147,1318,567,562,441,3320.0,462,177,248.0,856,390,26.1,2018,0.0
Bryce Brown,1673,187,1351,534,284,223,3646.0,975,382,166.0,376,152,21.7,2018,0.0
DeSean Murray,1358,157,965,491,475,354,2538.0,74,22,222.0,891,469,28.1,2018,0.0
Chuma Okeke,711,111,540,260,145,102,1839.0,229,89,93.0,311,171,18.5,2018,0.0
Anfernee McLemore,854,42,633,318,209,136,2399.0,252,82,111.0,381,236,16.8,2018,0.0
Malik Dunbar,444,31,379,162,85,51,1182.0,202,69,60.0,177,93,19.6,2018,0.0
Horace Spencer,580,69,471,224,225,129,2081.0,22,3,135.0,449,221,16.4,2018,0.0
Davion Mitchell,843,342,671,308,175,115,2545.0,298,112,178.0,373,196,18.0,2018,0.0
Cole Blackstock,13,1,3,1,13,11,55.0,0,0,0.0,3,1,8.1,2018,0.0
Patrick Keim,21,10,23,5,17,6,188.0,19,5,16.0,4,0,12.0,2018,0.0
Thomas Collier,2,0,4,1,0,0,23.0,0,0,2.0,4,1,12.5,2018,0.0
Brett Easterling,2,0,2,1,0,0,15.0,1,0,1.0,1,1,10.0,2018,0.0
Will Macoy,15,1,16,4,9,5,51.0,11,2,1.0,5,2,19.9,2018,0.0
Devontae Williams,4,1,3,1,2,1,21.0,2,1,3.0,1,0,15.9,2018,0.0
Averyl Ugba,925,56,622,343,331,223,1921.0,45,16,134.0,577,327,23.0,2018,0.0
Terry Taylor,2507,172,1804,967,579,420,4370.0,449,153,275.0,1355,814,26.1,2018,0.0
Dayton Gumm,509,90,400,176,151,98,1318.0,166,59,73.0,234,117,19.9,2018,0.0
Zach Glotta,759,199,619,239,117,96,2515.0,491,185,102.0,128,54,15.0,2018,0.0
Chris Porter-Bunton,1028,182,749,355,328,225,2782.0,234,93,185.0,515,262,19.0,2018,0.0
Steve Harris,612,121,524,245,158,108,1711.0,42,14,134.0,482,231,20.6,2018,1.0
Tre' Ivory,229,203,269,76,119,61,1607.0,69,16,97.0,200,60,12.8,2018,0.0
Richard Henderson,166,12,130,68,66,30,511.0,0,0,34.0,130,68,18.4,2018,0.0
Edward Stephens,1157,169,960,391,191,150,2852.0,600,225,115.0,360,166,20.8,2018,0.0
Ivan Cucak,77,13,58,32,16,8,311.0,7,5,23.0,51,27,13.7,2018,0.0
Deyshawn Martin,21,3,15,7,7,5,62.0,8,2,6.0,7,5,18.9,2018,0.0
Acoydan McCarthy,18,5,21,7,9,3,107.0,4,1,6.0,17,6,14.1,2018,0.0
Ferran Bernacer,5,3,10,2,0,0,31.0,8,1,4.0,2,1,21.8,2018,0.0
Tayler Persons,1950,559,1574,715,508,383,3857.0,401,137,384.0,1173,578,28.5,2018,0.0
Tahjai Teague,1516,174,1124,589,444,283,3261.0,205,55,247.0,919,534,24.2,2018,0.0
Trey Moses,1140,284,801,426,503,284,3301.0,13,4,278.0,788,422,19.9,2018,0.0
Kyle Mallers,915,113,708,288,213,181,3107.0,463,158,149.0,245,130,15.3,2018,0.0
Sean Sellers,1131,156,841,364,222,174,3225.0,566,229,145.0,275,135,17.4,2018,0.0
Ishmael El-Amin,1083,204,912,378,198,154,2773.0,487,173,179.0,425,205,21.3,2018,0.0
Zach Gunn,327,36,266,104,60,48,923.0,202,71,39.0,64,33,18.0,2018,0.0
Jontrell Walker,1104,163,874,335,313,269,2379.0,492,165,194.0,382,170,26.0,2018,0.0
Jeremie Tyler,703,80,606,254,92,72,1737.0,320,123,94.0,286,131,22.1,2018,0.0
Francis Kiapway,848,136,720,265,148,111,2946.0,560,207,124.0,160,58,15.9,2018,0.0
Josh Thompson,217,103,195,69,71,48,1114.0,103,31,70.0,92,38,13.5,2018,0.0
Tyler Leedy,2,1,1,1,0,0,6.0,0,0,0.0,1,1,8.2,2018,0.0
Manu Lecomte,1491,392,1120,468,370,314,3893.0,595,241,237.0,525,227,20.8,2018,0.0
Jo Acuil,782,38,607,320,209,128,1937.0,45,14,107.0,562,306,21.1,2018,0.0
Nuni Omot,435,67,306,142,102,86,1086.0,162,65,69.0,144,77,19.5,2018,0.0
T.J. Maston,780,53,594,319,176,139,1608.0,20,3,119.0,574,316,24.8,2018,0.0
King McClure,848,168,711,294,158,115,2524.0,403,145,146.0,308,149,18.5,2018,0.0
Tristan Clark,516,59,347,215,126,83,1363.0,13,3,87.0,334,212,18.1,2018,0.0
Mark Vital,811,233,677,319,335,166,3187.0,55,7,197.0,622,312,16.1,2018,0.0
Jake Lindsey,396,293,335,148,88,60,2015.0,113,40,104.0,222,108,12.0,2018,0.0
Tyson Jolly,537,93,420,180,153,114,1421.0,178,63,94.0,242,117,21.1,2018,0.0
Jonathan Davis,27,2,18,9,7,6,52.0,8,3,4.0,10,6,24.6,2018,0.0
Obim Okeke,14,8,27,5,2,1,77.0,23,3,7.0,4,2,22.7,2018,0.0
Dylan Windler,1687,251,1096,593,373,284,3759.0,534,217,210.0,562,376,19.9,2018,1.0
Amanze Egekeze,1350,103,909,448,286,232,3322.0,554,222,136.0,355,226,18.3,2018,0.0
Kevin McClain,1279,256,986,437,343,241,2863.0,482,164,201.0,504,273,23.7,2018,0.0
Austin Luke,763,681,594,250,138,102,3020.0,425,161,337.0,169,89,16.9,2018,0.0
Nick Hopkins,695,124,575,228,86,71,1805.0,449,168,65.0,126,60,19.0,2018,0.0
Mack Mercer,460,43,329,172,125,96,904.0,71,20,66.0,258,152,25.8,2018,0.0
Tyler Hadden,271,20,208,100,79,52,679.0,73,19,51.0,135,81,22.7,2018,0.0
Seth Adelsperger,357,20,222,135,150,87,1193.0,0,0,44.0,222,135,14.1,2018,0.0
Burton Sampson,121,38,90,36,44,34,804.0,52,15,42.0,38,21,9.9,2018,0.0
Michael Benkert,326,76,314,111,51,41,1784.0,237,63,59.0,77,48,11.0,2018,0.0
Grayson Murphy,965,585,761,402,143,86,2874.0,220,75,198.0,541,327,17.5,2018,0.0
Caleb Hollander,562,65,502,215,64,39,1231.0,280,93,60.0,222,122,23.6,2018,0.0
Brandon Tabb,1138,102,926,359,248,217,2038.0,595,203,116.0,331,156,26.4,2018,0.0
Isaiah Bailey,999,225,690,295,466,363,1893.0,169,46,223.0,521,249,26.9,2018,0.0
Shawntrez Davis,707,77,547,274,201,117,1495.0,124,42,118.0,423,232,22.7,2018,0.0
Soufiyane Diakite,536,62,386,213,146,89,1338.0,52,21,113.0,334,192,19.0,2018,0.0
Malik Maitland,1093,421,1058,376,274,208,2864.0,394,133,234.0,664,243,22.9,2018,0.0
Jeffrey Altidort,341,155,290,114,117,74,1336.0,113,39,115.0,177,75,16.1,2018,0.0
Houston Smith,516,129,406,197,155,91,2305.0,104,31,154.0,302,166,12.6,2018,0.0
Armani Collins,278,39,279,92,45,30,852.0,226,64,35.0,53,28,17.9,2018,0.0
Davis Francis,104,25,104,40,41,17,407.0,21,7,23.0,83,33,16.1,2018,0.0
Ulmer Manzie,136,23,120,48,84,40,703.0,0,0,49.0,120,48,14.1,2018,0.0
Rodney Ross,6,0,11,3,4,0,42.0,0,0,1.0,11,3,14.8,2018,0.0
Jamal Gaines,11,1,23,4,4,3,52.0,7,0,4.0,16,4,25.2,2018,0.0
J.C. Show,1200,145,1039,405,190,156,3068.0,643,234,151.0,396,171,22.1,2018,0.0
Thomas Bruce,788,103,578,309,316,170,2607.0,5,0,151.0,573,309,17.6,2018,0.0
Willie Rodriguez,1391,142,1113,511,424,292,3422.0,274,77,262.0,839,434,24.5,2018,0.0
Fard Muhammad,413,41,345,141,40,30,1013.0,251,101,40.0,94,40,20.9,2018,0.0
Everson Davis,845,214,744,287,319,227,2853.0,158,44,189.0,586,243,20.0,2018,0.0
Bobby Ahearn,721,63,559,282,181,126,2291.0,86,31,150.0,473,251,18.4,2018,0.0
Timmy Rose,578,313,480,210,158,97,2410.0,160,61,174.0,320,149,15.9,2018,0.0
Tyler Stewart,465,38,406,162,129,103,1129.0,116,38,81.0,290,124,24.4,2018,0.0
Caleb Stewart,466,35,392,162,88,62,1276.0,223,80,61.0,169,82,20.6,2018,0.0
Albert Odero,99,10,91,36,34,21,251.0,25,6,19.0,66,30,26.4,2018,0.0
Dusan Perovic,549,48,525,203,103,66,1364.0,228,77,81.0,297,126,25.6,2018,0.0
Jordan McRae,23,2,23,11,1,1,89.0,0,0,3.0,23,11,15.6,2018,1.0
John Schurman,101,8,114,36,7,1,337.0,93,28,7.0,21,8,19.3,2018,0.0
Yosef Yacob,667,145,557,198,227,167,2126.0,312,104,174.0,245,94,21.1,2018,0.0
Chandler Hutchison,1478,255,1098,523,514,353,2948.0,224,79,236.0,874,444,26.9,2018,1.0
Christian Sengfelder,1437,95,1150,522,244,176,3914.0,605,217,160.0,545,305,18.7,2018,0.0
Justinian Jessup,1583,256,1257,543,207,172,4019.0,797,325,165.0,460,218,19.4,2018,0.0
Lexus Williams,722,228,600,243,162,129,2479.0,305,107,160.0,295,136,17.1,2018,0.0
Alex Hobbs,1024,228,836,390,196,161,2908.0,240,83,187.0,596,307,19.7,2018,0.0
Zach Haney,748,62,599,310,198,106,2096.0,89,22,116.0,510,288,19.8,2018,0.0
Marcus Dickinson,593,153,471,183,153,127,2711.0,284,100,98.0,187,83,12.2,2018,0.0
Robin Jorch,272,15,168,100,120,72,1161.0,7,0,67.0,161,100,12.6,2018,0.0
David Wacker,355,53,212,118,179,119,1606.0,3,0,75.0,209,118,12.1,2018,0.0
Cam Christon,562,60,420,186,148,112,1265.0,214,78,90.0,206,108,22.6,2018,0.0
Casdon Jardine,549,43,424,187,115,82,1447.0,239,93,74.0,185,94,19.3,2018,0.0
Malek Harwell,278,38,211,70,126,104,907.0,113,34,47.0,98,36,18.3,2018,0.0
Derrick Alston,1479,198,1089,482,396,325,2912.0,520,190,221.0,569,292,26.5,2018,1.0
Jerome Robinson,1591,294,1249,562,408,308,3118.0,423,159,259.0,826,403,27.4,2018,1.0
Ky Bowman,1661,382,1331,576,378,288,3477.0,570,221,295.0,761,355,25.9,2018,1.0
Jordan Chatman,1163,170,932,373,229,197,3362.0,576,220,124.0,356,153,17.2,2018,0.0
Nik Popovic,1141,119,926,459,274,187,2652.0,130,36,194.0,796,423,23.6,2018,0.0
Steffon Mitchell,729,255,531,232,371,210,3442.0,206,55,129.0,325,177,12.2,2018,0.0
Deontae Hawkins,1106,103,965,420,141,106,2537.0,416,160,132.0,549,260,23.7,2018,0.0
Johncarlos Reyes,343,29,271,151,82,41,1330.0,0,0,79.0,271,151,14.6,2018,0.0
Vin Baker Jr.,70,9,75,24,14,12,289.0,53,10,22.0,22,14,17.9,2018,0.0
Lucas Kraljevic,92,31,87,34,37,19,574.0,20,5,58.0,67,29,14.2,2018,0.0
Avery Wilson,23,4,19,9,10,3,76.0,5,2,11.0,14,7,22.8,2018,0.0
Ervins Meznieks,132,36,134,44,25,15,706.0,98,29,32.0,36,15,13.3,2018,0.0
Gordon Gehan,9,0,8,4,3,1,30.0,2,0,0.0,6,4,16.0,2018,0.0
Mac Bohuny,0,1,0,0,0,0,2.0,0,0,0.0,0,0,0.0,2018,0.0
Matt DiLuccio,0,0,1,0,0,0,10.0,0,0,1.0,1,0,10.1,2018,0.0
Sam Holtze,0,0,0,0,0,0,3.0,0,0,1.0,0,0,16.5,2018,0.0
Will Jackowitz,2,0,3,0,4,2,21.0,2,0,2.0,1,0,16.3,2018,0.0
Max Mahoney,1559,188,1075,646,458,267,2682.0,0,0,196.0,1075,646,28.6,2018,0.0
Tyler Scanlon,1437,323,1137,525,211,164,3867.0,581,223,216.0,556,302,19.0,2018,0.0
Cedric Hankerson,1299,162,990,387,449,290,3079.0,649,235,162.0,341,152,23.4,2018,0.0
Javante McCoy,1321,274,1120,489,274,205,3251.0,384,138,196.0,736,351,23.0,2018,0.0
Walter Whyte,908,72,723,329,230,154,2189.0,292,96,145.0,431,233,23.1,2018,0.0
Nick Havener,571,107,451,242,140,84,1709.0,13,3,137.0,438,239,19.6,2018,0.0
Will Goff,337,60,258,105,60,41,1500.0,214,86,58.0,44,19,11.8,2018,0.0
Eric Johnson,302,163,258,94,82,56,1461.0,152,58,91.0,106,36,13.6,2018,1.0
Sukhmail Mathon,545,122,445,236,108,68,1947.0,22,5,128.0,423,231,16.5,2018,0.0
Andrew Petcash,378,50,309,130,39,30,1397.0,236,88,45.0,73,42,13.8,2018,0.0
Kamali Chambers,96,33,87,30,37,24,436.0,45,12,18.0,42,18,14.4,2018,0.0
Cheddi Mosely,822,86,682,274,153,115,2077.0,458,159,127.0,224,115,22.1,2018,0.0
Destin Barnes,531,57,511,199,71,48,1468.0,270,85,77.0,241,114,21.8,2018,0.0
Justin Turner,2077,359,1686,725,546,443,3874.0,516,184,240.0,1170,541,26.9,2018,0.0
Demajeo Wiggins,1316,80,880,465,611,386,3101.0,0,0,235.0,880,465,21.8,2018,0.0
Dylan Frye,1458,306,1281,515,270,190,3518.0,670,238,219.0,611,277,22.2,2018,0.0
Rodrick Caldwell,483,135,394,144,174,126,1352.0,201,69,78.0,193,75,19.7,2018,0.0
Antwon Lillard,1041,156,766,345,374,260,2693.0,284,91,189.0,482,254,20.3,2018,0.0
Derek Koch,201,34,162,67,65,54,642.0,37,13,34.0,125,54,17.0,2018,0.0
Daeqwon Plowden,1130,84,948,431,239,166,2970.0,298,102,145.0,650,329,19.4,2018,0.0
Matt Fox,325,51,259,103,37,32,1210.0,214,87,30.0,45,16,12.3,2018,0.0
Nelly Cummings,643,105,507,219,153,118,1749.0,245,87,79.0,262,132,18.7,2018,0.0
Jeffrey Uju,140,17,117,58,39,21,708.0,11,3,30.0,106,55,11.1,2018,0.0
Joniya Gadson,29,2,19,11,17,7,106.0,0,0,11.0,19,11,17.2,2018,0.0
De Andre' Austin,19,4,10,5,9,8,49.0,1,1,3.0,9,4,16.7,2018,0.0
Ethan Good,9,3,16,3,4,2,66.0,12,1,4.0,4,2,15.9,2018,0.0
Darrell Brown,1860,491,1553,576,617,483,4321.0,596,225,350.0,957,351,26.5,2018,1.0
Donte Thomas,990,101,769,370,312,214,2691.0,149,36,190.0,620,334,21.6,2018,0.0
Nate Kennell,1236,254,1021,423,188,137,3515.0,614,253,158.0,407,170,18.8,2018,0.0
Elijah Childs,1350,104,1154,559,300,194,3068.0,144,38,186.0,1010,521,25.3,2018,0.0
Dwayne Lautier-Ogunleye,1055,308,753,304,524,351,3536.0,276,96,260.0,477,208,18.8,2018,0.0
Jayden Hodgson,343,122,287,109,84,63,1705.0,166,62,112.0,121,47,13.4,2018,0.0
Koch Bar,748,78,546,271,305,206,2643.0,0,0,180.0,546,271,17.1,2018,0.0
Luuk van Bree,774,77,694,282,115,78,2389.0,369,132,127.0,325,150,19.2,2018,0.0
Ryan Stipanovich,65,17,39,19,13,13,271.0,27,14,22.0,12,5,12.9,2018,0.0
JoJo McGlaston,549,106,497,183,186,117,1757.0,198,66,120.0,299,117,21.6,2018,0.0
Luqman Lundy,127,59,105,45,35,23,629.0,45,14,32.0,60,31,12.9,2018,0.0
Callum Barker,227,15,176,82,96,60,1032.0,24,3,75.0,152,79,15.1,2018,0.0
Peter Hanley,31,9,31,12,7,5,226.0,7,2,11.0,24,10,10.6,2018,0.0
Elijah Bryant,1373,221,989,432,444,355,2622.0,421,154,231.0,568,278,27.6,2018,0.0
Yoeli Childs,2031,222,1491,801,566,360,3659.0,194,69,266.0,1297,732,28.2,2018,0.0
TJ Haws,1899,601,1417,623,499,411,4328.0,671,242,309.0,746,381,22.9,2018,0.0
Jashire Hardnett,632,170,537,221,168,137,2128.0,184,53,128.0,353,168,18.3,2018,0.0
Zac Seljaas,884,158,661,297,156,119,2756.0,433,171,105.0,228,126,15.4,2018,0.0
Luke Worthington,331,36,258,123,146,85,1516.0,0,0,61.0,258,123,13.0,2018,0.0
Dalton Nixon,493,112,367,180,136,100,1599.0,118,33,77.0,249,147,16.5,2018,0.0
Payton Dastrup,168,24,138,64,30,22,450.0,52,18,31.0,86,46,21.1,2018,0.0
McKay Cannon,485,237,387,155,112,80,2364.0,265,95,110.0,122,60,12.1,2018,0.0
Rylan Bergersen,973,214,731,314,369,252,2126.0,306,93,160.0,425,221,23.7,2018,0.0
Kajon Brown,156,36,144,58,38,24,661.0,57,16,38.0,87,42,15.5,2018,0.0
Evan Troy,20,6,20,7,10,4,109.0,9,2,8.0,11,5,15.6,2018,0.0
Braiden Shaw,56,8,37,21,32,14,260.0,0,0,14.0,37,21,11.8,2018,0.0
Brandon Anderson,1405,294,1115,425,532,431,3053.0,415,124,306.0,700,301,26.6,2018,0.0
Desmond Cambridge,1364,124,1194,469,265,213,2480.0,640,213,144.0,554,256,29.1,2018,0.0
Zach Hunsaker,802,125,673,256,175,152,2529.0,412,138,135.0,261,118,17.1,2018,0.0
Obi Okolie,1067,156,799,364,352,244,2943.0,253,95,156.0,546,269,18.7,2018,0.0
Tamenang Choh,951,239,720,332,399,260,2475.0,97,27,246.0,623,305,22.8,2018,0.0
Joshua Howard,750,56,564,278,206,138,2012.0,174,56,121.0,390,222,19.0,2018,0.0
Jason Massey,317,59,249,122,113,64,1175.0,32,9,62.0,217,113,15.4,2018,0.0
Matt DeWolf,233,65,169,91,85,50,1008.0,3,1,83.0,166,90,14.1,2018,0.0
Chris Sullivan,217,26,180,70,34,28,960.0,139,49,21.0,41,21,11.1,2018,0.0
Travis Fuller,383,63,285,141,163,95,1075.0,32,6,95.0,253,135,20.9,2018,0.0
David Erebor,22,0,18,9,7,4,99.0,0,0,7.0,18,9,13.9,2018,0.0
George Mawanda-Kalema,129,13,109,48,23,18,316.0,47,15,15.0,62,33,21.1,2018,0.0
Patrick Triplett,105,19,114,31,53,36,475.0,49,7,40.0,65,24,19.0,2018,0.0
Jake Shaper,19,4,18,7,4,2,59.0,11,3,7.0,7,4,22.4,2018,0.0
Ikenna Ndugba,1017,415,900,349,283,207,3364.0,360,112,260.0,540,237,19.2,2018,0.0
Adam Grant,1837,265,1608,637,353,258,4261.0,848,305,264.0,760,332,23.7,2018,0.0
Bosko Kostur,890,75,646,294,237,188,2217.0,287,114,146.0,359,180,20.7,2018,0.0
Sebastian Townes,914,98,715,329,333,221,1843.0,117,35,141.0,598,294,27.6,2018,0.0
Brandon Carroll,206,21,174,75,69,45,622.0,44,11,36.0,130,64,19.3,2018,0.0
Hunter Ware,771,147,710,286,138,102,2547.0,287,97,154.0,423,189,18.7,2018,0.0
Tanner Johnson,204,19,212,68,10,7,632.0,196,61,20.0,16,7,18.6,2018,0.0
Ryan Layman,81,10,77,32,10,5,429.0,41,12,19.0,36,20,11.6,2018,0.0
Mantvydas Urmilevicius,85,14,65,34,33,17,302.0,0,0,16.0,65,34,15.9,2018,0.0
Taylor McHugh,195,141,209,63,46,31,1448.0,130,38,75.0,79,25,10.6,2018,0.0
Angus Riley,244,36,230,82,51,36,902.0,141,44,37.0,89,38,16.4,2018,0.0
Aram Martin,33,7,46,13,8,6,186.0,16,1,15.0,30,12,17.3,2018,0.0
Zach Thomas,1738,255,1145,534,648,501,3116.0,423,169,287.0,722,365,27.9,2018,0.0
Nana Foulland,1754,134,1202,696,666,362,3586.0,2,0,247.0,1200,696,24.8,2018,0.0
Stephen Brown,1309,524,967,457,344,258,3450.0,359,137,207.0,608,320,19.4,2018,0.0
Nate Sestina,1037,106,760,399,198,153,2326.0,230,86,152.0,530,313,21.6,2018,0.0
Kimbal MacKenzie,1330,291,996,419,329,281,3306.0,554,211,187.0,442,208,20.2,2018,0.0
Bruce Moore,803,71,569,253,312,236,2434.0,202,61,122.0,367,192,17.3,2018,0.0
Jimmy Sotos,830,403,657,263,239,188,2936.0,327,116,241.0,330,147,17.4,2018,0.0
Avi Toomer,832,170,647,274,211,140,2744.0,381,144,157.0,266,130,16.6,2018,0.0
Nate Jones,300,79,256,98,66,39,1440.0,191,65,52.0,65,33,11.7,2018,0.0
John Meeks,701,72,551,262,139,111,1502.0,183,66,106.0,368,196,24.4,2018,0.0
Ben Robertson,136,36,113,56,41,16,631.0,33,8,29.0,80,48,12.8,2018,0.0
Matt O'Reilly,178,10,184,59,8,4,546.0,177,56,17.0,7,3,18.7,2018,0.0
Paul Newman,356,39,290,144,146,68,1234.0,1,0,92.0,289,144,18.5,2018,0.0
Jordan Sechan,8,5,21,3,0,0,62.0,13,2,5.0,8,1,20.7,2018,0.0
C.J. Massinburg,1990,318,1386,626,614,465,4008.0,708,273,203.0,678,353,21.9,2018,0.0
Nick Perkins,1774,84,1406,639,521,349,3429.0,453,147,258.0,953,492,26.0,2018,0.0
Jeremy Harris,1062,185,895,397,151,114,2321.0,450,154,102.0,445,243,21.4,2018,0.0
Wes Clark,1015,354,870,348,247,186,2825.0,364,133,210.0,506,215,21.4,2018,0.0
Davonta Jordan,945,522,849,384,172,70,3318.0,327,107,317.0,522,277,17.3,2018,0.0
Jayvon Graves,1436,281,1263,533,291,179,3444.0,562,191,192.0,701,342,21.1,2018,0.0
Dontay Caruthers,639,221,410,220,214,155,1957.0,123,44,144.0,287,176,15.6,2018,0.0
Montell McRae,313,30,226,116,68,41,1033.0,122,40,45.0,104,76,13.4,2018,0.0
Ikenna Smart,374,20,267,154,113,66,1678.0,1,0,91.0,266,154,11.6,2018,0.0
James Reese,634,77,544,227,71,62,1929.0,352,118,76.0,192,109,18.2,2018,0.0
Brock Bertram,115,13,82,47,33,21,616.0,0,0,24.0,82,47,9.0,2018,0.0
Dominic Johnson,9,0,6,4,0,0,37.0,2,1,2.0,4,3,10.1,2018,0.0
Gabe Agorioge,6,1,2,1,4,3,18.0,1,1,1.0,1,0,12.7,2018,0.0
Colby Moultrie,3,1,3,1,0,0,21.0,2,1,5.0,1,0,17.8,2018,0.0
Kelan Martin,2047,161,1631,713,505,397,3656.0,644,224,237.0,987,489,29.6,2018,1.0
Kamar Baldwin,1956,364,1672,746,360,294,4217.0,510,170,278.0,1162,576,26.6,2018,0.0
Paul Jorgensen,1055,253,962,378,175,129,2785.0,462,170,128.0,500,208,21.8,2018,0.0
Tyler Wideman,894,74,554,345,312,204,2654.0,6,0,140.0,548,345,16.3,2018,0.0
Sean McDermott,977,88,706,330,142,117,3004.0,496,200,81.0,210,130,15.1,2018,0.0
Nate Fowler,590,73,417,235,115,85,1748.0,95,35,83.0,322,200,16.5,2018,0.0
Aaron Thompson,697,452,555,267,261,149,3083.0,63,14,213.0,492,253,15.4,2018,0.0
Henry Baddley,392,44,304,143,73,51,1558.0,156,55,48.0,148,88,13.0,2018,0.0
Christian David,149,41,136,51,42,26,853.0,83,21,36.0,53,30,11.9,2018,0.0
Joey Brunk,516,56,374,210,165,95,1399.0,5,1,75.0,369,209,19.4,2018,0.0
Jerald Gillens-Butler,73,9,66,24,28,20,201.0,28,5,9.0,38,19,23.0,2018,0.0
Campbell Donovan,13,3,13,3,4,4,59.0,11,3,0.0,2,0,13.5,2018,0.0
Victor Joseph,818,83,673,270,193,164,1704.0,317,114,111.0,356,156,27.0,2018,0.0
Donovan Fields,1245,303,1109,457,254,222,2796.0,312,109,195.0,797,348,26.7,2018,0.0
Luke Meikle,774,77,745,280,158,120,2212.0,294,94,91.0,451,186,21.4,2018,0.0
Jakub Niziol,482,61,444,154,92,71,1356.0,326,103,62.0,118,51,21.3,2018,0.0
Josh Martin,527,92,461,174,215,128,1811.0,148,51,130.0,313,123,20.0,2018,0.0
Marcellus Garrick,518,32,446,173,110,85,1249.0,244,87,46.0,202,86,22.9,2018,0.0
Hank Hollingsworth,304,14,222,129,108,46,1639.0,0,0,88.0,222,129,11.6,2018,0.0
Mark Crowe,646,107,555,220,95,56,2664.0,405,150,109.0,150,70,14.0,2018,0.0
Trevor John,477,45,378,153,43,41,1372.0,328,130,24.0,50,23,15.6,2018,0.0
Aleks Abrams,178,20,158,63,84,52,1150.0,0,0,51.0,158,63,11.4,2018,0.0
Iziah James,284,93,264,92,72,55,1033.0,128,45,71.0,136,47,18.2,2018,0.0
Karlis Garoza,113,19,100,43,51,27,576.0,0,0,42.0,100,43,15.2,2018,0.0
Paulo Cruz,0,0,6,0,0,0,37.0,4,0,5.0,2,0,15.2,2018,0.0
Damiyne Durham,1442,119,1407,523,121,80,2886.0,961,316,147.0,446,207,27.6,2018,0.0
Rickey Holden,691,211,574,229,182,154,1954.0,228,79,133.0,346,150,20.2,2018,0.0
Jarkell Joiner,1180,118,1036,429,266,217,2794.0,335,105,115.0,701,324,22.7,2018,0.0
Shon Briggs,498,82,407,174,228,145,1319.0,25,5,98.0,382,169,23.2,2018,0.0
Moataz Aly,312,15,197,132,121,48,976.0,0,0,92.0,197,132,17.9,2018,0.0
Justin Davis,231,25,176,80,55,47,652.0,68,24,34.0,108,56,18.4,2018,0.0
Brent Wrapp,577,520,422,166,304,212,3250.0,123,33,203.0,299,133,12.1,2018,0.0
Fallou Ndoye,228,15,206,92,97,44,1157.0,1,0,108.0,205,92,15.9,2018,0.0
Greg Lee,730,106,658,304,101,71,1866.0,172,51,160.0,486,253,23.6,2018,1.0
Justin McCall,535,50,441,216,168,98,1814.0,22,5,81.0,419,211,16.7,2018,0.0
Bray Barnes,59,4,48,17,26,20,218.0,27,5,9.0,21,12,15.7,2018,0.0
James Suber,295,24,195,105,151,85,1309.0,2,0,73.0,193,105,12.8,2018,0.0
Kyle Allman,1680,238,1225,532,670,489,3690.0,361,127,279.0,864,405,24.9,2018,0.0
Khalil Ahmad,1768,172,1425,604,481,383,3465.0,553,177,249.0,872,427,27.7,2018,0.0
Jackson Rowe,1340,200,899,481,405,287,3374.0,244,91,259.0,655,390,20.3,2018,0.0
Austen Awosika,1088,394,888,400,409,248,3596.0,149,40,230.0,739,360,18.6,2018,0.0
Arkim Robertson,280,13,169,106,115,68,915.0,0,0,66.0,169,106,15.9,2018,0.0
Jamal Smith,464,159,370,157,164,107,2222.0,128,43,164.0,242,114,14.1,2018,0.0
Davon Clare,547,163,502,216,116,78,2443.0,148,37,143.0,354,179,14.6,2018,0.0
Dominik Heinzl,131,7,88,51,42,29,529.0,0,0,31.0,88,51,13.4,2018,0.0
Daniel Venzant,115,38,84,42,35,19,421.0,30,12,26.0,54,30,15.5,2018,0.0
Dwight Ramos,116,14,124,42,29,14,324.0,67,18,17.0,57,24,23.9,2018,0.0
Josh Pitts,119,11,95,47,57,25,468.0,0,0,37.0,95,47,17.5,2018,0.0
Landon Kirkwood,17,3,13,7,0,0,51.0,7,3,2.0,6,4,15.0,2018,0.0
Johnny Wang,280,20,220,107,70,53,1153.0,39,13,60.0,181,94,13.9,2018,0.0
Ian Fox,6,7,28,2,0,0,77.0,21,2,3.0,7,0,21.2,2018,0.0
Jose Garcia Gonzalez,7,0,9,3,0,0,9.0,4,1,0.0,5,2,51.0,2018,0.0
Tavrion Dawson,1221,141,968,456,345,254,2659.0,201,55,154.0,767,401,24.4,2018,0.0
Terrell Gomez,1877,342,1428,629,309,275,4173.0,799,344,195.0,629,285,21.4,2018,0.0
Micheal Warren,921,166,660,299,283,227,2439.0,247,96,142.0,413,203,19.3,2018,0.0
Lyrik Shreiner,380,115,318,135,113,86,1468.0,92,24,120.0,226,111,17.3,2018,0.0
Reggie Theus Jr.,287,35,292,118,87,44,1131.0,22,7,53.0,270,111,17.5,2018,0.0
Jalon Pipkins,500,90,387,184,104,82,1429.0,127,50,97.0,260,134,19.8,2018,0.0
Carl Brown,66,4,58,23,10,8,184.0,31,12,7.0,27,11,20.2,2018,0.0
Zeno Lake,61,4,44,23,30,15,323.0,0,0,9.0,44,23,11.1,2018,0.0
Jonathan Guevara,57,28,61,19,25,13,391.0,20,6,21.0,41,13,12.8,2018,0.0
Anthony Swan,76,21,88,31,3,0,382.0,45,14,18.0,43,17,14.7,2018,0.0
Mahamadou Kaba-Camara,76,2,63,35,28,6,601.0,0,0,16.0,63,35,7.7,2018,0.0
Blair Orr,50,4,44,21,11,8,183.0,0,0,10.0,44,21,16.0,2018,0.0
Alex Sokol,12,5,24,3,4,3,84.0,20,3,3.0,4,0,17.0,2018,0.0
TJ Shorts II,930,272,637,324,354,260,2003.0,72,22,169.0,565,302,26.1,2018,0.0
Siler Schneider,1440,271,1290,532,324,229,3560.0,447,147,330.0,843,385,26.2,2018,0.0
Chima Moneke,913,51,624,326,374,252,1612.0,24,9,150.0,600,317,30.3,2018,0.0
A.J. John,463,42,419,170,87,55,1828.0,212,68,85.0,207,102,15.8,2018,0.0
Michael Onyebalu,214,38,148,65,63,49,1007.0,83,35,59.0,65,30,12.5,2018,0.0
Joe Mooney,946,116,748,317,168,140,2367.0,468,172,115.0,280,145,21.2,2018,0.0
Garrison Goode,425,84,326,158,197,109,2689.0,1,0,122.0,325,158,10.7,2018,0.0
Arell Hennings,156,73,123,48,46,39,567.0,55,21,47.0,68,27,17.6,2018,0.0
Rogers Printup,285,46,262,99,28,25,1362.0,194,62,38.0,68,37,12.3,2018,0.0
Colin Russell,81,13,75,30,50,21,589.0,0,0,30.0,75,30,11.3,2018,0.0
Delveion Jackson,24,14,33,9,7,2,205.0,16,4,8.0,17,5,11.5,2018,0.0
Evan Leonard,1285,202,989,417,313,259,2896.0,519,192,178.0,470,225,22.9,2018,0.0
Eyassu Worku,1273,410,1194,475,278,201,3406.0,352,122,263.0,842,353,23.5,2018,0.0
Tommy Rutherford,1148,91,746,447,353,242,2647.0,28,12,207.0,718,435,21.4,2018,0.0
John Edgar Jr.,722,112,675,289,111,79,2373.0,248,65,150.0,427,224,18.6,2018,0.0
Max Hazzard,1067,217,920,365,179,133,2699.0,554,204,155.0,366,161,21.8,2018,0.0
Brad Greene,797,68,625,335,186,126,2027.0,4,1,122.0,621,334,20.6,2018,0.0
Elston Jones,536,85,436,227,173,82,1991.0,0,0,124.0,436,227,16.6,2018,0.0
Jonathan Galloway,647,85,461,240,281,167,3260.0,0,0,133.0,461,240,11.4,2018,0.0
Brandon Smith,243,67,241,85,80,49,1495.0,95,24,80.0,146,61,12.2,2018,0.0
Darrian Traylor,137,26,121,44,30,17,420.0,94,32,24.0,27,12,19.2,2018,0.0
Justin Wertner,47,6,38,14,9,9,139.0,24,10,3.0,14,4,16.2,2018,0.0
Riley Welch,14,15,14,4,5,4,152.0,8,2,8.0,6,2,8.1,2018,0.0
Teo Davidian,11,3,12,3,6,4,16.0,3,1,1.0,9,2,49.4,2018,0.0
Chance Murray,749,223,703,252,264,177,2217.0,244,68,156.0,459,184,22.5,2018,0.0
Dikymbe Martin,1315,268,1070,471,235,197,3224.0,427,176,196.0,643,295,22.5,2018,0.0
Alex Larsson,735,51,589,300,253,135,2531.0,0,0,178.0,589,300,17.9,2018,0.0
DJ Sylvester,291,47,247,89,106,72,908.0,123,41,50.0,124,48,19.3,2018,0.0
Brandon Rosser,333,49,284,120,104,68,1239.0,95,25,77.0,189,95,16.7,2018,0.0
Menno Dijkstra,756,71,613,309,92,75,2095.0,170,63,83.0,443,246,18.3,2018,0.0
Koh Flippin,162,43,136,49,45,32,549.0,92,32,24.0,44,17,16.7,2018,0.0
Ajani Kennedy,424,61,340,156,89,63,1317.0,132,49,92.0,208,107,18.7,2018,0.0
Idy Diallo,122,13,101,56,30,10,599.0,0,0,55.0,101,56,14.7,2018,0.0
James Jackson,115,35,112,45,34,14,650.0,34,11,44.0,78,34,13.5,2018,0.0
Eric Rwahwire,116,13,137,41,20,15,382.0,77,19,24.0,60,22,23.7,2018,0.0
Alec Hickman,40,8,47,16,1,0,211.0,32,8,2.0,15,8,11.8,2018,0.0
Jayvon Brown,31,5,26,9,15,11,89.0,11,2,10.0,15,7,24.3,2018,0.0
Dominick Pickett,603,196,491,208,84,75,2498.0,289,112,96.0,202,96,13.6,2018,0.0
Ryker Pierce,52,5,57,15,17,11,196.0,39,11,5.0,18,4,18.9,2018,0.0
Marcus Berkley,0,0,1,0,0,0,2.0,1,0,1.0,0,0,50.2,2018,0.0
Max Heidegger,1347,229,1093,423,422,328,2792.0,525,173,138.0,568,250,26.4,2018,0.0
Leland King,1135,120,956,439,223,155,2281.0,298,102,141.0,658,337,26.6,2018,0.0
Gabe Vincent,1441,285,1213,496,268,206,3359.0,646,243,154.0,567,253,22.9,2018,1.0
Jalen Canty,432,40,298,172,145,88,978.0,0,0,47.0,298,172,21.6,2018,0.0
Marcus Jackson,1307,369,1066,429,291,224,3692.0,626,225,240.0,440,204,20.5,2018,0.0
Ami Lakoju,292,11,219,127,79,38,849.0,0,0,60.0,219,127,19.1,2018,0.0
Jarriesse Blackmon,302,58,261,120,102,55,1344.0,20,5,49.0,241,115,13.7,2018,0.0
Alex Hart,353,27,294,134,123,72,1053.0,49,13,57.0,245,121,19.9,2018,0.0
Brandon Davis,307,161,292,110,95,60,1404.0,87,27,117.0,205,83,17.1,2018,0.0
Maxwell Kupchak,233,50,227,84,83,58,1144.0,38,7,59.0,189,77,14.4,2018,0.0
Sam Walters,41,16,40,14,2,2,210.0,35,11,13.0,5,3,13.1,2018,0.0
J.D. Slajchert,100,8,102,41,24,17,367.0,3,1,22.0,99,40,18.7,2018,0.0
Clifton Powell,176,39,196,69,38,19,575.0,56,19,47.0,140,50,23.0,2018,0.0
Andrew Pickles,6,2,4,2,3,2,27.0,0,0,1.0,4,2,12.2,2018,0.0
Justice Sueing,1219,151,908,406,417,308,2971.0,312,99,177.0,596,307,21.8,2018,0.0
Don Coleman,617,79,563,194,267,189,1471.0,156,40,103.0,407,154,26.4,2018,0.0
Marcus Lee,755,67,533,326,206,103,2254.0,0,0,142.0,533,326,16.8,2018,0.0
Darius McNeill,792,110,723,282,109,79,2346.0,420,149,116.0,303,133,18.9,2018,0.0
Juhwan Harris-Dyson,345,70,291,132,142,81,1250.0,25,0,103.0,266,132,18.6,2018,0.0
Kingsley Okoroh,445,71,380,176,162,93,2255.0,0,0,122.0,380,176,12.8,2018,0.0
Nick Hamilton,65,24,65,21,27,18,491.0,19,5,32.0,46,16,10.8,2018,0.0
Roman Davis,81,11,95,31,46,17,362.0,10,2,20.0,85,29,18.7,2018,0.0
Deschon Winston,231,82,245,83,65,45,854.0,78,20,54.0,167,63,18.0,2018,0.0
Grant Anticevich,594,98,575,230,80,63,2205.0,204,71,122.0,371,159,17.8,2018,0.0
Cole Welle,37,0,44,15,19,7,125.0,5,0,1.0,39,15,21.6,2018,0.0
Derek King,5,0,3,2,0,0,4.0,2,1,1.0,1,1,47.6,2018,0.0
Austin McCullough,282,24,203,93,51,40,869.0,150,56,23.0,53,37,15.6,2018,0.0
Jacob Orender,9,3,17,2,4,3,53.0,13,2,6.0,4,0,24.5,2018,0.0
Jules Erving,0,0,0,0,0,0,8.0,0,0,1.0,0,0,6.6,2018,0.0
Chris Clemons,3225,335,2307,1024,860,733,4433.0,1224,444,324.0,1083,580,36.1,2018,1.0
Marcus Burk,1848,167,1412,644,330,264,3530.0,744,296,205.0,668,348,25.2,2018,0.0
Andrew Eudy,935,282,730,371,162,127,3053.0,170,66,181.0,560,305,17.1,2018,0.0
Cory Gensler,1106,199,917,421,111,72,4125.0,518,192,88.0,399,229,13.6,2018,0.0
Shane Whitfield,977,225,641,308,509,359,3333.0,15,2,228.0,626,306,17.6,2018,0.0
Damontez Oliver,254,44,201,82,54,36,968.0,140,54,53.0,61,28,15.3,2018,0.0
Mogga Lado,285,62,186,108,114,69,1153.0,0,0,70.0,186,108,14.3,2018,0.0
Jordan Whitfield,861,241,676,304,158,132,2835.0,307,121,163.0,369,183,17.5,2018,0.0
Ja'cor Nelson,454,142,390,174,172,95,1577.0,62,11,140.0,328,163,20.6,2018,0.0
Jon Ander Cuadra,74,3,46,29,18,11,126.0,12,5,9.0,34,24,26.5,2018,0.0
Nick Parker,35,10,28,13,2,2,72.0,17,7,4.0,11,6,24.3,2018,0.0
Nick Greely,12,2,6,4,5,4,15.0,0,0,1.0,6,4,33.2,2018,0.0
Brooks Cluxton,62,14,41,24,31,14,251.0,0,0,14.0,41,24,14.6,2018,0.0
Wyatt Self,3,2,2,1,0,0,10.0,2,1,0.0,0,0,10.6,2018,0.0
Jermaine Crumpton,1587,132,1237,573,387,282,3104.0,439,159,175.0,798,414,25.6,2018,0.0
Isaiah Reese,1033,340,879,380,169,134,2447.0,426,139,198.0,453,241,23.7,2018,0.0
Takal Molson,1103,172,862,361,379,273,2537.0,367,108,188.0,495,253,24.7,2018,0.0
Malik Johnson,1098,644,970,374,332,237,4374.0,390,113,281.0,580,261,16.1,2018,0.0
Jonathan Sanks,462,72,388,153,98,64,1341.0,258,92,53.0,130,61,18.4,2018,0.0
Spencer Foley,274,33,212,94,28,23,649.0,159,63,25.0,53,31,19.0,2018,0.0
Selvedin Planincic,230,31,152,86,69,46,714.0,52,12,58.0,100,74,16.9,2018,0.0
Jibreel Faulkner,362,42,290,140,59,37,899.0,123,45,38.0,167,95,20.1,2018,0.0
Marcale Lotts,82,9,62,37,25,8,435.0,0,0,36.0,62,37,12.7,2018,0.0
Jalanni White,497,60,388,196,158,91,1552.0,63,14,106.0,325,182,18.4,2018,0.0
Scott Hitchon,581,84,450,203,168,123,1480.0,142,52,115.0,308,151,21.9,2018,0.0
D.J. Heath,324,123,300,118,85,51,1417.0,120,37,130.0,180,81,16.2,2018,0.0
Shaquille Evans,0,0,1,0,0,0,5.0,0,0,0.0,1,0,10.0,2018,0.0
Dantai St. Louis,129,6,102,49,54,31,620.0,0,0,31.0,102,49,12.8,2018,0.0
Jordan Howard,2524,320,1823,790,643,558,4311.0,934,386,298.0,889,404,27.0,2018,0.0
Mathieu Kamba,1451,218,1007,532,580,347,3553.0,119,40,283.0,888,492,21.1,2018,0.0
Thatch Unruh,1066,217,858,347,234,186,2898.0,552,186,194.0,306,161,19.5,2018,0.0
Hayden Koval,1297,124,957,445,374,277,3418.0,389,130,199.0,568,315,18.6,2018,0.0
Deandre Jones,1012,489,730,300,319,264,3014.0,383,148,299.0,347,152,18.7,2018,0.0
Tanner Schmit,520,44,532,220,83,55,1669.0,83,25,72.0,449,195,18.5,2018,0.0
Matthew Mondesir,328,109,291,120,124,68,1251.0,62,20,71.0,229,100,16.3,2018,0.0
Ethan Lee,415,57,325,154,190,107,1602.0,7,0,93.0,318,154,15.2,2018,0.0
Darraja Parnell,274,80,199,94,97,73,746.0,37,13,78.0,162,81,20.7,2018,0.0
Jared Chatham,605,59,512,238,167,116,1637.0,63,13,139.0,449,225,21.2,2018,0.0
Aaron Weidenaar,308,45,302,98,51,37,1180.0,242,75,58.0,60,23,15.5,2018,0.0
Otas Iyekekpolor,81,8,66,27,40,25,448.0,5,2,25.0,61,25,11.9,2018,0.0
Jordan Grant,32,13,18,11,0,0,188.0,17,10,6.0,1,1,6.3,2018,0.0
Tyler Simmons,5,2,11,2,0,0,33.0,8,1,2.0,3,1,19.1,2018,0.0
Brandon Vanover,7,0,9,2,6,3,28.0,2,0,3.0,7,2,25.4,2018,0.0
Tyler Kohl,1008,251,820,335,310,254,2005.0,272,84,214.0,548,251,30.1,2018,0.0
Mustafa Jones,871,93,793,381,151,105,2540.0,20,4,134.0,773,377,20.3,2018,0.0
Deion Bute,570,34,361,216,192,138,1452.0,0,0,138.0,361,216,20.8,2018,0.0
Austin Nehls,1110,147,868,335,283,216,3544.0,610,224,126.0,258,111,16.3,2018,0.0
Joe Hugley,735,23,513,224,245,196,1353.0,251,91,103.0,262,133,27.6,2018,0.0
Eric Bowles,231,175,199,80,93,55,1512.0,47,16,110.0,152,64,12.1,2018,0.0
Kashaun Hicks,534,44,429,168,149,110,1585.0,244,88,118.0,185,80,19.4,2018,0.0
Tyson Batiste,533,368,489,215,157,59,2845.0,121,44,221.0,368,171,13.7,2018,0.0
Shakaris Laney,122,39,137,44,29,19,651.0,67,15,37.0,70,29,15.1,2018,0.0
Talek Williams,29,9,26,9,13,10,118.0,9,1,7.0,17,8,17.5,2018,0.0
Chris Williams,101,7,105,38,15,13,336.0,47,12,16.0,58,26,19.6,2018,0.0
Harrison Kay,54,8,58,20,18,10,277.0,12,4,23.0,46,16,16.7,2018,0.0
Donyell Marshall Jr.,21,2,19,6,14,9,105.0,2,0,6.0,17,6,15.3,2018,0.0
A.J. Davis,1030,235,802,317,450,321,3213.0,249,75,232.0,553,242,20.2,2018,0.0
Dayon Griffin,815,130,708,293,158,87,2494.0,415,142,122.0,293,151,18.5,2018,0.0
Ceasar DeJesus,654,149,521,241,179,133,1981.0,107,39,162.0,414,202,20.3,2018,0.0
B.J. Taylor,1618,324,1248,491,622,456,3541.0,501,180,178.0,747,311,25.6,2018,0.0
Tacko Fall,1160,50,672,497,384,166,2649.0,1,0,240.0,671,497,21.5,2018,1.0
Terrell Allen,1006,458,805,341,319,247,3929.0,207,77,241.0,598,264,15.7,2018,0.0
Chad Brown,473,23,319,158,268,157,1709.0,1,0,79.0,318,158,16.2,2018,0.0
Chance McSpadden,271,59,224,93,82,62,838.0,83,23,83.0,141,70,21.4,2018,0.0
Djordjije Mumin,125,7,124,42,6,4,552.0,106,37,20.0,18,5,14.1,2018,0.0
Myles Douglas,346,61,322,109,113,81,1158.0,159,47,103.0,163,62,20.7,2018,0.0
Rokas Ulvydas,63,1,48,22,34,19,300.0,0,0,19.0,48,22,14.9,2018,0.0
Nathan Laing,25,27,47,6,18,12,415.0,26,1,37.0,21,5,11.6,2018,0.0
Cecil Williams,795,112,545,257,312,244,1870.0,108,37,149.0,437,220,21.8,2018,0.0
Shawn Roundtree,1189,301,898,368,397,313,2931.0,391,140,233.0,507,228,22.3,2018,0.0
David DiLeo,1604,132,1218,506,311,255,4203.0,878,337,108.0,340,169,16.6,2018,0.0
Kevin McKay,1225,155,844,466,353,267,2961.0,99,26,188.0,745,440,19.3,2018,0.0
Luke Meyer,988,63,677,369,199,161,2676.0,240,89,90.0,437,280,16.0,2018,0.0
Josh Kozinski,1000,65,915,323,63,48,3244.0,877,306,27.0,38,17,14.9,2018,0.0
Gavin Peppers,515,92,410,166,120,106,1212.0,212,77,84.0,198,89,22.7,2018,0.0
Matt Beachler,369,58,334,122,57,38,1324.0,271,87,50.0,63,35,14.7,2018,0.0
Innocent Nwoko,47,1,34,20,17,7,188.0,1,0,10.0,33,20,13.3,2018,0.0
Matty Smith,45,51,53,20,12,4,350.0,12,1,30.0,41,19,12.1,2018,0.0
Corey Redman,107,11,85,35,11,9,401.0,69,28,16.0,16,7,13.0,2018,0.0
John McCarty,14,2,14,6,0,0,43.0,8,2,1.0,6,4,16.8,2018,0.0
Austin Ervin,6,1,7,2,3,2,22.0,4,0,0.0,3,2,18.6,2018,0.0
Adam Kozinski,3,0,7,1,0,0,8.0,7,1,0.0,0,0,43.6,2018,0.0
Jamarrio Rule,1,1,0,0,2,1,6.0,0,0,0.0,0,0,7.9,2018,0.0
Christian Keeling,1878,215,1458,652,521,407,3638.0,479,167,248.0,979,485,26.3,2018,0.0
Phlandrous Fleming Jr.,1510,269,1271,528,367,286,3181.0,553,168,244.0,718,360,26.8,2018,0.0
Travis McConico,585,118,489,206,104,70,1718.0,282,103,87.0,207,103,17.9,2018,0.0
Cortez Mitchell,599,116,487,221,181,119,1384.0,121,38,83.0,366,183,23.8,2018,0.0
Ty Jones,820,166,649,329,162,133,2403.0,84,29,183.0,565,300,19.0,2018,0.0
Javis Howard,698,54,550,297,158,97,2438.0,27,7,127.0,523,290,15.4,2018,0.0
Deontaye Buskey,645,179,587,224,139,88,2107.0,320,109,120.0,267,115,18.5,2018,0.0
Jamaal David,78,26,59,24,29,20,313.0,29,10,31.0,30,14,16.9,2018,0.0
Sean Price,353,79,269,136,83,55,1173.0,83,26,77.0,186,110,16.3,2018,0.0
Jamar Martin,126,29,112,44,24,17,482.0,66,21,26.0,46,23,15.5,2018,0.0
Jamal Thomas,140,26,116,43,41,26,408.0,83,28,30.0,33,15,19.8,2018,0.0
JC Cavin,17,4,14,6,5,3,70.0,7,2,3.0,7,4,17.0,2018,0.0
Abdul Sarki,17,0,14,6,6,5,45.0,0,0,3.0,14,6,22.4,2018,0.0
Nathan Payne,14,0,16,5,11,4,51.0,0,0,1.0,16,5,21.4,2018,0.0
Alex Stewart,0,0,3,0,0,0,11.0,1,0,2.0,2,0,23.1,2018,0.0
Jon Davis,2113,547,1567,681,691,551,4247.0,575,200,415.0,992,481,27.5,2018,0.0
Andrien White,1337,139,1035,424,347,264,2990.0,595,225,196.0,440,199,22.8,2018,0.0
Austin Ajukwa,641,56,543,219,168,132,1919.0,198,71,127.0,345,148,19.8,2018,0.0
Najee Garvin,680,49,572,272,206,132,1756.0,32,4,132.0,540,268,22.0,2018,0.0
Milos Supica,674,75,491,270,212,134,2085.0,1,0,173.0,490,270,19.6,2018,0.0
Jailan Haslem,225,31,169,94,72,37,865.0,1,0,64.0,168,94,16.0,2018,0.0
Ryan Murphy,390,61,377,140,41,30,1234.0,232,80,60.0,145,60,18.7,2018,0.0
Hudson Price,378,58,296,123,96,71,1497.0,165,61,71.0,131,62,13.9,2018,0.0
Luka Vasic,163,30,125,51,64,39,619.0,69,22,44.0,56,29,16.6,2018,0.0
Jaylan McGill,205,33,185,70,25,18,1089.0,131,47,34.0,54,23,11.2,2018,0.0
Bryant Thomas,22,2,16,8,12,6,127.0,0,0,5.0,16,8,10.4,2018,0.0
Corey Bias,4,1,2,1,2,2,18.0,0,0,0.0,2,1,8.1,2018,0.0
Bo Blight,29,7,38,11,6,4,249.0,16,3,10.0,22,8,11.2,2018,0.0
Nat Dixon,660,126,521,215,181,127,2355.0,280,103,106.0,241,112,15.8,2018,0.0
Rodney Chatman,895,348,697,294,294,213,2811.0,289,94,257.0,408,200,20.4,2018,0.0
Makinde London,604,81,508,208,162,114,1325.0,222,74,137.0,286,134,28.3,2018,0.0
Makale Foreman,1147,177,1018,372,181,153,3232.0,707,250,159.0,311,122,20.0,2018,0.0
Joshua Phillips,313,20,235,120,130,73,1013.0,1,0,75.0,234,120,19.3,2018,0.0
David Jean-Baptiste,1279,263,1113,472,183,137,3495.0,544,198,194.0,569,274,20.7,2018,0.0
James Lewis Jr.,521,38,325,169,263,183,1709.0,0,0,110.0,325,169,17.0,2018,0.0
Jonathan Bryant II,46,5,47,18,16,9,215.0,10,1,12.0,37,17,16.3,2018,0.0
Duane Moss,34,9,24,11,7,4,142.0,15,8,7.0,9,3,12.7,2018,0.0
Dylan Brewster,25,8,20,8,4,2,90.0,19,7,6.0,1,1,16.1,2018,0.0
A.J. Bowers,8,2,4,3,2,2,74.0,1,0,4.0,3,3,6.4,2018,0.0
Nick Desmarais,0,0,1,0,0,0,4.0,1,0,0.0,0,0,13.1,2018,0.0
C.J. Massengill,0,0,1,0,0,0,7.0,0,0,0.0,1,0,7.5,2018,0.0
Fred Sims Jr.,1348,106,1397,482,255,212,2634.0,545,172,146.0,852,310,30.5,2018,0.0
Glen Burns,399,148,267,120,193,143,1266.0,47,16,119.0,220,104,18.1,2018,0.0
Deionte Simmons,475,8,314,173,194,129,1074.0,2,0,74.0,312,173,21.6,2018,0.0
Jelani Pruitt,197,24,183,78,64,34,468.0,24,7,49.0,159,71,26.7,2018,0.0
Montana Byrd,378,38,386,129,48,36,1395.0,258,84,74.0,128,45,16.9,2018,0.0
Anthony Harris,572,97,423,184,217,164,1549.0,122,40,130.0,301,144,21.0,2018,0.0
Cameron Bowles,418,48,359,153,152,106,1571.0,44,6,107.0,315,147,17.0,2018,0.0
Rob Shaw,459,233,545,197,83,56,1583.0,68,9,163.0,477,188,23.4,2018,0.0
Travon Bell,395,56,377,141,32,22,1148.0,273,91,58.0,104,50,19.4,2018,0.0
Patrick Szpir,378,58,307,143,136,92,1990.0,3,0,121.0,304,143,12.3,2018,0.0
Alex Dubovitskiy,58,7,59,20,11,6,381.0,42,12,20.0,17,8,10.7,2018,0.0
Simeon Henton,22,8,15,7,13,8,72.0,1,0,3.0,14,7,16.0,2018,0.0
Jalen Stephens-Holmes,20,3,19,9,5,2,84.0,1,0,6.0,18,9,15.6,2018,0.0
Nathan Townsen Jr.,19,10,15,5,10,8,76.0,3,1,12.0,12,4,20.0,2018,0.0
John Joyce,13,1,17,5,0,0,44.0,13,3,2.0,4,2,20.6,2018,0.0
Ken Odiase,69,5,60,25,38,18,242.0,3,1,22.0,57,24,20.7,2018,0.0
Jacob Evans,1233,263,985,423,282,213,3051.0,462,174,133.0,523,249,20.9,2018,1.0
Gary Clark,1462,279,1033,542,464,324,4003.0,141,54,158.0,892,488,18.4,2018,1.0
Jarron Cumberland,1782,415,1355,561,599,437,3721.0,634,223,296.0,721,338,26.5,2018,0.0
Kyle Washington,1275,76,1066,520,278,193,3049.0,113,42,166.0,953,478,23.0,2018,0.0
Cane Broome,1715,337,1356,595,469,353,3577.0,528,172,283.0,828,423,25.5,2018,0.0
Justin Jenifer,629,291,504,206,137,100,2270.0,294,117,82.0,210,89,14.7,2018,0.0
Trevor Moore,391,81,359,121,100,71,1408.0,260,78,69.0,99,43,16.2,2018,0.0
Tre Scott,885,170,709,349,255,157,2887.0,102,30,144.0,607,319,17.2,2018,0.0
Keith Williams,1156,157,989,419,346,241,2720.0,262,77,179.0,727,342,24.6,2018,0.0
Nysier Brooks,653,45,460,240,280,173,2161.0,5,0,109.0,455,240,16.7,2018,0.0
Eliel Nsoseme,302,26,208,118,134,66,1079.0,0,0,40.0,208,118,14.3,2018,0.0
Mamoudou Diarra,184,21,149,68,57,37,604.0,20,11,40.0,129,57,18.0,2018,0.0
Jackson Bart,6,0,8,2,0,0,26.0,7,2,0.0,1,0,15.6,2018,0.0
John Koz,4,3,5,2,0,0,33.0,2,0,2.0,3,2,10.9,2018,0.0
Sam Martin,7,6,7,2,3,3,40.0,2,0,4.0,5,2,15.6,2018,0.0
Zane Najdawi,1634,114,1166,566,515,395,3056.0,291,107,252.0,875,459,23.6,2018,0.0
Matt Frierson,1148,138,962,350,136,124,2652.0,893,324,91.0,69,26,18.5,2018,0.0
Kaelon Harris,952,136,702,309,379,257,2111.0,256,77,182.0,446,232,22.7,2018,0.0
Tariq Simmons,508,106,498,178,135,99,1383.0,187,53,127.0,311,125,23.5,2018,0.0
Quayson Williams,851,161,749,279,151,117,1906.0,516,176,146.0,233,103,21.8,2018,0.0
Frankie Johnson,459,259,384,145,163,119,1673.0,170,50,135.0,214,95,15.2,2018,0.0
Alex Reed,478,85,386,157,147,98,1344.0,198,66,70.0,188,91,17.8,2018,0.0
Hayden Brown,839,119,628,309,225,160,1693.0,205,61,134.0,423,248,23.8,2018,0.0
Kaiden Rice,1232,76,1065,427,131,104,2480.0,794,274,126.0,271,153,23.6,2018,0.0
Leandro Allende,320,78,276,114,81,54,1128.0,133,38,51.0,143,76,13.7,2018,0.0
Preston Parks,1082,264,951,369,233,194,2315.0,447,150,202.0,504,219,24.3,2018,0.0
Rob Johnson,77,12,59,29,33,18,256.0,9,1,20.0,50,28,16.2,2018,0.0
Derek Webster Jr.,277,83,214,110,97,56,1119.0,6,1,83.0,208,109,14.3,2018,0.0
Marcquise Reed,2013,348,1524,682,557,468,4003.0,486,181,293.0,1038,501,27.0,2018,0.0
Gabe DeVoe,936,188,829,328,153,111,2762.0,489,169,154.0,340,159,20.0,2018,0.0
Shelton Mitchell,1218,420,977,393,365,298,3553.0,379,134,258.0,598,259,20.7,2018,0.0
Elijah Thomas,1023,96,694,407,352,209,2232.0,2,0,195.0,692,407,24.6,2018,0.0
Donte Grantham,1100,220,972,402,186,135,3448.0,484,161,169.0,488,241,18.8,2018,1.0
Aamir Simms,1122,198,876,421,233,170,3089.0,304,110,189.0,572,311,20.3,2018,0.0
Mark Donnal,638,30,417,235,166,122,1857.0,112,46,62.0,305,189,16.5,2018,0.0
David Skara,708,164,555,253,178,129,2777.0,225,73,148.0,330,180,14.6,2018,0.0
Clyde Trapp,557,185,489,194,162,99,2269.0,228,70,155.0,261,124,16.9,2018,0.0
A.J. Oliver II,493,40,431,155,107,90,1459.0,293,93,46.0,138,62,18.5,2018,0.0
Malik William,25,3,27,10,6,4,74.0,3,1,2.0,24,9,22.5,2018,0.0
Scott Spencer,420,51,389,147,42,31,1326.0,234,95,57.0,155,52,17.7,2018,0.0
Lyles Davis,5,6,8,2,4,0,30.0,4,1,2.0,4,1,20.7,2018,0.0
Isaac Fields,2,0,3,1,0,0,12.0,2,0,0.0,1,1,12.8,2018,0.0
Kenny Carpenter,864,168,796,339,138,95,2487.0,290,91,117.0,506,248,20.7,2018,0.0
Tyree Appleby,1181,379,843,359,421,324,2471.0,384,139,287.0,459,220,27.3,2018,0.0
Bobby Word,1193,113,1012,382,248,181,3412.0,686,248,124.0,326,134,19.0,2018,0.0
Stefan Kenic,1117,122,825,357,322,258,2675.0,400,145,165.0,425,212,22.0,2018,0.0
Anthony Wright,319,62,253,124,62,46,1095.0,81,25,61.0,172,99,16.2,2018,0.0
Jamarcus Hairston,265,34,232,102,50,30,978.0,106,31,33.0,126,71,15.3,2018,0.0
Kasheem Thomas,741,310,651,233,242,172,3121.0,317,103,178.0,334,130,15.3,2018,0.0
Dontel Highsmith,587,125,466,200,189,137,2021.0,166,50,106.0,300,150,16.5,2018,0.0
Evan Clayborne,389,39,283,171,142,47,1526.0,0,0,89.0,283,171,14.7,2018,0.0
Terrell Hales,125,87,116,46,50,30,1449.0,25,3,72.0,91,43,7.5,2018,0.0
Shawn Christian Jr.,12,1,18,4,0,0,45.0,15,4,0.0,3,0,20.9,2018,0.0
Derek Sloan,164,24,124,60,81,44,762.0,4,0,42.0,120,60,14.4,2018,0.0
David Payne,1,0,3,0,2,1,10.0,2,0,0.0,1,0,20.1,2018,0.0
Jaylen Shaw,1485,479,1176,528,357,276,3424.0,408,153,298.0,768,375,23.5,2018,0.0
Zac Cuthbertson,1073,129,723,341,409,318,2000.0,216,73,152.0,507,268,26.1,2018,0.0
Artur Labinowicz,827,114,649,252,288,208,2352.0,320,115,170.0,329,137,20.3,2018,0.0
Demario Beck,702,47,559,277,174,97,1786.0,190,51,102.0,369,226,20.2,2018,0.0
Amidou Bamba,709,67,529,303,206,103,2145.0,0,0,126.0,529,303,17.6,2018,0.0
Ajay Sanders,413,76,382,139,67,47,1682.0,251,88,84.0,131,51,14.4,2018,0.0
Josh Coleman,272,6,223,117,87,38,1086.0,2,0,46.0,221,117,13.9,2018,0.0
Matt Lindsey,85,18,97,27,18,12,383.0,66,19,21.0,31,8,16.2,2018,0.0
Tre Brown,75,43,69,29,7,6,326.0,27,11,26.0,42,18,14.8,2018,0.0
Tyrell Gumbs-Frater,782,53,618,265,116,86,1536.0,386,166,90.0,232,99,23.4,2018,0.0
Christian Adams,81,27,92,28,33,21,536.0,21,4,46.0,71,24,14.1,2018,0.0
Josh Peterson,67,41,70,22,43,20,405.0,18,3,30.0,52,19,13.7,2018,0.0
Bill Muse,7,1,11,2,2,1,55.0,11,2,2.0,0,0,12.9,2018,0.0
Will Rayman,1836,180,1405,618,473,351,4272.0,621,249,226.0,784,369,22.7,2018,0.0
Jordan Swopshire,1078,110,815,342,240,180,2622.0,542,214,158.0,273,128,22.1,2018,0.0
Jordan Burns,1666,503,1366,573,347,282,3406.0,629,238,302.0,737,335,27.5,2018,0.0
Sean O'Brien,1040,335,811,346,199,169,3371.0,478,179,136.0,333,167,16.6,2018,0.0
Dana Batt,592,56,402,246,135,100,2045.0,1,0,102.0,401,246,14.6,2018,0.0
Jordan Robertson,450,40,398,160,124,78,1345.0,156,52,78.0,242,108,21.3,2018,0.0
Jack Ferguson,815,93,618,261,154,124,1891.0,434,169,74.0,184,92,20.6,2018,0.0
Malcolm Regisford,715,74,512,286,250,142,2148.0,4,1,141.0,508,285,19.1,2018,0.0
Francisco Amiel,378,219,377,122,89,65,2542.0,240,69,143.0,137,53,11.7,2018,0.0
Sam Lindgren,44,11,37,20,7,4,177.0,1,0,8.0,36,20,14.4,2018,0.0
David Maynard,116,14,93,42,12,7,450.0,60,25,13.0,33,17,12.4,2018,0.0
Hugh Baxter,181,28,144,71,10,7,417.0,90,32,28.0,54,39,22.4,2018,0.0
Milan Williams,17,3,6,4,9,8,55.0,1,1,1.0,5,3,10.5,2018,0.0
Tom Rivard,551,71,459,215,116,68,1489.0,160,53,105.0,299,162,22.3,2018,0.0
Dylan Whitbread,2,0,1,1,0,0,5.0,0,0,1.0,1,1,20.9,2018,0.0
David Favorite,33,2,34,11,2,0,126.0,34,11,1.0,0,0,15.3,2018,0.0
Grant Riller,2474,366,1695,880,662,527,4265.0,526,187,287.0,1169,693,29.0,2018,0.0
Joe Chealey,1827,397,1320,533,723,582,4018.0,516,179,244.0,804,354,25.8,2018,1.0
Jarrell Brantley,1914,203,1424,694,539,414,3896.0,317,112,314.0,1107,582,27.5,2018,1.0
Cameron Johnson,1134,233,965,401,244,163,4130.0,459,169,191.0,506,232,16.6,2018,1.0
Nick Harris,630,41,443,248,216,134,2847.0,1,0,112.0,442,248,12.4,2018,0.0
Marquise Pointer,824,267,791,277,203,143,3147.0,407,127,176.0,384,150,18.0,2018,0.0
Jaylen McManus,567,48,514,202,133,96,2142.0,228,67,76.0,286,135,16.4,2018,0.0
Evan Bailey,468,44,430,150,90,64,1735.0,315,104,56.0,115,46,16.4,2018,0.0
Osinachi Smart,232,17,153,86,97,60,1231.0,0,0,47.0,153,86,10.8,2018,0.0
Samba Ndiaye,21,1,20,8,8,5,101.0,0,0,8.0,20,8,17.1,2018,0.0
Brevin Galloway,674,98,576,243,78,49,1882.0,386,139,66.0,190,104,19.4,2018,0.0
Trent Robinson,2,0,3,1,1,0,4.0,1,0,0.0,2,1,46.7,2018,0.0
Jermaine Blackmon Jr.,0,0,2,0,0,0,6.0,0,0,0.0,2,0,17.9,2018,0.0
Prentiss Nixon,1362,230,1210,446,350,276,3449.0,617,194,200.0,593,252,22.6,2018,0.0
Deion James,361,61,313,137,113,74,947.0,55,13,63.0,258,124,22.1,2018,0.0
Che Bob,454,68,339,152,184,125,1099.0,80,25,97.0,259,127,23.3,2018,0.0
Nico Carvacho,1414,240,991,553,567,301,3663.0,21,7,259.0,970,546,21.1,2018,0.0
Anthony Masinton-Bonner,695,93,516,238,138,119,2052.0,250,100,93.0,266,138,16.5,2018,0.0
J.D. Paige,724,153,617,257,139,111,1773.0,281,99,108.0,336,158,22.6,2018,0.0
Raquan Mitchell,209,50,203,83,45,33,696.0,53,10,28.0,150,73,17.5,2018,0.0
Lorenzo Jenkins,423,39,345,142,106,80,1378.0,171,59,63.0,174,83,17.2,2018,0.0
Robbie Berwick,149,53,157,49,38,24,662.0,98,27,34.0,59,22,16.2,2018,0.0
Logan Ryan,113,18,68,41,33,24,382.0,19,7,20.0,49,34,13.7,2018,0.0
Juan Sabino II,2,1,7,1,0,0,17.0,5,0,4.0,2,1,32.4,2018,0.0
McKinley Wright IV,1857,683,1429,668,483,388,4333.0,405,133,366.0,1024,535,23.9,2018,0.0
George King,1294,88,1001,444,308,225,2866.0,451,181,196.0,550,263,23.1,2018,1.0
Namon Wright,890,105,729,295,239,179,2352.0,348,121,161.0,381,174,21.9,2018,0.0
Dominique Collier,789,221,661,243,247,177,2438.0,343,126,176.0,318,117,19.4,2018,0.0
Lucas Siewert,856,117,693,292,169,132,2476.0,365,140,131.0,328,152,18.4,2018,0.0
Tyler Bey,1113,85,749,397,403,301,2475.0,59,18,184.0,690,379,23.0,2018,0.0
Dallas Walton,384,44,293,142,106,84,1117.0,39,16,61.0,254,126,18.6,2018,0.0
Deleon Brown,250,43,236,83,63,43,979.0,131,41,51.0,105,42,16.2,2018,0.0
D'Shawn Schwartz,1026,137,851,356,217,158,3161.0,432,156,127.0,419,200,17.5,2018,0.0
Lazar Nikolic,72,30,71,27,21,10,480.0,34,8,28.0,37,19,11.4,2018,0.0
Tory Stewart-Miller,603,36,442,227,222,144,1687.0,15,5,123.0,427,222,19.7,2018,0.0
Alexander Strating,65,14,41,26,31,13,317.0,0,0,17.0,41,26,11.6,2018,0.0
A.J. Martinka,0,1,3,0,0,0,10.0,0,0,3.0,3,0,30.2,2018,0.0
Josh Repine,3,3,9,1,0,0,27.0,5,1,1.0,4,0,18.2,2018,0.0
Mike Smith,1906,542,1624,668,459,378,4039.0,559,192,273.0,1065,476,26.6,2018,1.0
Quinton Adlesh,909,216,782,333,68,47,2581.0,491,196,146.0,291,137,18.7,2018,0.0
Lukas Meisner,524,84,405,193,92,52,1525.0,218,86,95.0,187,107,17.9,2018,0.0
Nate Hickman,700,111,575,223,229,169,1972.0,268,85,135.0,307,138,21.0,2018,0.0
Kyle Castlin,765,102,586,263,236,177,2461.0,185,62,103.0,401,201,17.3,2018,0.0
Gabe Stefanini,545,143,468,203,96,72,1248.0,154,67,116.0,314,136,25.5,2018,0.0
Jaron Faulds,124,11,100,56,25,12,405.0,0,0,24.0,100,56,16.6,2018,0.0
Patrick Tape,488,62,336,203,126,81,1265.0,1,1,103.0,335,202,19.9,2018,0.0
Myles Hanson,61,8,65,22,7,5,206.0,43,12,8.0,22,10,18.2,2018,0.0
Tai Bibbs,338,46,336,114,102,65,1376.0,173,45,48.0,163,69,16.1,2018,0.0
Rodney Hunter,110,48,107,48,32,13,733.0,14,1,46.0,93,47,11.4,2018,0.0
Peter Barba,109,28,98,39,4,3,473.0,71,28,12.0,27,11,12.0,2018,0.0
Randy Brumant,368,62,311,144,85,57,1360.0,93,23,63.0,218,121,15.7,2018,0.0
Jake Killingsworth,650,156,583,229,65,43,2571.0,406,149,72.0,177,80,13.7,2018,0.0
Luke Bolster,52,27,60,18,14,9,329.0,37,7,24.0,23,11,14.1,2018,0.0
Jalen Adams,1706,511,1479,655,312,257,3901.0,416,139,318.0,1063,516,25.8,2018,0.0
Christian Vital,1735,269,1313,534,481,402,3889.0,740,265,257.0,573,269,23.4,2018,0.0
Terry Larrier,696,53,628,242,170,125,1759.0,270,87,115.0,358,155,24.1,2018,0.0
Antwoine Anderson,957,310,784,322,312,217,3283.0,305,96,253.0,479,226,18.8,2018,0.0
Josh Carlton,746,52,557,299,248,148,2091.0,0,0,166.0,557,299,20.0,2018,0.0
Tyler Polley,673,43,556,218,138,102,2164.0,354,135,53.0,202,83,15.5,2018,0.0
Mamadou Diarra,85,0,64,35,30,15,320.0,0,0,14.0,64,35,14.9,2018,0.0
Isaiah Whaley,461,62,359,186,129,81,1697.0,23,8,75.0,336,178,14.6,2018,0.0
Alterique Gilbert,883,318,824,297,252,178,2456.0,360,111,190.0,464,186,22.9,2018,0.0
David Onuorah,323,32,260,130,147,62,2128.0,3,1,131.0,257,129,11.2,2018,0.0
Eric Cobb,170,23,143,73,67,21,656.0,6,3,56.0,137,70,17.3,2018,0.0
Kwintin Williams,32,2,24,9,23,14,136.0,4,0,4.0,20,9,14.5,2018,0.0
Temi Aiyegbusi,2,1,7,1,0,0,33.0,2,0,2.0,5,1,13.4,2018,0.0
Christian Foxen,4,0,7,2,0,0,25.0,4,0,0.0,3,2,14.8,2018,0.0
Mike Noyes,7,0,9,3,2,1,38.0,2,0,2.0,7,3,16.6,2018,0.0
Lamar Morgan,755,30,629,238,144,109,1978.0,491,170,113.0,138,68,20.6,2018,0.0
Karonn Davis,707,281,711,232,189,143,2466.0,338,100,136.0,373,132,19.6,2018,0.0
Chad Andrews-Fulton,439,79,337,153,190,119,1459.0,41,14,128.0,296,139,19.1,2018,0.0
Cedric Council Jr.,373,45,360,141,106,60,1608.0,119,31,78.0,241,110,15.3,2018,0.0
Adam Traore,161,31,132,47,76,60,550.0,33,7,52.0,99,40,20.7,2018,0.0
Tre' Thomas,464,49,469,160,74,57,1372.0,270,87,71.0,199,73,21.0,2018,0.0
Lucian Brownlee,468,47,408,149,92,72,1236.0,272,98,106.0,136,51,22.3,2018,0.0
Keandre Fair,88,18,87,29,8,5,387.0,76,25,9.0,11,4,13.3,2018,0.0
Taqwain Drummond,189,35,214,59,62,46,974.0,109,25,57.0,105,34,15.5,2018,0.0
Kent Auslander,274,32,236,84,76,54,1073.0,165,52,80.0,71,32,16.4,2018,0.0
Dejuan Clayton,1518,419,1193,470,592,437,3923.0,494,141,286.0,699,329,21.7,2018,0.0
Jordan Hardwick,54,2,55,21,18,11,241.0,14,1,21.0,41,20,17.6,2018,0.0
Joel Boyce,22,3,18,10,5,2,75.0,2,0,11.0,16,10,21.6,2018,0.0
Blake Simpson,155,24,134,43,118,69,1415.0,3,0,62.0,131,43,8.6,2018,0.0
Donnell Frayer,0,0,1,0,0,0,1.0,1,0,0.0,0,0,51.7,2018,0.0
Matt Morgan,2333,296,1580,743,615,513,3704.0,885,334,296.0,695,409,29.8,2018,0.0
Stone Gettings,1066,196,839,390,242,182,2312.0,301,104,195.0,538,286,25.1,2018,0.0
Jack Gordon,366,106,257,114,100,69,1449.0,170,69,97.0,87,45,14.3,2018,0.0
Steven Julian,321,106,277,119,118,66,1722.0,67,17,65.0,210,102,12.0,2018,0.0
Joel Davis,316,69,285,106,131,82,1150.0,80,22,75.0,205,84,18.8,2018,0.0
Terrance McBride,604,208,481,224,147,111,2254.0,156,45,98.0,325,179,15.3,2018,0.0
Josh Warren,806,251,616,310,216,147,2495.0,120,39,223.0,496,271,19.8,2018,0.0
Jimmy Boeheim,800,83,696,299,184,124,1717.0,262,78,91.0,434,221,27.1,2018,0.0
Wil Bathurst,392,90,360,144,130,76,1370.0,113,28,96.0,247,116,19.2,2018,0.0
Bryan Knapp,281,52,255,109,37,29,1105.0,82,34,51.0,173,75,15.6,2018,0.0
Jake Kuhn,136,14,135,51,20,10,453.0,91,24,16.0,44,27,18.6,2018,0.0
Jordan Abdur-Ra'oof,176,28,194,65,39,20,779.0,94,26,30.0,100,39,15.7,2018,0.0
Kyle Brown,32,4,40,11,7,3,142.0,32,7,13.0,8,4,20.1,2018,0.0
Riley Voss,147,66,158,57,13,5,644.0,91,28,30.0,67,29,16.1,2018,0.0
Marcus Foster,2167,312,1758,784,407,293,3901.0,814,306,284.0,944,478,29.1,2018,0.0
Khyri Thomas,1140,255,839,429,210,151,2773.0,323,131,165.0,516,298,19.6,2018,1.0
Toby Hegner,824,83,640,278,153,113,2474.0,414,155,79.0,226,123,16.2,2018,0.0
Mitchell Ballock,1304,350,1028,451,128,94,4019.0,773,308,145.0,255,143,15.6,2018,0.0
Martin Krampelj,800,59,517,311,235,143,1547.0,106,35,93.0,411,276,23.5,2018,0.0
Ronnie Harrell,744,183,611,258,198,147,2052.0,232,81,151.0,379,177,21.0,2018,0.0
Davion Mintz,925,337,757,306,259,186,2830.0,351,127,193.0,406,179,18.9,2018,0.0
Ty-Shon Alexander,1241,222,957,400,284,231,2768.0,565,210,152.0,392,190,22.9,2018,0.0
Jacob Epperson,135,9,90,58,26,12,317.0,12,7,13.0,78,51,18.4,2018,0.0
Manny Suarez,108,12,117,41,21,14,323.0,48,12,23.0,69,29,23.4,2018,0.0
Kaleb Joseph,416,194,372,149,109,81,1634.0,113,37,116.0,259,112,16.9,2018,0.0
Tyler Clement,155,89,131,54,31,19,722.0,83,28,57.0,48,26,14.1,2018,0.0
Jordan Scurry,58,9,59,22,2,1,166.0,47,13,9.0,12,9,20.9,2018,0.0
Miles Wright,1128,88,991,399,238,174,3035.0,454,156,165.0,537,243,21.7,2018,0.0
Taylor Johnson,682,156,483,237,163,131,1804.0,201,77,185.0,282,160,21.5,2018,0.0
Brendan Barry,905,272,663,298,142,121,2885.0,421,188,116.0,242,110,15.4,2018,0.0
Chris Knight,1144,156,917,481,283,173,2113.0,44,9,217.0,873,472,32.0,2018,0.0
Will Emery,257,40,201,88,138,78,926.0,25,3,62.0,176,85,18.7,2018,0.0
Adrease Jackson,327,23,267,118,67,50,751.0,117,41,46.0,150,77,24.1,2018,0.0
Aaryn Rai,608,91,482,220,155,116,1842.0,146,52,131.0,336,168,20.0,2018,0.0
Ian Sistare,648,135,518,212,166,131,2188.0,289,93,126.0,229,119,17.5,2018,0.0
James Foye,646,148,527,229,82,64,2049.0,308,124,65.0,219,105,16.4,2018,0.0
Guilien Smith,661,104,557,221,183,142,1915.0,233,77,121.0,324,144,20.7,2018,0.0
Isaac Letoa,33,19,33,14,11,5,166.0,6,0,11.0,27,14,15.7,2018,0.0
Joseph Cook,6,0,3,3,0,0,8.0,0,0,0.0,3,3,19.9,2018,0.0
Ben Swett,4,3,4,2,0,0,33.0,1,0,1.0,3,2,7.9,2018,0.0
Peyton Aldridge,2171,275,1602,775,462,382,4540.0,617,239,166.0,985,536,22.8,2018,0.0
Kellan Grady,2002,248,1556,734,386,294,4119.0,656,240,180.0,900,494,25.6,2018,0.0
Jon Axel Gudmundsson,1700,566,1212,535,521,412,4483.0,609,218,275.0,603,317,20.9,2018,0.0
KiShawn Pritchett,540,244,441,185,93,69,2286.0,272,101,150.0,169,84,14.9,2018,0.0
Will Magarity,586,72,468,228,108,74,2013.0,186,56,112.0,282,172,16.9,2018,0.0
Oskar Michelsen,526,92,445,174,92,65,1829.0,336,113,61.0,109,61,15.7,2018,0.0
Rusty Reigel,342,145,277,116,62,45,1939.0,178,65,78.0,99,51,10.3,2018,0.0
Carter Collins,750,140,578,256,178,135,2381.0,293,103,99.0,285,153,17.5,2018,0.0
Jordan Watkins,336,80,282,106,62,47,1345.0,210,77,54.0,72,29,13.8,2018,0.0
Dusan Kovacevic,126,34,128,51,27,17,504.0,32,7,45.0,96,44,19.7,2018,0.0
Malcolm Wynter,48,10,39,15,12,8,153.0,26,10,5.0,13,5,17.7,2018,0.0
Bates Jones,165,70,158,56,34,25,962.0,87,28,38.0,71,28,12.1,2018,0.0
Cal Freundlich,7,1,16,2,4,2,46.0,11,1,1.0,5,1,22.5,2018,0.0
Michael Brown,0,1,1,0,0,0,15.0,1,0,1.0,0,0,7.1,2018,0.0
Josh Cunningham,1224,125,795,463,417,269,3052.0,112,29,197.0,683,434,21.1,2018,0.0
Darrell Davis,1008,188,815,321,219,175,3036.0,507,191,174.0,308,130,19.1,2018,0.0
Trey Landers,946,192,671,365,253,167,2657.0,166,49,154.0,505,316,19.0,2018,0.0
Jalen Crutcher,1593,584,1233,544,342,263,4092.0,646,242,287.0,587,302,22.2,2018,0.0
Jordan Davis,826,167,735,293,138,100,2719.0,417,140,124.0,318,153,17.9,2018,0.0
Kostas Antetokounmpo,151,13,101,58,64,33,438.0,15,2,39.0,86,56,20.9,2018,1.0
John Crosby,901,224,787,317,255,183,2224.0,259,84,219.0,528,233,24.4,2018,0.0
Xeyrius Williams,838,103,726,295,143,122,2286.0,389,126,116.0,337,169,20.2,2018,0.0
Matej Svoboda,61,17,76,25,2,2,318.0,45,9,25.0,31,16,17.2,2018,0.0
Jack Westerfield,16,1,18,5,4,2,75.0,13,4,1.0,5,1,14.9,2018,0.0
Camron Greer,10,2,4,3,2,2,25.0,2,2,2.0,2,1,14.5,2018,0.0
Joey Gruden,5,1,6,1,3,2,28.0,4,1,2.0,2,0,17.6,2018,0.0
Jordan Pierce,26,2,25,9,14,8,96.0,0,0,11.0,25,9,22.0,2018,0.0
Dalton Stewart,0,0,1,0,0,0,1.0,0,0,0.0,1,0,53.6,2018,0.0
Artem Tavakalyan,649,103,546,229,174,115,1769.0,208,76,119.0,338,153,21.6,2018,0.0
Simon Okolue,311,7,219,134,68,43,720.0,1,0,43.0,218,134,21.1,2018,0.0
Pinky Wiley,1079,400,1098,368,234,168,3918.0,599,175,291.0,499,193,18.3,2018,0.0
Marquise Collins,251,16,203,84,63,52,542.0,84,31,42.0,119,53,26.2,2018,0.0
Johnathan Walker,222,58,187,80,66,45,726.0,59,17,53.0,128,63,19.3,2018,0.0
Kavon Waller,782,129,660,274,127,81,2727.0,403,153,149.0,257,121,16.2,2018,0.0
Joseph Lewis,335,71,368,135,91,50,1228.0,61,15,123.0,307,120,22.3,2018,0.0
Ameer Bennett,729,65,627,256,298,188,2417.0,121,29,180.0,506,227,18.5,2018,0.0
Kobe Gantz,207,87,163,65,98,60,685.0,54,17,58.0,109,48,19.9,2018,0.0
Jonathan Mitchell,310,48,277,103,127,82,838.0,84,22,68.0,193,81,23.2,2018,0.0
Saleik Edwards,345,44,388,115,61,44,1104.0,244,71,65.0,144,44,20.9,2018,0.0
Daivon Gamble,28,1,21,9,11,9,100.0,2,1,4.0,19,8,15.6,2018,0.0
Demola Onifade,105,21,150,48,25,9,1222.0,0,0,63.0,150,48,9.4,2018,0.0
Matthew Stevenson,7,0,7,2,2,1,21.0,6,2,2.0,1,0,24.5,2018,0.0
Myles Carter,622,56,535,226,146,115,1378.0,155,55,113.0,380,171,24.0,2018,0.0
Reginald Giles,4,0,5,2,0,0,15.0,0,0,0.0,5,2,17.2,2018,0.0
Ryan Daly,1801,286,1521,648,474,326,3512.0,565,179,186.0,956,469,28.0,2018,0.0
Ryan Allen,1441,205,1212,484,320,231,3512.0,687,242,179.0,525,242,23.3,2018,0.0
Eric Carter,1087,184,722,402,411,281,2807.0,7,2,209.0,715,400,21.5,2018,0.0
Anthony Mosley,991,279,699,325,454,322,3178.0,57,19,229.0,642,306,18.7,2018,0.0
Darian Bryant,683,191,626,267,144,83,3079.0,214,66,162.0,412,201,14.9,2018,0.0
Kevin Anderson,975,295,785,342,236,178,2891.0,317,113,220.0,468,229,20.6,2018,0.0
Skye Johnson,311,27,218,123,105,65,991.0,0,0,89.0,218,123,18.8,2018,0.0
Chyree Walker,363,44,324,152,103,47,1431.0,47,12,82.0,277,140,16.8,2018,0.0
Jacob Cushing,280,30,255,98,39,30,1121.0,170,54,53.0,85,44,15.5,2018,0.0
Derrick Woods,384,18,267,145,134,90,1123.0,12,4,106.0,255,141,19.9,2018,0.0
Connor Rufo,16,3,9,5,6,4,43.0,3,2,1.0,6,3,16.1,2018,0.0
Curtis Lochner,9,3,16,2,6,4,78.0,9,1,6.0,7,1,16.6,2018,0.0
Joe Rosga,1621,312,1171,534,349,308,3849.0,575,245,222.0,596,289,21.4,2018,0.0
Daniel Amigo,1041,109,803,419,281,176,1827.0,62,27,209.0,741,392,32.9,2018,0.0
Jake Pemberton,767,308,587,262,154,127,2911.0,301,116,186.0,286,146,15.4,2018,0.0
Ade Murkey,1251,234,962,451,413,302,2762.0,133,47,208.0,829,404,25.2,2018,0.0
Jake Krafka,278,82,230,95,90,59,1103.0,92,29,53.0,138,66,15.0,2018,0.0
Christian Mackey,432,87,298,167,134,91,1233.0,27,7,104.0,271,160,21.0,2018,0.0
Elvin Rodriguez,206,37,190,72,79,49,499.0,53,13,42.0,137,59,27.5,2018,0.0
Jake Holtzmann,138,47,113,40,40,33,585.0,75,25,40.0,38,15,15.8,2018,0.0
Donoven Carlisle,204,31,153,81,42,26,963.0,43,16,48.0,110,65,11.7,2018,0.0
Luke Neff,60,10,48,20,6,5,186.0,43,15,8.0,5,5,15.7,2018,0.0
Abiola Akintola,216,32,167,87,89,42,1090.0,0,0,46.0,167,87,12.0,2018,0.0
Thomas Neff,462,105,351,150,93,70,1831.0,216,92,79.0,135,58,14.1,2018,0.0
Emil Knighton,6,1,7,3,0,0,22.0,1,0,0.0,6,3,13.8,2018,0.0
Elijah Blake,4,0,2,2,0,0,7.0,0,0,0.0,2,2,14.5,2018,0.0
Max Strus,1226,162,960,403,274,226,2413.0,554,194,152.0,406,209,24.7,2018,1.0
Marin Maric,1371,104,925,500,487,349,2943.0,70,22,238.0,855,478,23.2,2018,0.0
Eli Cain,1642,405,1416,564,489,335,4165.0,504,179,293.0,912,385,23.0,2018,0.0
Tre'Darius McCallum,621,72,565,254,93,65,1902.0,170,48,97.0,395,206,18.2,2018,0.0
Brandon Cyrus,678,141,624,251,188,130,2855.0,172,46,117.0,452,205,14.8,2018,0.0
Justin Roberts,843,280,730,304,149,118,2113.0,311,117,161.0,419,187,21.7,2018,0.0
Paul Reed,983,91,749,401,199,147,2161.0,103,34,145.0,646,367,22.0,2018,0.0
Jaylen Butz,636,72,436,257,235,122,1917.0,1,0,133.0,435,257,17.1,2018,0.0
Devin Gage,572,214,528,217,149,108,1977.0,111,30,165.0,417,187,18.9,2018,0.0
Peter Ryckbosch,123,7,92,49,53,25,599.0,0,0,35.0,92,49,12.2,2018,0.0
Austin Grandstaff,71,16,88,25,4,2,265.0,74,19,18.0,14,6,20.2,2018,0.0
Joe Hanel,185,32,127,77,61,31,1109.0,1,0,45.0,126,77,9.1,2018,0.0
Tobias Dwumaah,2,0,0,0,2,2,9.0,0,0,0.0,0,0,5.0,2018,0.0
Kameron Chatman,709,96,596,254,152,122,1632.0,217,79,95.0,379,175,23.4,2018,0.0
Corey Allen,1613,236,1304,559,301,224,3346.0,686,271,227.0,618,288,23.6,2018,0.0
Josh McFolley,1456,289,1154,471,368,281,3403.0,644,233,225.0,510,238,21.6,2018,0.0
Jermaine Jackson Jr.,909,232,785,287,212,180,2303.0,468,155,152.0,317,132,21.3,2018,0.0
Roschon Prince,945,98,664,319,448,307,2514.0,11,0,146.0,653,319,19.6,2018,0.0
DeShawndre Black,271,126,259,92,68,48,1087.0,111,39,76.0,148,53,15.8,2018,0.0
Jaleel Hogan,1082,79,722,425,435,232,2246.0,1,0,174.0,721,425,23.2,2018,0.0
Cole Long,215,56,219,77,54,37,1022.0,87,24,46.0,132,53,13.4,2018,0.0
Tariiq Jones,68,8,54,26,15,10,133.0,17,6,16.0,37,20,27.0,2018,0.0
Jack Ballantyne,185,56,169,66,59,35,888.0,69,18,65.0,100,48,13.9,2018,0.0
Gerald Blackshear,489,32,326,201,163,87,1712.0,0,0,111.0,326,201,14.2,2018,0.0
Malik Eichler,79,1,59,28,24,14,307.0,18,9,13.0,41,19,12.8,2018,0.0
Isaiah Jones,23,1,24,10,7,3,121.0,0,0,4.0,24,10,12.0,2018,0.0
Bass Ollie,7,2,5,2,4,2,24.0,1,1,1.0,4,1,15.3,2018,0.0
Jacob Joubert,3,3,5,1,0,0,50.0,3,1,3.0,2,0,7.4,2018,0.0
Reed Timmer,2000,287,1404,618,654,550,4003.0,551,214,254.0,853,404,26.4,2018,0.0
Nick McGlynn,1109,104,832,424,312,233,2464.0,114,28,140.0,718,396,23.4,2018,0.0
De'Antae McMurray,623,181,586,212,133,101,1850.0,291,98,120.0,295,114,21.2,2018,0.0
Graham Woodward,954,221,811,322,190,130,2797.0,461,180,194.0,350,142,20.4,2018,0.0
Ore Arogundade,759,123,642,261,159,121,2641.0,291,116,127.0,351,145,17.0,2018,0.0
C.J. Rivers,457,237,374,180,108,74,2357.0,83,23,128.0,291,157,12.6,2018,0.0
Casey Schlatter,361,107,297,136,107,73,1314.0,46,16,79.0,251,120,16.8,2018,0.0
Jalen Gibbs,910,110,815,321,208,144,2551.0,393,124,126.0,422,197,21.2,2018,0.0
Kory Kuenstling,124,9,85,40,64,44,611.0,0,0,44.0,85,40,14.5,2018,0.0
Connor Gholson,6,2,12,1,5,4,60.0,6,0,3.0,6,1,15.2,2018,0.0
Samm Jones,18,5,16,6,4,3,83.0,8,3,2.0,8,3,12.6,2018,0.0
Antonio Pilipovic,120,45,126,45,7,4,503.0,98,26,30.0,28,19,16.7,2018,0.0
Tramaine Isabell,1352,297,1099,462,397,295,2964.0,416,133,258.0,683,329,26.2,2018,0.0
Kurk Lee,1069,333,954,376,242,179,2762.0,378,138,207.0,576,238,22.5,2018,1.0
Sammy Mojica,1153,233,1101,414,207,132,3657.0,590,193,171.0,511,221,19.0,2018,0.0
Alihan Demir,993,191,815,389,220,160,2614.0,188,55,159.0,627,334,20.6,2018,0.0
Troy Harper,1273,164,969,369,582,441,2718.0,338,94,219.0,631,275,27.5,2018,0.0
Jarvis Doles,350,24,250,113,92,75,994.0,126,49,41.0,124,64,17.1,2018,0.0
Tadas Kararinas,95,10,83,34,18,16,371.0,33,11,16.0,50,23,14.5,2018,0.0
Tyshawn Myles,182,14,149,69,89,44,1076.0,0,0,39.0,149,69,11.1,2018,0.0
Miles Overton,372,63,369,111,128,95,996.0,201,55,83.0,168,56,25.3,2018,0.0
Sam Green,266,39,238,97,25,13,918.0,156,59,45.0,82,38,16.2,2018,0.0
Kris Alford,6,1,9,2,1,1,23.0,7,1,2.0,2,1,24.1,2018,0.0
Kevin Doi,18,4,11,5,5,3,38.0,10,5,5.0,1,0,24.2,2018,0.0
Marvin Bagley III,694,50,440,270,209,131,1118.0,58,23,75.0,382,247,26.3,2018,1.0
Grayson Allen,1996,432,1409,606,591,493,3965.0,766,291,240.0,643,315,24.1,2018,1.0
Gary Trent Jr.,536,52,427,177,97,85,1253.0,241,97,38.0,186,80,19.5,2018,1.0
Wendell Carter Jr.,501,74,319,179,168,124,997.0,46,19,75.0,273,160,22.8,2018,1.0
Trevon Duval,380,207,346,148,89,53,1103.0,107,31,102.0,239,117,21.3,2018,1.0
Alex O'Connell,513,73,443,189,71,49,1497.0,243,86,75.0,200,103,17.5,2018,0.0
Marques Bolden,334,35,227,130,108,74,1195.0,7,0,52.0,220,130,13.0,2018,0.0
Javin DeLaurier,386,50,234,154,131,76,1533.0,16,2,86.0,218,152,11.7,2018,0.0
Jordan Goldwire,342,213,331,132,51,34,1902.0,149,44,81.0,182,88,11.0,2018,0.0
Justin Robinson,86,10,63,32,9,3,252.0,47,19,11.0,16,13,14.6,2018,1.0
Jack White,279,57,242,93,57,46,1404.0,163,47,56.0,79,46,10.8,2018,0.0
Antonio Vrankovic,74,18,47,28,31,18,269.0,0,0,17.0,47,28,14.1,2018,0.0
Jordan Tucker,504,40,426,153,115,92,1228.0,291,106,76.0,135,47,24.4,2018,0.0
Mike Buckmire,7,3,12,3,1,1,39.0,1,0,3.0,11,3,18.9,2018,0.0
Mike Lewis II,979,81,761,301,259,213,2220.0,454,164,110.0,307,137,22.3,2018,0.0
Eric Williams Jr.,1144,135,937,379,313,232,2804.0,424,154,154.0,513,225,22.4,2018,0.0
Rene Castro,715,184,585,253,178,127,1809.0,250,82,109.0,335,171,21.6,2018,0.0
Tarin Smith,1074,303,928,382,365,235,3282.0,264,75,204.0,664,307,20.1,2018,0.0
Jordan Robinson,412,33,284,156,165,100,1165.0,1,0,59.0,283,156,18.1,2018,0.0
Kellon Taylor,289,61,209,115,92,56,1206.0,14,3,73.0,195,112,13.9,2018,0.0
Chas Brown,333,30,265,131,138,69,935.0,4,2,90.0,261,129,22.4,2018,0.0
Tydus Verhoeven,262,69,191,110,80,42,1612.0,0,0,67.0,191,110,9.4,2018,0.0
Eric James,536,80,457,193,169,103,1605.0,181,47,112.0,276,146,19.8,2018,0.0
Marko Krivacevic,10,0,8,3,3,2,30.0,3,2,2.0,5,1,19.4,2018,0.0
Nicholas Kratholm,239,24,213,97,75,43,926.0,10,2,41.0,203,95,17.1,2018,0.0
Zach Snyder,5,1,4,2,1,0,11.0,3,1,0.0,1,1,20.5,2018,0.0
Caleb Davis,10,2,9,4,0,0,23.0,5,2,4.0,4,2,28.5,2018,0.0
B.J. Tyson,1570,268,1355,569,418,311,3589.0,416,121,231.0,939,448,26.0,2018,0.0
Isaac Fleming,1196,389,985,455,314,204,3065.0,323,82,293.0,662,373,23.2,2018,0.0
Shawn Williams,873,111,741,279,157,137,2249.0,505,178,101.0,236,101,20.7,2018,0.0
Kentrell Barkley,1024,230,764,335,401,270,2679.0,255,84,180.0,509,251,21.8,2018,0.0
Dimitri Spasojevic,689,88,585,312,140,65,2248.0,1,0,127.0,584,312,17.7,2018,0.0
Jabari Craig,141,14,133,50,74,41,704.0,1,0,50.0,132,50,15.9,2018,0.0
K.J. Davis,318,41,354,116,47,26,1120.0,212,60,49.0,142,56,19.0,2018,0.0
Justin Whatley,225,44,193,87,42,25,956.0,77,26,59.0,116,61,14.4,2018,0.0
Aaron Jackson,340,41,305,113,90,53,1326.0,183,61,62.0,122,52,15.8,2018,1.0
Usman Haruna,50,3,35,21,22,8,300.0,0,0,14.0,35,21,9.8,2018,0.0
Justice Obasohan,31,8,40,12,10,7,233.0,3,0,11.0,37,12,12.1,2018,0.0
John Whitley,4,2,1,1,2,2,20.0,0,0,0.0,1,1,4.9,2018,0.0
Addison Hill,29,12,23,10,6,5,286.0,12,4,12.0,11,6,6.7,2018,0.0
Desonta Bradford,1256,349,894,424,404,309,3189.0,286,99,219.0,608,325,20.3,2018,0.0
Jalan McCloud,687,155,518,237,194,155,1611.0,170,58,107.0,348,179,22.2,2018,0.0
Devontavius Payne,537,62,443,183,69,54,1309.0,299,117,62.0,144,66,20.4,2018,0.0
Bo Hodges,1081,208,863,417,331,202,2672.0,155,45,172.0,708,372,22.4,2018,0.0
Peter Jurkin,462,7,312,170,145,115,1112.0,20,7,81.0,292,163,20.6,2018,0.0
David Burrell,493,49,379,191,103,62,1315.0,142,49,66.0,237,142,18.6,2018,0.0
Mladen Armus,703,95,482,267,274,168,2156.0,12,1,161.0,470,266,17.7,2018,0.0
Jermaine Long,247,147,205,74,108,75,1145.0,109,24,99.0,96,50,15.4,2018,0.0
Kanayo Obi-Rapu,575,87,491,193,104,76,1703.0,315,113,103.0,176,80,19.0,2018,0.0
Jason Williams,134,72,108,42,27,18,561.0,75,32,54.0,33,10,15.5,2018,1.0
Andre Edwards,29,3,28,12,2,1,60.0,12,4,2.0,16,8,25.8,2018,0.0
Dillon Reppart,20,4,13,5,11,6,45.0,8,4,2.0,5,1,22.3,2018,0.0
Karl Overstreet,2,0,1,1,0,0,3.0,0,0,0.0,1,1,16.7,2018,0.0
Montell Goodwin,880,194,791,307,166,125,1998.0,377,141,125.0,414,166,25.0,2018,0.0
Mack Smith,1339,179,1086,456,238,171,3227.0,705,256,129.0,381,200,20.7,2018,0.0
Muusa Dama,561,52,420,221,166,118,1527.0,3,1,112.0,417,220,20.1,2018,0.0
Jajuan Starks,270,26,244,102,85,52,665.0,50,14,52.0,194,88,26.2,2018,0.0
Ray Crossland,547,83,501,203,150,101,1737.0,120,40,123.0,381,163,20.0,2018,0.0
D'Angelo Jackson,129,37,94,35,82,54,339.0,10,5,52.0,84,30,28.2,2018,0.0
Terrell Lewis,1011,506,820,316,229,170,3508.0,513,209,213.0,307,107,16.9,2018,0.0
DeVantae Price,68,10,49,21,41,25,213.0,3,1,17.0,46,20,20.5,2018,0.0
Justice Green,53,5,48,20,8,4,137.0,30,9,3.0,18,11,20.7,2018,0.0
Lucas Jones,140,34,121,51,21,16,794.0,59,22,23.0,62,29,9.9,2018,0.0
Michael Chavers,43,8,37,17,5,3,136.0,9,6,4.0,28,11,16.5,2018,0.0
Aboubacar Diallo,99,31,94,39,40,21,915.0,0,0,33.0,94,39,8.0,2018,0.0
Logan Koch,50,30,60,17,2,2,366.0,48,14,17.0,12,3,10.8,2018,0.0
Shawn Wilson,22,19,23,9,9,2,146.0,6,2,15.0,17,7,14.7,2018,0.0
Nick Mayo,2316,259,1612,829,636,524,4156.0,346,134,339.0,1266,695,26.0,2018,0.0
DeAndre Dishman,658,75,480,252,255,154,1857.0,2,0,118.0,478,252,19.6,2018,0.0
Dedric Boyd,650,93,620,229,135,104,1414.0,285,88,95.0,335,141,28.1,2018,0.0
Zach Charles,393,37,251,131,175,122,1367.0,26,9,50.0,225,122,14.2,2018,0.0
Dillon Avare,354,70,320,115,18,14,1417.0,307,110,45.0,13,5,13.3,2018,0.0
Tay Weaver,620,174,571,209,58,41,2126.0,456,161,100.0,115,48,15.4,2018,0.0
Jackson Davis,208,9,167,79,66,46,497.0,19,4,35.0,148,75,23.7,2018,0.0
Jacquess Hobbs,408,228,422,154,97,69,1664.0,119,31,117.0,303,123,16.5,2018,0.0
Peyton Broughton,270,51,251,95,52,38,1042.0,122,42,32.0,129,53,13.8,2018,0.0
A.J. Youngman,119,16,103,41,7,5,449.0,80,32,14.0,23,9,13.6,2018,0.0
Asante Gist,1322,307,1098,415,394,303,3044.0,540,189,240.0,558,226,25.3,2018,0.0
Lachlan Anderson,422,38,328,143,117,86,1164.0,175,50,68.0,153,93,17.6,2018,0.0
Cameron Carmical,88,67,75,28,20,13,550.0,54,19,27.0,21,9,9.2,2018,0.0
Kirkland Humphrey,4,0,12,2,0,0,24.0,5,0,1.0,7,2,27.4,2018,0.0
Elijah Minnie,1468,105,1185,531,247,198,3415.0,611,208,232.0,574,323,23.0,2018,0.0
Paul Jackson,1233,500,1093,438,397,277,3409.0,268,80,269.0,825,358,23.2,2018,0.0
James Thompson IV,1823,78,1109,701,649,414,4278.0,18,7,225.0,1091,694,19.0,2018,0.0
Tim Bond,1056,373,914,403,234,167,3583.0,261,83,226.0,653,320,17.2,2018,0.0
Jordan Nobles,452,93,379,167,68,46,2122.0,196,72,61.0,183,95,11.0,2018,0.0
Ty Groce,931,158,745,328,285,203,2801.0,273,72,181.0,472,256,19.2,2018,0.0
Kevin McAdoo,498,86,435,175,98,72,1404.0,238,76,88.0,197,99,20.8,2018,0.0
Malik Ellison,115,68,133,37,34,24,661.0,65,17,48.0,68,20,15.3,2018,0.0
Terry Harris,399,25,333,133,79,57,1094.0,204,76,49.0,129,57,19.6,2018,0.0
Bud Jones,43,1,30,19,10,5,150.0,0,0,11.0,30,19,15.6,2018,0.0
Isaiah Green,42,3,36,18,10,5,180.0,5,1,6.0,31,17,13.3,2018,0.0
Jalen King,71,9,52,31,34,9,579.0,0,0,19.0,52,31,7.7,2018,0.0
Bogdan Bliznyuk,2169,414,1553,776,556,467,4265.0,397,150,355.0,1156,626,26.3,2018,0.0
Jacob Davison,1365,180,1087,484,335,259,2620.0,396,138,200.0,691,346,27.3,2018,0.0
Mason Peatling,1250,176,888,493,332,215,2730.0,144,49,156.0,744,444,21.9,2018,0.0
Jack Perry,616,234,477,205,69,56,2818.0,363,150,107.0,114,55,11.1,2018,0.0
Cody Benzel,693,65,566,228,38,34,2064.0,504,203,44.0,62,25,15.7,2018,0.0
Ty Gibson,578,104,459,180,83,65,2340.0,399,153,56.0,60,27,12.3,2018,0.0
Sir Washington,686,154,559,224,268,184,2432.0,176,54,119.0,383,170,17.1,2018,0.0
Benas Griciunas,364,27,330,154,78,45,1009.0,45,11,57.0,285,143,21.2,2018,0.0
Jesse Hunt,793,154,600,284,197,146,2102.0,217,79,114.0,383,205,19.7,2018,0.0
Richard Polanco,103,10,83,38,25,18,227.0,30,9,29.0,53,29,28.6,2018,0.0
Luka Vulikic,261,89,253,106,81,40,1185.0,42,9,83.0,211,97,16.3,2018,0.0
Grant Gibb,14,2,12,4,9,5,45.0,4,1,2.0,8,3,21.2,2018,0.0
Joshua Thomas,9,0,9,4,0,0,16.0,3,1,3.0,6,3,39.1,2018,0.0
Tyler Seibring,1794,242,1378,659,267,198,4077.0,680,278,137.0,698,381,20.7,2018,0.0
Dmitri Thompson,1193,163,944,448,321,211,3272.0,269,86,191.0,675,362,20.0,2018,0.0
Dainan Swoope,1321,364,1075,404,361,275,3680.0,686,238,221.0,389,166,20.1,2018,0.0
Brian Dawkins,962,80,776,391,156,91,2212.0,247,89,116.0,529,302,22.4,2018,0.0
Steve Santa Ana,1409,254,1130,476,316,220,3320.0,674,237,208.0,456,239,23.0,2018,0.0
Sheldon Eberhardt,570,214,483,213,110,78,1760.0,226,66,139.0,257,147,19.9,2018,0.0
Seth Fuller,135,51,145,44,19,15,696.0,110,32,49.0,35,12,15.3,2018,0.0
Karolis Kundrotas,240,28,217,92,65,35,966.0,61,21,63.0,156,71,16.5,2018,0.0
Simon Wright,405,89,334,146,77,53,1620.0,169,60,79.0,165,86,14.7,2018,0.0
Jack Anton,131,22,111,48,48,28,762.0,28,7,21.0,83,41,10.1,2018,0.0
Nathan Priddy,239,81,231,86,22,19,816.0,133,48,58.0,98,38,19.1,2018,0.0
Duje Radja,11,0,10,4,4,3,48.0,2,0,2.0,8,4,15.3,2018,0.0
Collin Luther,87,33,85,28,27,18,651.0,53,13,27.0,32,15,9.6,2018,0.0
Jack George,4,0,4,2,0,0,18.0,0,0,1.0,4,2,14.1,2018,1.0
Maxwell Chester,0,0,1,0,0,0,2.0,0,0,0.0,1,0,26.3,2018,0.0
Ryan Taylor,1537,149,1335,553,262,222,3614.0,579,209,155.0,756,344,23.9,2018,0.0
Blake Simmons,1088,326,879,379,239,185,4198.0,404,145,201.0,475,234,15.3,2018,0.0
Dru Smith,1216,402,871,400,348,301,3198.0,308,115,251.0,563,285,20.8,2018,0.0
K.J. Riley,1062,276,693,300,580,440,2846.0,104,22,249.0,589,278,22.7,2018,0.0
Noah Frederking,813,95,703,276,131,97,2926.0,451,164,94.0,252,112,16.1,2018,0.0
Dainius Chatkevicius,347,30,264,139,118,68,1084.0,6,1,85.0,258,138,19.8,2018,0.0
Duane Gibson,756,396,584,277,291,202,2861.0,3,0,283.0,581,277,18.8,2018,0.0
John Hall,657,78,631,252,132,77,2484.0,267,76,142.0,364,176,17.5,2018,0.0
Dalen Traore,117,7,77,31,84,55,619.0,1,0,26.0,76,31,12.4,2018,0.0
Evan Kuhlman,646,130,558,238,74,57,2292.0,312,113,98.0,246,125,16.5,2018,0.0
Marty Hill,400,60,342,151,47,34,1015.0,150,64,47.0,192,87,21.0,2018,0.0
Solomon Hainna,197,23,147,54,119,84,980.0,17,5,37.0,130,49,12.3,2018,0.0
Tyler Nelson,2172,358,1586,681,568,495,4308.0,844,315,244.0,742,366,24.6,2018,0.0
Ferron Flavors Jr.,905,67,793,298,137,102,2254.0,568,207,71.0,225,91,20.2,2018,0.0
Jesus Cruz,1180,168,1114,465,256,179,3290.0,283,71,210.0,831,394,23.0,2018,0.0
Jonathan Kasibabu,1006,147,648,376,343,227,2711.0,85,27,227.0,563,349,19.2,2018,0.0
Wassef Methnani,480,63,419,186,103,67,1270.0,126,41,138.0,293,145,24.7,2018,0.0
Matija Milin,780,101,607,302,161,104,2117.0,225,72,113.0,382,230,18.7,2018,0.0
Jerome Segura,677,417,691,271,153,85,3083.0,165,50,260.0,526,221,16.9,2018,0.0
Aidas Kavaliauskas,312,225,242,101,91,69,1694.0,114,41,144.0,128,60,13.2,2018,0.0
Omar El-Sheikh,105,15,77,39,50,23,311.0,10,4,36.0,67,35,22.0,2018,0.0
Kevin Senghore-Peterson,145,18,133,50,76,37,779.0,28,8,35.0,105,42,13.6,2018,0.0
Taj Benning,809,164,700,256,272,219,2879.0,233,78,160.0,467,178,18.3,2018,0.0
Olivier Cadieux,25,4,27,8,8,6,139.0,12,3,11.0,15,5,14.9,2018,0.0
Thomas Nolan,31,8,46,11,2,1,216.0,35,8,7.0,11,3,12.5,2018,0.0
Jared Harper,4,2,2,1,2,1,23.0,2,1,3.0,0,0,13.1,2018,1.0
Darnell Edge,1431,224,1037,485,284,260,3594.0,486,201,167.0,551,284,18.6,2018,0.0
Mike Holloway,1490,146,1080,570,509,334,3487.0,51,16,248.0,1029,554,22.4,2018,0.0
Jahlil Jenkins,1698,477,1366,578,445,363,4261.0,502,179,283.0,864,399,21.9,2018,0.0
Noah Morgan,330,41,246,117,58,48,838.0,110,48,61.0,136,69,19.3,2018,0.0
Kaleb Bishop,1110,82,876,423,256,187,3062.0,217,77,182.0,659,346,19.4,2018,0.0
Darian Anderson,1538,354,1362,541,368,286,3340.0,492,170,269.0,870,371,26.8,2018,0.0
Elyjah Williams,1050,238,731,421,278,166,3032.0,107,42,250.0,624,379,18.5,2018,0.0
Pat McNamara,173,29,151,59,11,6,651.0,126,49,21.0,25,10,13.5,2018,0.0
Nadi Beciri,93,11,76,30,42,27,299.0,18,6,29.0,58,24,20.7,2018,0.0
Mike Schroback,64,26,72,19,22,14,342.0,45,12,30.0,27,7,16.2,2018,0.0
Malik Miller,260,9,207,101,80,46,790.0,65,12,40.0,142,89,17.8,2018,0.0
Dondre Rhoden,33,2,25,13,19,7,210.0,0,0,9.0,25,13,10.0,2018,0.0
Brian Fabre,2,0,2,1,0,0,9.0,1,0,2.0,1,1,21.5,2018,0.0
Desmond Williams,1088,108,881,403,394,271,2148.0,46,11,163.0,835,392,28.3,2018,0.0
Marcus Barham,904,118,756,294,213,163,2043.0,414,153,150.0,342,141,24.4,2018,0.0
Elijah Mayes,334,85,270,130,51,44,885.0,67,30,53.0,203,100,19.7,2018,0.0
Justin Ravenel,1322,132,1037,437,203,165,3603.0,694,283,106.0,343,154,17.3,2018,0.0
Nasir Core,580,161,431,161,309,210,1889.0,161,48,177.0,270,113,19.8,2018,0.0
Isaiah Martin,307,13,204,130,85,47,925.0,0,0,38.0,204,130,15.6,2018,0.0
Nick Severado,260,32,255,99,105,61,1553.0,7,1,83.0,248,98,12.3,2018,0.0
Craig Bowman,654,154,622,206,268,175,1986.0,251,67,179.0,371,139,23.7,2018,0.0
Kamron Reaves,581,173,619,200,164,112,2241.0,275,69,249.0,344,131,21.2,2018,0.0
Brendon Myles,291,33,287,106,59,43,1148.0,108,36,88.0,179,70,17.1,2018,0.0
Bryce Moragne,427,59,365,172,121,80,1720.0,16,3,101.0,349,169,15.1,2018,0.0
Javonni Harrell,12,6,17,5,6,2,99.0,1,0,3.0,16,5,11.6,2018,0.0
Rashad Austin,8,6,7,3,5,2,131.0,0,0,4.0,7,3,5.1,2018,0.0
Ronald Delph,962,44,793,418,191,126,2213.0,2,0,128.0,791,418,22.7,2018,0.0
Justin Massey,907,102,742,285,238,180,2152.0,450,157,95.0,292,128,22.1,2018,0.0
Gerdarius Troutman,774,82,637,247,136,111,1689.0,449,169,40.0,188,78,21.7,2018,0.0
Jailyn Ingram,1334,185,1170,521,258,185,3095.0,296,107,238.0,874,414,24.2,2018,0.0
Anthony Adger,701,157,621,220,197,162,1691.0,324,99,122.0,297,121,24.2,2018,0.0
Payton Hulsey,472,251,418,166,201,125,2165.0,56,15,158.0,362,151,15.6,2018,0.0
William Pfister,178,54,158,77,42,24,1309.0,0,0,65.0,158,77,9.1,2018,0.0
Amir Smith,138,5,104,57,42,24,540.0,0,0,27.0,104,57,13.6,2018,0.0
Devorious Brown,54,26,61,19,24,16,326.0,9,0,31.0,52,19,15.4,2018,0.0
Je'Quan Perry,24,4,26,8,3,2,113.0,17,6,5.0,9,2,13.9,2018,0.0
Simeon Lepichev,187,24,175,78,40,23,879.0,36,8,50.0,139,70,13.6,2018,0.0
Tre' Maloney,4,0,3,2,0,0,21.0,0,0,1.0,3,2,9.2,2018,0.0
Chisom Obidike,3,0,1,1,3,1,9.0,0,0,1.0,1,1,18.4,2018,0.0
Byron Abrams,0,0,2,0,0,0,9.0,2,0,0.0,0,0,10.7,2018,0.0
Brandon Goodwin,1651,477,1212,575,535,383,3633.0,392,118,290.0,820,457,24.1,2018,1.0
Zach Johnson,1720,399,1413,607,477,323,4033.0,518,183,312.0,895,424,23.9,2018,0.0
Christian Terrell,1312,291,1038,472,260,194,3375.0,471,174,191.0,567,298,19.7,2018,0.0
Dinero Mercurius,673,86,513,217,146,117,1799.0,330,122,83.0,183,95,18.5,2018,0.0
Antravious Simmons,686,71,512,286,173,113,1637.0,2,1,103.0,510,285,20.8,2018,0.0
RaySean Scott Jr.,376,48,296,151,84,54,1017.0,75,20,69.0,221,131,19.6,2018,0.0
Michael Gilmore,397,48,322,157,79,42,1188.0,120,41,99.0,202,116,18.9,2018,0.0
Christian Carlyle,603,156,483,221,195,132,1993.0,93,29,109.0,390,192,17.0,2018,0.0
Ricky Doyle,495,34,329,194,174,107,1521.0,2,0,78.0,327,194,17.2,2018,0.0
Brady Ernst,201,38,127,80,81,41,862.0,0,0,46.0,127,80,12.2,2018,0.0
Brian Thomas,202,16,136,88,62,26,974.0,0,0,43.0,136,88,10.7,2018,0.0
Darnell Rogers,312,73,244,95,83,63,897.0,151,59,66.0,93,36,20.0,2018,0.0
Joshua Ko,25,5,35,10,2,0,64.0,17,5,4.0,18,5,31.2,2018,0.0
Ryan McAdoo,6,2,13,1,8,4,53.0,4,0,4.0,9,1,18.5,2018,0.0
Dolan Mahoney,17,3,17,7,0,0,79.0,11,3,3.0,6,4,12.5,2018,0.0
Brian Beard Jr.,1096,381,880,352,443,302,2202.0,333,90,218.0,547,262,27.8,2018,0.0
Eric Lockett,730,206,618,286,189,125,2397.0,103,33,134.0,515,253,17.7,2018,0.0
Trejon Jacob,1135,98,886,409,212,133,2595.0,485,184,134.0,401,225,20.5,2018,0.0
Michael Douglas,393,34,387,135,99,57,1645.0,223,66,46.0,164,69,14.4,2018,0.0
Hassan Hussein,355,18,310,152,69,48,1118.0,13,3,58.0,297,149,18.3,2018,0.0
Josh Stamps,101,8,93,35,21,14,235.0,53,17,11.0,40,18,24.4,2018,0.0
Osasumwen Osaghae,767,27,468,299,262,166,1904.0,10,3,108.0,458,296,17.0,2018,0.0
Willy Nunez Jr.,586,52,516,184,107,77,1549.0,423,141,44.0,93,43,18.2,2018,0.0
Jay Harvey,59,3,47,22,46,15,526.0,0,0,24.0,47,22,8.9,2018,0.0
Isaiah Banks,481,79,387,188,115,55,1610.0,183,50,86.0,204,138,15.1,2018,0.0
Cordell Veira,65,35,70,23,29,11,395.0,31,8,16.0,39,15,12.0,2018,0.0
Ronald Whitaker,61,5,61,24,18,11,233.0,18,2,14.0,43,22,18.4,2018,0.0
Elhadji Dieng,102,5,73,36,76,30,559.0,0,0,35.0,73,36,11.8,2018,0.0
Kasper Christensen,17,1,17,5,3,2,56.0,16,5,1.0,1,0,17.5,2018,0.0
Phil Cofer,977,59,780,358,260,172,2870.0,243,89,139.0,537,269,18.0,2018,0.0
Braian Angola-Rodas,594,147,439,187,164,135,1365.0,220,85,90.0,219,102,21.3,2018,0.0
Terance Mann,1322,269,915,505,385,258,3620.0,165,54,191.0,750,451,17.2,2018,1.0
CJ Walker,967,354,784,324,279,223,2935.0,299,96,195.0,485,228,19.0,2018,0.0
Trent Forrest,1143,455,844,390,449,336,3474.0,109,27,260.0,735,363,18.5,2018,0.0
M.J. Walker,1077,193,911,346,270,212,2919.0,479,173,208.0,432,173,20.9,2018,0.0
Mfiondu Kabengele,734,21,500,249,279,202,1301.0,91,34,83.0,409,215,26.9,2018,1.0
PJ Savoy,557,40,459,173,91,69,1123.0,393,142,56.0,66,31,24.1,2018,0.0
Christ Koumadje,550,16,384,239,133,72,1474.0,2,0,89.0,382,239,17.7,2018,0.0
Ike Obiagu,281,9,160,104,139,73,1282.0,0,0,81.0,160,104,11.9,2018,0.0
Brandon Allen,90,16,73,33,6,6,323.0,46,18,22.0,27,15,14.9,2018,0.0
Travis Light,22,0,24,7,2,2,52.0,23,6,0.0,1,1,23.6,2018,0.0
Wyatt Wilkes,221,43,199,79,14,11,699.0,148,52,39.0,51,27,17.3,2018,0.0
Harrison Prieto,24,2,18,11,6,1,69.0,2,1,5.0,16,10,18.5,2018,0.0
Justin Lindner,19,18,16,7,6,4,60.0,6,1,10.0,10,6,24.1,2018,0.0
Will Miles,7,4,16,3,2,1,47.0,4,0,5.0,12,3,23.0,2018,0.0
Anthony Polite,471,92,373,164,92,64,1493.0,220,79,80.0,153,85,16.5,2018,0.0
Jalen Hudson,1376,126,1120,469,405,273,2950.0,484,165,175.0,636,304,26.2,2018,0.0
Egor Koulechov,1740,173,1330,579,409,340,3719.0,615,242,181.0,715,337,22.6,2018,0.0
Chris Chiozza,1025,571,879,344,277,207,3494.0,398,130,223.0,481,214,17.7,2018,1.0
KeVaughn Allen,1723,266,1397,556,411,361,4178.0,743,250,195.0,654,306,21.6,2018,0.0
Keith Stone,615,69,504,207,180,125,1973.0,212,76,110.0,292,131,18.1,2018,0.0
Kevarrius Hayes,778,53,454,287,339,204,2727.0,0,0,132.0,454,287,14.0,2018,0.0
Mike Okauru,716,184,634,255,175,130,2056.0,225,76,132.0,409,179,21.0,2018,0.0
Deaundrae Ballard,242,15,233,93,42,31,658.0,96,25,36.0,137,68,22.9,2018,0.0
Gorjok Gak,397,47,261,161,130,75,958.0,5,0,76.0,256,161,20.7,2018,0.0
Dontay Bassett,328,33,234,109,126,94,1066.0,54,16,50.0,180,93,16.7,2018,0.0
Chase Johnson,125,11,82,53,23,14,320.0,7,5,18.0,75,48,18.6,2018,0.0
Andrew Fava,12,2,10,5,2,1,20.0,5,1,3.0,5,4,36.1,2018,0.0
Mak Krause,6,0,3,2,5,2,24.0,0,0,2.0,3,2,15.9,2018,0.0
Will Tavares,540,62,486,200,152,99,1537.0,156,41,103.0,330,159,23.4,2018,0.0
Prokop Slanina,500,56,400,196,80,58,1332.0,145,50,69.0,255,146,20.7,2018,0.0
Joseph Chartouny,1100,505,898,352,348,254,3365.0,427,142,274.0,471,210,21.0,2018,0.0
Ivan Raut,495,80,463,164,74,53,1890.0,359,114,77.0,104,50,16.5,2018,0.0
Perris Hicks,207,29,166,65,56,42,713.0,112,35,27.0,54,30,16.9,2018,0.0
David Pekarek,429,68,432,150,73,51,1577.0,283,78,98.0,149,72,18.9,2018,0.0
Cavit Ege Havsa,364,239,310,137,60,44,1918.0,154,46,149.0,156,91,13.1,2018,0.0
Tre Evans,84,27,79,29,31,21,335.0,29,5,16.0,50,24,18.0,2018,0.0
Jesse Bunting,303,26,215,122,81,56,1149.0,9,3,40.0,206,119,13.5,2018,0.0
Chris Downing,21,3,14,9,6,3,96.0,0,0,3.0,14,9,11.1,2018,0.0
Thomas Sanchez,11,0,12,4,0,0,66.0,7,3,1.0,5,1,10.6,2018,0.0
Chuba Ohams,392,63,369,161,143,64,1405.0,31,6,114.0,338,155,21.1,2018,0.0
Brenton Petty,2,1,8,1,0,0,77.0,3,0,3.0,5,1,7.7,2018,0.0
Peter Burquest,2,0,0,0,2,2,19.0,0,0,1.0,0,0,5.4,2018,0.0
Deshon Taylor,1732,334,1134,495,633,525,3773.0,548,217,252.0,586,278,22.9,2018,0.0
Bryson Williams,1627,93,1214,650,375,276,3252.0,159,51,212.0,1055,599,25.3,2018,0.0
Ray Bowles,1297,271,1076,438,437,298,3700.0,379,123,218.0,697,315,20.9,2018,0.0
Jahmel Taylor,760,156,566,238,134,102,2320.0,421,182,79.0,145,56,15.5,2018,0.0
Jaron Hopkins,1073,274,916,430,290,162,3005.0,166,51,253.0,750,379,22.2,2018,0.0
Terrell Carter,542,28,394,218,178,106,1427.0,0,0,124.0,394,218,21.6,2018,0.0
Sam Bittner,434,150,336,147,66,46,2340.0,225,94,83.0,111,53,9.8,2018,0.0
Nate Grimes,830,53,610,338,201,116,1991.0,105,38,122.0,505,300,21.4,2018,0.0
Johnny McWilliams,120,21,122,41,43,24,513.0,56,14,18.0,66,27,15.9,2018,0.0
Gilles Dekoninck,54,4,38,18,32,15,194.0,13,3,13.0,25,15,17.2,2018,0.0
New Williams,615,85,536,193,144,106,1806.0,379,123,75.0,157,70,19.4,2018,0.0
Lazaro Rojas,133,13,90,50,52,33,413.0,4,0,35.0,86,50,18.1,2018,0.0
Myles Fitzgerald-Warren,41,19,44,15,11,4,211.0,24,7,12.0,20,8,14.6,2018,0.0
Devin Sibley,1817,239,1318,621,529,365,3729.0,559,210,329.0,759,411,26.5,2018,0.0
Daniel Fowler,1217,369,939,420,306,225,3784.0,411,152,249.0,528,268,18.4,2018,0.0
John Davis III,946,282,789,326,225,162,3234.0,365,132,163.0,424,194,17.0,2018,0.0
Matt Rafferty,1340,311,877,505,384,290,3144.0,128,40,166.0,749,465,19.9,2018,0.0
Andrew Brown,711,149,543,240,94,68,2239.0,389,163,94.0,154,77,15.6,2018,0.0
Jordan Lyons,1529,197,1249,500,305,241,3306.0,846,288,221.0,403,212,25.1,2018,0.0
Clay Mounce,1269,181,937,479,211,145,3040.0,452,166,149.0,485,313,19.9,2018,0.0
Geoff Beans,731,66,584,217,149,121,2124.0,497,176,67.0,87,41,17.9,2018,0.0
Alex Hunter,966,353,779,341,104,79,3383.0,548,205,120.0,231,136,14.3,2018,0.0
Jalen Williams,191,22,132,62,97,67,659.0,0,0,61.0,132,62,18.6,2018,0.0
Jonathan Jean,102,78,94,38,29,21,557.0,27,5,46.0,67,33,14.3,2018,0.0
Brady Schuck,36,1,24,10,18,14,91.0,10,2,4.0,14,8,20.5,2018,0.0
Seve Stavroff,1,0,7,0,2,1,29.0,4,0,1.0,3,0,15.4,2018,0.0
David Efianayi,1747,274,1220,579,584,437,3374.0,393,152,268.0,827,427,26.5,2018,0.0
Liam O'Reilly,743,169,637,259,103,81,2020.0,382,144,135.0,255,115,20.4,2018,0.0
DJ Laster,1202,46,956,499,229,143,2438.0,174,61,157.0,782,438,25.6,2018,0.0
Jaheam Cornwall,1213,368,933,412,212,159,3206.0,543,230,198.0,390,182,20.1,2018,0.0
Patrick Zeck,172,21,114,67,45,34,734.0,12,4,24.0,102,63,11.0,2018,0.0
Eric Jamison,857,78,670,342,199,139,2364.0,104,34,149.0,566,308,20.1,2018,0.0
Jamaal Robateau,466,79,421,161,82,61,1443.0,256,83,73.0,165,78,18.1,2018,0.0
Christian Turner,327,314,251,105,126,92,2367.0,82,25,129.0,169,80,9.6,2018,0.0
Justin Jenkins,439,77,401,139,144,99,1485.0,213,62,104.0,188,77,20.2,2018,0.0
Brandon Miller,394,20,273,149,180,94,1384.0,3,2,74.0,270,147,15.4,2018,0.0
Nate Johnson,970,138,742,325,171,136,2688.0,467,184,119.0,275,141,18.2,2018,0.0
L'Hassane Niangane,202,35,163,72,118,58,1554.0,0,0,95.0,163,72,9.9,2018,0.0
Otis Livingston II,1865,493,1517,621,489,420,4558.0,583,203,316.0,934,418,22.8,2018,0.0
Jaire Grayer,1393,113,1251,506,224,151,3859.0,652,230,188.0,599,276,20.2,2018,0.0
Justin Kier,1358,271,1065,474,396,304,4133.0,304,106,308.0,761,368,18.8,2018,0.0
Goanar Mar,520,62,442,167,177,133,2111.0,190,53,108.0,252,114,15.2,2018,0.0
Ian Boyd,598,81,525,214,143,103,1909.0,224,67,96.0,301,147,18.2,2018,0.0
Greg Calixte,418,37,306,184,131,50,1582.0,0,0,88.0,306,184,14.6,2018,0.0
Javon Greene,1139,199,895,365,313,253,3142.0,485,156,228.0,410,209,20.5,2018,0.0
A.J. Wilson,780,56,669,301,270,155,2055.0,80,23,125.0,589,278,22.7,2018,0.0
Jack Tempchin,8,1,7,1,11,6,29.0,1,0,4.0,6,1,28.2,2018,0.0
Nick Diclementi,0,0,1,0,0,0,9.0,1,0,1.0,0,0,11.2,2018,0.0
Zach Garrett,0,0,0,0,2,0,5.0,0,0,0.0,0,0,9.6,2018,0.0
Yuta Watanabe,1460,197,1197,509,363,286,4027.0,463,156,170.0,734,353,19.8,2018,1.0
Jair Bolden,1044,228,995,370,168,116,3140.0,541,188,175.0,454,182,20.5,2018,0.0
Patrick Steeves,741,158,598,293,160,114,2039.0,105,41,155.0,493,252,21.0,2018,0.0
Terry Nolan Jr.,843,204,656,259,291,201,2357.0,367,124,164.0,289,135,21.3,2018,0.0
Arnaldo Toro,672,81,549,239,270,180,2223.0,60,14,119.0,489,225,18.7,2018,0.0
Bo Zeigler,695,122,542,304,189,86,2654.0,17,1,186.0,525,303,15.9,2018,0.0
Justin Mazzulla,525,214,445,193,155,100,2148.0,125,39,152.0,320,154,16.5,2018,0.0
Maceo Jack,869,60,725,293,136,117,2431.0,476,166,95.0,249,127,19.3,2018,0.0
Justin Williams,198,24,158,76,46,34,877.0,41,12,18.0,117,64,11.9,2018,1.0
Javier Langarica,228,25,225,81,76,58,918.0,54,8,57.0,171,73,18.3,2018,0.0
Jack Granger,3,1,2,1,0,0,14.0,2,1,0.0,0,0,7.4,2018,0.0
Adam Mitola,36,9,44,12,2,1,240.0,38,11,13.0,6,1,12.7,2018,0.0
Luke Sasser,2,2,2,1,0,0,30.0,0,0,2.0,2,1,7.1,2018,0.0
Jessie Govan,1664,171,1221,612,460,349,3235.0,223,91,214.0,998,521,25.1,2018,0.0
Marcus Derrickson,919,122,640,294,250,214,2284.0,295,117,151.0,345,177,19.8,2018,1.0
Jamorko Pickett,1124,177,1013,383,243,184,3448.0,477,174,253.0,536,209,19.4,2018,0.0
Jahvon Blair,1120,243,992,360,228,190,2731.0,626,210,166.0,366,150,22.5,2018,0.0
Kaleb Johnson,536,98,339,185,219,137,1892.0,78,29,96.0,261,156,14.0,2018,0.0
Jagan Mosely,692,351,472,219,253,193,3014.0,172,61,196.0,300,158,12.7,2018,0.0
Jonathan Mulmore,283,162,182,75,142,108,1329.0,61,25,93.0,121,50,12.7,2018,0.0
Trey Dickerson,514,170,444,179,160,107,1268.0,155,49,114.0,289,130,24.3,2018,0.0
Antwan Walker,404,46,293,165,85,61,1098.0,47,13,76.0,246,152,18.2,2018,0.0
Chris Sodom,45,2,29,16,30,13,232.0,0,0,16.0,29,16,11.8,2018,0.0
Ra'Mond Hines,3,2,4,0,4,3,22.0,3,0,1.0,1,0,15.5,2018,0.0
George Muresan,13,1,12,3,8,7,110.0,1,0,5.0,11,3,9.1,2018,0.0
Tookie Brown,2290,526,1598,741,787,608,4277.0,533,200,299.0,1065,541,25.7,2018,0.0
Mike Hughes,1375,223,1094,426,418,310,3773.0,625,213,212.0,469,213,19.6,2018,0.0
Ike Smith,1931,189,1567,680,547,354,3734.0,655,217,270.0,912,463,27.3,2018,0.0
Jake Allsmiller,915,109,787,292,79,66,3108.0,720,265,91.0,67,27,14.5,2018,0.0
Montae Glenn,848,38,596,349,230,149,2449.0,2,1,136.0,594,348,16.6,2018,0.0
Quan Jackson,1412,165,1166,493,461,290,3473.0,434,136,183.0,732,357,21.8,2018,0.0
Shawn O'Connell,418,22,271,163,148,89,1738.0,12,3,68.0,259,160,11.5,2018,0.0
David-Lee Jones Jr.,498,131,425,175,115,81,1614.0,189,67,104.0,236,108,17.2,2018,0.0
B.J. Gladden,341,53,299,109,215,108,1244.0,69,15,85.0,230,94,19.5,2018,0.0
Coye Simmons,283,17,233,110,107,63,1411.0,1,0,62.0,232,110,12.0,2018,0.0
Jared Hamilton,635,81,587,248,166,110,2154.0,119,29,72.0,468,219,17.5,2018,0.0
DeDe Reynolds,4,0,6,2,0,0,12.0,2,0,1.0,4,2,28.2,2018,0.0
Tione Jones,0,0,5,0,0,0,8.0,5,0,0.0,0,0,30.2,2018,0.0
D'Marcus Simonds,1755,334,1402,641,519,358,3224.0,391,115,329.0,1011,526,31.3,2018,0.0
Devin Mitchell,918,129,728,312,114,76,2179.0,525,218,95.0,203,94,20.6,2018,0.0
Jeff Thomas,1160,116,943,402,177,141,3264.0,549,215,113.0,394,187,18.0,2018,0.0
Malik Benlevi,1067,128,821,377,197,131,3417.0,455,182,92.0,366,195,15.1,2018,0.0
Jordan Session,539,59,436,213,180,96,1885.0,53,17,96.0,383,196,17.1,2018,0.0
Kane Williams,1227,383,886,376,544,394,3058.0,243,81,234.0,643,295,22.0,2018,0.0
Jordan Tyson,208,8,162,80,88,48,1133.0,0,0,63.0,162,80,12.0,2018,0.0
Josh Linder,356,30,239,133,139,89,1093.0,4,1,89.0,235,132,17.5,2018,0.0
Matt Chism,12,2,8,5,4,1,31.0,1,1,2.0,7,4,19.6,2018,0.0
Denis Alibegovic,5,1,13,2,0,0,24.0,8,1,1.0,5,1,30.3,2018,0.0
Chris Clerkley,38,7,34,16,17,6,252.0,0,0,14.0,34,16,10.7,2018,0.0
Nile Felton,0,0,6,0,0,0,21.0,5,0,1.0,1,0,16.9,2018,0.0
Josh Okogie,1033,120,748,327,403,313,2014.0,173,66,138.0,575,261,27.4,2018,1.0
Ben Lammers,1055,150,850,431,271,190,3107.0,12,3,131.0,838,428,18.3,2018,0.0
Tadric Jackson,1136,200,1071,433,283,168,2642.0,376,102,173.0,695,331,26.7,2018,0.0
Jose Alvarado,1429,384,1106,491,348,275,3702.0,505,172,240.0,601,319,21.2,2018,0.0
Abdoulaye Gueye,407,67,347,168,118,67,1440.0,24,4,113.0,323,164,18.6,2018,0.0
Brandon Alston,718,134,572,240,218,163,2351.0,206,75,151.0,366,165,18.3,2018,0.0
Moses Wright,1130,125,947,466,285,172,2793.0,113,26,186.0,834,440,23.5,2018,0.0
Curtis Haywood II,366,138,340,120,69,53,1580.0,246,73,86.0,94,47,15.2,2018,0.0
Evan Cole,487,56,392,186,162,90,1430.0,93,25,97.0,299,161,19.8,2018,0.0
Justin Moore,457,192,428,170,145,90,1618.0,79,27,140.0,349,143,20.3,2018,0.0
Sylvester Ogbonda,274,34,209,98,99,68,1005.0,32,10,68.0,177,88,16.5,2018,0.0
Evan Jester,1,0,1,0,4,1,7.0,1,0,2.0,0,0,36.5,2018,0.0
Jon Brown,114,20,110,48,31,11,455.0,30,7,46.0,80,41,18.6,2018,0.0
Malachi Rice,3,1,3,1,2,1,11.0,0,0,1.0,3,1,23.6,2018,0.0
Avi Schafer,0,0,1,0,0,0,6.0,0,0,0.0,1,0,8.7,2018,0.0
Yante Maten,1886,129,1355,655,686,518,3576.0,144,58,245.0,1211,597,27.5,2018,1.0
William Jackson II,640,238,612,210,124,94,2556.0,393,126,147.0,219,84,16.2,2018,0.0
Juwan Parker,793,148,702,259,274,227,2604.0,191,48,142.0,511,211,19.2,2018,0.0
Derek Ogbeide,894,83,685,374,262,146,2620.0,2,0,170.0,683,374,18.8,2018,0.0
Rayshaun Hammonds,974,138,782,361,241,174,2374.0,230,78,170.0,552,283,22.1,2018,0.0
Tyree Crump,801,131,704,253,149,119,1920.0,524,176,134.0,180,77,23.5,2018,0.0
Nicolas Claxton,545,64,396,181,257,157,1496.0,86,26,90.0,310,155,20.2,2018,1.0
TeShaun Hightower,774,154,621,251,288,200,1852.0,247,72,166.0,374,179,25.5,2018,0.0
Jordan Harris,593,125,433,203,160,123,1816.0,172,64,161.0,261,139,18.2,2018,0.0
Mike Edwards,291,26,244,113,127,65,1498.0,3,0,86.0,241,113,13.2,2018,0.0
E'Torrion Wilridge,226,113,183,75,100,58,1601.0,81,18,87.0,102,57,9.9,2018,0.0
Pape Diatta,105,23,83,33,39,27,478.0,35,12,31.0,48,21,14.0,2018,0.0
Isaac Kante,692,42,441,269,223,154,1756.0,0,0,114.0,441,269,19.0,2018,0.0
Connor O'Neill,2,1,6,0,6,2,33.0,0,0,4.0,6,0,19.9,2018,0.0
Christian Harrison,43,13,27,15,21,12,290.0,3,1,14.0,24,14,8.8,2018,0.0
Johnathan Williams,1478,141,1085,554,559,320,3893.0,150,50,254.0,935,504,21.2,2018,1.0
Zach Norvell Jr.,1023,201,772,343,195,163,2134.0,470,174,111.0,302,169,22.6,2018,1.0
Killian Tillie,1023,148,702,385,196,147,2188.0,239,106,113.0,463,279,20.4,2018,0.0
Josh Perkins,1562,712,1211,531,332,249,4689.0,651,251,310.0,560,280,17.9,2018,0.0
Rui Hachimura,1230,81,798,462,378,282,2012.0,76,24,120.0,722,438,26.9,2018,1.0
Silas Melson,960,181,800,331,185,145,3143.0,423,153,103.0,377,178,15.9,2018,0.0
Corey Kispert,1586,192,1149,555,250,206,3755.0,662,270,142.0,487,285,18.2,2018,0.0
Jacob Larsen,100,17,55,36,42,28,284.0,0,0,26.0,55,36,17.3,2018,0.0
Jeremy Jones,242,55,146,80,109,68,1184.0,38,14,49.0,108,66,10.7,2018,0.0
Jesse Wade,35,10,38,11,8,4,144.0,32,9,3.0,6,2,16.0,2018,0.0
Brian Pete,4,1,6,2,0,0,14.0,1,0,0.0,5,2,21.2,2018,0.0
Alex Martin,3,0,4,1,2,1,7.0,3,0,0.0,1,1,35.0,2018,0.0
Jack Beach,16,5,23,5,4,2,108.0,16,4,0.0,7,1,11.4,2018,0.0
Ivy Smith Jr.,1466,526,1079,420,683,547,3480.0,260,79,348.0,819,341,24.3,2018,0.0
Shirmane Thomas,642,231,584,212,262,163,2519.0,177,55,213.0,407,157,17.7,2018,0.0
Anthony Gaston,698,101,590,235,211,159,2133.0,226,69,147.0,364,166,18.9,2018,0.0
Axel Mpoyo,499,23,393,191,140,89,1550.0,76,28,107.0,317,163,17.5,2018,0.0
Devante Jackson,897,97,692,330,301,211,2073.0,72,26,152.0,620,304,23.1,2018,0.0
Jason Perry-Murray,158,4,108,66,44,26,528.0,0,0,32.0,108,66,14.1,2018,0.0
Diontae Jones,217,20,194,80,51,41,669.0,42,16,49.0,152,64,18.9,2018,0.0
Nigel Ribeiro,857,222,803,319,203,129,2725.0,299,90,186.0,504,229,19.9,2018,0.0
Drake Wilks,278,41,244,101,51,31,963.0,133,45,54.0,111,56,16.0,2018,0.0
Bobby Jackson,90,5,75,34,40,20,317.0,12,2,16.0,63,32,16.2,2018,1.0
Kareem Wright,24,12,36,9,10,4,148.0,17,2,20.0,19,7,19.0,2018,0.0
Diing Diing Wol,7,0,13,3,7,1,38.0,1,0,7.0,12,3,28.5,2018,0.0
Charles Simmons,8,2,9,2,4,2,42.0,6,2,2.0,3,0,14.8,2018,0.0
Alessandro Lever,1629,193,1223,593,425,315,3280.0,357,128,220.0,866,465,25.4,2018,0.0
Joshua Braun,1714,140,1181,504,552,449,3641.0,675,257,147.0,506,247,21.8,2018,0.0
Casey Benson,877,414,685,276,262,194,3608.0,363,131,144.0,322,145,13.1,2018,0.0
Oscar Frayer,970,150,836,361,181,104,3021.0,439,144,154.0,397,217,17.6,2018,0.0
Keonta Vernon,838,93,656,340,290,157,2170.0,6,1,137.0,650,339,20.9,2018,0.0
Roberts Blumbergs,236,32,208,80,68,52,659.0,108,24,46.0,100,56,21.3,2018,0.0
Fiifi Aidoo,252,56,231,85,63,44,842.0,134,38,46.0,97,47,17.8,2018,0.0
Damari Milstead,573,187,457,186,191,149,1537.0,152,52,120.0,305,134,21.7,2018,0.0
Gerard Martin,497,236,435,168,105,66,2628.0,292,95,132.0,143,73,11.5,2018,0.0
Matt Jackson,481,105,427,176,114,75,1848.0,168,54,80.0,259,122,15.2,2018,0.0
Shaq Carr,220,121,157,76,71,61,838.0,16,7,90.0,141,69,16.3,2018,0.0
Kerwin Smith,392,25,287,164,159,64,1630.0,0,0,110.0,287,164,14.7,2018,0.0
Ibrahima Sankare,13,1,8,4,7,5,34.0,0,0,3.0,8,4,20.5,2018,0.0
Cheick Sy-Savane,12,0,13,4,0,0,18.0,8,4,1.0,5,0,37.9,2018,0.0
Nehemiah Allen,5,0,3,2,3,1,29.0,1,0,0.0,2,2,7.4,2018,0.0
Parker Dale,1,0,1,0,2,1,4.0,0,0,1.0,1,0,35.9,2018,0.0
Khalil Small,1335,215,1046,459,384,301,3018.0,328,116,202.0,718,343,21.9,2018,0.0
Sandy Cohen,1326,317,956,436,429,317,3251.0,400,137,236.0,556,299,20.6,2018,0.0
Kameron Hankerson,1100,250,923,408,186,147,2870.0,371,137,190.0,552,271,19.6,2018,0.0
David Jesperson,413,56,337,150,59,45,1576.0,188,68,68.0,149,82,13.2,2018,0.0
PJ Pipes,1103,258,881,361,234,201,3180.0,463,180,158.0,418,181,17.6,2018,0.0
Manny Patterson,649,42,477,241,233,166,1786.0,5,1,112.0,472,240,18.7,2018,0.0
T.J. Parham,356,45,401,120,90,63,1036.0,193,53,61.0,208,67,23.8,2018,0.0
Hunter Crist,237,116,185,73,88,59,1093.0,95,32,87.0,90,41,13.7,2018,0.0
Trevian Bell,524,62,454,196,103,80,1447.0,157,52,96.0,297,144,19.4,2018,0.0
Sukhjot Bains,98,38,88,38,33,15,517.0,29,7,22.0,59,31,11.6,2018,0.0
Will Chevalier,148,11,128,50,16,11,421.0,97,37,14.0,31,13,16.8,2018,0.0
Tyrone Powell,10,2,6,4,4,2,24.0,1,0,2.0,5,4,19.6,2018,0.0
Jermaine Marrow,2680,632,2232,883,872,684,4469.0,730,230,416.0,1502,653,32.7,2018,0.0
Kalin Fisher,1349,244,1186,475,362,275,3282.0,416,124,191.0,770,351,22.4,2018,0.0
Malique Trent,699,173,549,236,241,169,1588.0,214,58,154.0,335,178,24.8,2018,0.0
Akim Mitchell,814,133,605,291,214,172,2846.0,160,60,117.0,445,231,13.7,2018,0.0
Trevond Barnes,765,54,507,275,248,177,2184.0,107,38,95.0,400,237,15.6,2018,0.0
Charles Wilson-Fisher,515,38,413,211,123,84,1575.0,39,9,114.0,374,202,17.6,2018,0.0
Greg Heckstall,735,195,632,243,188,152,2396.0,288,97,119.0,344,146,16.7,2018,0.0
Lysander Bracey,477,67,434,152,79,65,1556.0,329,108,61.0,105,44,16.3,2018,0.0
Austin Colbert,179,18,163,67,52,35,776.0,45,10,37.0,118,57,14.2,2018,0.0
Trey Carver,151,18,151,54,69,40,767.0,14,3,25.0,137,51,12.9,2018,0.0
A.J. Astroth,296,33,240,107,111,69,1071.0,58,13,50.0,182,94,16.0,2018,0.0
Eugene Marshall III,33,5,32,11,8,6,100.0,22,5,4.0,10,6,18.8,2018,0.0
Jaekwon Carliyle,11,9,19,2,10,7,66.0,8,0,9.0,11,2,23.0,2018,0.0
Tre Houston,8,1,7,3,4,2,34.0,1,0,2.0,6,3,14.9,2018,0.0
John Carroll,1335,200,1087,464,493,341,3053.0,214,66,225.0,873,398,26.8,2018,0.0
Jason Dunne,1458,296,1230,491,255,200,3892.0,783,276,255.0,447,215,21.5,2018,0.0
J.R. Lynch,1412,374,1086,471,345,284,4085.0,486,186,215.0,600,285,18.7,2018,0.0
Travis Weatherington,615,79,452,213,68,57,1926.0,312,132,88.0,140,81,15.6,2018,0.0
Hassan Attia,425,33,282,180,152,65,1247.0,0,0,107.0,282,180,19.1,2018,0.0
George Blagojevic,1035,167,849,409,292,174,3004.0,168,43,221.0,681,366,21.0,2018,0.0
Jack Hobbs,490,58,452,168,74,44,1956.0,349,110,61.0,103,58,14.6,2018,0.0
Andrew Ramirez,175,54,151,57,67,43,723.0,64,18,59.0,87,39,17.1,2018,0.0
Max Twyman,128,32,101,42,27,17,731.0,73,27,21.0,28,15,9.6,2018,0.0
Jalen Knight,9,3,6,3,8,2,49.0,1,1,5.0,5,2,15.9,2018,0.0
Ziga Habat,4,0,1,1,2,2,9.0,0,0,0.0,1,1,11.4,2018,0.0
Petr Stepanyants,11,0,11,4,5,3,29.0,1,0,0.0,10,4,24.2,2018,0.0
Mark Plousis,17,1,7,2,23,13,81.0,0,0,4.0,7,2,14.1,2018,0.0
Nikola Colovic,38,3,19,15,17,8,109.0,0,0,7.0,19,15,16.2,2018,0.0
Seth Towns,920,97,738,312,222,180,1798.0,285,116,137.0,453,196,28.5,2018,0.0
Chris Lewis,1237,112,852,519,292,199,2764.0,1,0,205.0,851,519,22.4,2018,0.0
Justin Bassey,844,221,588,278,258,185,3335.0,288,103,212.0,300,175,14.3,2018,0.0
Christian Juzang,638,228,527,202,158,130,2410.0,314,104,154.0,213,98,16.2,2018,0.0
Corey Johnson,760,122,663,255,57,44,2558.0,546,206,90.0,117,49,15.9,2018,0.0
Bryce Aiken,1170,195,877,350,375,321,2083.0,438,149,202.0,439,201,31.2,2018,0.0
Danilo Djuricic,524,56,421,188,104,75,1626.0,212,73,60.0,209,115,16.8,2018,0.0
Rio Haskett,379,89,368,135,63,41,1453.0,189,68,98.0,179,67,17.6,2018,0.0
Robert Baker,444,55,369,163,80,62,1472.0,167,56,89.0,202,107,17.3,2018,0.0
Henry Welsh,199,23,183,87,33,21,771.0,18,4,44.0,165,83,16.3,2018,0.0
Weisner Perez,127,7,108,45,47,33,446.0,18,4,25.0,90,41,18.1,2018,0.0
Reed Farley,12,4,25,4,0,0,105.0,21,4,4.0,4,0,14.6,2018,0.0
Chris Egi,93,21,71,33,70,27,492.0,0,0,34.0,71,33,14.7,2018,0.0
Andre Chatfield,64,19,54,23,15,11,389.0,27,7,22.0,27,16,11.5,2018,0.0
Robbie Feinberg,3,1,11,1,0,0,28.0,8,1,1.0,3,0,22.4,2018,0.0
Balsa Dragovic,18,1,14,6,4,4,58.0,6,2,5.0,8,4,18.6,2018,0.0
Zach Yoshor,14,1,11,5,2,0,54.0,6,4,2.0,5,1,14.1,2018,0.0
Mike Thomas,899,82,626,324,357,236,2112.0,76,15,128.0,550,309,21.8,2018,0.0
Gibson Johnson,653,84,460,241,235,158,1441.0,49,13,97.0,411,228,23.9,2018,0.0
Sheriff Drammeh,794,191,672,246,254,189,2733.0,343,113,149.0,329,133,17.7,2018,0.0
Brocke Stepteau,783,271,529,237,259,217,2470.0,236,92,153.0,293,145,16.9,2018,0.0
Drew Buggs,846,485,787,314,222,151,3164.0,245,67,240.0,542,247,18.4,2018,0.0
Jack Purchase,877,192,698,287,129,101,2697.0,554,202,124.0,144,85,17.0,2018,0.0
Leland Green,428,63,449,158,83,42,1577.0,220,70,89.0,229,88,18.9,2018,0.0
Samuta Avea,483,61,423,177,96,71,1449.0,174,58,83.0,249,119,19.6,2018,0.0
Zigmars Raimo,775,165,589,290,319,193,2390.0,18,2,169.0,571,288,19.7,2018,0.0
Brandon Thomas,57,12,66,19,19,10,270.0,43,9,8.0,23,10,16.0,2018,0.0
Ido Flaisher,128,7,94,49,51,30,441.0,0,0,39.0,94,49,18.4,2018,0.0
Zach Buscher,27,5,24,11,9,5,102.0,9,0,11.0,15,11,19.5,2018,0.0
Andre Fox,1394,171,1075,445,426,340,3094.0,453,164,213.0,622,281,25.1,2018,0.0
Jahaad Proctor,1456,263,1161,512,357,277,3151.0,458,155,180.0,703,357,24.6,2018,0.0
Brandon Kamga,1131,134,933,399,300,222,2514.0,312,111,181.0,621,288,25.9,2018,0.0
Justyn Mutts,777,161,595,316,201,128,2268.0,64,17,175.0,531,299,19.9,2018,0.0
Jordan Whitehead,387,78,296,153,126,78,1553.0,18,3,63.0,278,150,14.0,2018,0.0
Denny Slay,506,186,492,176,119,91,2026.0,220,63,108.0,272,113,16.6,2018,0.0
Ricky Madison,748,69,551,280,282,181,2337.0,37,7,155.0,514,273,18.7,2018,0.0
Austin White,439,90,379,153,160,114,1901.0,71,19,67.0,308,134,14.3,2018,0.0
Jamal Wright,705,225,583,230,208,149,2313.0,291,96,160.0,292,134,18.8,2018,0.0
Luke Vargo,103,13,96,36,22,11,574.0,59,20,20.0,37,16,11.5,2018,0.0
Cliff Thomas Jr.,239,12,154,90,98,59,613.0,2,0,58.0,152,90,21.6,2018,0.0
Sam Berlin,35,5,36,15,16,5,184.0,0,0,10.0,36,15,15.1,2018,0.0
Dexter Gooding,69,12,74,24,7,4,213.0,61,17,14.0,13,7,22.2,2018,0.0
Justin Wright-Foreman,2327,258,1694,819,508,412,3507.0,718,277,212.0,976,542,30.9,2018,1.0
Eli Pemberton,1982,272,1387,621,666,525,4483.0,556,215,219.0,831,406,21.7,2018,0.0
Rokas Gustys,1184,113,824,507,445,170,3179.0,0,0,191.0,824,507,19.0,2018,0.0
Jalen Ray,1334,216,1078,431,315,251,3437.0,570,221,149.0,508,210,20.3,2018,0.0
Desure Buie,1310,548,1039,440,338,286,3636.0,397,144,237.0,642,296,20.0,2018,0.0
Kenny Wormley,309,107,272,106,107,72,1218.0,62,25,87.0,210,81,16.4,2018,0.0
Hunter Sabety,244,16,144,102,80,40,681.0,0,0,35.0,144,102,15.8,2018,0.0
Stafford Trueheart,256,25,241,93,54,37,1068.0,128,33,36.0,113,60,14.4,2018,0.0
Joel Angus III,410,40,311,154,138,102,1185.0,2,0,71.0,309,154,18.4,2018,0.0
Matija Radovic,69,7,72,22,12,7,295.0,59,18,16.0,13,4,15.8,2018,0.0
Connor Klementowicz,17,6,14,7,4,0,68.0,5,3,3.0,9,4,14.2,2018,0.0
Jehyve Floyd,957,204,636,417,258,123,2596.0,3,0,186.0,633,417,20.7,2018,0.0
Austin Butler,1321,188,1102,485,281,193,3444.0,422,158,204.0,680,327,22.6,2018,0.0
Jacob Grandison,876,196,715,319,142,114,2451.0,350,124,140.0,365,195,20.9,2018,0.0
Caleb Green,866,272,788,325,160,117,3126.0,305,99,158.0,483,226,18.2,2018,0.0
Karl Charles,897,272,615,263,362,287,2639.0,269,84,189.0,346,179,21.2,2018,0.0
Pat Benzan,614,231,502,224,203,144,2637.0,77,22,109.0,425,202,15.5,2018,0.0
Matt Faw,788,64,656,293,136,91,1946.0,305,111,125.0,351,182,23.2,2018,0.0
Matt Zignorski,259,63,253,90,50,36,1300.0,140,43,44.0,113,47,14.0,2018,0.0
Connor Niego,393,49,346,146,75,49,1334.0,154,52,46.0,192,94,17.1,2018,0.0
Kyle Copeland,120,27,118,45,13,8,510.0,76,22,19.0,42,23,15.4,2018,0.0
Clayton Le Sann,123,34,141,47,15,8,671.0,70,21,31.0,71,26,14.7,2018,0.0
Will Powers,0,1,1,0,0,0,10.0,0,0,0.0,1,0,6.0,2018,0.0
Jack Stevens,1,0,2,0,2,1,13.0,0,0,1.0,2,0,18.0,2018,0.0
David Caraher,613,91,487,214,154,114,1410.0,215,71,90.0,272,143,20.6,2018,0.0
Ian Dubose,1566,301,1163,518,549,384,3029.0,395,146,278.0,768,372,25.4,2018,0.0
Jalon Gates,1156,53,919,354,258,214,1973.0,672,234,70.0,247,120,25.2,2018,0.0
Braxton Bonds,866,368,789,339,281,172,2883.0,90,16,187.0,699,323,17.4,2018,0.0
William Gates,481,48,434,189,121,61,1660.0,132,42,95.0,302,147,17.5,2018,0.0
Oliver Lynch-Daniels,475,132,419,169,99,67,1410.0,203,70,97.0,216,99,18.0,2018,0.0
Edward Hardt,471,31,328,180,187,109,1132.0,4,2,98.0,324,178,20.4,2018,0.0
Josh Ibarra,909,89,639,386,236,137,1922.0,0,0,136.0,639,386,21.7,2018,0.0
Philip McKenzie,448,63,365,165,174,107,1850.0,56,11,99.0,309,154,13.4,2018,0.0
Tim Myles,112,23,92,41,64,29,613.0,1,1,63.0,91,40,13.9,2018,0.0
Chukuka Emili,41,3,57,16,13,5,232.0,19,4,13.0,38,12,14.5,2018,0.0
Tyquon Jordan,18,1,11,5,14,6,33.0,5,2,4.0,6,3,29.3,2018,0.0
Stephen O'Suji,214,73,180,64,92,63,717.0,60,23,62.0,120,41,18.2,2018,0.0
Michael Saladin,5,1,11,2,0,0,27.0,7,1,1.0,4,1,20.1,2018,0.0
Waseem Ali Jr.,0,0,4,0,0,0,8.0,1,0,1.0,3,0,27.6,2018,0.0
Robert Gray Jr.,1710,277,1326,601,429,336,2776.0,475,172,185.0,851,429,31.4,2018,0.0
Corey Davis Jr.,1086,187,815,350,203,172,2279.0,536,214,104.0,279,136,22.3,2018,0.0
Devin Davis,616,65,517,250,177,114,1580.0,11,2,89.0,506,248,22.1,2018,0.0
Armoni Brooks,942,56,788,327,83,59,2180.0,577,229,61.0,211,98,20.5,2018,0.0
Fabian White Jr.,760,83,620,304,207,150,2103.0,8,2,118.0,612,302,19.8,2018,0.0
Wes VanBeck,536,99,365,159,141,115,1496.0,239,103,86.0,126,56,17.7,2018,0.0
Galen Robinson Jr.,921,578,797,342,263,174,3774.0,210,63,233.0,587,279,15.5,2018,0.0
Breaon Brady,361,23,267,152,89,57,928.0,0,0,80.0,267,152,21.0,2018,0.0
Nura Zanna,849,46,600,326,390,197,2690.0,2,0,240.0,598,326,18.6,2018,0.0
Gabe Grant,177,16,177,57,44,31,513.0,115,32,22.0,62,25,20.0,2018,0.0
Chris Harris,228,11,147,99,78,30,991.0,0,0,39.0,147,99,11.2,2018,1.0
Valentine Sangoyomi,8,2,10,2,6,4,58.0,0,0,6.0,10,2,16.2,2018,0.0
Mike Adewunmi,596,52,437,206,173,129,1350.0,161,55,103.0,276,151,23.3,2018,0.0
Cedrick Alley Jr,352,56,328,122,77,55,1381.0,190,53,53.0,138,69,14.8,2018,0.0
R.J. Cole,1790,517,1375,551,576,456,3176.0,622,232,277.0,753,319,29.1,2018,0.0
Charles Williams,2404,103,2005,855,582,446,4347.0,695,248,221.0,1310,607,27.9,2018,0.0
Kyle Foster,613,65,520,188,148,105,1498.0,393,132,100.0,127,56,22.4,2018,0.0
Zion Cousins,553,67,462,221,172,105,2617.0,24,6,89.0,438,215,11.6,2018,0.0
Dalique Mingo,386,85,326,125,157,119,1503.0,84,17,101.0,242,108,16.2,2018,0.0
Cameron Lewis,216,36,160,80,80,54,984.0,5,2,58.0,155,78,12.5,2018,0.0
Jalen Jones,252,83,184,98,113,51,1779.0,12,5,89.0,172,93,8.8,2018,1.0
Marcus Hall,70,16,41,29,25,12,362.0,0,0,14.0,41,29,9.0,2018,0.0
Nate Garvey,399,86,339,140,40,29,1089.0,237,90,63.0,102,50,19.0,2018,0.0
Kai Tease,43,4,43,14,6,4,121.0,29,11,10.0,14,3,22.4,2018,0.0
Ibrahim Dosunmu,25,3,15,12,4,1,69.0,1,0,5.0,14,12,15.4,2018,0.0
Michael Obindu,29,5,27,11,16,7,251.0,0,0,12.0,27,11,9.1,2018,0.0
Justin Cotten,14,14,24,5,2,2,74.0,15,2,6.0,9,3,19.7,2018,0.0
Phillip Jones,52,46,37,12,36,27,309.0,9,1,46.0,28,11,15.9,2018,0.0
Henry Odunze,0,0,0,0,0,0,14.0,0,0,0.0,0,0,0.0,2018,0.0
Brandon Boyd,1575,309,1246,522,429,354,3570.0,515,177,246.0,731,345,24.2,2018,0.0
Jared Stutzman,1082,153,731,344,266,208,3061.0,458,186,126.0,273,158,16.4,2018,0.0
Geno Luzcando,1182,201,848,410,410,277,3283.0,263,85,287.0,585,325,20.7,2018,0.0
Novak Topalovic,813,83,607,331,303,151,2500.0,3,0,184.0,604,331,19.2,2018,0.0
Balint Mocsan,801,106,607,270,123,88,2161.0,406,173,116.0,201,97,18.6,2018,0.0
Gary Chivichyan,919,38,755,308,100,68,2156.0,588,235,65.0,167,73,20.6,2018,0.0
Blake Truman,84,13,84,32,9,6,386.0,45,14,24.0,39,18,15.0,2018,0.0
Jacob McCord,57,4,57,21,20,13,139.0,10,2,18.0,47,19,31.3,2018,0.0
Sam Dowd,105,67,103,34,44,29,515.0,32,8,42.0,71,26,16.6,2018,0.0
Kyle Ingram,235,63,194,100,55,34,911.0,1,1,46.0,193,99,14.6,2018,0.0
Erik Nakken,228,22,206,74,17,10,1093.0,196,70,36.0,10,4,11.7,2018,0.0
Hayes Garrity,354,68,325,123,78,63,979.0,138,45,60.0,187,78,23.2,2018,0.0
Lyle Sutton,53,15,36,16,35,21,150.0,11,0,7.0,25,16,20.5,2018,0.0
Houston Wahlen,11,0,8,4,2,1,17.0,4,2,0.0,4,2,27.2,2018,0.0
Callum Kimberley,0,0,1,0,1,0,18.0,0,0,2.0,1,0,9.9,2018,0.0
Victor Sanders,1804,287,1237,546,559,440,3156.0,659,272,283.0,578,274,28.9,2018,0.0
Brayon Blake,847,61,680,320,196,133,1580.0,181,74,98.0,499,246,28.2,2018,0.0
Nate Sherwood,742,118,577,284,191,141,2541.0,91,33,123.0,486,251,15.9,2018,0.0
Perrion Callandret,900,208,721,291,252,187,2571.0,356,131,182.0,365,160,20.3,2018,0.0
Jordan Scott,483,129,383,175,156,98,2446.0,96,35,114.0,287,140,11.9,2018,0.0
Arkadiy Mkrtychyan,931,94,647,336,385,252,2347.0,31,7,155.0,616,329,21.4,2018,0.0
Chad Sherwood,637,157,520,202,83,71,2264.0,404,162,115.0,116,40,15.2,2018,0.0
Trevon Allen,1395,241,1167,490,324,257,3090.0,441,158,219.0,726,332,25.9,2018,0.0
Scott Blakney,746,51,531,307,192,132,1988.0,3,0,144.0,528,307,20.3,2018,0.0
Geno West,160,51,139,53,40,31,542.0,75,23,44.0,64,30,19.6,2018,0.0
Garrett Kingman,10,2,10,3,4,3,56.0,5,1,2.0,5,2,12.7,2018,0.0
Chance Garvin,184,76,186,71,23,12,989.0,99,30,62.0,87,41,13.7,2018,0.0
Marcus Ottey,1579,239,1228,586,413,320,3489.0,245,87,276.0,983,499,23.7,2018,0.0
Dikembe Dixson,1250,91,1035,404,504,355,2345.0,276,87,249.0,759,317,30.5,2018,0.0
Tai Odiase,1153,33,839,453,450,247,3227.0,1,0,131.0,838,453,17.5,2018,0.0
Godwin Boahen,1420,367,1151,482,265,205,3702.0,671,251,290.0,480,231,20.7,2018,0.0
Tarkus Ferguson,1646,632,1333,541,405,312,4262.0,727,252,400.0,606,289,22.0,2018,0.0
Dominique Matthews,754,88,672,252,179,127,1656.0,354,123,111.0,318,129,24.7,2018,0.0
Jordan Blount,673,165,546,274,164,105,2074.0,97,20,222.0,449,254,20.0,2018,0.0
Clint Robinson,328,14,181,93,192,142,1039.0,3,0,65.0,178,93,15.3,2018,0.0
Michael Diggins,893,144,694,340,192,130,2835.0,244,83,147.0,450,257,16.5,2018,0.0
Jacob Wiley,287,44,215,107,134,66,1154.0,19,7,80.0,196,100,15.5,2018,1.0
Naradain James,3,0,9,1,2,1,25.0,4,0,1.0,5,1,20.9,2018,0.0
Milik Yarbrough,1611,338,1279,577,518,373,3137.0,271,84,375.0,1008,493,31.6,2018,0.0
Keyshawn Evans,921,246,778,296,180,130,2652.0,525,199,167.0,253,97,20.0,2018,0.0
Phil Fayne,1295,69,888,508,482,279,2681.0,1,0,143.0,887,508,24.3,2018,0.0
William Tinsley,335,46,340,124,19,9,1526.0,253,78,43.0,87,46,13.2,2018,0.0
Madison Williams,209,61,234,74,38,22,1054.0,137,39,59.0,97,35,15.1,2018,0.0
Taylor Bruninga,168,17,148,53,29,22,671.0,121,40,18.0,27,13,13.7,2018,0.0
Matt Hein,237,78,247,82,61,38,1532.0,129,35,93.0,118,47,12.3,2018,0.0
Isaac Gassman,202,28,173,72,24,16,852.0,106,42,18.0,67,30,12.2,2018,0.0
Daouda N'Diaye,180,15,151,70,73,40,1151.0,0,0,42.0,151,70,10.1,2018,0.0
Elijah Clarance,56,27,66,16,31,22,233.0,23,2,32.0,43,14,24.6,2018,0.0
Jerron Martin,89,33,86,31,15,11,336.0,55,16,24.0,31,15,17.4,2018,0.0
Luke Litwiller,13,0,8,5,0,0,49.0,6,3,1.0,2,2,9.3,2018,0.0
Leron Black,921,47,744,371,195,146,2003.0,83,33,126.0,661,338,24.1,2018,0.0
Trent Frazier,1434,326,1214,472,318,243,3805.0,690,247,210.0,524,225,20.3,2018,0.0
Kipper Nichols,706,80,597,255,183,137,1905.0,192,59,107.0,405,196,20.4,2018,0.0
Michael Finke,1116,126,853,418,202,139,2812.0,403,141,112.0,450,277,19.1,2018,0.0
Aaron Jordan,642,90,509,197,148,117,2047.0,321,131,65.0,188,66,15.6,2018,0.0
Mark Alstork,1395,277,1087,422,507,389,3298.0,462,162,292.0,625,260,24.8,2018,0.0
Mark Smith,887,116,749,287,202,155,2540.0,448,158,133.0,301,129,19.4,2018,0.0
Te'Jon Lucas,1079,470,873,367,370,263,2968.0,268,82,270.0,605,285,21.9,2018,0.0
Da'Monte Williams,479,167,373,145,171,119,2678.0,191,70,93.0,182,75,10.0,2018,0.0
Greg Eboigbodin,197,32,152,76,63,44,997.0,7,1,61.0,145,75,12.7,2018,0.0
Matic Vesel,7,5,7,2,8,3,70.0,0,0,5.0,7,2,10.9,2018,0.0
Drew Cayce,6,1,11,1,6,4,51.0,9,0,4.0,2,1,17.0,2018,0.0
Cameron Liss,6,0,3,2,4,2,42.0,0,0,2.0,3,2,8.5,2018,0.0
Samson Oladimeji,6,1,9,2,4,2,64.0,4,0,1.0,5,2,9.2,2018,0.0
Charles Brown III,664,55,483,245,156,130,1431.0,110,44,121.0,373,201,24.3,2018,0.0
Shawn Johnson,1237,148,901,394,360,252,3322.0,505,197,150.0,396,197,18.3,2018,0.0
Christian Peevy,604,45,368,195,243,209,1165.0,18,5,115.0,350,190,26.9,2018,0.0
Simi Socks,776,52,551,252,277,230,1686.0,118,42,157.0,433,210,24.6,2018,0.0
Keaton Hervey,378,37,274,116,145,111,1230.0,94,35,69.0,180,81,16.8,2018,0.0
Sam Burmeister,835,143,686,276,232,157,2718.0,340,126,169.0,346,150,17.3,2018,0.0
Cody Graham,219,107,201,86,43,30,1158.0,69,17,71.0,132,69,13.0,2018,0.0
Augustine Ene,553,81,446,200,123,99,1619.0,162,54,124.0,284,146,20.3,2018,0.0
Jalin Hart,553,178,409,195,184,117,1270.0,127,46,114.0,282,149,23.7,2018,0.0
Jorden Kite,312,35,255,94,53,47,1033.0,215,77,40.0,40,17,15.6,2018,0.0
Konstantin Kulikov,55,6,52,24,11,7,190.0,2,0,19.0,50,24,19.5,2018,0.0
Devin Wyatt,158,6,123,58,79,42,742.0,2,0,27.0,121,58,12.5,2018,0.0
Myles Thornton,14,0,9,4,5,4,70.0,7,2,1.0,2,2,8.7,2018,0.0
Jordan Barnes,1558,386,1258,492,352,302,3700.0,717,272,255.0,541,220,23.5,2018,0.0
Brenton Scott,1760,240,1487,592,423,306,3865.0,721,270,261.0,766,322,25.7,2018,0.0
Qiydar Davis,503,48,404,181,136,102,1336.0,114,39,80.0,290,142,20.5,2018,0.0
Tyreke Key,1650,196,1178,541,517,415,3690.0,409,153,188.0,769,388,23.0,2018,0.0
Brandon Murphy,533,32,354,179,285,175,1706.0,0,0,116.0,354,179,17.9,2018,0.0
Emondre Rickman,474,33,416,195,175,84,1555.0,0,0,103.0,416,195,19.7,2018,0.0
Clayton Hughes,212,51,181,82,37,23,944.0,80,25,67.0,101,57,14.3,2018,0.0
Bronson Kessinger,423,31,391,180,98,52,1463.0,39,11,53.0,352,169,17.4,2018,0.0
Devin Thomas,148,21,117,44,64,48,535.0,41,12,49.0,76,32,18.6,2018,0.0
Demonte Ojinnaka,63,11,76,22,6,3,345.0,50,16,14.0,26,6,13.5,2018,0.0
Matt Deady,24,5,18,8,13,8,151.0,1,0,9.0,17,8,10.6,2018,0.0
Trey Knight III,20,11,20,6,11,6,196.0,7,2,10.0,13,4,9.1,2018,0.0
Daniel Huenermann,13,0,10,5,5,3,44.0,1,0,2.0,9,5,16.7,2018,0.0
Ethan Claycomb,227,63,165,76,49,41,693.0,95,34,30.0,70,42,17.1,2018,0.0
Juwan Morgan,1374,151,920,517,422,283,2952.0,192,57,170.0,728,460,22.1,2018,1.0
Robert Johnson,1413,342,1172,513,213,148,3723.0,614,239,276.0,558,274,20.8,2018,0.0
Devonte Green,954,257,827,318,216,154,2528.0,435,164,214.0,392,154,22.8,2018,0.0
Josh Newkirk,892,348,786,324,200,135,2997.0,313,109,212.0,473,215,18.8,2018,0.0
Justin Smith,1202,113,945,490,315,197,3198.0,103,25,200.0,842,465,19.9,2018,0.0
Aljami Durham,1035,240,783,321,343,265,3248.0,358,128,163.0,425,193,17.5,2018,0.0
De'Ron Davis,590,87,397,217,258,156,1432.0,1,0,99.0,396,217,21.7,2018,0.0
Freddie McSwain,214,20,159,77,102,60,704.0,4,0,51.0,155,77,18.4,2018,0.0
Collin Hartman,437,110,352,156,72,51,1822.0,211,74,70.0,141,82,12.6,2018,0.0
Zach McRoberts,236,100,202,86,58,37,1860.0,81,27,52.0,121,59,8.0,2018,0.0
Curtis Jones Jr.,514,95,523,179,82,55,1500.0,327,101,62.0,196,78,20.8,2018,0.0
Clifton Moore,165,20,134,65,44,25,541.0,33,10,30.0,101,55,17.4,2018,0.0
Tim Priller,26,3,18,9,10,8,71.0,5,0,4.0,13,9,18.7,2018,0.0
Johnny Jager,2,3,2,0,4,2,23.0,2,0,1.0,0,0,10.9,2018,0.0
Ethan Lasko,49,5,40,16,5,3,192.0,35,14,11.0,5,2,14.2,2018,0.0
Quentin Taylor,5,2,5,2,2,1,31.0,1,0,5.0,4,2,17.6,2018,0.0
Rickey McGill,1434,551,1082,503,395,296,3809.0,372,132,276.0,710,371,20.1,2018,0.0
E.J. Crawford,1851,186,1338,634,479,391,3968.0,519,192,199.0,819,442,22.5,2018,0.0
Roland Griffin,815,109,630,303,273,191,1832.0,67,18,137.0,563,285,24.5,2018,0.0
Schadrac Casimir,1563,270,1066,472,387,340,3866.0,627,279,177.0,439,193,18.3,2018,0.0
Deyshonee Much,1008,185,829,345,142,109,2579.0,521,209,143.0,308,136,19.8,2018,0.0
TK Edogi,486,22,337,195,148,95,1443.0,7,1,86.0,330,194,17.4,2018,0.0
Zach Lewis,1292,273,1168,426,276,212,3600.0,687,228,161.0,481,198,20.5,2018,0.0
Jan Svandrlik,197,15,137,59,35,30,604.0,113,49,12.0,24,10,13.6,2018,0.0
C.J. Seaforth,46,12,35,16,5,3,143.0,26,11,13.0,9,5,17.6,2018,0.0
Gavin Kensmil,710,74,434,265,288,180,1493.0,4,0,135.0,430,265,22.1,2018,0.0
Tyrell Williams,40,2,31,15,13,10,194.0,0,0,12.0,31,15,12.5,2018,0.0
Nils Taylor,0,1,0,0,0,0,2.0,0,0,0.0,0,0,0.0,2018,0.0
Lindell Wigginton,855,141,649,269,294,202,1671.0,290,115,141.0,359,154,28.1,2018,0.0
Donovan Jackson,674,105,538,216,121,103,1620.0,334,139,67.0,204,77,20.5,2018,0.0
Cameron Lard,499,29,353,220,97,59,1066.0,0,0,71.0,353,220,22.2,2018,0.0
Nick Weiler-Babb,723,358,587,248,204,154,2696.0,215,73,138.0,372,175,15.4,2018,0.0
Solomon Young,878,55,649,346,238,180,2509.0,27,6,116.0,622,340,17.5,2018,0.0
Zoran Talley,789,150,723,344,139,90,2179.0,51,11,102.0,672,333,21.2,2018,0.0
Jeff Beverly,931,61,803,334,288,213,2040.0,179,50,159.0,624,284,27.1,2018,0.0
Terrence Lewis,322,24,275,113,70,54,812.0,138,42,49.0,137,71,22.1,2018,0.0
Hans Brase,913,173,704,300,280,208,2645.0,306,105,173.0,398,195,21.2,2018,0.0
Jakolby Long,229,59,213,90,50,34,912.0,43,15,49.0,170,75,15.9,2018,0.0
Tyler Cook,1315,164,911,494,507,324,2601.0,21,3,239.0,890,491,26.0,2018,1.0
Jordan Bohannon,1638,639,1263,492,327,290,4295.0,909,364,257.0,354,128,19.0,2018,0.0
Luka Garza,2306,153,1594,870,636,446,3440.0,327,120,181.0,1267,750,29.5,2018,0.0
Isaiah Moss,1144,171,991,402,198,165,2961.0,463,175,150.0,528,227,20.5,2018,0.0
Jack Nunge,375,72,310,135,88,69,954.0,118,36,58.0,192,99,20.9,2018,0.0
Cordell Pemsl,596,125,378,219,253,157,1693.0,5,1,135.0,373,218,18.0,2018,0.0
Maishe Dailey,404,119,373,144,83,52,1575.0,205,64,74.0,168,80,15.1,2018,0.0
Nicholas Baer,791,169,635,282,139,87,2530.0,375,140,99.0,260,142,15.4,2018,0.0
Ryan Kriener,619,88,457,249,142,94,1568.0,88,27,113.0,369,222,19.8,2018,0.0
Brady Ellingson,698,137,521,246,72,61,2159.0,331,145,75.0,190,101,14.6,2018,0.0
Ahmad Wagner,297,70,212,116,137,63,1141.0,9,2,59.0,203,114,14.2,2018,0.0
Connor McCaffery,451,345,362,125,194,143,2324.0,193,58,104.0,169,67,11.8,2018,0.0
Charlie Rose,11,4,10,5,0,0,39.0,5,1,4.0,5,4,17.5,2018,0.0
Dom Uhl,385,85,344,131,135,81,1463.0,131,42,87.0,213,89,16.7,2018,0.0
Riley Till,117,18,88,40,57,35,612.0,19,2,38.0,69,38,12.9,2018,0.0
Bryson Scott,1569,235,1196,531,515,393,2723.0,362,114,247.0,834,417,29.8,2018,0.0
John Konchar,2065,553,1364,759,508,354,4675.0,464,193,247.0,900,566,19.2,2018,1.0
Kason Harrell,1349,163,1038,491,173,133,3038.0,580,234,158.0,458,257,20.2,2018,0.0
Xzavier Taylor,622,52,463,239,238,139,1954.0,13,5,127.0,450,234,17.9,2018,0.0
Jax Levitch,362,89,280,116,62,33,2160.0,231,97,42.0,49,19,8.3,2018,0.0
Jordon King,274,26,214,99,57,33,579.0,118,43,39.0,96,56,23.0,2018,0.0
Matt Weir,397,151,266,118,95,84,1245.0,176,77,81.0,90,41,15.2,2018,0.0
Dylan Carl,729,169,560,302,167,87,2417.0,122,38,167.0,438,264,16.5,2018,0.0
Jarius Stevens,39,2,35,14,10,10,86.0,9,1,4.0,26,13,24.3,2018,0.0
Chris Rollins,26,5,23,12,2,1,52.0,7,1,3.0,16,11,24.7,2018,0.0
Cameron Benford,195,33,181,83,57,28,1276.0,4,1,57.0,177,82,10.3,2018,0.0
Jordan Coblin,12,2,7,4,3,3,25.0,2,1,2.0,5,3,19.9,2018,0.0
Aaron Brennan,957,134,785,368,210,161,2568.0,158,60,158.0,627,308,20.5,2018,0.0
T.J. Henderson,660,150,509,211,191,146,1809.0,251,92,155.0,258,119,20.7,2018,0.0
Ron Patterson,709,172,645,260,85,50,2052.0,397,139,107.0,248,121,19.2,2018,0.0
Evan Hall,872,99,745,381,322,109,2392.0,2,1,171.0,743,380,21.8,2018,0.0
Jaylen Minnett,1403,256,1255,464,230,190,3058.0,813,285,218.0,442,179,25.0,2018,0.0
D.J. McCall,761,212,627,268,299,195,3089.0,107,30,200.0,520,238,15.6,2018,0.0
Nick Rogers,347,159,273,102,140,97,1378.0,133,46,108.0,140,56,16.0,2018,0.0
Maurice Kirby,220,26,194,92,73,36,905.0,1,0,51.0,193,92,16.0,2018,0.0
Elyjah Goss,808,78,632,311,273,174,2719.0,55,12,132.0,577,299,15.9,2018,0.0
Chad Hudson,13,4,10,3,11,6,50.0,6,1,5.0,4,2,19.9,2018,0.0
Evan Borgman,8,0,6,2,6,4,30.0,2,0,3.0,4,2,19.7,2018,0.0
Noah Thomas,9,0,6,2,6,5,28.0,1,0,7.0,5,2,27.5,2018,0.0
Maurice Rivers,633,60,540,227,237,162,1524.0,64,17,113.0,476,210,25.9,2018,0.0
Jeremiah Jefferson,842,106,756,304,93,69,1914.0,443,165,79.0,313,139,23.2,2018,0.0
Paris Collins,1031,193,1053,381,233,137,2567.0,462,132,157.0,591,249,25.9,2018,0.0
Julian Daughtry,205,39,176,65,62,44,797.0,84,31,32.0,92,34,15.1,2018,0.0
Darius Austin,553,104,552,208,175,97,2056.0,120,40,132.0,432,168,19.1,2018,0.0
Treshawn Bolden,604,131,584,228,242,139,2236.0,32,9,246.0,552,219,21.1,2018,0.0
Chace Franklin,565,121,520,187,178,123,1370.0,217,68,80.0,303,119,24.7,2018,0.0
Lemmie Howard,348,37,343,144,39,24,1225.0,116,36,50.0,227,108,17.2,2018,0.0
Jeremiah Bozeman,123,28,95,37,57,39,720.0,27,10,32.0,68,27,11.0,2018,0.0
Jesse Love,131,47,124,47,33,17,1021.0,62,20,29.0,62,27,8.4,2018,0.0
Jordan Berry,69,8,96,24,4,3,296.0,70,18,13.0,26,6,19.4,2018,0.0
Demetrice Clopton,46,6,46,19,14,8,212.0,0,0,14.0,46,19,16.1,2018,0.0
Payton Wilson,25,2,18,8,10,5,88.0,6,4,9.0,12,4,18.5,2018,0.0
Charles Taylor Jr.,217,29,220,80,86,53,820.0,30,4,63.0,190,76,20.4,2018,0.0
Dontelius Ross,245,139,227,66,90,68,1603.0,159,45,101.0,68,21,11.8,2018,0.0
Tyler Berryhill,0,0,0,0,0,0,1.0,0,0,0.0,0,0,0.0,2018,0.0
James Glenn,2,1,2,1,2,0,22.0,0,0,2.0,2,1,11.5,2018,0.0
Malcolm Drumwright,1429,404,1227,495,312,252,3821.0,535,187,220.0,692,308,21.7,2018,0.0
Jason Burnell,1009,169,739,363,272,215,2154.0,212,68,127.0,527,295,22.6,2018,0.0
Marlon Hunter,917,80,795,382,160,117,2243.0,109,36,101.0,686,346,21.3,2018,0.0
Norbertas Giga,673,108,557,258,171,126,1883.0,102,31,158.0,455,227,21.9,2018,0.0
Jamall Gregory,630,176,521,235,170,116,1636.0,147,44,154.0,374,191,22.7,2018,0.0
Christian Cunningham,913,86,620,385,255,143,3078.0,0,0,150.0,620,385,14.7,2018,0.0
Ashton Spears,198,48,146,56,85,62,681.0,79,24,35.0,67,32,16.7,2018,0.0
Cam Martin,115,20,74,38,45,28,273.0,26,11,21.0,48,27,21.5,2018,0.0
Maurice Dunlap,192,91,207,61,36,27,965.0,156,43,35.0,51,18,13.3,2018,0.0
Jacara Cross,773,45,535,314,215,144,1661.0,8,1,166.0,527,313,24.3,2018,0.0
Tyrik Edwards,206,96,161,69,91,64,800.0,20,4,50.0,141,65,16.6,2018,0.0
Mohamed Abuarisha,17,4,24,7,1,0,68.0,12,3,9.0,12,4,25.1,2018,0.0
Des Curry,20,6,22,7,9,6,86.0,5,0,3.0,17,7,17.5,2018,0.0
Deon Wright,5,0,2,0,6,5,10.0,0,0,0.0,2,0,24.5,2018,0.0
Jace Hogan,1181,84,984,473,328,230,2451.0,19,5,148.0,965,468,26.1,2018,0.0
JD Notae,1339,224,1146,467,325,238,2533.0,482,167,244.0,664,300,28.9,2018,0.0
Devin Harris,818,257,629,286,319,225,2413.0,75,21,198.0,554,265,20.1,2018,1.0
Jalyn Hinton,517,56,343,215,166,87,1461.0,0,0,60.0,343,215,15.9,2018,0.0
Cody Helgeland,508,72,423,165,78,66,1706.0,303,112,83.0,120,53,15.8,2018,0.0
Tanner Rubio,619,158,532,203,95,66,1806.0,399,147,142.0,133,56,19.6,2018,0.0
Radwan Bakkali,94,11,82,35,28,22,304.0,5,2,34.0,77,33,20.7,2018,0.0
Antwon Clayton,427,101,352,161,192,101,2111.0,21,4,118.0,331,157,13.4,2018,0.0
Damien Sears,172,25,135,74,64,24,739.0,2,0,44.0,133,74,13.4,2018,0.0
Corey Romich,107,30,140,36,9,5,697.0,125,30,17.0,15,6,11.6,2018,0.0
Lee Richmond,39,10,24,12,15,13,135.0,7,2,11.0,17,10,15.3,2018,0.0
Derrick Flowers,99,20,90,30,30,17,630.0,60,22,20.0,30,8,9.7,2018,0.0
Stuckey Mosley,1568,286,1336,542,336,259,3618.0,623,225,204.0,713,317,23.9,2018,0.0
Matt Lewis,1928,341,1470,593,654,504,3875.0,674,238,229.0,796,355,25.9,2018,0.0
Darius Banks,1206,200,965,399,343,275,3303.0,390,133,231.0,575,266,20.8,2018,0.0
Develle Phillips,381,48,266,156,149,69,1099.0,1,0,81.0,265,156,19.2,2018,0.0
Joey McLean,851,240,711,287,185,146,2779.0,374,131,167.0,337,156,18.2,2018,0.0
Ramone Snowden,999,252,730,310,406,258,3668.0,332,121,228.0,398,189,15.8,2018,0.0
Zach Jacobs,488,45,429,191,115,82,1718.0,108,24,76.0,321,167,16.2,2018,0.0
Dwight Wilson III,1005,48,748,435,215,135,2312.0,2,0,141.0,746,435,21.5,2018,0.0
Gerron Scissum,261,40,267,106,69,43,888.0,34,6,75.0,233,100,21.6,2018,0.0
Cameron Smith,158,14,104,59,62,40,701.0,0,0,35.0,104,59,12.5,2018,0.0
Antanee Pinkard,59,7,66,23,27,11,391.0,17,2,26.0,49,21,13.6,2018,0.0
Alex Schulz,5,0,5,2,2,1,9.0,0,0,0.0,5,2,34.5,2018,0.0
Barry Brown,1781,350,1519,633,488,342,4472.0,542,173,271.0,977,460,23.7,2018,0.0
Dean Wade,1510,260,1100,548,402,286,3695.0,332,128,148.0,768,420,20.4,2018,1.0
Xavier Sneed,1463,205,1202,477,417,293,3854.0,651,216,168.0,551,261,21.4,2018,0.0
Kamau Stokes,1242,415,1049,385,352,265,3602.0,595,207,258.0,454,178,21.4,2018,0.0
Cartier Diarra,894,260,710,303,253,175,2620.0,333,113,225.0,377,190,21.2,2018,0.0
Makol Mawien,728,38,558,293,181,134,2177.0,29,8,164.0,529,285,19.6,2018,0.0
Amaad Wainright,99,18,85,38,26,11,470.0,39,12,17.0,46,26,13.0,2018,0.0
Levi Stockard III,403,30,314,167,111,69,1491.0,0,0,101.0,314,167,16.5,2018,0.0
Brian Patrick,449,43,388,165,57,44,1097.0,220,75,76.0,168,90,22.7,2018,0.0
Mike McGuirl,705,209,630,235,165,117,2436.0,364,118,135.0,266,117,18.1,2018,0.0
Mawdo Sallah,452,27,377,199,102,54,1612.0,0,0,77.0,377,199,16.4,2018,0.0
James Love,22,2,18,10,5,2,161.0,0,0,8.0,18,10,9.2,2018,0.0
Nigel Shadd,41,1,38,16,20,9,212.0,0,0,21.0,38,16,16.6,2018,0.0
Pierson McAtee,39,5,31,14,12,6,161.0,15,5,7.0,16,9,14.2,2018,0.0
Kade Kinnamon,0,3,3,0,0,0,20.0,3,0,0.0,0,0,8.0,2018,0.0
Mason Schoen,10,4,16,3,5,1,61.0,11,3,2.0,5,0,17.4,2018,0.0
Devonte' Graham,1750,632,1295,546,460,362,4498.0,723,296,270.0,572,250,19.7,2018,1.0
Sviatoslav Mykhailiuk,1181,202,986,422,134,100,3070.0,579,237,146.0,407,185,19.3,2018,0.0
Malik Newman,882,145,686,297,182,142,2037.0,366,146,111.0,320,151,21.6,2018,0.0
Lagerald Vick,1100,168,875,416,137,101,3017.0,412,167,168.0,463,249,18.2,2018,0.0
Udoka Azubuike,1069,60,629,469,315,131,2033.0,0,0,172.0,629,469,23.5,2018,0.0
Marcus Garrett,984,351,823,366,296,188,3539.0,212,64,178.0,611,302,16.2,2018,0.0
Mitch Lightfoot,352,29,263,143,98,54,1351.0,38,12,77.0,225,131,14.2,2018,0.0
Silvio De Sousa,126,6,81,48,46,28,323.0,3,2,35.0,78,46,21.5,2018,0.0
Sam Cunliffe,482,54,460,178,87,61,1181.0,201,65,85.0,259,113,26.0,2018,0.0
Chris Teahan,36,4,30,12,2,2,93.0,26,10,7.0,4,2,20.5,2018,0.0
Clay Young,15,9,12,5,11,5,111.0,3,0,4.0,9,5,9.5,2018,0.0
James Sosinski,6,0,3,3,0,0,9.0,0,0,0.0,3,3,16.7,2018,0.0
Monty Scott,1209,181,1086,434,304,214,2492.0,397,127,212.0,689,307,28.2,2018,0.0
Nick Masterson,1119,245,830,398,126,106,3113.0,459,217,132.0,371,181,16.1,2018,0.0
Tyler Hooker,1414,281,1249,482,494,370,3235.0,312,80,289.0,937,402,27.0,2018,0.0
Jordan Jones,498,99,452,214,118,70,2113.0,2,0,80.0,450,214,13.7,2018,0.0
Kosta Jankovic,436,93,414,167,94,67,1390.0,100,35,102.0,314,132,19.6,2018,0.0
Anthony Wilson,190,52,160,69,65,51,565.0,17,1,30.0,143,68,19.1,2018,0.0
Kyle Clarke,533,213,531,211,166,110,2281.0,17,1,216.0,514,210,17.6,2018,0.0
Bryson Lockley,581,120,526,197,253,169,2353.0,84,18,165.0,442,179,17.1,2018,0.0
Isaac Mbuyamba,191,30,145,68,127,55,1284.0,1,0,44.0,144,68,9.4,2018,0.0
Tristan Jarrett,975,93,855,336,273,206,1616.0,325,97,161.0,530,239,35.1,2018,0.0
Arthur Gray,3,0,3,1,2,1,4.0,0,0,1.0,3,1,60.5,2018,0.0
Isaiah Rose,0,0,0,0,0,0,1.0,0,0,0.0,0,0,0.0,2018,0.0
Markus Smith,2,1,5,1,0,0,11.0,0,0,2.0,5,1,30.8,2018,0.0
Jaylin Walker,1804,167,1529,590,415,329,3489.0,853,295,244.0,676,295,27.3,2018,0.0
Kevin Zabo,683,149,598,238,171,129,1805.0,244,78,122.0,354,160,21.6,2018,0.0
Adonis De La Rosa,595,54,406,201,271,193,1581.0,1,0,178.0,405,201,21.8,2018,0.0
Jalen Avery,899,326,744,280,226,177,3287.0,461,162,76.0,283,118,13.7,2018,0.0
Danny Pippen,1183,133,968,392,327,252,2547.0,457,147,214.0,511,245,25.5,2018,0.0
B.J. Duling,242,30,226,95,89,38,796.0,52,14,38.0,174,81,18.8,2018,0.0
Desmond Ridenour,461,152,457,178,121,68,1759.0,155,37,109.0,302,141,17.4,2018,0.0
Mitch Peterson,495,111,490,176,93,62,2403.0,268,81,95.0,222,95,12.6,2018,0.0
Akiean Frederick,246,29,180,100,58,41,833.0,25,5,42.0,155,95,14.7,2018,0.0
Taishaun Johnson,733,170,558,206,347,266,1934.0,217,55,177.0,341,151,23.0,2018,0.0
Johnathan Nwankwo,5,0,5,2,2,1,22.0,0,0,1.0,5,2,15.4,2018,0.0
Ryan Bernstein,226,142,251,86,43,21,1331.0,121,33,68.0,130,53,12.3,2018,0.0
Kevin Knox,576,53,440,196,164,127,1198.0,167,57,85.0,273,139,24.6,2018,0.0
Shai Gilgeous-Alexander,532,189,377,183,175,143,1248.0,57,23,100.0,320,160,21.9,2018,1.0
PJ Washington,932,120,624,325,386,244,2036.0,99,38,140.0,525,287,23.3,2018,0.0
Hamidou Diallo,371,46,313,134,125,77,918.0,77,26,51.0,236,108,22.6,2018,1.0
Quade Green,947,281,747,336,196,166,2277.0,297,109,198.0,450,227,22.8,2018,0.0
Wenyen Gabriel,425,47,345,147,111,69,1526.0,169,62,70.0,176,85,14.6,2018,1.0
Nick Richards,771,23,448,281,287,209,1908.0,0,0,101.0,448,281,18.2,2018,0.0
Sacha Killeya-Jones,152,10,106,62,54,28,563.0,1,0,30.0,105,62,13.8,2018,0.0
Jarred Vanderbilt,82,14,68,29,38,24,238.0,1,0,15.0,67,29,20.8,2018,1.0
Tai Wynyard,19,1,13,8,5,3,97.0,0,0,5.0,13,8,10.0,2018,0.0
Brad Calipari,177,9,156,54,31,20,641.0,141,49,12.0,15,5,13.8,2018,0.0
Jonny David,7,0,4,1,6,4,40.0,3,1,7.0,1,0,16.6,2018,0.0
Dillon Pulliam,0,1,1,0,0,0,11.0,0,0,1.0,1,0,8.4,2018,0.0
B.J. Johnson,1188,62,947,403,300,253,2317.0,385,129,157.0,562,274,27.7,2018,0.0
Pookie Powell,1342,348,1125,456,331,271,3103.0,483,159,232.0,642,297,24.9,2018,0.0
Amar Stukes,868,370,716,303,275,210,3766.0,160,52,184.0,556,251,14.3,2018,0.0
Isiah Deas,984,137,895,330,257,179,2326.0,441,145,167.0,454,185,25.7,2018,0.0
Tony Washington,624,54,438,267,157,90,2018.0,0,0,136.0,438,267,16.7,2018,0.0
Saul Phiri,685,150,598,209,163,124,2589.0,424,143,120.0,174,66,15.5,2018,0.0
Miles Brookins,286,29,206,105,93,74,991.0,13,2,58.0,193,103,15.7,2018,0.0
Jamir Moultrie,285,25,244,96,50,38,670.0,138,55,36.0,106,41,22.9,2018,0.0
Johnnie Shuler,480,160,438,148,112,82,1925.0,306,102,120.0,132,46,16.7,2018,0.0
Dajour Joseph,21,1,18,8,2,1,58.0,10,4,4.0,8,4,20.0,2018,0.0
Chris Kuhar,3,1,1,1,0,0,9.0,1,1,3.0,0,0,22.8,2018,0.0
Key Sullivan,13,0,12,3,8,6,61.0,1,1,4.0,11,2,16.5,2018,0.0
Kyle Cooney,0,1,1,0,0,0,7.0,1,0,0.0,0,0,7.3,2018,0.0
Matt Klinewski,1492,127,1119,562,412,317,2731.0,123,51,209.0,996,511,29.2,2018,0.0
Alex Petrie,902,54,743,314,165,141,1440.0,331,133,90.0,412,181,32.8,2018,0.0
Justin Jaworski,1484,233,1054,488,298,261,3067.0,586,247,195.0,468,241,23.5,2018,0.0
Paulius Zalys,1048,230,855,405,235,162,2806.0,247,76,293.0,608,329,23.2,2018,0.0
E.J. Stephens,1017,175,837,372,206,170,2721.0,309,103,115.0,528,269,20.0,2018,0.0
Eric Stafford,379,178,321,122,122,91,1793.0,134,44,130.0,187,78,14.8,2018,0.0
Kyle Stout,570,107,524,198,62,43,2414.0,392,131,93.0,132,67,13.9,2018,0.0
Myles Cherry,589,114,429,241,153,93,1942.0,49,14,125.0,380,227,16.9,2018,0.0
Lukas Jarrett,614,189,467,225,162,113,2361.0,150,51,166.0,317,174,15.7,2018,0.0
Dylan Hastings,139,66,153,55,33,15,1148.0,59,14,48.0,94,41,9.8,2018,0.0
Cal Reichwein,27,11,33,11,3,1,67.0,19,4,7.0,14,7,32.3,2018,0.0
Auston Evans,176,41,168,70,80,33,868.0,30,3,67.0,138,67,16.3,2018,0.0
Colton Weisbrod,1156,102,834,413,461,311,2618.0,52,19,171.0,782,394,22.5,2018,0.0
Nick Garth,1758,257,1351,564,380,310,3444.0,843,320,164.0,508,244,23.3,2018,0.0
Josh Nzeakor,1359,82,937,525,529,309,3158.0,2,0,214.0,935,525,21.1,2018,0.0
Zjori Bosha,682,106,581,227,205,125,2426.0,346,103,89.0,235,124,15.2,2018,0.0
James Harrison,406,36,346,144,42,30,935.0,235,88,46.0,111,56,21.0,2018,0.0
Joey Frenchwood,569,287,525,196,121,81,1965.0,295,96,179.0,230,100,18.9,2018,0.0
Torey Noel,310,179,280,100,133,85,1124.0,103,25,113.0,177,75,19.6,2018,0.0
T.J. Atwood,898,121,675,340,252,186,2002.0,87,32,154.0,588,308,22.7,2018,0.0
Jordan Foster,83,5,50,30,45,23,373.0,0,0,36.0,50,30,13.6,2018,0.0
Avery Sullivan,743,69,576,273,267,197,2216.0,5,0,140.0,571,273,18.6,2018,0.0
Da'Shawn Robinson,55,30,61,19,19,10,227.0,31,7,11.0,30,12,17.1,2018,0.0
Cannon Broussard,11,0,9,3,2,2,15.0,6,3,1.0,3,0,34.7,2018,0.0
Lance Tejada,1114,248,938,366,250,173,2654.0,527,209,181.0,411,157,23.9,2018,0.0
Kahron Ross,1368,660,1046,473,402,304,4043.0,308,118,265.0,738,355,19.1,2018,0.0
Pat Andree,1048,92,833,353,161,124,2590.0,544,218,94.0,289,135,19.5,2018,0.0
Kyle Leufroy,1417,299,1079,471,332,286,3532.0,472,189,276.0,607,282,21.8,2018,0.0
Jordan Cohen,1301,377,955,451,302,261,3373.0,347,138,207.0,608,313,19.7,2018,0.0
James Karnik,863,57,664,353,237,153,2298.0,24,4,150.0,640,349,20.3,2018,0.0
Caleb Bennett,273,55,224,96,74,57,964.0,68,24,72.0,156,72,17.2,2018,0.0
Marques Wilson,727,181,633,264,154,111,2101.0,239,88,146.0,394,176,20.5,2018,0.0
Ed Porter,133,10,111,62,11,9,542.0,0,0,30.0,111,62,13.7,2018,0.0
Shane Acoveno,13,0,8,6,0,0,47.0,1,1,4.0,7,5,12.8,2018,0.0
Caleb Sedore,7,0,6,3,4,1,35.0,1,0,2.0,5,3,14.2,2018,0.0
Josh Wolf,8,0,4,3,2,2,21.0,0,0,3.0,4,3,19.2,2018,0.0
Jay Jay Davis,15,6,16,4,6,6,52.0,9,1,5.0,7,3,23.7,2018,0.0
Scottie James,1417,135,897,545,414,294,2854.0,111,33,168.0,786,512,24.7,2018,0.0
Lovell Cabbil,1406,360,1077,456,356,301,4025.0,531,193,263.0,546,263,21.0,2018,0.0
Georgie Pacheco-Ortiz,1292,335,936,412,332,291,4221.0,437,177,171.0,499,235,17.0,2018,0.0
Ryan Kemrite,1211,104,836,381,249,191,3575.0,600,258,97.0,236,123,16.5,2018,0.0
Caleb Homesley,1539,306,1226,578,317,202,3533.0,535,181,203.0,691,397,25.3,2018,0.0
Myo Baxter-Bell,912,173,697,342,299,220,2224.0,45,8,183.0,652,334,26.2,2018,0.0
Elijah Cuffee,981,265,791,345,125,104,3723.0,483,187,174.0,308,158,15.5,2018,0.0
Keegan McDowell,419,73,342,151,32,30,1421.0,226,87,53.0,116,64,16.1,2018,0.0
Isaiah Williams,339,56,276,110,200,111,1103.0,27,8,99.0,249,102,21.9,2018,0.0
Ezra Talbert,330,18,265,118,71,49,966.0,120,45,45.0,145,73,20.0,2018,0.0
Zach Farquhar,57,7,30,17,11,8,169.0,27,15,3.0,3,2,12.6,2018,0.0
Brody Hicks,4,6,5,2,0,0,35.0,2,0,2.0,3,2,11.2,2018,0.0
Garrison Mathews,2478,252,1693,755,771,608,3774.0,963,360,275.0,730,395,29.0,2018,1.0
Rob Marberry,1472,199,995,615,341,242,2629.0,3,0,134.0,992,615,22.9,2018,0.0
Kenny Cooper,955,423,797,335,330,213,2879.0,243,72,265.0,554,263,19.9,2018,0.0
Matt Rose,787,75,610,248,154,116,1995.0,447,175,74.0,163,73,18.2,2018,0.0
Michael Buckland,873,306,686,289,189,147,3512.0,400,148,194.0,286,141,13.2,2018,0.0
Eli Pepper,925,223,677,335,319,192,3037.0,195,63,231.0,482,272,16.4,2018,0.0
Aaron Korn,422,88,355,145,98,64,1679.0,202,68,79.0,153,77,13.5,2018,0.0
George Brammeier,551,43,364,212,218,127,1453.0,0,0,108.0,364,212,18.7,2018,0.0
Greg Jones,522,68,461,169,108,86,1852.0,314,98,61.0,147,71,15.6,2018,0.0
John Matt Merritt,60,13,44,25,5,3,201.0,18,7,9.0,26,18,13.2,2018,0.0
Asa Duvall,79,21,80,25,30,15,409.0,55,14,11.0,25,11,12.5,2018,0.0
Zach Flener,13,5,10,4,3,3,55.0,5,2,6.0,5,2,15.0,2018,0.0
Gabe Levin,1413,142,1062,484,520,394,3165.0,166,51,239.0,896,433,23.6,2018,0.0
Deishuan Booker,960,292,583,275,380,341,2020.0,187,69,224.0,396,206,23.2,2018,0.0
Bryan Alberts,750,86,713,269,69,51,2170.0,442,161,63.0,271,108,17.9,2018,0.0
Temidayo Yussuf,995,130,749,360,459,275,2200.0,1,0,216.0,748,360,26.0,2018,0.0
Edon Maxhuni,449,70,389,150,73,66,1148.0,208,83,91.0,181,67,21.3,2018,0.0
Jordan Griffin,485,42,452,168,52,42,1381.0,317,107,51.0,135,61,18.4,2018,0.0
K.J. Byers,399,57,315,145,146,87,1334.0,96,22,115.0,219,123,17.8,2018,0.0
Barry Ogalue,262,29,196,108,62,42,600.0,23,4,34.0,173,104,20.7,2018,0.0
Jordan Roberts,597,113,520,222,245,149,2129.0,28,4,169.0,492,218,18.3,2018,0.0
Mason Riggins,589,67,416,241,251,107,2362.0,0,0,87.0,416,241,12.7,2018,0.0
LaRond Williams,55,4,55,20,26,15,281.0,0,0,25.0,55,20,15.8,2018,0.0
Javonntie Jackson,66,11,57,26,22,13,323.0,4,1,30.0,53,25,14.5,2018,0.0
Breamon Richard,27,10,25,5,19,14,230.0,12,3,17.0,13,2,10.5,2018,0.0
Quentin Shropshire,16,4,22,6,8,4,135.0,0,0,4.0,22,6,10.6,2018,0.0
Joel Hernandez,1429,157,1178,523,470,287,3025.0,290,96,216.0,888,427,25.8,2018,0.0
Raiquan Clark,2030,180,1391,716,769,545,3872.0,193,53,431.0,1198,663,27.4,2018,0.0
Jashaun Agosto,1320,484,1109,460,391,278,4157.0,382,122,287.0,727,338,18.5,2018,0.0
Julian Batts,1058,275,811,330,268,213,3683.0,479,185,186.0,332,145,14.8,2018,0.0
Zach Coleman,403,76,376,141,126,75,1633.0,179,46,95.0,197,95,15.8,2018,0.0
Jamall Robinson,693,109,676,241,155,100,2839.0,348,111,90.0,328,130,14.8,2018,0.0
Raul Frias,470,33,434,164,31,24,1455.0,334,118,45.0,100,46,16.4,2018,0.0
Eral Penn,537,36,321,190,227,142,1376.0,44,15,49.0,277,175,16.2,2018,0.0
Julius Van Sauers,333,75,259,99,127,94,1693.0,122,41,95.0,137,58,11.8,2018,0.0
Shyheim Hicks,49,6,46,15,15,10,190.0,31,9,12.0,15,6,16.5,2018,0.0
Ashtyn Bradley,235,14,236,76,29,22,534.0,204,61,19.0,32,15,24.6,2018,0.0
Byron Ashe,1432,189,1302,506,295,214,3561.0,630,206,212.0,672,300,24.0,2018,0.0
Isaiah Walton,1104,185,835,373,286,238,2150.0,325,120,277.0,510,253,29.9,2018,0.0
Charles Glover,526,122,443,168,137,99,2043.0,260,91,154.0,183,77,16.7,2018,0.0
Damarion Geter,541,179,407,217,180,94,3253.0,36,13,162.0,371,204,10.4,2018,0.0
JaShaun Smith,1080,74,895,409,211,121,3248.0,367,141,193.0,528,268,18.9,2018,0.0
Spencer Franklin,325,26,203,103,167,116,1207.0,16,3,74.0,187,100,15.2,2018,0.0
Kamil Chapman,171,21,166,49,49,40,527.0,123,33,37.0,43,16,22.2,2018,0.0
Chris Shields,356,57,335,140,48,34,1468.0,131,42,114.0,204,98,16.4,2018,0.0
Jordan Cintron,583,71,403,200,252,162,2102.0,69,21,114.0,334,179,15.8,2018,0.0
Jahleem Montague,51,11,49,20,17,11,222.0,2,0,22.0,47,20,18.4,2018,0.0
Dominic Ezeani,15,8,14,6,9,3,143.0,2,0,4.0,12,6,8.0,2018,0.0
Boaz Williams,78,7,75,30,16,10,210.0,23,8,22.0,52,22,23.5,2018,0.0
Pernell Adgei,58,12,46,19,36,20,328.0,1,0,17.0,45,19,12.6,2018,0.0
Keoni Wallington,0,0,0,0,0,0,0.0,0,0,0.0,0,0,0,2018,0.0
Frank Bartley,1304,214,962,409,426,312,2758.0,477,174,163.0,485,235,22.5,2018,0.0
Jakeenan Gant,1339,81,995,529,271,202,2610.0,243,79,140.0,752,450,23.1,2018,0.0
Bryce Washington,1319,243,922,519,432,275,3865.0,29,6,225.0,893,513,16.3,2018,0.0
Johnathan Stove,1080,220,776,362,397,306,2939.0,149,50,182.0,627,312,18.2,2018,0.0
Malik Marquetti,631,128,520,212,133,102,2140.0,269,105,102.0,251,107,15.2,2018,0.0
Justin Miller,1157,172,923,398,390,291,2606.0,238,70,216.0,685,328,23.9,2018,0.0
Marcus Stroman,769,552,579,228,416,287,2974.0,112,26,299.0,467,202,17.2,2018,0.0
Cedric Russell,1409,168,1169,479,238,185,3316.0,710,266,187.0,459,213,21.0,2018,0.0
Jerekius Davis,550,31,455,207,102,75,1166.0,192,61,56.0,263,146,22.3,2018,0.0
P.J. Hardy,719,124,617,236,108,77,2102.0,460,170,103.0,157,66,17.2,2018,0.0
Larenz Stalcup,83,14,74,31,31,21,279.0,0,0,16.0,74,31,17.5,2018,0.0
Jacob Broussard,28,7,25,9,2,2,99.0,22,8,7.0,3,1,15.5,2018,0.0
Mason Aucoin,56,5,53,19,12,9,223.0,33,9,11.0,20,10,14.7,2018,0.0
Travis Munnings,1722,280,1348,625,384,264,4373.0,560,208,281.0,788,417,21.5,2018,0.0
Sam McDaniel,858,114,725,295,205,157,2030.0,309,111,135.0,416,184,24.7,2018,0.0
Michael Ertel,1769,292,1518,637,333,268,4168.0,634,227,158.0,884,410,22.8,2018,0.0
Marvin Jean-Pierre,624,115,503,241,137,94,1659.0,152,48,108.0,351,193,21.3,2018,0.0
Jordon Harris,450,144,440,166,43,32,1407.0,248,86,102.0,192,80,20.9,2018,0.0
Sam Alabakis,207,6,153,83,71,41,1176.0,0,0,65.0,153,83,11.2,2018,0.0
Brandon Newman,162,82,105,52,51,39,697.0,43,19,38.0,62,33,12.4,2018,0.0
Majok Deng,1010,107,756,351,266,208,2480.0,276,100,127.0,480,251,21.4,2018,0.0
Roderick Taylor,100,6,93,44,27,12,670.0,0,0,36.0,93,44,11.0,2018,0.0
Donovan Walker,22,6,29,8,3,2,103.0,9,4,10.0,20,4,20.6,2018,0.0
Lance Richard,56,6,58,19,0,0,158.0,55,18,9.0,3,1,22.4,2018,0.0
Calvin Anderson,13,3,18,4,4,3,62.0,11,2,5.0,7,2,21.0,2018,0.0
Tremont Waters,1029,390,803,340,274,221,2159.0,376,128,210.0,427,212,26.1,2018,1.0
Duop Reath,786,47,615,324,175,108,1659.0,80,30,121.0,535,294,24.2,2018,0.0
Skylar Mays,1617,382,1168,520,478,404,3963.0,501,173,238.0,667,347,20.0,2018,0.0
Aaron Epps,618,36,478,243,103,75,1631.0,163,57,85.0,315,186,18.4,2018,0.0
Daryl Edwards,655,117,515,230,102,76,1951.0,318,119,102.0,197,111,17.4,2018,0.0
Brandon Sampson,674,86,511,226,184,137,1720.0,262,85,107.0,249,141,19.8,2018,1.0
Wayde Sims,379,29,295,150,80,56,1145.0,70,23,54.0,225,127,16.5,2018,0.0
Randy Onwuasor,1146,211,944,374,408,314,2601.0,289,84,232.0,655,290,25.7,2018,0.0
Brandon Rachal,828,112,647,294,261,191,2029.0,172,49,143.0,475,245,23.5,2018,0.0
Jeremy Combs,1601,101,1014,598,716,400,3396.0,23,5,228.0,991,593,22.2,2018,0.0
Marshall Graves,74,19,76,25,9,6,322.0,61,18,10.0,15,7,13.6,2018,0.0
Galen Alexander,293,29,229,100,90,59,779.0,101,34,59.0,128,66,20.0,2018,0.0
Mayan Kiir,203,18,137,62,119,75,554.0,23,4,67.0,114,58,23.0,2018,0.0
Reed Vial,6,0,7,1,4,3,31.0,6,1,1.0,1,0,16.0,2018,0.0
Jacobi Boykins,1393,156,1033,450,279,224,3247.0,687,269,123.0,346,181,19.7,2018,0.0
DaQuan Bracey,1477,508,1220,547,379,234,3356.0,404,149,240.0,816,398,24.6,2018,0.0
Derric Jean,1188,348,953,398,312,226,3567.0,434,166,227.0,519,232,18.6,2018,0.0
Oliver Powell,522,74,391,193,210,132,2157.0,19,4,117.0,372,189,14.2,2018,0.0
Anthony Duruji,784,71,636,290,201,125,2219.0,230,79,124.0,406,211,19.5,2018,0.0
Amorie Archibald,1208,391,1035,404,304,231,3396.0,493,169,216.0,542,235,20.7,2018,0.0
Jy'lan Washington,661,69,445,222,211,144,2005.0,191,73,105.0,254,149,16.1,2018,0.0
Jalen Harris,1113,186,852,384,277,232,1885.0,315,113,142.0,537,271,29.7,2018,0.0
Exavian Christon,370,78,328,126,74,61,1487.0,185,57,64.0,143,69,14.5,2018,0.0
Joniah White,259,39,178,99,114,61,1181.0,0,0,55.0,178,99,12.1,2018,0.0
JaColby Pemberton,796,131,592,269,280,190,2499.0,229,68,148.0,363,201,17.6,2018,0.0
Jeremiah Taylor,12,3,16,4,2,1,62.0,12,3,2.0,4,1,15.4,2018,0.0
Kyle McKinley,8,0,10,3,10,2,44.0,0,0,1.0,10,3,18.1,2018,0.0
Harrison Curry,160,2,139,61,53,35,388.0,21,3,25.0,118,58,24.3,2018,0.0
Deng Adel,998,178,799,350,254,197,2386.0,290,101,148.0,509,249,22.3,2018,1.0
Raymond Spalding,813,89,596,332,247,143,2173.0,25,6,131.0,571,326,19.4,2018,0.0
Quentin Snider,1207,415,1049,407,277,209,3482.0,482,184,166.0,567,223,19.4,2018,0.0
V.J. King,616,67,525,210,197,152,1795.0,148,44,98.0,377,166,20.1,2018,0.0
Anas Mahmoud,527,85,407,227,155,73,1945.0,0,0,112.0,407,227,15.2,2018,0.0
Ryan McMahon,765,178,561,223,150,137,2047.0,461,182,111.0,100,41,18.4,2018,0.0
Jordan Nwora,1294,95,986,439,303,238,2446.0,452,178,168.0,534,261,27.1,2018,0.0
Dwayne Sutton,1183,182,852,394,413,279,3630.0,338,116,156.0,514,278,16.7,2018,0.0
Darius Perry,761,248,622,249,168,141,2259.0,329,122,171.0,293,127,19.8,2018,0.0
Malik Williams,619,26,488,214,198,132,1505.0,188,59,63.0,300,155,21.9,2018,0.0
Lance Thomas,179,13,155,65,38,28,570.0,79,21,29.0,76,44,17.1,2018,1.0
Jacob Redding,19,0,8,6,2,2,25.0,7,5,0.0,1,1,18.2,2018,0.0
Jo Griffin,4,3,5,2,0,0,41.0,2,0,2.0,3,2,8.7,2018,0.0
Clayton Custer,1199,332,902,425,218,167,3299.0,444,182,193.0,458,243,20.3,2018,0.0
Marques Townes,1539,334,1185,581,368,262,3748.0,332,115,237.0,853,466,23.0,2018,0.0
Donte Ingram,1235,147,981,448,231,164,3611.0,455,175,152.0,526,273,19.1,2018,0.0
Aundre Jackson,869,67,561,348,195,139,1484.0,86,34,113.0,475,314,28.4,2018,0.0
Cameron Krutwig,1833,373,1291,762,462,308,3713.0,7,1,272.0,1284,761,27.1,2018,0.0
Ben Richardson,761,307,612,260,117,85,3346.0,384,156,138.0,228,104,13.4,2018,0.0
Lucas Williamson,881,184,659,294,203,143,3081.0,405,150,146.0,254,144,16.4,2018,0.0
Bruno Skokna,377,87,326,127,95,72,1764.0,184,51,86.0,142,76,14.5,2018,0.0
Cameron Satterwhite,416,98,364,145,111,81,1497.0,146,45,104.0,218,100,18.5,2018,0.0
Adarius Avery,36,4,27,13,15,10,94.0,1,0,7.0,26,13,24.3,2018,0.0
Christian Negron,73,10,58,28,31,17,261.0,0,0,20.0,58,28,20.3,2018,0.0
Carson Shanks,462,48,350,171,197,118,1281.0,16,2,124.0,334,169,22.2,2018,0.0
Jake Baughman,17,2,13,5,10,5,92.0,6,2,4.0,7,3,13.3,2018,0.0
Nick DiNardi,4,0,6,2,0,0,22.0,0,0,1.0,6,2,17.6,2018,0.0
Dylan Boehm,0,2,1,0,0,0,11.0,0,0,0.0,1,0,5.1,2018,0.0
James Batemon,1091,261,763,341,398,323,2251.0,261,86,190.0,502,255,26.4,2018,0.0
Eli Scott,1498,358,1100,552,575,372,3501.0,85,22,312.0,1015,530,25.3,2018,0.0
Steven Haney,961,102,830,319,144,112,2464.0,567,211,91.0,263,108,20.1,2018,0.0
Mattias Markusson,886,57,584,350,254,185,2295.0,6,1,130.0,578,349,18.8,2018,0.0
Zafir Williams,377,52,329,155,67,49,1117.0,62,18,53.0,267,137,19.2,2018,0.0
Cam Allen,483,134,481,176,100,66,1512.0,186,65,101.0,295,111,21.1,2018,0.0
Jeffery McClendon,396,134,380,140,121,79,2026.0,129,37,109.0,251,103,13.8,2018,0.0
Erik Johansson,440,71,376,139,60,50,1764.0,317,112,61.0,59,27,13.9,2018,0.0
Donald Gipson,73,24,100,29,10,6,324.0,49,9,21.0,51,20,19.8,2018,0.0
Joe Quintana,458,110,375,139,103,84,1637.0,254,96,83.0,121,43,16.2,2018,0.0
Mikail Simmons,152,21,137,51,37,22,484.0,97,28,31.0,40,23,18.6,2018,0.0
Petr Herman,360,41,307,149,93,55,1186.0,23,7,73.0,284,142,18.5,2018,0.0
Dylan Causwell,2,0,2,0,4,2,10.0,1,0,0.0,1,0,19.5,2018,0.0
Andre Walker,1682,393,1520,546,486,376,3814.0,618,214,342.0,902,332,28.1,2018,0.0
Cam Gregory,1019,83,684,398,385,222,3074.0,8,1,162.0,676,397,17.2,2018,0.0
Isaiah Hart,1052,305,864,387,315,218,3004.0,192,60,250.0,672,327,21.1,2018,0.0
Chuck Champion,920,155,913,350,185,129,2800.0,313,91,178.0,600,259,21.2,2018,0.0
Andrew Kostecka,1751,232,1210,602,499,400,3353.0,406,147,232.0,804,455,25.1,2018,0.0
Brent Holcombe,391,52,350,152,85,51,1159.0,139,36,83.0,211,116,20.5,2018,0.0
KaVaughn Scott,623,77,410,228,298,165,1917.0,13,2,148.0,397,226,18.3,2018,0.0
Sam Norton,129,63,126,43,42,31,976.0,39,12,46.0,87,31,9.9,2018,0.0
James Fives,361,46,291,95,170,120,1531.0,152,51,86.0,139,44,15.1,2018,0.0
Luke Johnson,127,25,111,53,24,16,693.0,22,5,18.0,89,48,10.2,2018,0.0
River Reed,36,6,23,14,16,8,135.0,2,0,5.0,21,14,13.1,2018,0.0
Ian Langendoerfer,47,9,55,14,23,14,280.0,26,5,23.0,29,9,16.0,2018,0.0
Nevell Provo,72,38,102,26,8,5,501.0,70,15,30.0,32,11,13.7,2018,0.0
Matt Staubi,59,63,61,19,13,10,404.0,35,11,44.0,26,8,14.0,2018,0.0
Ethan Norton,9,4,10,3,7,3,46.0,4,0,3.0,6,3,17.8,2018,0.0
Aaron Calixte,1349,365,1104,480,273,236,3653.0,439,153,360.0,665,327,21.6,2018,0.0
Andrew Fleming,1414,238,1188,549,396,253,3689.0,209,63,295.0,979,486,23.5,2018,0.0
Isaiah White,1013,122,900,378,172,127,2498.0,395,130,145.0,505,248,23.6,2018,0.0
Ilker Er,332,16,344,120,48,34,737.0,197,58,30.0,147,62,26.7,2018,0.0
Vernon Lowndes Jr.,189,16,142,68,56,38,466.0,48,15,51.0,94,53,23.2,2018,0.0
Ilija Stojiljkovic,382,132,348,145,102,54,1920.0,138,38,151.0,210,107,14.1,2018,0.0
Dennis Ashley,367,72,355,121,71,49,1285.0,233,76,58.0,122,45,17.6,2018,0.0
Danny Evans,244,55,216,87,39,27,1065.0,126,43,71.0,90,44,14.3,2018,0.0
Dusan Majstorovic,107,19,123,37,22,18,465.0,72,15,23.0,51,22,16.7,2018,0.0
Miks Antoms,155,75,140,57,91,41,774.0,3,0,68.0,137,57,16.8,2018,0.0
Celio Araujo,74,88,62,19,34,26,824.0,36,10,51.0,26,9,8.0,2018,0.0
Trae Bryant,90,33,95,29,20,16,414.0,62,16,29.0,33,13,15.8,2018,0.0
Garvey Melmed,68,21,80,23,11,5,516.0,69,17,17.0,11,6,10.1,2018,0.0
Duncan Douglas,0,0,2,0,0,0,19.0,2,0,1.0,0,0,7.8,2018,0.0
Rich Williams,1187,160,989,434,238,180,2693.0,372,139,228.0,617,295,25.4,2018,0.0
Zane Waterman,1275,76,916,431,406,292,2730.0,344,121,212.0,572,310,24.5,2018,0.0
Zavier Turner,1404,435,1017,396,503,420,3595.0,494,192,381.0,523,204,23.1,2018,0.0
Pauly Paulicap,852,16,617,321,363,210,1956.0,0,0,133.0,617,321,24.3,2018,0.0
Calvin Crawford,847,88,723,316,172,130,2356.0,253,85,170.0,470,231,21.0,2018,0.0
Aaron Walker,473,99,408,163,178,111,1057.0,121,36,120.0,287,127,28.8,2018,0.0
Thomas Capuano,660,194,594,242,87,54,3055.0,325,122,132.0,269,120,13.0,2018,0.0
Patrick Strzala,60,9,55,18,7,7,215.0,44,17,12.0,11,1,16.9,2018,0.0
Nehemiah Mack,355,193,284,106,98,80,2036.0,175,63,94.0,109,43,11.1,2018,0.0
Ebube Ebube,214,39,197,89,44,19,1048.0,58,17,55.0,139,72,14.0,2018,0.0
Ibrahima Diallo,100,10,104,42,38,16,514.0,0,0,33.0,104,42,15.3,2018,0.0
Jesse Boyce,0,0,3,0,0,0,7.0,1,0,0.0,2,0,22.6,2018,0.0
Matt Maloney,13,0,15,4,4,2,86.0,13,3,4.0,2,1,12.8,2018,1.0
Kevin Salis,0,0,0,0,0,0,2.0,0,0,0.0,0,0,0.0,2018,0.0
David Varoli,0,0,1,0,0,0,4.0,1,0,0.0,0,0,13.0,2018,0.0
Brian Parker,1822,386,1304,629,741,500,3683.0,193,64,410.0,1111,565,29.3,2018,0.0
Ryan Funk,1195,57,916,379,209,173,3098.0,684,264,88.0,232,115,18.6,2018,0.0
David Knudsen,803,131,693,279,118,94,2420.0,434,151,123.0,259,128,18.8,2018,0.0
Isaiah Lamb,889,73,755,304,252,168,2709.0,355,113,135.0,400,191,19.5,2018,0.0
Aleksandar Dozic,460,123,409,173,68,48,1387.0,206,66,103.0,203,107,20.4,2018,0.0
Tobias Sjoberg,383,114,260,157,110,69,2023.0,0,0,140.0,260,157,11.7,2018,0.0
Lasse Gummerus,141,13,109,47,18,16,416.0,83,31,12.0,26,16,15.8,2018,0.0
Connor McClenaghan,197,38,179,67,75,44,857.0,63,19,67.0,116,48,17.2,2018,0.0
Andrea Bernardi,44,6,30,10,26,20,127.0,16,4,20.0,14,6,24.9,2018,0.0
Kristinn Palsson,412,88,371,135,54,36,1826.0,314,106,76.0,57,29,13.4,2018,0.0
Ryan Carmello,13,4,9,5,10,3,45.0,1,0,4.0,8,5,20.7,2018,0.0
Michael Servetas,2,0,3,1,0,0,14.0,0,0,0.0,3,1,10.8,2018,0.0
Tucker Lee,0,0,5,0,0,0,25.0,4,0,1.0,1,0,12.8,2018,0.0
Andrew Rowsey,2331,425,1645,693,606,541,3976.0,989,404,313.0,656,289,28.1,2018,0.0
Markus Howard,2761,392,1945,864,679,599,3853.0,1017,434,380.0,928,430,34.2,2018,0.0
Sam Hauser,1682,269,1223,591,217,191,3978.0,704,309,136.0,519,282,19.2,2018,0.0
Sacar Anim,962,143,814,362,245,152,3058.0,233,86,144.0,581,276,17.4,2018,0.0
Greg Elliott,447,100,313,149,113,89,1585.0,142,60,78.0,171,89,14.1,2018,0.0
Jamal Cain,619,77,510,235,99,62,2191.0,231,87,117.0,279,148,15.5,2018,0.0
Matt Heldt,245,36,143,92,87,61,1446.0,0,0,39.0,143,92,7.8,2018,0.0
Theo John,684,79,454,261,273,159,2395.0,4,3,153.0,450,258,15.4,2018,0.0
Harry Froling,99,26,93,43,15,6,394.0,29,7,30.0,64,36,17.0,2018,0.0
Haanif Cheatham,1261,221,943,441,396,292,3221.0,243,87,214.0,700,354,20.6,2018,0.0
Mike Lelito,0,0,2,0,0,0,6.0,2,0,0.0,0,0,16.7,2018,0.0
Cam Marotta,9,3,12,2,4,3,52.0,7,2,4.0,5,0,17.2,2018,0.0
Jon Elmore,2638,783,1952,798,849,686,4806.0,1001,356,419.0,951,442,27.0,2018,0.0
C.J. Burks,1892,334,1495,706,332,266,3879.0,599,214,310.0,896,492,23.7,2018,0.0
Ajdin Penava,781,89,522,281,231,175,1652.0,151,44,108.0,371,237,21.1,2018,0.0
Jarrod West,1204,424,1023,418,220,148,4096.0,581,220,212.0,442,198,15.5,2018,0.0
Rondale Watson,554,134,471,200,155,104,1869.0,162,50,87.0,309,150,16.1,2018,0.0
Jannson Williams,943,47,771,324,177,123,2671.0,513,172,89.0,258,152,16.7,2018,0.0
Darius George,589,38,429,219,159,89,1638.0,190,62,73.0,239,157,16.7,2018,0.0
Phil Bledsoe,99,5,83,35,27,19,254.0,30,10,8.0,53,25,19.2,2018,0.0
Dani Koljanin,131,18,135,50,28,16,579.0,67,15,17.0,68,35,13.9,2018,0.0
Milan Mijovic,141,26,103,53,60,34,755.0,2,1,48.0,101,52,11.2,2018,0.0
Ot Elmore,77,31,88,24,10,8,401.0,73,21,12.0,15,3,13.0,2018,0.0
Christian Thieneman,53,5,46,15,24,14,282.0,32,9,9.0,14,6,11.0,2018,0.0
Marcus Reed,1,3,2,0,2,1,9.0,2,0,0.0,0,0,15.6,2018,0.0
Will Fenton,0,0,0,0,0,0,4.0,0,0,0.0,0,0,0.0,2018,0.0
Christian Villers,0,0,2,0,0,0,5.0,1,0,0.0,1,0,19.0,2018,0.0
Jairus Lyles,1764,264,1367,607,525,388,3078.0,460,162,240.0,907,445,30.4,2018,0.0
Joe Sherburne,1563,255,1252,577,174,143,4244.0,669,266,164.0,583,311,18.2,2018,0.0
K.J. Maura,700,337,512,228,152,134,2426.0,266,110,137.0,246,118,15.1,2018,0.0
Arkel Lamar,862,98,789,306,198,118,2565.0,387,132,107.0,402,174,20.1,2018,0.0
Jourdan Grant,978,349,772,328,420,252,3348.0,220,70,273.0,552,258,19.4,2018,0.0
Max Curran,306,18,244,108,101,65,872.0,113,25,57.0,131,83,20.7,2018,0.0
Daniel Akin,482,42,316,184,263,114,1824.0,0,0,110.0,316,184,15.7,2018,0.0
Brandon Horvath,986,110,749,344,316,203,2637.0,298,95,138.0,451,249,20.6,2018,0.0
Nolan Gerrity,355,53,287,156,105,43,1364.0,0,0,77.0,287,156,15.3,2018,0.0
Max Portmann,86,3,68,33,28,18,229.0,5,2,16.0,63,31,21.6,2018,0.0
Ishmail Jabbie,94,13,67,29,38,27,277.0,24,9,21.0,43,20,19.4,2018,0.0
Josh Rosario,36,17,43,10,15,11,161.0,24,5,18.0,19,5,22.0,2018,0.0
David Park,2,0,1,1,0,0,5.0,0,0,0.0,1,1,10.2,2018,0.0
Isiah Rogers,7,0,6,3,0,0,15.0,4,1,3.0,2,2,31.9,2018,0.0
Sam Schwietz,154,32,104,65,58,24,878.0,1,0,33.0,103,65,9.7,2018,0.0
Tyler Jones,886,44,781,336,214,150,2186.0,233,64,126.0,548,272,23.7,2018,0.0
Ahmad Frost,783,201,821,278,125,82,2760.0,487,145,175.0,334,133,19.6,2018,0.0
Logan McIntosh,637,281,538,214,239,167,2052.0,139,42,161.0,399,172,20.0,2018,0.0
Miryne Thomas,522,53,399,180,183,122,1326.0,129,40,125.0,270,140,23.2,2018,0.0
Cameron Bacote,354,100,347,127,46,35,1398.0,203,65,71.0,144,62,16.4,2018,0.0
Colen Gaynor,208,15,187,78,58,33,817.0,68,19,46.0,119,59,16.5,2018,0.0
LeAndre Thomas,99,3,102,39,41,21,454.0,0,0,28.0,102,39,16.7,2018,0.0
Sean Hoggs,88,14,95,29,13,8,442.0,74,22,18.0,21,7,13.7,2018,0.0
Montraz Oliver,92,15,96,30,34,25,369.0,35,7,19.0,61,23,19.0,2018,0.0
Micheal Odiana,8,2,10,3,0,0,65.0,7,2,2.0,3,1,9.4,2018,0.0
Najee Fitzgerald,7,3,5,2,5,3,98.0,1,0,5.0,4,2,6.4,2018,0.0
Anthony Cowan,1881,584,1354,548,714,579,4395.0,610,206,328.0,744,342,23.7,2018,0.0
Kevin Huerter,779,196,586,273,127,95,2072.0,350,138,126.0,236,135,19.3,2018,1.0
Bruno Fernando,770,89,489,291,241,184,1692.0,13,4,148.0,476,287,23.1,2018,1.0
Darryl Morsell,1090,277,920,414,303,212,3542.0,187,50,250.0,733,364,19.5,2018,0.0
Michal Cekovsky,454,27,306,190,142,74,1325.0,2,0,76.0,304,190,17.8,2018,0.0
Jared Nickens,671,49,598,224,59,44,2219.0,479,179,59.0,119,45,16.3,2018,0.0
Dion Wiley,488,63,447,164,82,54,1689.0,315,106,77.0,132,58,17.4,2018,0.0
Justin Jackson,455,52,368,154,125,91,1240.0,145,56,86.0,223,98,21.2,2018,1.0
Joshua Tomaic,211,25,148,81,58,37,809.0,41,12,37.0,107,69,13.7,2018,0.0
Ivan Bender,230,58,147,92,74,45,779.0,4,1,69.0,143,91,16.6,2018,0.0
Sean Obi,376,26,258,152,132,72,945.0,0,0,68.0,258,152,22.5,2018,0.0
Reese Mona,37,21,17,11,26,13,257.0,6,2,11.0,11,9,8.4,2018,0.0
Travis Valmon,19,1,12,6,7,4,45.0,5,3,6.0,7,3,24.5,2018,0.0
Alex Tostado,6,3,5,2,3,2,29.0,2,0,3.0,3,2,17.0,2018,0.0
Andrew Terrell,5,4,8,2,2,0,46.0,6,1,0.0,2,1,10.1,2018,0.0
Jahad Thomas,1864,384,1327,735,577,370,3599.0,64,24,391.0,1263,711,27.7,2018,0.0
Matt Harris,1205,130,905,375,255,221,2902.0,612,234,163.0,293,141,20.5,2018,0.0
Ryan Jones,1148,282,902,396,279,201,3177.0,422,155,245.0,480,241,19.7,2018,0.0
Rinardo Perry,394,77,364,150,98,54,1219.0,144,40,66.0,220,110,19.2,2018,0.0
Josh Gantz,1013,271,793,380,178,134,3555.0,347,119,176.0,446,261,14.6,2018,0.0
Obadiah Noel,1616,240,1100,532,610,432,3185.0,335,120,262.0,765,412,26.0,2018,0.0
Shawn Jones,206,98,168,66,88,65,758.0,33,9,53.0,135,57,17.1,2018,0.0
Connor Bennett,117,11,73,48,31,21,355.0,0,0,16.0,73,48,14.4,2018,0.0
Stefan Borovac,100,26,83,35,52,26,419.0,21,4,42.0,62,31,17.5,2018,0.0
Joey Naccarato,25,3,15,5,19,14,68.0,6,1,4.0,9,4,20.3,2018,0.0
Dontavious Smith,119,24,94,50,33,19,377.0,1,0,48.0,93,50,20.3,2018,0.0
Luwane Pipkins,1752,422,1490,564,427,338,3622.0,828,286,296.0,662,278,27.6,2018,0.0
Carl Pierre,1353,154,1152,460,190,147,3554.0,745,286,103.0,407,174,19.3,2018,0.0
C.J. Anderson,644,324,532,224,176,134,2920.0,178,62,161.0,354,162,13.5,2018,0.0
Malik Hines,630,73,425,259,176,110,1903.0,5,2,136.0,420,257,17.3,2018,0.0
Unique McLean,848,189,773,336,174,123,2866.0,187,53,158.0,586,283,17.5,2018,0.0
Rayshawn Miller,237,103,252,88,27,17,1297.0,146,44,65.0,106,44,13.3,2018,0.0
Rashaan Holloway,937,51,609,387,307,163,1741.0,1,0,182.0,608,387,26.7,2018,0.0
Chris Baldwin,405,53,355,151,112,73,1306.0,99,30,99.0,256,121,18.7,2018,0.0
Khalea Turner-Morris,55,5,35,22,22,11,225.0,0,0,15.0,35,22,13.9,2018,0.0
Randall West,23,4,17,6,16,11,128.0,0,0,1.0,17,6,10.4,2018,0.0
Jaylen Franklin,5,5,10,2,0,0,41.0,6,1,1.0,4,1,14.1,2018,0.0
Mike Gillespie,2,0,1,0,2,2,6.0,1,0,0.0,0,0,17.1,2018,0.0
Kalob Ledoux,1421,101,1155,503,244,189,2892.0,590,226,204.0,565,277,24.9,2018,0.0
Jarren Greenwood,1134,290,937,359,399,311,3390.0,358,105,194.0,579,254,19.0,2018,0.0
Quatarrius Wilson,533,69,411,198,208,130,1505.0,37,7,113.0,374,191,20.2,2018,0.0
James Harvey,1247,120,1074,399,231,186,3270.0,768,263,155.0,306,136,20.1,2018,0.0
Jacob Ledoux,331,66,272,119,96,68,801.0,91,25,79.0,181,94,23.6,2018,0.0
Stephen Ugochukwu,706,63,601,262,270,172,1951.0,36,10,119.0,565,252,21.0,2018,0.0
LaBarrius Hill,208,26,145,81,67,45,960.0,4,1,48.0,141,80,11.2,2018,0.0
Richard Laku,135,9,127,43,31,23,406.0,82,26,17.0,45,17,18.8,2018,0.0
Demarco Owens,57,7,49,20,32,17,135.0,2,0,18.0,47,20,28.7,2018,0.0
Adrian Brown,197,16,167,73,83,49,729.0,4,2,45.0,163,71,16.8,2018,0.0
Myles Hutchinson,217,69,167,76,40,35,735.0,73,30,69.0,94,46,16.9,2018,0.0
Kelvin Henry Jr.,21,9,16,5,15,11,95.0,3,0,8.0,13,5,15.4,2018,0.0
Fred Haywood,16,0,13,7,5,2,28.0,1,0,0.0,12,7,25.9,2018,0.0
Jacob Bonnington,8,0,14,4,0,0,24.0,4,0,2.0,10,4,31.4,2018,0.0
Jeremiah Martin,1625,436,1173,517,596,444,3679.0,452,147,249.0,721,370,22.4,2018,1.0
Kyvon Davenport,921,63,641,324,305,197,1935.0,214,76,111.0,427,248,22.5,2018,0.0
Kareem Brewton Jr.,601,163,518,229,148,100,1633.0,158,43,137.0,360,186,21.7,2018,0.0
Mike Parks Jr.,481,29,354,203,116,72,1285.0,16,3,88.0,338,200,19.0,2018,0.0
Jamal Johnson,594,82,504,179,150,106,1937.0,366,130,70.0,138,49,16.2,2018,0.0
Jimario Rivers,418,90,309,162,137,89,1447.0,19,5,82.0,290,157,15.9,2018,0.0
Raynere Thornton,436,77,319,153,154,93,1640.0,103,37,92.0,216,116,14.2,2018,0.0
David Nickelberry,244,70,229,100,41,25,872.0,67,19,85.0,162,81,18.2,2018,0.0
Malik Rhodes,65,32,54,18,24,19,264.0,37,10,21.0,17,8,16.9,2018,0.0
Victor Enoh,124,11,83,43,67,38,662.0,0,0,41.0,83,43,12.3,2018,0.0
Karim Sameh Azab,15,5,21,7,3,1,84.0,0,0,4.0,21,7,16.2,2018,0.0
Jesse Johnson,0,0,0,0,0,0,2.0,0,0,0.0,0,0,0.0,2018,0.0
Alex Moffatt,4,0,8,2,0,0,32.0,2,0,4.0,6,2,18.6,2018,0.0
Evin Olds,9,0,3,1,6,6,18.0,2,1,2.0,1,0,19.9,2018,0.0
Jordan Strawberry,1200,494,1003,399,293,253,3320.0,407,149,219.0,596,250,21.8,2018,0.0
Demetre Rivers,1065,103,789,369,233,201,2794.0,354,126,174.0,435,243,20.3,2018,0.0
Stephon Jelks,1113,192,847,390,268,207,3123.0,338,126,146.0,509,264,19.0,2018,0.0
Ria'n Holland,899,113,675,299,192,162,1743.0,348,139,78.0,327,160,25.9,2018,0.0
Desmond Ringer,793,50,523,299,249,193,2517.0,5,2,163.0,518,297,16.8,2018,0.0
Ross Cummings,1244,166,919,401,247,196,2711.0,609,246,149.0,310,155,22.4,2018,0.0
Marcus Cohen,278,190,255,115,110,47,1104.0,9,1,123.0,246,114,20.2,2018,0.0
Cory Kilby,461,74,383,160,116,85,1754.0,186,56,84.0,197,104,15.5,2018,0.0
Ethan Stair,1171,172,910,427,230,176,3297.0,389,141,164.0,521,286,18.2,2018,0.0
Jaylen Stowe,501,68,365,179,181,121,1585.0,76,22,87.0,289,157,17.5,2018,0.0
Ryan Johnson,304,54,227,96,109,76,1097.0,107,36,49.0,120,60,16.2,2018,0.0
Mason Green,86,2,62,30,41,26,297.0,0,0,26.0,62,30,18.0,2018,0.0
Mac Brydon,11,1,4,3,7,5,37.0,0,0,1.0,4,3,11.9,2018,0.0
Lonnie Walker,368,61,318,132,65,48,888.0,162,56,37.0,156,76,22.4,2018,0.0
Dewan Hernandez,552,20,400,224,154,104,1382.0,5,0,74.0,395,224,20.6,2018,1.0
Chris Lykes,1256,251,1016,419,325,253,2611.0,476,165,208.0,540,254,27.2,2018,0.0
Dejan Vasiljevic,1271,98,1063,432,153,135,3380.0,742,272,83.0,321,160,18.6,2018,0.0
Ja'Quan Newton,1145,308,916,409,432,296,2953.0,103,31,264.0,813,378,24.8,2018,0.0
Anthony Lawrence Jr.,1043,258,790,360,256,181,3299.0,376,142,193.0,414,218,17.4,2018,0.0
Bruce Brown,607,182,480,212,191,134,1693.0,155,49,110.0,325,163,21.0,2018,1.0
Ebuka Izundu,676,50,443,282,174,111,1843.0,3,1,104.0,440,281,17.7,2018,0.0
Sam Waardenburg,415,86,340,141,120,87,1951.0,138,46,85.0,202,95,12.7,2018,0.0
Rodney Miller,250,14,187,105,78,40,856.0,1,0,27.0,186,105,15.1,2018,0.0
Mike Robinson,18,1,18,6,2,1,46.0,14,5,1.0,4,1,22.8,2018,0.0
Chris Stowell,1,1,4,0,2,1,43.0,3,0,1.0,1,0,7.3,2018,0.0
Nike Sibande,1560,155,1248,517,438,323,3245.0,593,203,242.0,655,314,26.5,2018,0.0
Darrian Ringo,556,387,425,183,193,144,1865.0,166,46,193.0,259,137,19.3,2018,0.0
Logan McLane,875,97,692,350,227,138,2362.0,133,37,155.0,559,313,20.7,2018,0.0
Jalen Adaway,762,82,597,300,169,119,2388.0,141,43,77.0,456,257,16.2,2018,0.0
Dalonte Brown,1229,65,998,432,286,217,2845.0,442,148,142.0,556,284,22.8,2018,0.0
Bam Bowman,704,53,553,255,172,119,1864.0,218,75,88.0,335,180,19.6,2018,0.0
Isaiah Coleman-Lands,648,198,552,218,101,76,2096.0,381,136,98.0,171,82,17.0,2018,0.0
Jake Wright,1002,66,823,326,98,86,3038.0,671,264,71.0,152,62,16.2,2018,0.0
Rod Mills,573,59,575,219,76,54,2034.0,258,81,109.0,317,138,18.1,2018,0.0
Precious Ayah,220,16,163,90,57,38,930.0,7,2,38.0,156,88,12.5,2018,0.0
Grant Pitman,10,0,4,3,2,1,10.0,3,3,0.0,1,0,25.3,2018,0.0
Darius Harper,91,2,92,41,29,9,383.0,0,0,33.0,92,41,17.9,2018,0.0
Michael Ritchie,17,2,24,5,7,3,50.0,12,4,6.0,12,1,33.8,2018,0.0
Miles Bridges,1055,150,821,386,201,156,1962.0,339,127,133.0,482,259,27.2,2018,1.0
Cassius Winston,1969,890,1405,648,490,414,3997.0,602,259,374.0,803,389,25.5,2018,0.0
Nick Ward,1359,55,837,506,547,344,2064.0,3,3,185.0,834,503,31.7,2018,0.0
Joshua Langford,1109,170,948,409,185,146,2810.0,372,145,160.0,576,264,21.5,2018,0.0
Jaren Jackson Jr.,382,39,232,119,133,106,764.0,96,38,62.0,136,81,23.5,2018,1.0
Matt McQuaid,877,217,722,289,133,105,3114.0,492,194,114.0,230,95,14.7,2018,0.0
Gavin Schilling,442,51,296,172,181,98,1527.0,0,0,96.0,296,172,16.4,2018,0.0
Xavier Tillman,913,167,598,348,282,196,2235.0,77,21,135.0,521,327,19.5,2018,0.0
Kenny Goins,544,167,440,204,113,76,2521.0,178,60,126.0,262,144,12.5,2018,0.0
Lourawls Nairn Jr.,346,415,344,136,102,51,2666.0,79,23,130.0,265,113,10.2,2018,0.0
Ben Carter,357,93,258,121,153,115,1407.0,4,0,86.0,254,121,14.3,2018,0.0
Conner George,37,3,41,13,17,9,144.0,16,2,7.0,25,11,19.6,2018,0.0
Moritz Wagner,1114,57,770,421,232,162,2244.0,286,110,126.0,484,311,24.7,2018,1.0
Charles Matthews,1007,160,821,381,314,181,2674.0,208,64,160.0,613,317,22.8,2018,0.0
Muhammad-Ali Abdur-Rahkman,1313,295,1051,467,293,221,4147.0,432,158,125.0,619,309,17.5,2018,0.0
Duncan Robinson,1072,142,785,357,140,121,2863.0,565,237,80.0,220,120,17.8,2018,1.0
Zavier Simpson,1073,667,901,410,273,161,3679.0,293,92,250.0,608,318,18.6,2018,0.0
Jordan Poole,705,102,544,236,142,118,1700.0,311,115,82.0,233,121,22.2,2018,1.0
Jon Teske,856,85,659,330,249,157,2464.0,144,39,81.0,515,291,18.5,2018,0.0
Isaiah Livers,987,110,744,346,153,131,2785.0,398,164,90.0,346,182,17.3,2018,0.0
Ibi Watson,771,95,578,269,147,114,1809.0,315,119,80.0,263,150,21.8,2018,0.0
Eli Brooks,722,213,653,261,109,86,2586.0,328,114,97.0,325,147,16.3,2018,0.0
Jaaron Simmons,1149,547,879,386,403,301,3009.0,211,76,308.0,668,310,23.1,2018,0.0
Austin Davis,286,11,186,128,57,30,656.0,0,0,46.0,186,128,20.7,2018,0.0
Brent Hibbitts,12,3,7,4,2,2,37.0,3,2,3.0,4,2,16.3,2018,0.0
C.J. Baird,24,2,23,8,4,3,71.0,15,5,3.0,8,3,20.9,2018,0.0
Naji Ozeir,2,0,2,1,0,0,7.0,0,0,0.0,2,1,15.5,2018,0.0
Rico Ozuna-Harrison,2,2,5,1,0,0,17.0,2,0,2.0,3,1,21.9,2018,0.0
Luke Wilson,3,2,11,1,1,0,39.0,8,1,3.0,3,0,19.7,2018,0.0
Nick King,1085,108,845,400,348,229,2080.0,161,56,148.0,684,344,28.2,2018,0.0
Giddy Potts,1645,202,1245,557,305,245,3610.0,686,286,172.0,559,271,22.5,2018,0.0
Brandon Walters,512,25,334,212,122,87,1110.0,6,1,73.0,328,211,21.6,2018,0.0
Antwain Johnson,835,140,701,277,236,186,2057.0,298,95,104.0,403,182,21.7,2018,0.0
Tyrik Dixon,684,333,592,236,170,122,2553.0,245,90,162.0,347,146,16.4,2018,0.0
David Simmons,149,51,103,54,55,35,573.0,19,6,37.0,84,48,14.8,2018,0.0
Karl Gamble,449,32,389,173,151,83,1552.0,58,20,79.0,331,153,17.3,2018,0.0
Edward Simpson Jr.,458,204,419,156,82,40,2635.0,292,106,86.0,127,50,10.8,2018,0.0
James Hawthorne,295,42,262,110,79,58,1004.0,62,17,87.0,200,93,19.0,2018,0.0
Donovan Sims,746,249,659,258,145,108,2404.0,354,122,190.0,305,136,18.7,2018,0.0
Therren Shelton-Szmidt,35,9,39,13,1,0,133.0,26,9,10.0,13,4,19.0,2018,0.0
Davion Thomas,189,13,180,67,53,36,597.0,69,19,34.0,111,48,19.6,2018,0.0
Chase Miller,9,1,22,3,2,0,51.0,18,3,1.0,4,0,23.5,2018,0.0
Will Slatten,0,0,1,0,0,0,3.0,0,0,0.0,1,0,17.0,2018,0.0
Jeremiah Bell,973,181,852,342,206,141,2620.0,426,148,126.0,426,194,21.8,2018,0.0
Brock Stull,1007,237,858,354,198,153,2879.0,383,146,175.0,475,208,20.9,2018,0.0
Bryce Nze,1121,157,807,470,310,151,3204.0,79,30,226.0,728,440,19.9,2018,0.0
Brett Prahl,637,66,409,261,172,111,1948.0,21,4,117.0,388,257,16.6,2018,0.0
Bryce Barnes,754,247,671,267,224,157,2549.0,188,63,199.0,483,204,20.1,2018,0.0
Carson Warren-Newsome,271,46,237,90,71,58,723.0,118,33,39.0,119,57,22.2,2018,0.0
Vance Johnson,465,36,352,167,145,116,1132.0,50,15,75.0,302,152,22.6,2018,0.0
August Haas,299,223,287,110,88,47,1612.0,111,32,125.0,176,78,15.2,2018,0.0
Jeremy Johnson,293,51,271,103,58,47,1014.0,135,40,41.0,136,63,18.1,2018,0.0
Sam Burkart,3,0,3,1,0,0,10.0,1,1,0.0,2,0,15.7,2018,0.0
Alex Prahl,18,2,12,5,14,8,145.0,0,0,6.0,12,5,9.0,2018,0.0
Seth Dittmer,2,0,1,0,2,2,14.0,1,0,0.0,0,0,7.5,2018,0.0
Jordan Murphy,1802,189,1322,655,698,460,3895.0,138,32,273.0,1184,623,24.7,2018,0.0
Nate Mason,1731,512,1493,582,466,355,3981.0,584,212,194.0,909,370,23.9,2018,0.0
Isaiah Washington,935,342,885,339,222,171,2560.0,305,86,203.0,580,253,23.4,2018,0.0
Dupree McBrayer,1100,332,939,355,383,263,3451.0,392,127,159.0,547,228,18.5,2018,0.0
Amir Coffey,1255,277,929,416,448,329,2933.0,287,94,182.0,642,322,22.5,2018,1.0
Reggie Lynch,1036,52,717,393,391,250,2606.0,0,0,181.0,717,393,21.1,2018,0.0
Davonte Fitzgerald,715,36,671,264,179,108,1805.0,264,79,88.0,407,185,24.0,2018,0.0
Jamir Harris,641,106,517,208,113,93,1732.0,333,132,93.0,184,76,19.7,2018,0.0
Michael Hurt,203,60,169,72,63,42,1219.0,62,17,52.0,107,55,10.2,2018,0.0
Bakary Konate,306,30,223,113,128,80,1617.0,2,0,85.0,221,113,11.5,2018,0.0
Gaston Diedhiou,54,5,57,23,16,8,361.0,5,0,12.0,52,23,10.6,2018,0.0
Hunt Conroy,3,0,3,1,2,1,10.0,2,0,0.0,1,1,19.6,2018,0.0
Brady Rudrud,11,3,14,4,2,1,39.0,9,2,5.0,5,2,25.5,2018,0.0
Quinndary Weatherspoon,2012,315,1471,706,524,413,4081.0,508,187,307.0,963,519,24.8,2018,1.0
Aric Holman,1035,98,754,384,249,171,2622.0,251,96,169.0,503,288,19.9,2018,0.0
Nick Weatherspoon,863,216,691,322,217,165,2323.0,172,54,129.0,519,268,20.0,2018,1.0
Tyson Carter,1352,216,1116,465,244,206,3250.0,624,216,149.0,492,249,21.3,2018,0.0
Lamar Peters,1054,429,930,358,211,144,2701.0,561,194,259.0,369,164,23.9,2018,0.0
Abdul Ado,800,70,520,309,309,182,3489.0,0,0,197.0,520,309,12.5,2018,0.0
Xavian Stapleton,957,53,793,340,187,136,2158.0,421,141,108.0,372,199,23.0,2018,0.0
Eli Wright,207,37,170,77,53,36,861.0,55,17,37.0,115,60,13.5,2018,0.0
E.J. Datcher,102,5,77,39,35,23,481.0,2,1,22.0,75,38,12.1,2018,0.0
KeyShawn Feazell,360,56,280,145,88,63,1146.0,35,7,97.0,245,138,17.7,2018,0.0
Nick Singleton,22,1,14,9,1,0,25.0,7,4,2.0,7,5,33.3,2018,0.0
Schnider Herard,174,7,117,60,110,54,683.0,0,0,59.0,117,60,16.7,2018,0.0
Drew Davis,14,4,17,5,2,1,29.0,8,3,4.0,9,2,38.0,2018,0.0
T.J. Gray,8,0,10,3,0,0,23.0,6,2,5.0,4,1,32.7,2018,0.0
Tate Clayton,2,1,1,1,0,0,19.0,0,0,0.0,1,1,2.6,2018,0.0
Mitchell Storm,2,0,7,1,0,0,39.0,3,0,1.0,4,1,10.3,2018,0.0
Jordan Evans,884,124,817,291,255,191,1856.0,319,111,117.0,498,180,27.6,2018,0.0
Dante Scott,871,113,777,307,234,174,1960.0,238,83,126.0,539,224,25.1,2018,0.0
Gemaal Davis,165,15,152,55,67,47,416.0,23,8,24.0,129,47,24.3,2018,0.0
Emmanuel Ejeh,350,46,300,137,116,74,1229.0,10,2,61.0,290,135,16.5,2018,0.0
Lorenzo Hunt,188,27,190,71,70,38,829.0,28,8,39.0,162,63,15.2,2018,0.0
Nate Nahimy,127,41,141,48,25,16,578.0,67,15,33.0,74,33,15.6,2018,0.0
Arinze Anakwenze,119,15,108,52,32,15,525.0,4,0,32.0,104,52,14.4,2018,0.0
Kylan Phillips,337,142,427,121,83,58,1926.0,144,37,110.0,283,84,14.5,2018,0.0
Tereke Eckwood,203,70,200,67,84,59,764.0,50,10,67.0,150,57,19.5,2018,0.0
Jeffery Lewis,68,12,89,25,4,2,283.0,65,16,22.0,24,9,19.4,2018,0.0
Davere Creighton,65,5,71,19,31,19,210.0,38,8,11.0,33,11,22.4,2018,0.0
LaCurtis Allen,100,16,75,38,44,23,588.0,1,1,25.0,74,37,10.0,2018,0.0
Henry Taylor,34,10,34,11,11,7,145.0,22,5,13.0,12,6,17.5,2018,0.0
Kaleb Allison,96,3,91,42,37,12,360.0,0,0,33.0,91,42,19.1,2018,0.0
Jamal Watson,77,15,89,34,27,9,400.0,0,0,23.0,89,34,15.0,2018,0.0
Marcus Roberts,2,0,4,1,2,0,12.0,0,0,2.0,4,1,16.0,2018,0.0
Terence Davis,1512,249,1234,549,332,238,2941.0,519,176,242.0,715,373,27.0,2018,1.0
Deandre Burnett,1158,243,879,319,437,364,2354.0,443,156,184.0,436,163,26.3,2018,0.0
Breein Tyree,1797,325,1433,603,488,384,3648.0,581,207,285.0,852,396,26.6,2018,0.0
Bruce Stevens,625,63,447,228,162,128,1388.0,134,41,70.0,313,187,21.2,2018,0.0
Markel Crawford,1056,229,869,380,268,196,3364.0,339,100,146.0,530,280,16.6,2018,0.0
Devontae Shuler,1319,329,1154,477,258,187,3610.0,523,178,210.0,631,299,20.8,2018,0.0
Marcanvis Hymon,469,63,360,192,178,85,2022.0,0,0,89.0,360,192,12.6,2018,0.0
Dominik Olejniczak,632,50,445,271,129,90,1855.0,0,0,124.0,445,271,17.3,2018,0.0
Justas Furmanavicius,326,50,230,106,143,91,1439.0,70,23,51.0,160,83,11.4,2018,0.0
D.C. Davis,77,26,58,24,30,21,417.0,29,8,13.0,29,16,10.4,2018,0.0
Lane Below,2,0,2,1,0,0,11.0,0,0,0.0,2,1,8.5,2018,0.0
Eric Horn,0,0,0,0,0,0,1.0,0,0,0.0,0,0,0.0,2018,0.0
Antonio Morgano,2,0,2,1,0,0,6.0,1,0,1.0,1,1,25.0,2018,0.0
Ilya Tyrtyshnik,0,0,3,0,0,0,5.0,2,0,1.0,1,0,38.7,2018,0.0
Xavier Bishop,1361,380,1114,447,405,311,3322.0,462,156,260.0,652,291,23.8,2018,0.0
Isaiah Ross,1288,109,1007,429,230,181,2909.0,657,249,166.0,350,180,22.0,2018,0.0
Broderick Robinson,508,119,424,163,118,81,1774.0,269,101,95.0,155,62,15.9,2018,0.0
Jordan Giles,936,117,663,311,341,260,2321.0,184,54,208.0,479,257,22.9,2018,0.0
Brandon McKissic,1178,251,931,451,270,164,2988.0,291,112,192.0,640,339,22.0,2018,0.0
Aleer Leek,352,13,326,121,106,72,1613.0,121,38,99.0,205,83,14.8,2018,0.0
Marco Smith,234,43,217,93,46,32,823.0,62,16,52.0,155,77,17.6,2018,0.0
Marvin Nesbitt Jr.,538,107,428,203,134,86,1730.0,125,46,97.0,303,157,17.9,2018,0.0
Tony Jackson,71,8,64,24,12,7,265.0,48,16,10.0,16,8,15.0,2018,1.0
Robert Knar,81,21,66,28,21,17,307.0,25,8,8.0,41,20,14.1,2018,0.0
Steve Dulley,84,6,82,27,33,20,247.0,44,10,11.0,38,17,22.2,2018,0.0
Mo Ahmed,33,0,28,13,14,7,135.0,0,0,8.0,28,13,15.8,2018,0.0
Alize Johnson,982,157,746,341,306,219,2025.0,249,81,150.0,497,260,26.4,2018,1.0
Jarrid Rhodes,588,68,487,209,81,67,1740.0,261,103,75.0,226,106,17.7,2018,0.0
Jarred Dixon,1245,229,1083,458,294,225,3430.0,313,104,154.0,770,354,20.8,2018,0.0
J.T. Miller,255,40,224,106,49,32,658.0,37,11,52.0,187,95,23.3,2018,0.0
Obediah Church,692,150,455,286,247,119,2709.0,8,1,162.0,447,285,13.9,2018,0.0
Reggie Scurry,724,49,511,282,234,156,1691.0,16,4,111.0,495,278,21.4,2018,0.0
Ryan Kreklow,820,145,666,256,171,140,2716.0,457,168,156.0,209,88,17.2,2018,0.0
Ronnie Rousseau III,302,82,266,109,71,49,961.0,106,35,54.0,160,74,18.9,2018,0.0
Mustafa Lawrence,329,107,299,107,70,54,961.0,187,61,67.0,112,46,21.1,2018,0.0
Tanveer Bhullar,327,42,249,130,126,67,1018.0,2,0,68.0,247,130,18.7,2018,0.0
Ross Owens,87,35,93,31,10,5,434.0,75,20,18.0,18,11,13.6,2018,0.0
Abdul Fofana,11,1,9,4,5,3,67.0,0,0,5.0,9,4,12.5,2018,0.0
Kassius Robertson,1773,255,1278,563,418,329,4074.0,771,318,232.0,507,245,21.1,2018,0.0
Jordan Barnett,773,59,599,262,144,122,1924.0,343,127,90.0,256,135,20.1,2018,0.0
Jontay Porter,326,74,238,104,104,78,808.0,110,40,63.0,128,64,22.5,2018,0.0
Kevin Puryear,1241,108,987,426,409,324,3295.0,213,65,197.0,774,361,21.2,2018,0.0
Jeremiah Tilmon,1021,67,709,407,355,206,2390.0,4,1,222.0,705,406,23.7,2018,0.0
Jordan Geist,942,255,701,294,316,234,2647.0,351,120,164.0,350,174,19.7,2018,0.0
Reed Nikko,391,37,264,154,135,83,1389.0,0,0,80.0,264,154,15.1,2018,0.0
Cullen VanLeer,378,96,372,130,39,25,1734.0,306,93,61.0,66,37,13.1,2018,0.0
Blake Harris,300,122,255,99,104,81,843.0,62,21,106.0,193,78,23.4,2018,0.0
Terrence Phillips,627,286,519,196,190,146,1931.0,259,89,172.0,260,107,20.2,2018,0.0
Michael Porter Jr.,30,1,30,10,9,7,53.0,10,3,3.0,20,7,36.5,2018,1.0
Brett Rau,10,2,10,4,3,1,57.0,3,1,5.0,7,3,14.9,2018,0.0
Adam Wolf,20,0,18,8,0,0,62.0,10,4,0.0,8,4,15.0,2018,0.0
Deion Hammond,1613,120,1362,539,355,263,3212.0,751,272,176.0,611,267,26.2,2018,0.0
Austin Tilghman,841,302,539,259,432,297,2778.0,86,26,222.0,453,233,17.2,2018,0.0
Ray Salnave,1266,267,991,390,467,371,2875.0,350,115,276.0,641,275,25.8,2018,0.0
Micah Seaborn,1144,177,937,380,248,210,2357.0,465,174,170.0,472,206,24.8,2018,0.0
Louie Pillari,605,67,518,208,128,99,1572.0,261,90,90.0,257,118,21.2,2018,0.0
Diago Quinn,751,17,534,266,321,219,2058.0,1,0,127.0,533,266,19.6,2018,0.0
Zac Tillman,591,52,452,228,203,135,1858.0,0,0,97.0,452,228,17.4,2018,0.0
Melik Martin,640,106,510,238,169,113,2122.0,143,51,124.0,367,187,16.5,2018,0.0
Mustapha Traore,616,74,526,248,190,120,2083.0,1,0,144.0,525,248,18.1,2018,0.0
Marcus McClary,520,104,411,195,173,112,2163.0,43,18,92.0,368,177,13.4,2018,0.0
Pierre Sarr,443,48,341,151,149,105,1365.0,122,36,104.0,219,115,18.7,2018,0.0
George Papas,643,123,513,193,163,133,1525.0,371,124,81.0,142,69,21.5,2018,0.0
Sam Ibiezugbe,144,5,139,60,49,24,713.0,0,0,29.0,139,60,13.2,2018,0.0
Daniel Pillari,39,5,33,8,26,19,105.0,21,4,10.0,12,4,25.3,2018,0.0
Tyler Hall,2518,316,1895,849,453,389,4160.0,1077,431,245.0,818,418,27.6,2018,0.0
Harald Frey,1890,514,1351,582,546,456,4267.0,717,270,255.0,634,312,21.9,2018,0.0
Keljin Blevins,890,122,800,319,321,207,2710.0,192,45,210.0,608,274,21.8,2018,0.0
Joe Mvuezolo Jr.,372,48,342,130,89,65,1088.0,135,47,73.0,207,83,20.4,2018,0.0
Devonte Klines,458,106,441,169,157,93,1494.0,107,27,102.0,334,142,20.1,2018,0.0
Konner Frey,654,58,490,223,198,144,1374.0,179,64,92.0,311,159,23.6,2018,0.0
Zach Green,856,140,685,300,315,216,2537.0,157,40,134.0,528,260,18.8,2018,0.0
Sam Neumann,552,137,336,175,212,148,2361.0,149,54,80.0,187,121,10.7,2018,0.0
Isaac Bonton,886,211,836,303,246,183,1864.0,304,97,201.0,532,206,30.6,2018,0.0
Benson Osayande,182,9,119,62,81,58,529.0,0,0,30.0,119,62,17.2,2018,0.0
Luke Schultz,17,0,8,5,14,7,49.0,0,0,5.0,8,5,19.4,2018,0.0
Lassi Nikkarinen,84,52,67,26,32,22,594.0,35,10,33.0,32,16,9.6,2018,0.0
Ahmaad Rorie,1803,430,1457,644,381,314,4115.0,563,201,204.0,894,443,22.7,2018,0.0
Michael Oguine,1647,235,1166,535,614,446,3876.0,380,131,199.0,786,404,21.9,2018,0.0
Jamar Akoh,922,118,658,336,397,246,2502.0,20,4,174.0,638,332,20.5,2018,0.0
Sayeed Pridgett,1679,286,1322,701,360,242,3541.0,116,35,297.0,1206,666,26.1,2018,0.0
Fabijan Krslovic,800,177,578,311,291,178,3215.0,8,0,175.0,570,311,14.4,2018,0.0
Bobby Moorehead,746,135,691,254,105,70,3276.0,497,168,112.0,194,86,13.3,2018,0.0
Timmy Falls,502,212,435,176,111,79,2144.0,189,71,154.0,246,105,15.5,2018,0.0
Joirdon Karl Nicholas,490,35,391,206,151,78,1128.0,1,0,94.0,390,206,23.7,2018,0.0
Admir Besovic,77,8,61,33,15,11,230.0,0,0,18.0,61,33,18.9,2018,0.0
Trevor Spoja,19,4,24,6,6,3,76.0,19,4,4.0,5,2,20.2,2018,0.0
Lars Espe,6,5,6,2,5,1,42.0,3,1,2.0,3,1,12.1,2018,0.0
Niko Bevens,3,1,4,1,0,0,24.0,3,1,1.0,1,0,10.2,2018,0.0
Peter Jones,0,0,1,0,0,0,12.0,0,0,1.0,1,0,4.4,2018,0.0
Jordan Walker,1478,273,1203,478,415,320,3526.0,581,202,241.0,622,276,22.9,2018,0.0
A.J. Hicks,714,312,552,212,355,228,1968.0,198,62,185.0,354,150,22.6,2018,0.0
Djimon Henson,849,89,790,293,161,118,2408.0,431,145,98.0,359,148,19.7,2018,0.0
Lamontray Harris,1084,119,870,415,240,190,2311.0,214,64,191.0,656,351,24.7,2018,0.0
Londell King,221,18,154,83,62,43,517.0,39,12,52.0,115,71,22.2,2018,0.0
Malek Green,615,32,472,243,160,105,1668.0,75,24,74.0,397,219,18.3,2018,0.0
DeVon Cooper,861,171,723,288,201,152,2570.0,375,133,169.0,348,155,19.3,2018,0.0
James Baker,846,78,705,320,215,135,2742.0,230,71,152.0,475,249,17.6,2018,0.0
Alonzo Chatman,64,8,42,25,28,14,317.0,0,0,31.0,42,25,13.2,2018,0.0
Trell Thompson,49,6,53,19,5,3,164.0,30,8,11.0,23,11,19.7,2018,0.0
Richard Feagin,40,19,39,15,5,4,191.0,17,6,14.0,22,9,14.2,2018,0.0
Cedric Wright,13,0,9,6,3,1,36.0,0,0,4.0,9,6,19.5,2018,0.0
Austin Crawford,4,0,7,1,2,1,17.0,4,1,1.0,3,0,25.6,2018,0.0
Tiwian Kendley,1032,75,755,312,427,328,1436.0,272,80,174.0,483,232,37.4,2018,0.0
Phillip Carr,1165,104,959,409,363,294,2861.0,156,53,147.0,803,356,21.4,2018,0.0
Martez Cameron,728,448,755,263,257,165,3396.0,108,37,269.0,647,226,15.9,2018,0.0
Stanley Davis,1044,193,879,387,323,244,2503.0,122,26,242.0,757,361,23.8,2018,0.0
David Syfax,818,105,725,288,302,196,2411.0,161,46,175.0,564,242,20.3,2018,0.0
Lapri McCray-Pace,258,33,215,90,98,62,765.0,45,16,36.0,170,74,18.2,2018,0.0
Antonio Gillespie,464,63,480,157,66,43,1626.0,328,107,47.0,152,50,16.3,2018,0.0
Kyson Rawls,434,87,345,122,135,110,1206.0,241,80,79.0,104,42,18.8,2018,0.0
Tyler Streeter,303,17,241,116,47,35,671.0,92,36,29.0,149,80,20.6,2018,0.0
Khalil Gracey,60,13,57,22,16,9,175.0,21,7,13.0,36,15,21.0,2018,0.0
Elijah Staley,41,12,35,16,17,9,214.0,0,0,16.0,35,16,13.1,2018,0.0
Azariah Sykes,58,9,29,16,51,26,657.0,2,0,16.0,27,16,5.0,2018,0.0
Alex Ennis,255,12,199,107,71,41,1224.0,1,0,65.0,198,107,12.0,2018,0.0
Tyjhai Byers,28,1,27,14,3,0,288.0,0,0,8.0,27,14,6.0,2018,0.0
Junior Robinson,1872,457,1461,603,509,436,4049.0,619,230,325.0,842,373,26.5,2018,0.0
Jonah Antonio,669,61,624,223,54,42,2032.0,529,181,50.0,95,42,18.2,2018,0.0
Greg Alexander,625,39,498,214,71,49,1848.0,392,148,43.0,106,66,16.6,2018,0.0
Donald Carey,836,224,669,282,166,138,2646.0,340,134,209.0,329,148,18.8,2018,0.0
Chris Wray,681,163,517,304,228,73,2449.0,4,0,126.0,513,304,16.1,2018,0.0
Bobby Planutis,583,82,418,188,133,111,2062.0,237,96,116.0,181,92,15.3,2018,0.0
Ryan Gomes,364,29,288,155,96,54,1204.0,2,0,74.0,286,155,16.8,2018,1.0
Omar Habwe,695,90,544,219,232,165,2119.0,277,92,101.0,267,127,18.4,2018,0.0
James West IV,20,7,23,4,11,8,107.0,17,4,8.0,6,0,17.6,2018,0.0
Ace Stallings,62,9,46,25,26,12,320.0,1,0,15.0,45,25,12.2,2018,0.0
Ross Young,6,0,3,2,4,2,13.0,0,0,1.0,3,2,24.7,2018,0.0
Brandon Leftwich,101,35,81,30,53,38,378.0,15,3,39.0,66,27,20.4,2018,0.0
Odri Dedolli,9,0,13,3,0,0,33.0,10,3,1.0,3,0,22.2,2018,0.0
Damon'te Moore,0,0,0,0,0,0,5.0,0,0,1.0,0,0,10.1,2018,0.0
Jack Vukelich,0,0,4,0,0,0,10.0,2,0,0.0,2,0,21.7,2018,0.0
Jonathan Stark,2231,578,1762,749,547,440,4621.0,755,293,333.0,1007,456,26.2,2018,0.0
Terrell Miller Jr.,1012,96,741,362,200,151,1955.0,343,137,138.0,398,225,24.6,2018,0.0
Ja Morant,1213,532,821,398,411,333,2295.0,245,84,249.0,576,314,27.2,2018,1.0
Leroy Buchanan,722,92,577,279,137,96,1978.0,210,68,82.0,367,211,18.1,2018,0.0
Byron Hawkins,1209,197,1020,393,338,256,2991.0,515,167,146.0,505,226,22.5,2018,0.0
Jalen Dupree,793,36,546,282,309,213,2040.0,44,16,128.0,502,266,19.3,2018,0.0
Brion Sanchious,327,50,232,136,116,55,2183.0,0,0,93.0,232,136,8.6,2018,0.0
Brion Whitley,196,20,145,65,44,28,527.0,94,38,28.0,51,27,18.3,2018,0.0
Jachai Taylor,94,3,93,37,19,8,270.0,44,12,13.0,49,25,20.8,2018,0.0
Zach Hopewell,11,4,9,3,9,3,27.0,5,2,2.0,4,1,28.8,2018,0.0
Devin Gilmore,403,45,248,173,83,56,1140.0,5,1,39.0,243,172,14.4,2018,0.0
Shawn Anderson,1344,314,1044,473,496,339,3296.0,221,59,254.0,823,414,24.3,2018,0.0
Bryce Dulin,745,141,620,252,227,148,2344.0,284,93,145.0,336,159,19.4,2018,0.0
Hasan Abdullah,895,351,848,320,198,125,2742.0,403,130,273.0,445,190,22.6,2018,0.0
George Kiernan,928,76,756,302,214,178,1974.0,418,146,132.0,338,156,25.5,2018,0.0
Tom Lacey,679,125,450,231,341,216,2384.0,6,1,152.0,444,230,16.6,2018,0.0
Evan Wieck,797,88,541,338,197,121,2462.0,1,0,129.0,540,338,16.1,2018,0.0
Cam Davis,1215,192,1003,420,303,231,3008.0,410,144,127.0,593,276,22.0,2018,0.0
Ryan Pearson,241,36,247,84,33,23,785.0,171,50,55.0,76,34,20.8,2018,0.0
Tyler Riemersma,59,22,51,20,25,19,288.0,5,0,18.0,46,20,14.5,2018,0.0
Mo Lewis,52,7,34,19,15,14,204.0,0,0,7.0,34,19,12.2,2018,0.0
Nourse Fox,112,101,133,40,27,17,979.0,69,15,74.0,64,25,11.7,2018,0.0
Luke Loehr,327,44,275,121,67,44,1227.0,129,41,59.0,146,80,15.5,2018,0.0
Matt Cullen,8,4,5,3,0,0,21.0,4,2,1.0,1,1,14.8,2018,0.0
Ryan Reagan,6,0,4,2,3,2,8.0,0,0,0.0,4,2,35.0,2018,0.0
Dom Antonelli,23,0,26,8,0,0,83.0,22,7,5.0,4,1,18.3,2018,0.0
Anthony Mathis Jr.,5,1,4,2,0,0,14.0,2,1,1.0,2,1,18.4,2018,0.0
Alex Loehr,51,14,43,18,19,13,333.0,9,2,20.0,34,16,11.5,2018,0.0
Connor Mannion,11,0,10,2,7,7,44.0,6,0,2.0,4,2,17.6,2018,0.0
Danny Ogele,91,15,90,37,29,15,294.0,12,2,31.0,78,35,22.9,2018,0.0
Eli Lake,0,0,0,0,0,0,3.0,0,0,1.0,0,0,17.2,2018,0.0
Jack Lawrence,0,0,3,0,1,0,9.0,0,0,1.0,3,0,26.3,2018,0.0
Zach Jackson,1570,147,1101,536,434,345,3413.0,367,153,180.0,734,383,21.3,2018,0.0
Daniel Norl,572,115,437,195,132,108,1503.0,209,74,103.0,228,121,19.4,2018,0.0
JT Gibson,1309,244,1118,468,175,143,3449.0,642,230,178.0,476,238,19.8,2018,0.0
KJ Robinson,1112,269,949,390,202,170,2909.0,416,162,177.0,533,228,20.8,2018,0.0
Lamar Wofford-Humphrey,244,18,207,102,47,27,667.0,38,13,44.0,169,89,20.0,2018,0.0
Matt Pile,1177,136,876,512,323,153,3084.0,0,0,215.0,876,512,20.1,2018,0.0
Mitchell Hahn,1082,126,838,363,249,198,2600.0,424,158,114.0,414,205,20.4,2018,0.0
Ayo Akinwole,815,255,621,293,162,128,2748.0,243,101,126.0,378,192,14.9,2018,0.0
Daniel Meyer,277,25,249,116,109,45,1058.0,3,0,52.0,246,116,15.7,2018,0.0
Renard Suggs,187,35,186,66,35,22,502.0,109,33,34.0,77,33,23.8,2018,0.0
Alex Allbery,61,10,54,23,9,6,291.0,21,9,20.0,33,14,13.0,2018,0.0
James Palmer,1534,256,1219,485,563,418,3188.0,463,146,192.0,756,339,27.3,2018,0.0
Isaac Copeland,1333,155,1064,488,315,236,3472.0,371,121,161.0,693,367,20.3,2018,0.0
Glynn Watson Jr.,1532,382,1417,557,295,234,4027.0,527,184,182.0,890,373,21.8,2018,0.0
Isaiah Roby,786,143,588,280,252,177,2319.0,146,49,154.0,442,231,18.9,2018,1.0
Anton Gill,405,62,381,138,80,50,1397.0,240,79,57.0,141,59,17.2,2018,0.0
Evan Taylor,569,148,504,206,176,121,2299.0,102,36,124.0,402,170,15.6,2018,0.0
Jordy Tshimanga,514,46,390,202,188,110,1583.0,5,0,154.0,385,202,20.6,2018,0.0
Thomas Allen,480,104,424,173,68,56,1644.0,213,78,71.0,211,95,16.5,2018,0.0
Jack McVeigh,416,56,382,138,71,53,1370.0,257,87,53.0,125,51,17.1,2018,0.0
Duby Okeke,412,16,265,168,176,76,1593.0,0,0,121.0,265,168,14.7,2018,0.0
Tanner Borchardt,143,18,95,57,54,29,863.0,0,0,23.0,95,57,8.5,2018,0.0
Thorir Thorbjarnarson,444,119,395,160,66,50,1856.0,225,74,87.0,170,86,13.6,2018,0.0
Nana Akenten,377,33,346,130,58,38,1109.0,237,79,61.0,109,51,20.1,2018,0.0
Malcolm Laws,11,0,20,4,7,2,61.0,8,1,2.0,12,3,21.2,2018,0.0
Johnny Trueblood,46,26,41,17,23,9,241.0,9,3,12.0,32,14,13.6,2018,0.0
Brandon McCoy,559,17,382,208,193,140,949.0,9,3,87.0,373,205,27.5,2018,0.0
Shakur Juiston,773,133,604,343,141,74,1963.0,50,13,161.0,554,330,20.6,2018,0.0
Jovan Mooring,858,238,672,251,297,235,2032.0,358,121,143.0,314,130,22.5,2018,0.0
Jordan Johnson,867,466,559,241,380,309,2293.0,208,76,181.0,351,165,19.6,2018,0.0
Tervell Beck,669,51,427,247,212,142,1638.0,89,33,124.0,338,214,19.1,2018,0.0
Kris Clyburn,910,124,777,317,236,162,2504.0,347,114,135.0,430,203,19.7,2018,0.0
Amauri Hardy,1143,330,970,406,283,196,3198.0,418,135,198.0,552,271,20.2,2018,0.0
Cheikh Mbacke Diong,736,49,511,295,247,145,2499.0,13,1,145.0,498,294,15.5,2018,0.0
Anthony Smith,45,8,40,20,2,1,144.0,13,4,8.0,27,16,15.8,2018,0.0
Cheickna Dembele,166,20,137,60,94,46,886.0,0,0,66.0,137,60,13.6,2018,0.0
Jay Green,92,31,99,37,30,16,518.0,28,2,40.0,71,35,15.6,2018,0.0
Caleb Martin,1885,261,1461,605,502,364,3959.0,866,311,198.0,595,294,23.9,2018,1.0
Jordan Caroline,2045,242,1492,688,862,557,4535.0,322,112,268.0,1170,576,24.2,2018,0.0
Cody Martin,1178,434,899,450,328,226,3526.0,160,52,201.0,739,398,17.8,2018,1.0
Kendall Stephens,1181,123,980,376,158,128,2777.0,775,301,104.0,205,75,21.1,2018,0.0
Josh Hall,653,154,552,249,171,113,2409.0,141,42,136.0,411,207,15.9,2018,0.0
Lindsey Drew,982,508,769,347,255,179,3934.0,290,109,241.0,479,238,14.1,2018,0.0
Hallice Cooke,518,165,395,174,90,67,1935.0,232,103,89.0,163,71,13.8,2018,0.0
Elijah Foster,258,44,195,96,90,66,1152.0,2,0,53.0,193,96,12.3,2018,0.0
Darien Williams,133,6,96,47,49,36,432.0,14,3,28.0,82,44,16.5,2018,0.0
Charlie Tooley,17,0,16,5,2,2,57.0,15,5,4.0,1,0,18.4,2018,0.0
Justin Brent,2,0,1,1,0,0,5.0,0,0,0.0,1,1,10.1,2018,0.0
David Cunningham,7,3,9,2,4,2,51.0,6,1,4.0,3,1,14.3,2018,0.0
Elijah Cooks,0,0,0,0,0,0,4.0,0,0,0.0,0,0,0.0,2018,0.0
John Jones,644,106,616,207,111,95,1816.0,406,135,115.0,210,72,19.8,2018,0.0
Tanner Leissner,1962,196,1476,667,675,521,4096.0,339,107,230.0,1137,560,25.6,2018,0.0
Iba Camara,918,92,698,357,351,204,2595.0,1,0,210.0,697,357,21.3,2018,0.0
Josh Hopkins,759,92,747,256,122,86,2408.0,499,161,80.0,248,95,18.7,2018,0.0
Jordan Reed,673,149,657,223,99,81,2627.0,456,146,143.0,201,77,16.8,2018,0.0
Jacoby Armstrong,1028,106,834,383,358,241,2724.0,89,21,181.0,745,362,22.9,2018,0.0
John Ogwuche,251,37,217,81,69,51,981.0,117,38,35.0,100,43,15.0,2018,0.0
Elijah Jordan,327,143,332,119,59,36,1221.0,158,53,86.0,174,66,19.0,2018,0.0
Darryl Stewart,83,28,95,31,16,9,310.0,50,12,29.0,45,19,21.7,2018,0.0
Keon Burns,194,46,181,62,32,23,969.0,132,47,40.0,49,15,12.5,2018,0.0
David Watkins,376,36,372,132,89,52,1213.0,206,60,75.0,166,72,21.1,2018,0.0
Evan Horn,36,9,38,11,15,9,141.0,17,5,15.0,21,6,21.8,2018,0.0
Luke Rosinski,107,16,102,37,58,32,563.0,4,1,37.0,98,36,15.2,2018,0.0
Chris Lester,419,76,390,156,86,50,1589.0,187,57,64.0,203,99,15.8,2018,0.0
Zach Lofton,1599,188,1238,511,524,407,2906.0,528,170,198.0,710,341,28.7,2018,1.0
Jemerrio Jones,705,209,595,299,171,98,1797.0,65,9,151.0,530,290,22.3,2018,1.0
A.J. Harris,743,277,692,277,136,85,2278.0,326,104,144.0,366,173,19.5,2018,0.0
Eli Chuha,1049,124,675,396,377,246,2272.0,53,11,160.0,622,385,21.8,2018,0.0
Sidy Ndir,669,143,517,219,220,158,2042.0,240,73,119.0,277,146,17.9,2018,0.0
Johnathon Wilkins,692,136,542,289,150,86,2489.0,75,28,152.0,467,261,15.4,2018,0.0
Keyon Jones,243,37,202,83,29,18,741.0,154,59,37.0,48,24,16.6,2018,0.0
Johnny McCants,817,129,549,311,243,132,2384.0,176,63,123.0,373,248,16.7,2018,0.0
Shunn Buchanan,230,226,241,69,90,62,1702.0,112,30,129.0,129,39,12.2,2018,0.0
Gabe Hadley,259,41,199,91,26,19,643.0,141,58,40.0,58,33,20.3,2018,0.0
Joe Garza,82,18,65,22,21,20,365.0,53,18,19.0,12,4,12.5,2018,0.0
Kortrijk Miles,11,2,5,4,5,3,32.0,1,0,4.0,4,4,17.2,2018,0.0
Leston Gordon,9,2,9,4,4,1,36.0,0,0,4.0,9,4,20.0,2018,0.0
Anthony Mathis,1244,145,856,381,219,191,2675.0,667,291,120.0,189,90,19.4,2018,0.0
Antino Jackson,1282,407,1108,429,263,200,3171.0,639,224,267.0,469,205,23.8,2018,0.0
Joe Furstinger,545,120,374,183,238,174,1932.0,35,5,100.0,339,178,15.2,2018,0.0
Sam Logwood,930,162,740,333,303,216,2749.0,134,48,178.0,606,285,19.4,2018,0.0
Makuach Maluach,1308,172,1018,467,337,248,3078.0,371,126,206.0,647,341,21.6,2018,0.0
Chris McNeal,592,269,548,186,184,122,2226.0,349,98,158.0,199,88,17.4,2018,0.0
Troy Simmons,695,107,571,235,98,79,1743.0,385,146,69.0,186,89,19.3,2018,0.0
Dane Kuiper,568,152,522,195,106,85,2181.0,303,93,87.0,219,102,14.6,2018,0.0
Vladimir Pinchuk,297,30,218,115,131,67,1158.0,0,0,49.0,218,115,13.7,2018,0.0
Jachai Simmons,84,18,81,33,8,4,341.0,43,14,14.0,38,19,14.0,2018,0.0
Mike Mondragon,2,1,1,1,0,0,12.0,0,0,2.0,1,1,12.1,2018,0.0
Travin Thibodeaux,984,223,716,376,342,216,2810.0,46,16,231.0,670,360,19.2,2018,0.0
Makur Puou,470,63,373,191,139,88,1683.0,2,0,108.0,371,191,16.1,2018,0.0
Bryson Robinson,1171,240,914,367,282,233,2615.0,572,204,197.0,342,163,23.2,2018,0.0
Troy Green,1327,313,994,455,496,377,3177.0,139,40,273.0,855,415,22.9,2018,0.0
Ezekiel Charles,528,68,404,180,102,75,1380.0,224,93,62.0,180,87,18.3,2018,0.0
Michael Zeno,607,94,570,226,273,154,1979.0,12,1,190.0,558,225,21.6,2018,0.0
Dionte Champion,153,21,98,51,67,47,515.0,21,4,26.0,77,47,15.1,2018,0.0
Damion Rosser,880,226,693,349,262,171,2504.0,59,11,187.0,634,338,19.4,2018,0.0
Lamont Berzat,440,229,391,145,109,78,1875.0,236,72,126.0,155,73,14.7,2018,0.0
Scott Plaisance,462,40,388,188,127,78,1163.0,33,8,90.0,355,180,22.5,2018,0.0
Tyren Harrison,101,27,62,37,35,23,386.0,11,4,29.0,51,33,13.8,2018,0.0
Matthew Jiles,50,21,57,16,19,11,314.0,30,7,21.0,27,9,13.5,2018,0.0
Bol Riek,30,3,21,10,13,8,100.0,4,2,12.0,17,8,19.2,2018,0.0
Jorge Rosa,627,63,562,208,116,82,1603.0,362,129,80.0,200,79,22.2,2018,0.0
Charles Bohannon,68,24,61,23,17,12,292.0,36,10,21.0,25,13,15.0,2018,0.0
Kahlil Dukes,1294,254,983,427,287,261,2498.0,435,179,175.0,548,248,24.4,2018,0.0
Matt Scott,1726,273,1336,553,623,457,3600.0,493,163,290.0,843,390,25.9,2018,0.0
Marvin Prochet,1340,179,1136,463,337,238,3882.0,473,176,149.0,663,287,18.1,2018,0.0
James Towns,1124,270,871,366,395,317,2694.0,238,75,218.0,633,291,23.9,2018,0.0
Dominic Robb,1033,66,789,416,293,194,2814.0,21,7,126.0,768,409,18.2,2018,0.0
Greg King,368,26,289,158,126,52,1262.0,0,0,96.0,289,158,17.0,2018,0.0
Keleaf Tate,369,45,405,134,59,39,1254.0,202,62,64.0,203,72,19.2,2018,0.0
Chris Barton,709,121,544,219,276,207,2477.0,199,64,152.0,345,155,16.3,2018,0.0
Kevin Larkin,637,69,638,240,112,89,1495.0,237,68,71.0,401,172,24.0,2018,0.0
Greg Kuakumensah,497,51,440,205,97,59,1653.0,91,28,87.0,349,177,18.4,2018,0.0
Kierell Green,61,8,58,25,10,6,217.0,26,5,14.0,32,20,17.0,2018,0.0
Sam Volmy,2,0,3,0,2,2,5.0,1,0,0.0,2,0,36.5,2018,0.0
Dominik Fragala,284,28,244,91,67,52,629.0,158,50,29.0,86,41,22.7,2018,0.0
Roddy Peters,857,237,658,316,290,211,1608.0,61,14,216.0,597,302,29.6,2018,0.0
Tevon Saddler,1274,297,1001,434,535,374,2690.0,136,32,326.0,865,402,28.6,2018,0.0
Lafayette Rutledge,531,19,409,161,70,55,1082.0,391,154,24.0,18,7,20.2,2018,0.0
Jahvaughn Powell,685,242,556,228,110,91,1905.0,365,138,177.0,191,90,19.5,2018,0.0
Kimani Jackson,396,27,272,152,141,90,1085.0,12,2,93.0,260,150,18.8,2018,0.0
Kevin Johnson,1101,437,974,378,262,202,3793.0,433,143,197.0,541,235,16.3,2018,1.0
Ryghe Lyons,507,101,408,223,90,56,1691.0,29,5,125.0,379,218,16.1,2018,0.0
Legend Robertin,96,1,73,40,39,16,442.0,1,0,28.0,72,40,12.7,2018,0.0
Stevie Repichowski,409,24,349,132,50,39,1270.0,297,106,34.0,52,26,15.7,2018,0.0
Zaquavian Smith,357,37,341,125,50,38,834.0,219,69,42.0,122,56,21.7,2018,0.0
Daniel Regis,243,28,171,91,98,60,772.0,6,1,51.0,165,90,17.0,2018,0.0
Maurice O'Field,37,8,35,15,8,3,234.0,14,4,10.0,21,11,10.0,2018,0.0
Zach Young,35,36,42,4,38,26,362.0,21,1,30.0,21,3,12.1,2018,0.0
Rafe Blades,0,2,3,0,0,0,23.0,2,0,2.0,1,0,9.9,2018,0.0
Anthony Tarke,1153,174,923,416,384,227,2548.0,307,94,219.0,616,322,25.0,2018,0.0
Abdul Lewis,1247,180,991,457,478,303,3530.0,104,30,316.0,887,427,21.8,2018,0.0
Diandre Wilson,700,96,534,219,228,170,1744.0,253,92,105.0,281,127,21.8,2018,0.0
Zach Cooks,1788,230,1456,623,461,344,3811.0,570,198,236.0,886,425,26.1,2018,0.0
Shawndale Jones,336,49,272,118,91,65,1015.0,97,35,46.0,175,83,17.9,2018,0.0
Shyquan Gibbs,818,246,655,278,240,174,3345.0,231,88,135.0,424,190,13.9,2018,0.0
Reilly Walsh,363,99,353,142,56,37,1737.0,135,42,78.0,218,100,13.4,2018,0.0
Donovan Greer,245,35,218,83,28,21,685.0,155,58,32.0,63,25,19.4,2018,0.0
Mohamed Bendary,409,84,278,181,77,47,1479.0,1,0,92.0,277,181,13.8,2018,0.0
San Antonio Brinson,745,91,655,276,221,139,2200.0,171,54,142.0,484,222,21.4,2018,0.0
David Kachelries,442,158,325,173,66,47,1084.0,146,49,98.0,179,124,19.7,2018,0.0
Taj Price,65,8,44,21,26,21,158.0,6,2,11.0,38,19,20.9,2018,0.0
Chris Jenkins,565,45,534,192,28,17,1714.0,464,164,48.0,70,28,17.3,2018,0.0
Steven Whitley,1126,419,933,397,429,263,3092.0,256,69,310.0,677,328,22.7,2018,0.0
Alex Long,1056,99,878,427,344,201,3058.0,11,1,248.0,867,426,20.6,2018,0.0
Kyle Williams,510,71,430,169,92,65,1485.0,281,107,87.0,149,62,18.2,2018,0.0
Preston Bungei,465,100,371,163,179,129,1479.0,43,10,121.0,328,153,18.9,2018,0.0
Derrik Jamerson Jr.,658,32,484,223,51,45,1818.0,373,167,41.0,111,56,14.5,2018,0.0
Nic Thomas,954,120,800,284,266,213,2202.0,460,173,156.0,340,111,24.1,2018,0.0
Mastadi Pitt,589,162,498,196,164,124,1481.0,214,73,99.0,284,123,22.0,2018,0.0
Bryan Gellineau,180,10,125,77,47,26,531.0,0,0,50.0,125,77,17.9,2018,0.0
Stavian Allen,158,16,144,61,41,25,547.0,41,11,38.0,103,50,17.7,2018,0.0
Dan Robinson,195,25,174,77,71,41,940.0,0,0,69.0,174,77,14.3,2018,0.0
Vilontae Eanes,0,1,0,0,2,0,3.0,0,0,0.0,0,0,15.0,2018,0.0
MaCio Teague,1943,277,1462,646,423,364,4188.0,703,287,168.0,759,359,22.1,2018,0.0
Ahmad Thomas,1626,256,1329,671,346,214,3470.0,201,70,245.0,1128,601,25.4,2018,0.0
Raekwon Miller,686,179,512,210,186,138,1906.0,339,128,152.0,173,82,20.2,2018,0.0
Kevin Vannatta,1243,378,889,412,383,290,4166.0,366,129,215.0,523,283,15.6,2018,0.0
Jonathan Baehre,378,58,304,148,62,48,1254.0,101,34,67.0,203,114,16.8,2018,0.0
Alec Wnuk,456,87,341,179,152,90,1466.0,33,8,118.0,308,171,18.6,2018,0.0
Drew Rackley,219,43,166,72,43,30,698.0,103,45,38.0,63,27,16.6,2018,0.0
Donovan Gilmore,399,22,301,155,126,87,1389.0,8,2,87.0,293,153,17.5,2018,0.0
Jalen Seegars,177,28,138,54,71,48,831.0,62,21,60.0,76,33,15.0,2018,0.0
Justin Brown,50,3,34,17,14,13,103.0,16,3,9.0,18,14,25.8,2018,0.0
Grant Townsend,17,1,17,7,16,3,61.0,1,0,6.0,16,7,25.8,2018,0.0
L.J. Thorpe,804,173,594,279,290,201,1776.0,126,45,175.0,468,234,26.1,2018,0.0
Femi Olujobi,1059,88,690,376,388,275,2401.0,106,32,175.0,584,344,21.4,2018,0.0
Davaris McGowens,624,66,449,241,215,142,1494.0,1,0,93.0,448,241,22.1,2018,0.0
Denzel Keyes,655,66,532,246,213,125,2138.0,149,38,95.0,383,208,17.3,2018,0.0
Aaren Edmead,738,217,645,226,232,176,2308.0,332,110,190.0,313,116,20.4,2018,0.0
Devonte Boykins,632,179,530,205,175,122,2499.0,308,100,116.0,222,105,14.3,2018,0.0
Kameron Langley,979,757,748,343,435,258,3558.0,109,35,314.0,639,308,17.3,2018,0.0
Japhet Kadji,331,26,297,118,63,47,1062.0,144,48,53.0,153,70,17.5,2018,0.0
Amari Hamilton,536,71,496,177,101,74,1352.0,326,108,90.0,170,69,24.2,2018,0.0
Milik Gantz,390,71,305,156,93,61,1059.0,62,17,80.0,243,139,20.8,2018,0.0
Kwei Lartey,100,40,104,37,17,9,429.0,61,17,33.0,43,20,16.7,2018,0.0
Raymon Pratt,236,29,204,93,67,40,764.0,43,10,42.0,161,83,18.9,2018,0.0
Donte Watson,169,27,134,65,23,19,484.0,60,20,32.0,74,45,19.0,2018,0.0
Austin Williams,252,143,254,89,144,63,1127.0,56,11,153.0,198,78,22.2,2018,0.0
D'Andre Johnson,50,5,48,20,7,3,160.0,22,7,10.0,26,13,19.7,2018,0.0
Dalen Dotson,3,1,2,1,2,1,6.0,0,0,4.0,2,1,57.3,2018,0.0
Raasean Davis,1126,33,744,483,246,160,2319.0,1,0,164.0,743,483,22.0,2018,0.0
Pablo Rivas,623,45,456,249,98,72,1504.0,148,53,61.0,308,196,18.6,2018,0.0
Reggie Gardner,568,102,546,186,109,80,1594.0,363,116,76.0,183,70,21.0,2018,0.0
Jordan Perkins,688,524,589,251,224,149,2790.0,126,37,278.0,463,214,17.5,2018,0.0
Larry McKnight,531,43,448,185,149,106,1512.0,179,55,92.0,269,130,20.1,2018,0.0
Dominique Reid,445,38,363,161,175,120,1022.0,9,3,101.0,354,158,27.4,2018,0.0
Zacarry Douglas,560,77,463,208,142,96,1792.0,150,48,96.0,313,160,17.3,2018,0.0
C.J. Wiggins,256,127,231,86,95,64,860.0,61,20,60.0,170,66,19.4,2018,0.0
Brandon Goldsmith,106,20,99,39,38,24,425.0,19,4,34.0,80,35,17.6,2018,0.0
Alston Jones,103,45,84,38,25,21,316.0,8,6,41.0,76,32,21.4,2018,0.0
John Guerra,114,26,94,32,54,38,444.0,42,12,21.0,52,20,15.7,2018,0.0
Raekwon Harney,37,62,54,16,8,1,277.0,15,4,26.0,39,12,15.0,2018,0.0
Marius McAllister,45,22,36,18,15,9,252.0,2,0,15.0,34,18,11.5,2018,0.0
Alex Mills,3,0,10,1,1,1,22.0,6,0,0.0,4,1,23.6,2018,0.0
Rashann London,522,172,545,199,123,80,2221.0,163,44,143.0,382,155,18.0,2018,0.0
Francis Alonso,2144,324,1541,661,489,426,4031.0,977,396,309.0,564,265,26.0,2018,0.0
Marvin Smith,1147,94,1060,380,264,187,3112.0,624,200,142.0,436,180,21.6,2018,0.0
James Dickey,1013,171,759,413,348,186,3248.0,12,1,231.0,747,412,17.7,2018,0.0
Isaiah Miller,1965,341,1750,830,423,244,3376.0,253,61,282.0,1497,769,32.4,2018,0.0
Demetrius Troy,956,453,872,341,140,103,3132.0,461,171,244.0,411,170,19.0,2018,0.0
Jordy Kuiper,531,76,451,208,98,62,2164.0,162,53,102.0,289,155,13.9,2018,0.0
Kyrin Galloway,838,49,638,309,140,98,2576.0,347,122,89.0,291,187,15.3,2018,0.0
Malik Massey,537,186,497,173,136,100,2511.0,279,91,124.0,218,82,13.5,2018,0.0
Garrett Collins,156,10,115,51,18,17,413.0,96,37,11.0,19,14,16.5,2018,0.0
Kylia Sykes,69,21,50,27,13,8,355.0,22,7,20.0,28,20,11.0,2018,0.0
Justin Jordan,187,59,177,68,42,28,907.0,72,23,54.0,105,45,14.7,2018,0.0
Lloyd Burgess,67,9,44,25,42,17,401.0,0,0,22.0,44,25,10.9,2018,0.0
Allerik Freeman,1378,213,1064,435,406,324,3480.0,488,184,213.0,576,251,20.8,2018,0.0
Torin Dorn,1651,158,1288,648,389,258,3622.0,295,97,220.0,993,551,22.6,2018,0.0
Omer Yurtseven,978,72,752,405,205,142,1911.0,61,26,125.0,691,379,24.4,2018,0.0
Braxton Beverly,1012,307,862,333,171,128,3419.0,589,218,129.0,273,115,15.2,2018,0.0
Lennard Freeman,635,77,448,244,268,147,2700.0,0,0,88.0,448,244,12.3,2018,0.0
Markell Johnson,1163,607,961,420,268,173,3260.0,436,150,289.0,525,270,20.4,2018,0.0
Sam Hunt,1157,152,899,352,270,245,2942.0,574,208,178.0,325,144,20.7,2018,0.0
Abdul-Malik Abu,1174,110,934,462,395,248,2934.0,19,2,184.0,915,460,21.9,2018,0.0
Lavar Batts Jr.,605,185,509,213,216,143,1684.0,157,36,139.0,352,177,22.2,2018,0.0
Darius Hicks,189,29,157,63,125,63,929.0,6,0,57.0,151,63,13.9,2018,0.0
Shaun Kirk,46,5,44,18,9,6,176.0,19,4,13.0,25,14,16.8,2018,0.0
Spencer Newman,0,0,3,0,0,0,11.0,2,0,1.0,1,0,17.3,2018,0.0
Devontae Cacok,1593,66,1018,651,490,290,3064.0,1,1,198.0,1017,650,22.4,2018,1.0
Jordon Talley,1306,479,1052,419,447,351,3097.0,341,117,219.0,711,302,22.9,2018,0.0
Ty Taylor II,1065,153,1011,364,236,174,2592.0,507,163,168.0,504,201,23.4,2018,0.0
Jaylen Fornes,881,121,699,294,229,168,2146.0,335,125,133.0,364,169,20.6,2018,0.0
Marcus Bryan,513,62,443,200,197,112,2092.0,1,1,84.0,442,199,14.1,2018,0.0
